Rk,Date,Tm,Unnamed: 3_level_1,Opp,Result,MP,FG,FGA,FG%,2P,2PA,2P%,3P,3PA,3P%,FT,FTA,FT%,PTS
1,2019-04-10,ATL,,IND,L 134-135,240,43,103,.417,26,62,.419,17,41,.415,31,38,.816,134
2,2019-04-10,IND,@,ATL,W 135-134,240,45,98,.459,33,68,.485,12,30,.400,33,39,.846,135
3,2019-04-10,BRK,,MIA,W 113-94,240,43,114,.377,22,56,.393,21,58,.362,6,7,.857,113
4,2019-04-10,MIA,@,BRK,L 94-113,240,38,98,.388,30,57,.526,8,41,.195,10,15,.667,94
5,2019-04-10,CHA,,ORL,L 114-122,240,41,78,.526,33,49,.673,8,29,.276,24,27,.889,114
6,2019-04-10,ORL,@,CHO,W 122-114,240,48,88,.545,37,58,.638,11,30,.367,15,20,.750,122
7,2019-04-10,DEN,,MIN,W 99-95,240,39,87,.448,29,54,.537,10,33,.303,11,17,.647,99
8,2019-04-10,MIN,@,DEN,L 95-99,240,39,91,.429,26,59,.441,13,32,.406,4,6,.667,95
9,2019-04-10,LAC,,UTA,W 143-137 (OT),265,54,106,.509,42,78,.538,12,28,.429,23,30,.767,143
10,2019-04-10,UTA,@,LAC,L 137-143 (OT),265,47,106,.443,33,71,.465,14,35,.400,29,33,.879,137
11,2019-04-10,GSW,@,MEM,L 117-132,240,46,92,.500,33,62,.532,13,30,.433,12,14,.857,117
12,2019-04-10,MEM,,GSW,W 132-117,240,48,98,.490,27,52,.519,21,46,.457,15,18,.833,132
13,2019-04-10,MIL,,OKC,L 116-127,240,43,100,.430,28,54,.519,15,46,.326,15,21,.714,116
14,2019-04-10,OKC,@,MIL,W 127-116,240,48,99,.485,25,45,.556,23,54,.426,8,13,.615,127
15,2019-04-10,DET,@,NYK,W 115-89,240,41,85,.482,27,52,.519,14,33,.424,19,20,.950,115
16,2019-04-10,NYK,,DET,L 89-115,240,31,77,.403,22,47,.468,9,30,.300,18,25,.720,89
17,2019-04-10,CHI,@,PHI,L 109-125,240,45,95,.474,36,71,.507,9,24,.375,10,15,.667,109
18,2019-04-10,PHI,,CHI,W 125-109,240,52,93,.559,40,67,.597,12,26,.462,9,15,.600,125
19,2019-04-10,POR,,SAC,W 136-131,240,53,91,.582,39,67,.582,14,24,.583,16,22,.727,136
20,2019-04-10,SAC,@,POR,L 131-136,240,50,96,.521,32,53,.604,18,43,.419,13,16,.813,131
21,2019-04-10,DAL,@,SAS,L 94-105,240,37,91,.407,26,54,.481,11,37,.297,9,12,.750,94
22,2019-04-10,SAS,,DAL,W 105-94,240,41,88,.466,33,64,.516,8,24,.333,15,18,.833,105
23,2019-04-09,CHI,,NYK,L 86-96,240,30,83,.361,23,61,.377,7,22,.318,19,29,.655,86
24,2019-04-09,NYK,@,CHI,W 96-86,240,37,93,.398,23,53,.434,14,40,.350,8,13,.615,96
25,2019-04-09,CHA,@,CLE,W 124-97,240,45,78,.577,23,34,.676,22,44,.500,12,17,.706,124
26,2019-04-09,CLE,,CHO,L 97-124,240,40,89,.449,29,59,.492,11,30,.367,6,8,.750,97
27,2019-04-09,DAL,,PHO,W 120-109,240,41,91,.451,25,51,.490,16,40,.400,22,27,.815,120
28,2019-04-09,PHO,@,DAL,L 109-120,240,38,88,.432,25,53,.472,13,35,.371,20,28,.714,109
29,2019-04-09,DET,,MEM,W 100-93,240,35,88,.398,25,54,.463,10,34,.294,20,28,.714,100
30,2019-04-09,MEM,@,DET,L 93-100,240,33,69,.478,23,45,.511,10,24,.417,17,21,.810,93
31,2019-04-09,LAL,,POR,L 101-104,240,40,94,.426,30,65,.462,10,29,.345,11,17,.647,101
32,2019-04-09,POR,@,LAL,W 104-101,240,37,90,.411,26,53,.491,11,37,.297,19,22,.864,104
33,2019-04-09,MIA,,PHI,W 122-99,240,46,87,.529,33,60,.550,13,27,.481,17,23,.739,122
34,2019-04-09,PHI,@,MIA,L 99-122,240,40,98,.408,35,73,.479,5,25,.200,14,16,.875,99
35,2019-04-09,MIN,,TOR,L 100-120,240,38,91,.418,25,49,.510,13,42,.310,11,14,.786,100
36,2019-04-09,TOR,@,MIN,W 120-100,240,46,88,.523,30,51,.588,16,37,.432,12,17,.706,120
37,2019-04-09,GSW,@,NOP,W 112-103,240,43,89,.483,31,59,.525,12,30,.400,14,21,.667,112
38,2019-04-09,NOP,,GSW,L 103-112,240,44,99,.444,35,66,.530,9,33,.273,6,10,.600,103
39,2019-04-09,HOU,@,OKC,L 111-112,240,38,88,.432,20,35,.571,18,53,.340,17,20,.850,111
40,2019-04-09,OKC,,HOU,W 112-111,240,40,96,.417,24,55,.436,16,41,.390,16,20,.800,112
41,2019-04-09,DEN,@,UTA,L 108-118,240,41,88,.466,29,63,.460,12,25,.480,14,22,.636,108
42,2019-04-09,UTA,,DEN,W 118-108,240,41,78,.526,31,51,.608,10,27,.370,26,34,.765,118
43,2019-04-09,BOS,@,WAS,W 116-110,240,45,99,.455,30,55,.545,15,44,.341,11,23,.478,116
44,2019-04-09,WAS,,BOS,L 110-116,240,41,97,.423,27,58,.466,14,39,.359,14,18,.778,110
45,2019-04-07,BOS,,ORL,L 108-116,240,42,89,.472,30,58,.517,12,31,.387,12,14,.857,108
46,2019-04-07,ORL,@,BOS,W 116-108,240,41,90,.456,29,57,.509,12,33,.364,22,22,1.000,116
47,2019-04-07,CLE,,SAS,L 90-112,240,31,79,.392,23,50,.460,8,29,.276,20,27,.741,90
48,2019-04-07,SAS,@,CLE,W 112-90,240,43,82,.524,34,60,.567,9,22,.409,17,22,.773,112
49,2019-04-07,CHA,@,DET,W 104-91,240,38,88,.432,28,57,.491,10,31,.323,18,23,.783,104
50,2019-04-07,DET,,CHO,L 91-104,240,34,92,.370,24,51,.471,10,41,.244,13,15,.867,91
51,2019-04-07,GSW,,LAC,W 131-104,240,53,97,.546,41,60,.683,12,37,.324,13,15,.867,131
52,2019-04-07,LAC,@,GSW,L 104-131,240,38,79,.481,28,60,.467,10,19,.526,18,29,.621,104
53,2019-04-07,HOU,,PHO,W 149-113,240,53,100,.530,26,43,.605,27,57,.474,16,21,.762,149
54,2019-04-07,PHO,@,HOU,L 113-149,240,43,93,.462,32,59,.542,11,34,.324,16,21,.762,113
55,2019-04-07,BRK,@,IND,W 108-96,240,40,88,.455,29,52,.558,11,36,.306,17,22,.773,108
56,2019-04-07,IND,,BRK,L 96-108,240,41,85,.482,31,58,.534,10,27,.370,4,7,.571,96
57,2019-04-07,LAL,,UTA,W 113-109,240,46,89,.517,39,64,.609,7,25,.280,14,21,.667,113
58,2019-04-07,UTA,@,LAL,L 109-113,240,38,84,.452,25,42,.595,13,42,.310,20,28,.714,109
59,2019-04-07,DAL,@,MEM,W 129-127 (OT),265,45,98,.459,33,57,.579,12,41,.293,27,34,.794,129
60,2019-04-07,MEM,,DAL,L 127-129 (OT),265,42,98,.429,23,54,.426,19,44,.432,24,28,.857,127
61,2019-04-07,ATL,@,MIL,L 107-115,240,40,100,.400,23,55,.418,17,45,.378,10,19,.526,107
62,2019-04-07,MIL,,ATL,W 115-107,240,40,91,.440,31,50,.620,9,41,.220,26,34,.765,115
63,2019-04-07,MIN,,OKC,L 126-132,240,46,85,.541,36,62,.581,10,23,.435,24,29,.828,126
64,2019-04-07,OKC,@,MIN,W 132-126,240,48,92,.522,34,58,.586,14,34,.412,22,26,.846,132
65,2019-04-07,NYK,,WAS,W 113-110,240,41,80,.513,24,46,.522,17,34,.500,14,19,.737,113
66,2019-04-07,WAS,@,NYK,L 110-113,240,43,103,.417,33,69,.478,10,34,.294,14,18,.778,110
67,2019-04-07,DEN,@,POR,L 108-115,240,42,95,.442,29,62,.468,13,33,.394,11,20,.550,108
68,2019-04-07,POR,,DEN,W 115-108,240,41,89,.461,32,61,.525,9,28,.321,24,29,.828,115
69,2019-04-07,NOP,@,SAC,W 133-129,240,52,101,.515,33,59,.559,19,42,.452,10,12,.833,133
70,2019-04-07,SAC,,NOP,L 129-133,240,50,109,.459,34,69,.493,16,40,.400,13,17,.765,129
71,2019-04-07,MIA,@,TOR,L 109-117 (OT),265,41,100,.410,28,66,.424,13,34,.382,14,19,.737,109
72,2019-04-07,TOR,,MIA,W 117-109 (OT),265,39,87,.448,23,46,.500,16,41,.390,23,27,.852,117
73,2019-04-06,CHI,,PHI,L 96-116,240,38,89,.427,30,64,.469,8,25,.320,12,15,.800,96
74,2019-04-06,PHI,@,CHI,W 116-96,240,46,88,.523,37,61,.607,9,27,.333,15,26,.577,116
75,2019-04-06,BRK,@,MIL,W 133-128,240,48,97,.495,29,52,.558,19,45,.422,18,23,.783,133
76,2019-04-06,MIL,,BRK,L 128-133,240,49,88,.557,33,54,.611,16,34,.471,14,21,.667,128
77,2019-04-05,CHA,,TOR,W 113-111,240,44,94,.468,31,55,.564,13,39,.333,12,14,.857,113
78,2019-04-05,TOR,@,CHO,L 111-113,240,43,80,.538,34,54,.630,9,26,.346,16,20,.800,111
79,2019-04-05,DAL,,MEM,L 112-122,240,41,96,.427,24,49,.490,17,47,.362,13,21,.619,112
80,2019-04-05,MEM,@,DAL,W 122-112,240,46,96,.479,30,55,.545,16,41,.390,14,16,.875,122
81,2019-04-05,DEN,,POR,W 119-110,240,43,84,.512,36,57,.632,7,27,.259,26,29,.897,119
82,2019-04-05,POR,@,DEN,L 110-119,240,42,86,.488,32,57,.561,10,29,.345,16,20,.800,110
83,2019-04-05,CLE,@,GSW,L 114-120,240,43,97,.443,36,67,.537,7,30,.233,21,23,.913,114
84,2019-04-05,GSW,,CLE,W 120-114,240,46,87,.529,26,50,.520,20,37,.541,8,8,1.000,120
85,2019-04-05,HOU,,NYK,W 120-96,240,43,101,.426,21,42,.500,22,59,.373,12,17,.706,120
86,2019-04-05,NYK,@,HOU,L 96-120,240,37,82,.451,31,55,.564,6,27,.222,16,27,.593,96
87,2019-04-05,BOS,@,IND,W 117-97,240,48,92,.522,41,65,.631,7,27,.259,14,16,.875,117
88,2019-04-05,IND,,BOS,L 97-117,240,38,92,.413,28,69,.406,10,23,.435,11,19,.579,97
89,2019-04-05,LAC,,LAL,L 117-122,240,40,91,.440,30,62,.484,10,29,.345,27,31,.871,117
90,2019-04-05,LAL,@,LAC,W 122-117,240,43,96,.448,29,64,.453,14,32,.438,22,27,.815,122
91,2019-04-05,MIA,@,MIN,L 109-111,240,45,88,.511,35,54,.648,10,34,.294,9,12,.750,109
92,2019-04-05,MIN,,MIA,W 111-109,240,43,86,.500,35,62,.565,8,24,.333,17,21,.810,111
93,2019-04-05,DET,@,OKC,L 110-123,240,35,81,.432,20,40,.500,15,41,.366,25,31,.806,110
94,2019-04-05,OKC,,DET,W 123-110,240,48,101,.475,36,72,.500,12,29,.414,15,22,.682,123
95,2019-04-05,ATL,@,ORL,L 113-149,240,41,94,.436,31,55,.564,10,39,.256,21,31,.677,113
96,2019-04-05,ORL,,ATL,W 149-113,240,56,92,.609,38,55,.691,18,37,.486,19,25,.760,149
97,2019-04-05,NOP,@,PHO,L 126-133 (OT),265,49,101,.485,41,78,.526,8,23,.348,20,27,.741,126
98,2019-04-05,PHO,,NOP,W 133-126 (OT),265,51,104,.490,37,68,.544,14,36,.389,17,21,.810,133
99,2019-04-05,SAC,@,UTA,L 98-119,240,38,92,.413,33,71,.465,5,21,.238,17,25,.680,98
100,2019-04-05,UTA,,SAC,W 119-98,240,44,85,.518,29,52,.558,15,33,.455,16,25,.640,119
101,2019-04-05,SAS,@,WAS,W 129-112,240,51,91,.560,41,66,.621,10,25,.400,17,20,.850,129
102,2019-04-05,WAS,,SAS,L 112-129,240,42,88,.477,33,56,.589,9,32,.281,19,22,.864,112
103,2019-04-04,GSW,@,LAL,W 108-90,240,43,98,.439,25,52,.481,18,46,.391,4,5,.800,108
104,2019-04-04,LAL,,GSW,L 90-108,240,37,104,.356,29,67,.433,8,37,.216,8,14,.571,90
105,2019-04-04,MIL,@,PHI,W 128-122,240,42,93,.452,30,59,.508,12,34,.353,32,43,.744,128
106,2019-04-04,PHI,,MIL,L 122-128,240,45,95,.474,27,59,.458,18,36,.500,14,18,.778,122
107,2019-04-04,CLE,@,SAC,L 104-117,240,44,81,.543,33,56,.589,11,25,.440,5,9,.556,104
108,2019-04-04,SAC,,CLE,W 117-104,240,48,97,.495,34,59,.576,14,38,.368,7,10,.700,117
109,2019-04-03,ATL,,PHI,W 130-122,240,48,92,.522,36,56,.643,12,36,.333,22,28,.786,130
110,2019-04-03,PHI,@,ATL,L 122-130,240,45,98,.459,35,67,.522,10,31,.323,22,38,.579,122
111,2019-04-03,BRK,,TOR,L 105-115,240,41,86,.477,31,54,.574,10,32,.313,13,21,.619,105
112,2019-04-03,TOR,@,BRK,W 115-105,240,44,105,.419,29,67,.433,15,38,.395,12,14,.857,115
113,2019-04-03,DAL,,MIN,L 108-110,240,43,94,.457,36,55,.655,7,39,.179,15,19,.789,108
114,2019-04-03,MIN,@,DAL,W 110-108,240,42,86,.488,32,59,.542,10,27,.370,16,20,.800,110
115,2019-04-03,DEN,,SAS,W 113-85,240,47,87,.540,35,54,.648,12,33,.364,7,12,.583,113
116,2019-04-03,SAS,@,DEN,L 85-113,240,31,81,.383,26,54,.481,5,27,.185,18,25,.720,85
117,2019-04-03,DET,,IND,L 89-108,240,31,80,.388,20,39,.513,11,41,.268,16,24,.667,89
118,2019-04-03,IND,@,DET,W 108-89,240,43,92,.467,37,71,.521,6,21,.286,16,22,.727,108
119,2019-04-03,HOU,@,LAC,W 135-103,240,47,88,.534,29,50,.580,18,38,.474,23,29,.793,135
120,2019-04-03,LAC,,HOU,L 103-135,240,38,82,.463,30,56,.536,8,26,.308,19,31,.613,103
121,2019-04-03,BOS,@,MIA,W 112-102,240,38,80,.475,29,56,.518,9,24,.375,27,31,.871,112
122,2019-04-03,MIA,,BOS,L 102-112,240,39,95,.411,27,59,.458,12,36,.333,12,20,.600,102
123,2019-04-03,CHA,@,NOP,W 115-109,240,38,90,.422,26,56,.464,12,34,.353,27,32,.844,115
124,2019-04-03,NOP,,CHO,L 109-115,240,40,85,.471,25,44,.568,15,41,.366,14,17,.824,109
125,2019-04-03,NYK,@,ORL,L 100-114,240,38,85,.447,32,58,.552,6,27,.222,18,21,.857,100
126,2019-04-03,ORL,,NYK,W 114-100,240,45,99,.455,34,67,.507,11,32,.344,13,20,.650,114
127,2019-04-03,PHO,,UTA,L 97-118,240,42,91,.462,37,70,.529,5,21,.238,8,13,.615,97
128,2019-04-03,UTA,@,PHO,W 118-97,240,44,77,.571,28,45,.622,16,32,.500,14,18,.778,118
129,2019-04-03,MEM,@,POR,L 89-116,240,31,80,.388,20,47,.426,11,33,.333,16,19,.842,89
130,2019-04-03,POR,,MEM,W 116-89,240,48,94,.511,38,63,.603,10,31,.323,10,16,.625,116
131,2019-04-03,CHI,@,WAS,W 115-114,240,48,90,.533,43,71,.606,5,19,.263,14,17,.824,115
132,2019-04-03,WAS,,CHI,L 114-115,240,45,97,.464,40,70,.571,5,27,.185,19,26,.731,114
133,2019-04-02,DEN,@,GSW,L 102-116,240,36,96,.375,29,66,.439,7,30,.233,23,29,.793,102
134,2019-04-02,GSW,,DEN,W 116-102,240,50,92,.543,37,58,.638,13,34,.382,3,8,.375,116
135,2019-04-02,LAL,@,OKC,L 103-119,240,40,84,.476,24,45,.533,16,39,.410,7,10,.700,103
136,2019-04-02,OKC,,LAL,W 119-103,240,47,102,.461,34,58,.586,13,44,.295,12,20,.600,119
137,2019-04-02,HOU,@,SAC,W 130-105,240,46,94,.489,20,33,.606,26,61,.426,12,17,.706,130
138,2019-04-02,SAC,,HOU,L 105-130,240,42,95,.442,35,72,.486,7,23,.304,14,20,.700,105
139,2019-04-02,ATL,@,SAS,L 111-117,240,43,94,.457,31,60,.517,12,34,.353,13,20,.650,111
140,2019-04-02,SAS,,ATL,W 117-111,240,42,80,.525,28,50,.560,14,30,.467,19,22,.864,117
141,2019-04-01,BOS,,MIA,W 110-105,240,36,91,.396,19,51,.373,17,40,.425,21,24,.875,110
142,2019-04-01,MIA,@,BOS,L 105-110,240,40,88,.455,30,51,.588,10,37,.270,15,18,.833,105
143,2019-04-01,BRK,,MIL,L 121-131,240,39,94,.415,23,50,.460,16,44,.364,27,34,.794,121
144,2019-04-01,MIL,@,BRK,W 131-121,240,47,94,.500,36,60,.600,11,34,.324,26,30,.867,131
145,2019-04-01,DAL,,PHI,W 122-102,240,46,97,.474,34,65,.523,12,32,.375,18,27,.667,122
146,2019-04-01,PHI,@,DAL,L 102-122,240,36,93,.387,30,60,.500,6,33,.182,24,32,.750,102
147,2019-04-01,DET,@,IND,L 102-111,240,38,88,.432,26,55,.473,12,33,.364,14,19,.737,102
148,2019-04-01,IND,,DET,W 111-102,240,42,77,.545,32,55,.582,10,22,.455,17,22,.773,111
149,2019-04-01,MIN,,POR,L 122-132,240,47,96,.490,36,67,.537,11,29,.379,17,19,.895,122
150,2019-04-01,POR,@,MIN,W 132-122,240,50,91,.549,35,61,.574,15,30,.500,17,24,.708,132
151,2019-04-01,CHI,@,NYK,L 105-113,240,42,94,.447,38,77,.494,4,17,.235,17,23,.739,105
152,2019-04-01,NYK,,CHI,W 113-105,240,37,74,.500,19,36,.528,18,38,.474,21,25,.840,113
153,2019-04-01,CLE,@,PHO,L 113-122,240,45,99,.455,37,77,.481,8,22,.364,15,22,.682,113
154,2019-04-01,PHO,,CLE,W 122-113,240,46,84,.548,33,47,.702,13,37,.351,17,20,.850,122
155,2019-04-01,ORL,@,TOR,L 109-121,240,43,93,.462,31,60,.517,12,33,.364,11,15,.733,109
156,2019-04-01,TOR,,ORL,W 121-109,240,42,84,.500,23,47,.489,19,37,.514,18,22,.818,121
157,2019-04-01,CHA,@,UTA,L 102-111,240,36,90,.400,29,60,.483,7,30,.233,23,29,.793,102
158,2019-04-01,UTA,,CHO,W 111-102,240,38,79,.481,23,44,.523,15,35,.429,20,26,.769,111
159,2019-03-31,ATL,,MIL,W 136-135 (OT),265,52,118,.441,30,57,.526,22,61,.361,10,17,.588,136
160,2019-03-31,MIL,@,ATL,L 135-136 (OT),265,48,116,.414,31,61,.508,17,55,.309,22,23,.957,135
161,2019-03-31,DEN,,WAS,L 90-95,240,35,93,.376,28,57,.491,7,36,.194,13,20,.650,90
162,2019-03-31,WAS,@,DEN,W 95-90,240,37,92,.402,31,68,.456,6,24,.250,15,20,.750,95
163,2019-03-31,CHA,@,GSW,L 90-137,240,30,85,.353,22,53,.415,8,32,.250,22,25,.880,90
164,2019-03-31,GSW,,CHO,W 137-90,240,53,88,.602,32,55,.582,21,33,.636,10,12,.833,137
165,2019-03-31,LAC,,MEM,W 113-96,240,36,75,.480,29,48,.604,7,27,.259,34,38,.895,113
166,2019-03-31,MEM,@,LAC,L 96-113,240,32,85,.376,24,52,.462,8,33,.242,24,29,.828,96
167,2019-03-31,LAL,@,NOP,W 130-102,240,48,101,.475,33,63,.524,15,38,.395,19,22,.864,130
168,2019-03-31,NOP,,LAL,L 102-130,240,38,83,.458,30,52,.577,8,31,.258,18,21,.857,102
169,2019-03-31,DAL,@,OKC,W 106-103,240,37,87,.425,21,43,.488,16,44,.364,16,23,.696,106
170,2019-03-31,OKC,,DAL,L 103-106,240,38,98,.388,27,55,.491,11,43,.256,16,22,.727,103
171,2019-03-31,SAC,@,SAS,W 113-106,240,39,81,.481,28,56,.500,11,25,.440,24,28,.857,113
172,2019-03-31,SAS,,SAC,L 106-113,240,44,94,.468,36,67,.537,8,27,.296,10,14,.714,106
173,2019-03-30,BOS,@,BRK,L 96-110,240,35,83,.422,27,63,.429,8,20,.400,18,23,.783,96
174,2019-03-30,BRK,,BOS,W 110-96,240,38,83,.458,26,45,.578,12,38,.316,22,28,.786,110
175,2019-03-30,CHI,,TOR,L 101-124,240,41,97,.423,32,67,.478,9,30,.300,10,16,.625,101
176,2019-03-30,TOR,@,CHI,W 124-101,240,46,89,.517,28,51,.549,18,38,.474,14,18,.778,124
177,2019-03-30,DET,,POR,W 99-90,240,37,86,.430,32,61,.525,5,25,.200,20,26,.769,99
178,2019-03-30,POR,@,DET,L 90-99,240,38,102,.373,34,81,.420,4,21,.190,10,11,.909,90
179,2019-03-30,HOU,,SAC,W 119-108,240,39,83,.470,22,31,.710,17,52,.327,24,27,.889,119
180,2019-03-30,SAC,@,HOU,L 108-119,240,42,94,.447,27,65,.415,15,29,.517,9,15,.600,108
181,2019-03-30,IND,,ORL,L 116-121,240,48,90,.533,39,66,.591,9,24,.375,11,17,.647,116
182,2019-03-30,ORL,@,IND,W 121-116,240,47,92,.511,32,54,.593,15,38,.395,12,14,.857,121
183,2019-03-30,CLE,@,LAC,L 108-132,240,41,92,.446,38,69,.551,3,23,.130,23,28,.821,108
184,2019-03-30,LAC,,CLE,W 132-108,240,53,85,.624,38,52,.731,15,33,.455,11,16,.688,132
185,2019-03-30,MIN,,PHI,L 109-118,240,39,86,.453,28,60,.467,11,26,.423,20,25,.800,109
186,2019-03-30,PHI,@,MIN,W 118-109,240,44,94,.468,29,63,.460,15,31,.484,15,21,.714,118
187,2019-03-30,MIA,@,NYK,W 100-92,240,39,90,.433,30,58,.517,9,32,.281,13,17,.765,100
188,2019-03-30,NYK,,MIA,L 92-100,240,31,77,.403,22,39,.564,9,38,.237,21,25,.840,92
189,2019-03-30,MEM,@,PHO,W 120-115,240,41,89,.461,33,64,.516,8,25,.320,30,40,.750,120
190,2019-03-30,PHO,,MEM,L 115-120,240,43,81,.531,31,53,.585,12,28,.429,17,23,.739,115
191,2019-03-29,ATL,,POR,L 98-118,240,38,94,.404,29,56,.518,9,38,.237,13,14,.929,98
192,2019-03-29,POR,@,ATL,W 118-98,240,45,96,.469,36,64,.563,9,32,.281,19,22,.864,118
193,2019-03-29,BOS,,IND,W 114-112,240,44,86,.512,31,59,.525,13,27,.481,13,17,.765,114
194,2019-03-29,IND,@,BOS,L 112-114,240,42,90,.467,30,63,.476,12,27,.444,16,23,.696,112
195,2019-03-29,CHA,@,LAL,L 115-129,240,42,88,.477,27,49,.551,15,39,.385,16,17,.941,115
196,2019-03-29,LAL,,CHO,W 129-115,240,51,91,.560,33,53,.623,18,38,.474,9,12,.750,129
197,2019-03-29,GSW,@,MIN,L 130-131 (OT),265,46,98,.469,28,58,.483,18,40,.450,20,28,.714,130
198,2019-03-29,MIN,,GSW,W 131-130 (OT),265,45,103,.437,31,65,.477,14,38,.368,27,34,.794,131
199,2019-03-29,DEN,@,OKC,W 115-105,240,48,85,.565,34,52,.654,14,33,.424,5,6,.833,115
200,2019-03-29,OKC,,DEN,L 105-115,240,43,88,.489,35,61,.574,8,27,.296,11,16,.688,105
201,2019-03-29,UTA,,WAS,W 128-124,240,48,87,.552,34,55,.618,14,32,.438,18,18,1.000,128
202,2019-03-29,WAS,@,UTA,L 124-128,240,48,98,.490,33,61,.541,15,37,.405,13,22,.591,124
203,2019-03-28,DET,,ORL,W 115-98,240,46,86,.535,29,51,.569,17,35,.486,6,12,.500,115
204,2019-03-28,ORL,@,DET,L 98-115,240,37,94,.394,29,63,.460,8,31,.258,16,20,.800,98
205,2019-03-28,DEN,@,HOU,L 85-112,240,31,84,.369,27,60,.450,4,24,.167,19,20,.950,85
206,2019-03-28,HOU,,DEN,W 112-85,240,40,87,.460,25,47,.532,15,40,.375,17,20,.850,112
207,2019-03-28,DAL,@,MIA,L 99-105,240,36,92,.391,20,45,.444,16,47,.340,11,17,.647,99
208,2019-03-28,MIA,,DAL,W 105-99,240,39,89,.438,32,59,.542,7,30,.233,20,27,.741,105
209,2019-03-28,LAC,@,MIL,L 118-128,240,42,92,.457,25,59,.424,17,33,.515,17,22,.773,118
210,2019-03-28,MIL,,LAC,W 128-118,240,45,86,.523,29,49,.592,16,37,.432,22,27,.815,128
211,2019-03-28,NOP,,SAC,W 121-118,240,49,97,.505,40,69,.580,9,28,.321,14,14,1.000,121
212,2019-03-28,SAC,@,NOP,L 118-121,240,47,95,.495,37,72,.514,10,23,.435,14,16,.875,118
213,2019-03-28,NYK,,TOR,L 92-117,240,31,85,.365,25,59,.424,6,26,.231,24,32,.750,92
214,2019-03-28,TOR,@,NYK,W 117-92,240,40,89,.449,20,42,.476,20,47,.426,17,22,.773,117
215,2019-03-28,BRK,@,PHI,L 110-123,240,40,90,.444,29,58,.500,11,32,.344,19,29,.655,110
216,2019-03-28,PHI,,BRK,W 123-110,240,45,90,.500,33,65,.508,12,25,.480,21,28,.750,123
217,2019-03-28,CLE,@,SAS,L 110-116,240,45,92,.489,33,63,.524,12,29,.414,8,10,.800,110
218,2019-03-28,SAS,,CLE,W 116-110,240,45,85,.529,31,52,.596,14,33,.424,12,17,.706,116
219,2019-03-27,CHI,,POR,L 98-118,240,39,91,.429,34,68,.500,5,23,.217,15,19,.789,98
220,2019-03-27,POR,@,CHI,W 118-98,240,43,83,.518,32,51,.627,11,32,.344,21,25,.840,118
221,2019-03-27,GSW,@,MEM,W 118-103,240,45,84,.536,30,53,.566,15,31,.484,13,15,.867,118
222,2019-03-27,MEM,,GSW,L 103-118,240,39,100,.390,29,69,.420,10,31,.323,15,21,.714,103
223,2019-03-27,IND,@,OKC,L 99-107,240,40,92,.435,27,61,.443,13,31,.419,6,11,.545,99
224,2019-03-27,OKC,,IND,W 107-99,240,41,92,.446,28,56,.500,13,36,.361,12,19,.632,107
225,2019-03-27,PHO,,WAS,L 121-124,240,43,87,.494,29,50,.580,14,37,.378,21,26,.808,121
226,2019-03-27,WAS,@,PHO,W 124-121,240,43,90,.478,34,65,.523,9,25,.360,29,43,.674,124
227,2019-03-27,LAL,@,UTA,L 100-115,240,37,97,.381,28,70,.400,9,27,.333,17,24,.708,100
228,2019-03-27,UTA,,LAL,W 115-100,240,41,83,.494,31,51,.608,10,32,.313,23,36,.639,115
229,2019-03-26,CHA,,SAS,W 125-116 (OT),265,46,100,.460,33,58,.569,13,42,.310,20,28,.714,125
230,2019-03-26,SAS,@,CHO,L 116-125 (OT),265,44,108,.407,31,69,.449,13,39,.333,15,21,.714,116
231,2019-03-26,BOS,@,CLE,W 116-106,240,46,91,.505,36,66,.545,10,25,.400,14,19,.737,116
232,2019-03-26,CLE,,BOS,L 106-116,240,39,80,.488,30,52,.577,9,28,.321,19,25,.760,106
233,2019-03-26,DAL,,SAC,L 121-125,240,39,77,.506,24,32,.750,15,45,.333,28,32,.875,121
234,2019-03-26,SAC,@,DAL,W 125-121,240,44,87,.506,34,64,.531,10,23,.435,27,32,.844,125
235,2019-03-26,DEN,,DET,W 95-92,240,37,87,.425,30,60,.500,7,27,.259,14,20,.700,95
236,2019-03-26,DET,@,DEN,L 92-95,240,36,102,.353,25,60,.417,11,42,.262,9,13,.692,92
237,2019-03-26,LAL,,WAS,W 124-106,240,48,89,.539,37,56,.661,11,33,.333,17,23,.739,124
238,2019-03-26,WAS,@,LAL,L 106-124,240,39,90,.433,33,58,.569,6,32,.188,22,27,.815,106
239,2019-03-26,MIA,,ORL,L 99-104,240,36,86,.419,26,53,.491,10,33,.303,17,21,.810,99
240,2019-03-26,ORL,@,MIA,W 104-99,240,37,89,.416,23,47,.489,14,42,.333,16,23,.696,104
241,2019-03-26,HOU,@,MIL,L 94-108,240,36,99,.364,20,47,.426,16,52,.308,6,7,.857,94
242,2019-03-26,MIL,,HOU,W 108-94,240,42,94,.447,28,60,.467,14,34,.412,10,13,.769,108
243,2019-03-26,LAC,@,MIN,W 122-111,240,46,85,.541,30,53,.566,16,32,.500,14,14,1.000,122
244,2019-03-26,MIN,,LAC,L 111-122,240,41,94,.436,32,67,.478,9,27,.333,20,33,.606,111
245,2019-03-26,ATL,@,NOP,W 130-120,240,44,97,.454,25,46,.543,19,51,.373,23,26,.885,130
246,2019-03-26,NOP,,ATL,L 120-130,240,39,83,.470,27,49,.551,12,34,.353,30,40,.750,120
247,2019-03-26,CHI,@,TOR,L 103-112,240,39,86,.453,31,63,.492,8,23,.348,17,20,.850,103
248,2019-03-26,TOR,,CHI,W 112-103,240,42,86,.488,30,58,.517,12,28,.429,16,16,1.000,112
249,2019-03-25,MEM,,OKC,W 115-103,240,40,89,.449,29,56,.518,11,33,.333,24,31,.774,115
250,2019-03-25,OKC,@,MEM,L 103-115,240,38,95,.400,26,59,.441,12,36,.333,15,20,.750,103
251,2019-03-25,ORL,,PHI,W 119-98,240,45,87,.517,34,58,.586,11,29,.379,18,23,.783,119
252,2019-03-25,PHI,@,ORL,L 98-119,240,36,73,.493,30,50,.600,6,23,.261,20,26,.769,98
253,2019-03-25,BRK,@,POR,L 144-148 (2OT),290,49,103,.476,34,61,.557,15,42,.357,31,44,.705,144
254,2019-03-25,POR,,BRK,W 148-144 (2OT),290,53,121,.438,39,76,.513,14,45,.311,28,36,.778,148
255,2019-03-25,PHO,@,UTA,L 92-125,240,31,76,.408,24,53,.453,7,23,.304,23,28,.821,92
256,2019-03-25,UTA,,PHO,W 125-92,240,48,86,.558,38,65,.585,10,21,.476,19,23,.826,125
257,2019-03-24,BOS,,SAS,L 96-115,240,38,94,.404,31,59,.525,7,35,.200,13,16,.813,96
258,2019-03-24,SAS,@,BOS,W 115-96,240,50,98,.510,42,74,.568,8,24,.333,7,8,.875,115
259,2019-03-24,DET,@,GSW,L 114-121,240,39,84,.464,27,53,.509,12,31,.387,24,25,.960,114
260,2019-03-24,GSW,,DET,W 121-114,240,46,74,.622,33,49,.673,13,25,.520,16,19,.842,121
261,2019-03-24,DEN,@,IND,L 88-124,240,33,93,.355,26,64,.406,7,29,.241,15,16,.938,88
262,2019-03-24,IND,,DEN,W 124-88,240,51,91,.560,43,73,.589,8,18,.444,14,17,.824,124
263,2019-03-24,LAL,,SAC,W 111-106,240,39,85,.459,26,45,.578,13,40,.325,20,24,.833,111
264,2019-03-24,SAC,@,LAL,L 106-111,240,39,104,.375,25,71,.352,14,33,.424,14,23,.609,106
265,2019-03-24,CLE,@,MIL,L 105-127,240,41,96,.427,30,55,.545,11,41,.268,12,17,.706,105
266,2019-03-24,MIL,,CLE,W 127-105,240,48,87,.552,33,46,.717,15,41,.366,16,21,.762,127
267,2019-03-24,HOU,@,NOP,W 113-90,240,42,86,.488,21,37,.568,21,49,.429,8,9,.889,113
268,2019-03-24,NOP,,HOU,L 90-113,240,38,92,.413,31,64,.484,7,28,.250,7,10,.700,90
269,2019-03-24,LAC,@,NYK,W 124-113,240,38,86,.442,23,51,.451,15,35,.429,33,37,.892,124
270,2019-03-24,NYK,,LAC,L 113-124,240,41,86,.477,32,53,.604,9,33,.273,22,25,.880,113
271,2019-03-24,CHA,@,TOR,W 115-114,240,41,93,.441,23,52,.442,18,41,.439,15,17,.882,115
272,2019-03-24,TOR,,CHO,L 114-115,240,45,77,.584,34,51,.667,11,26,.423,13,13,1.000,114
273,2019-03-23,ATL,,PHI,W 129-127,240,49,106,.462,34,59,.576,15,47,.319,16,21,.762,129
274,2019-03-23,PHI,@,ATL,L 127-129,240,42,91,.462,32,68,.471,10,23,.435,33,39,.846,127
275,2019-03-23,CHI,,UTA,L 83-114,240,33,92,.359,31,76,.408,2,16,.125,15,20,.750,83
276,2019-03-23,UTA,@,CHI,W 114-83,240,46,95,.484,35,63,.556,11,32,.344,11,15,.733,114
277,2019-03-23,BOS,@,CHO,L 117-124,240,44,93,.473,25,50,.500,19,43,.442,10,15,.667,117
278,2019-03-23,CHA,,BOS,W 124-117,240,42,95,.442,24,57,.421,18,38,.474,22,28,.786,124
279,2019-03-23,DAL,@,GSW,W 126-91,240,44,83,.530,23,34,.676,21,49,.429,17,22,.773,126
280,2019-03-23,GSW,,DAL,L 91-126,240,36,90,.400,32,60,.533,4,30,.133,15,21,.714,91
281,2019-03-23,MEM,,MIN,L 99-112,240,36,96,.375,26,63,.413,10,33,.303,17,22,.773,99
282,2019-03-23,MIN,@,MEM,W 112-99,240,40,83,.482,28,57,.491,12,26,.462,20,21,.952,112
283,2019-03-23,DET,@,POR,L 112-117,240,42,84,.500,28,50,.560,14,34,.412,14,14,1.000,112
284,2019-03-23,POR,,DET,W 117-112,240,43,79,.544,32,53,.604,11,26,.423,20,27,.741,117
285,2019-03-23,PHO,@,SAC,L 103-112,240,36,88,.409,27,54,.500,9,34,.265,22,26,.846,103
286,2019-03-23,SAC,,PHO,W 112-103,240,39,92,.424,22,54,.407,17,38,.447,17,22,.773,112
287,2019-03-23,MIA,@,WAS,W 113-108,240,44,88,.500,32,49,.653,12,39,.308,13,19,.684,113
288,2019-03-23,WAS,,MIA,L 108-113,240,41,96,.427,32,66,.485,9,30,.300,17,23,.739,108
289,2019-03-22,CLE,,LAC,L 108-110,240,43,90,.478,31,59,.525,12,31,.387,10,13,.769,108
290,2019-03-22,LAC,@,CLE,W 110-108,240,42,82,.512,36,56,.643,6,26,.231,20,23,.870,110
291,2019-03-22,HOU,,SAS,W 111-105,240,36,86,.419,22,49,.449,14,37,.378,25,32,.781,111
292,2019-03-22,SAS,@,HOU,L 105-111,240,41,90,.456,34,66,.515,7,24,.292,16,17,.941,105
293,2019-03-22,BRK,@,LAL,W 111-106,240,37,92,.402,21,50,.420,16,42,.381,21,28,.750,111
294,2019-03-22,LAL,,BRK,L 106-111,240,37,96,.385,28,60,.467,9,36,.250,23,32,.719,106
295,2019-03-22,MIA,@,MIL,L 87-116,240,32,85,.376,21,48,.438,11,37,.297,12,23,.522,87
296,2019-03-22,MIL,,MIA,W 116-87,240,43,85,.506,26,51,.510,17,34,.500,13,20,.650,116
297,2019-03-22,DEN,@,NYK,W 111-93,240,40,96,.417,25,58,.431,15,38,.395,16,19,.842,111
298,2019-03-22,NYK,,DEN,L 93-111,240,34,90,.378,25,58,.431,9,32,.281,16,21,.762,93
299,2019-03-22,MEM,@,ORL,L 119-123 (OT),265,47,93,.505,32,55,.582,15,38,.395,10,21,.476,119
300,2019-03-22,ORL,,MEM,W 123-119 (OT),265,44,93,.473,30,54,.556,14,39,.359,21,27,.778,123
301,2019-03-22,OKC,@,TOR,W 116-109,240,42,94,.447,22,51,.431,20,43,.465,12,14,.857,116
302,2019-03-22,TOR,,OKC,L 109-116,240,39,78,.500,26,53,.491,13,25,.520,18,21,.857,109
303,2019-03-21,ATL,,UTA,W 117-114,240,41,87,.471,22,47,.468,19,40,.475,16,23,.696,117
304,2019-03-21,UTA,@,ATL,L 114-117,240,43,94,.457,33,62,.532,10,32,.313,18,26,.692,114
305,2019-03-21,CHA,,MIN,W 113-106,240,43,100,.430,34,71,.479,9,29,.310,18,24,.750,113
306,2019-03-21,MIN,@,CHO,L 106-113,240,39,88,.443,29,60,.483,10,28,.357,18,29,.621,106
307,2019-03-21,GSW,,IND,W 112-89,240,44,89,.494,31,53,.585,13,36,.361,11,16,.688,112
308,2019-03-21,IND,@,GSW,L 89-112,240,35,91,.385,29,68,.426,6,23,.261,13,17,.765,89
309,2019-03-21,DET,@,PHO,W 118-98,240,38,90,.422,21,48,.438,17,42,.405,25,34,.735,118
310,2019-03-21,PHO,,DET,L 98-118,240,35,73,.479,28,47,.596,7,26,.269,21,26,.808,98
311,2019-03-21,DAL,@,SAC,L 100-116,240,36,92,.391,24,52,.462,12,40,.300,16,23,.696,100
312,2019-03-21,SAC,,DAL,W 116-100,240,41,87,.471,28,52,.538,13,35,.371,21,28,.750,116
313,2019-03-21,DEN,@,WAS,W 113-108,240,46,87,.529,32,57,.561,14,30,.467,7,11,.636,113
314,2019-03-21,WAS,,DEN,L 108-113,240,40,79,.506,32,51,.627,8,28,.286,20,21,.952,108
315,2019-03-20,CHI,,WAS,W 126-120 (OT),265,50,106,.472,38,83,.458,12,23,.522,14,17,.824,126
316,2019-03-20,WAS,@,CHI,L 120-126 (OT),265,44,93,.473,30,51,.588,14,42,.333,18,23,.783,120
317,2019-03-20,CLE,,MIL,W 107-102,240,39,93,.419,28,54,.519,11,39,.282,18,24,.750,107
318,2019-03-20,MIL,@,CLE,L 102-107,240,36,91,.396,23,59,.390,13,32,.406,17,21,.810,102
319,2019-03-20,HOU,@,MEM,L 125-126 (OT),265,42,94,.447,21,46,.457,21,48,.438,20,20,1.000,125
320,2019-03-20,MEM,,HOU,W 126-125 (OT),265,41,89,.461,28,52,.538,13,37,.351,31,39,.795,126
321,2019-03-20,NYK,,UTA,L 116-137,240,45,86,.523,32,55,.582,13,31,.419,13,21,.619,116
322,2019-03-20,UTA,@,NYK,W 137-116,240,48,85,.565,28,43,.651,20,42,.476,21,25,.840,137
323,2019-03-20,OKC,,TOR,L 114-123 (OT),265,43,103,.417,30,60,.500,13,43,.302,15,29,.517,114
324,2019-03-20,TOR,@,OKC,W 123-114 (OT),265,45,87,.517,31,51,.608,14,36,.389,19,21,.905,123
325,2019-03-20,NOP,@,ORL,L 96-119,240,38,102,.373,28,68,.412,10,34,.294,10,13,.769,96
326,2019-03-20,ORL,,NOP,W 119-96,240,46,102,.451,31,64,.484,15,38,.395,12,14,.857,119
327,2019-03-20,BOS,@,PHI,L 115-118,240,45,96,.469,33,64,.516,12,32,.375,13,16,.813,115
328,2019-03-20,PHI,,BOS,W 118-115,240,34,90,.378,23,57,.404,11,33,.333,39,43,.907,118
329,2019-03-20,DAL,@,POR,L 118-126,240,43,87,.494,33,57,.579,10,30,.333,22,25,.880,118
330,2019-03-20,POR,,DAL,W 126-118,240,45,91,.495,29,55,.527,16,36,.444,20,25,.800,126
331,2019-03-20,MIA,@,SAS,W 110-105,240,40,86,.465,24,51,.471,16,35,.457,14,18,.778,110
332,2019-03-20,SAS,,MIA,L 105-110,240,38,88,.432,24,54,.444,14,34,.412,15,21,.714,105
333,2019-03-19,ATL,,HOU,L 105-121,240,39,84,.464,24,44,.545,15,40,.375,12,15,.800,105
334,2019-03-19,HOU,@,ATL,W 121-105,240,40,78,.513,21,31,.677,19,47,.404,22,30,.733,121
335,2019-03-19,CHA,,PHI,L 114-118,240,36,83,.434,27,48,.563,9,35,.257,33,44,.750,114
336,2019-03-19,PHI,@,CHO,W 118-114,240,43,86,.500,32,54,.593,11,32,.344,21,28,.750,118
337,2019-03-19,IND,@,LAC,L 109-115,240,45,87,.517,38,66,.576,7,21,.333,12,17,.706,109
338,2019-03-19,LAC,,IND,W 115-109,240,43,89,.483,33,55,.600,10,34,.294,19,27,.704,115
339,2019-03-19,LAL,@,MIL,L 101-115,240,33,86,.384,17,43,.395,16,43,.372,19,23,.826,101
340,2019-03-19,MIL,,LAL,W 115-101,240,41,89,.461,26,42,.619,15,47,.319,18,27,.667,115
341,2019-03-19,GSW,@,MIN,W 117-107,240,44,91,.484,25,49,.510,19,42,.452,10,14,.714,117
342,2019-03-19,MIN,,GSW,L 107-117,240,36,89,.404,27,53,.509,9,36,.250,26,32,.813,107
343,2019-03-19,BRK,@,SAC,W 123-121,240,47,94,.500,35,59,.593,12,35,.343,17,23,.739,123
344,2019-03-19,SAC,,BRK,L 121-123,240,49,95,.516,40,70,.571,9,25,.360,14,20,.700,121
345,2019-03-18,BOS,,DEN,L 105-114,240,39,93,.419,27,54,.500,12,39,.308,15,19,.789,105
346,2019-03-18,DEN,@,BOS,W 114-105,240,46,94,.489,32,55,.582,14,39,.359,8,10,.800,114
347,2019-03-18,CLE,,DET,W 126-119,240,46,79,.582,35,57,.614,11,22,.500,23,27,.852,126
348,2019-03-18,DET,@,CLE,L 119-126,240,42,94,.447,24,50,.480,18,44,.409,17,21,.810,119
349,2019-03-18,DAL,,NOP,L 125-129 (OT),265,46,105,.438,37,70,.529,9,35,.257,24,29,.828,125
350,2019-03-18,NOP,@,DAL,W 129-125 (OT),265,49,104,.471,37,65,.569,12,39,.308,19,22,.864,129
351,2019-03-18,MIA,@,OKC,W 116-107,240,46,97,.474,37,68,.544,9,29,.310,15,16,.938,116
352,2019-03-18,OKC,,MIA,L 107-116,240,38,87,.437,28,50,.560,10,37,.270,21,27,.778,107
353,2019-03-18,CHI,@,PHO,W 116-101,240,46,89,.517,42,73,.575,4,16,.250,20,24,.833,116
354,2019-03-18,PHO,,CHI,L 101-116,240,39,84,.464,32,58,.552,7,26,.269,16,26,.615,101
355,2019-03-18,IND,@,POR,L 98-106,240,35,83,.422,25,59,.424,10,24,.417,18,22,.818,98
356,2019-03-18,POR,,IND,W 106-98,240,37,79,.468,24,47,.511,13,32,.406,19,21,.905,106
357,2019-03-18,GSW,@,SAS,L 105-111,240,41,88,.466,28,49,.571,13,39,.333,10,12,.833,105
358,2019-03-18,SAS,,GSW,W 111-105,240,41,88,.466,31,62,.500,10,26,.385,19,22,.864,111
359,2019-03-18,NYK,@,TOR,L 92-128,240,28,85,.329,20,50,.400,8,35,.229,28,32,.875,92
360,2019-03-18,TOR,,NYK,W 128-92,240,49,88,.557,32,48,.667,17,40,.425,13,22,.591,128
361,2019-03-18,UTA,@,WAS,W 116-95,240,49,91,.538,35,54,.648,14,37,.378,4,6,.667,116
362,2019-03-18,WAS,,UTA,L 95-116,240,34,81,.420,26,54,.481,8,27,.296,19,22,.864,95
363,2019-03-17,DET,,TOR,W 110-107,240,39,83,.470,31,56,.554,8,27,.296,24,27,.889,110
364,2019-03-17,TOR,@,DET,L 107-110,240,39,82,.476,21,46,.457,18,36,.500,11,14,.786,107
365,2019-03-17,HOU,,MIN,W 117-102,240,43,94,.457,22,44,.500,21,50,.420,10,14,.714,117
366,2019-03-17,MIN,@,HOU,L 102-117,240,38,92,.413,28,60,.467,10,32,.313,16,23,.696,102
367,2019-03-17,BRK,@,LAC,L 116-119,240,42,100,.420,28,62,.452,14,38,.368,18,25,.720,116
368,2019-03-17,LAC,,BRK,W 119-116,240,42,97,.433,30,66,.455,12,31,.387,23,28,.821,119
369,2019-03-17,CHA,@,MIA,L 75-93,240,26,83,.313,19,47,.404,7,36,.194,16,18,.889,75
370,2019-03-17,MIA,,CHO,W 93-75,240,34,86,.395,21,53,.396,13,33,.394,12,19,.632,93
371,2019-03-17,MIL,,PHI,L 125-130,240,43,95,.453,27,45,.600,16,50,.320,23,28,.821,125
372,2019-03-17,PHI,@,MIL,W 130-125,240,47,100,.470,32,68,.471,15,32,.469,21,30,.700,130
373,2019-03-17,LAL,@,NYK,L 123-124,240,47,97,.485,40,70,.571,7,27,.259,22,28,.786,123
374,2019-03-17,NYK,,LAL,W 124-123,240,44,76,.579,32,50,.640,12,26,.462,24,29,.828,124
375,2019-03-17,ATL,@,ORL,L 91-101,240,38,91,.418,30,56,.536,8,35,.229,7,10,.700,91
376,2019-03-17,ORL,,ATL,W 101-91,240,33,85,.388,24,48,.500,9,37,.243,26,33,.788,101
377,2019-03-17,CHI,@,SAC,L 102-129,240,39,88,.443,29,62,.468,10,26,.385,14,21,.667,102
378,2019-03-17,SAC,,CHI,W 129-102,240,54,103,.524,46,80,.575,8,23,.348,13,16,.813,129
379,2019-03-16,ATL,@,BOS,L 120-129,240,43,100,.430,28,60,.467,15,40,.375,19,24,.792,120
380,2019-03-16,BOS,,ATL,W 129-120,240,44,93,.473,31,57,.544,13,36,.361,28,37,.757,129
381,2019-03-16,CLE,@,DAL,L 116-121,240,40,86,.465,25,48,.521,15,38,.395,21,22,.955,116
382,2019-03-16,DAL,,CLE,W 121-116,240,46,89,.517,30,55,.545,16,34,.471,13,16,.813,121
383,2019-03-16,DEN,,IND,W 102-100,240,39,82,.476,28,44,.636,11,38,.289,13,20,.650,102
384,2019-03-16,IND,@,DEN,L 100-102,240,34,75,.453,28,51,.549,6,24,.250,26,37,.703,100
385,2019-03-16,NOP,,PHO,L 136-138 (OT),265,47,102,.461,32,72,.444,15,30,.500,27,41,.659,136
386,2019-03-16,PHO,@,NOP,W 138-136 (OT),265,51,100,.510,42,71,.592,9,29,.310,27,36,.750,138
387,2019-03-16,GSW,@,OKC,W 110-88,240,39,83,.470,24,48,.500,15,35,.429,17,22,.773,110
388,2019-03-16,OKC,,GSW,L 88-110,240,31,96,.323,18,55,.327,13,41,.317,13,23,.565,88
389,2019-03-16,POR,@,SAS,L 103-108,240,42,101,.416,35,73,.479,7,28,.250,12,14,.857,103
390,2019-03-16,SAS,,POR,W 108-103,240,37,79,.468,29,62,.468,8,17,.471,26,30,.867,108
391,2019-03-16,BRK,@,UTA,L 98-114,240,33,95,.347,21,59,.356,12,36,.333,20,22,.909,98
392,2019-03-16,UTA,,BRK,W 114-98,240,39,91,.429,26,55,.473,13,36,.361,23,31,.742,114
393,2019-03-16,MEM,@,WAS,L 128-135,240,48,90,.533,36,57,.632,12,33,.364,20,26,.769,128
394,2019-03-16,WAS,,MEM,W 135-128,240,41,81,.506,24,46,.522,17,35,.486,36,43,.837,135
395,2019-03-15,DET,,LAL,W 111-97,240,37,86,.430,20,47,.426,17,39,.436,20,32,.625,111
396,2019-03-15,LAL,@,DET,L 97-111,240,36,86,.419,30,61,.492,6,25,.240,19,26,.731,97
397,2019-03-15,HOU,,PHO,W 108-102,240,36,83,.434,25,43,.581,11,40,.275,25,33,.758,108
398,2019-03-15,PHO,@,HOU,L 102-108,240,38,89,.427,31,63,.492,7,26,.269,19,25,.760,102
399,2019-03-15,CHI,@,LAC,L 121-128,240,42,80,.525,31,59,.525,11,21,.524,26,33,.788,121
400,2019-03-15,LAC,,CHI,W 128-121,240,44,99,.444,34,79,.430,10,20,.500,30,35,.857,128
401,2019-03-15,MIA,,MIL,L 98-113,240,38,93,.409,30,71,.423,8,22,.364,14,25,.560,98
402,2019-03-15,MIL,@,MIA,W 113-98,240,42,88,.477,30,55,.545,12,33,.364,17,24,.708,113
403,2019-03-15,NOP,,POR,L 110-122,240,45,94,.479,37,64,.578,8,30,.267,12,25,.480,110
404,2019-03-15,POR,@,NOP,W 122-110,240,43,96,.448,33,69,.478,10,27,.370,26,32,.813,122
405,2019-03-15,PHI,,SAC,W 123-114,240,46,91,.505,39,67,.582,7,24,.292,24,27,.889,123
406,2019-03-15,SAC,@,PHI,L 114-123,240,43,94,.457,34,67,.507,9,27,.333,19,24,.792,114
407,2019-03-15,NYK,@,SAS,L 83-109,240,35,86,.407,27,66,.409,8,20,.400,5,9,.556,83
408,2019-03-15,SAS,,NYK,W 109-83,240,47,88,.534,40,67,.597,7,21,.333,8,10,.800,109
409,2019-03-15,CHA,@,WAS,W 116-110,240,46,101,.455,32,70,.457,14,31,.452,10,12,.833,116
410,2019-03-15,WAS,,CHO,L 110-116,240,41,84,.488,28,50,.560,13,34,.382,15,19,.789,110
411,2019-03-14,BOS,,SAC,W 126-120,240,49,97,.505,40,69,.580,9,28,.321,19,26,.731,126
412,2019-03-14,SAC,@,BOS,L 120-126,240,48,95,.505,37,61,.607,11,34,.324,13,23,.565,120
413,2019-03-14,DAL,@,DEN,L 99-100,240,37,87,.425,25,50,.500,12,37,.324,13,17,.765,99
414,2019-03-14,DEN,,DAL,W 100-99,240,39,81,.481,31,52,.596,8,29,.276,14,17,.824,100
415,2019-03-14,IND,,OKC,W 108-106,240,37,82,.451,30,60,.500,7,22,.318,27,32,.844,108
416,2019-03-14,OKC,@,IND,L 106-108,240,38,86,.442,24,56,.429,14,30,.467,16,20,.800,106
417,2019-03-14,CLE,@,ORL,L 91-120,240,35,86,.407,28,55,.509,7,31,.226,14,15,.933,91
418,2019-03-14,ORL,,CLE,W 120-91,240,45,93,.484,31,62,.500,14,31,.452,16,21,.762,120
419,2019-03-14,LAL,@,TOR,L 98-111,240,38,85,.447,31,54,.574,7,31,.226,15,24,.625,98
420,2019-03-14,TOR,,LAL,W 111-98,240,36,91,.396,20,50,.400,16,41,.390,23,29,.793,111
421,2019-03-14,MIN,@,UTA,L 100-120,240,42,91,.462,37,67,.552,5,24,.208,11,15,.733,100
422,2019-03-14,UTA,,MIN,W 120-100,240,44,89,.494,31,51,.608,13,38,.342,19,27,.704,120
423,2019-03-13,ATL,,MEM,W 132-111,240,52,103,.505,35,58,.603,17,45,.378,11,14,.786,132
424,2019-03-13,MEM,@,ATL,L 111-132,240,38,89,.427,24,49,.490,14,40,.350,21,26,.808,111
425,2019-03-13,GSW,@,HOU,W 106-104,240,42,85,.494,30,53,.566,12,32,.375,10,10,1.000,106
426,2019-03-13,HOU,,GSW,L 104-106,240,37,78,.474,26,37,.703,11,41,.268,19,23,.826,104
427,2019-03-13,DET,@,MIA,L 74-108,240,27,77,.351,19,40,.475,8,37,.216,12,18,.667,74
428,2019-03-13,MIA,,DET,W 108-74,240,39,84,.464,28,56,.500,11,28,.393,19,24,.792,108
429,2019-03-13,BRK,@,OKC,L 96-108,240,35,84,.417,22,49,.449,13,35,.371,13,19,.684,96
430,2019-03-13,OKC,,BRK,W 108-96,240,41,96,.427,30,68,.441,11,28,.393,15,19,.789,108
431,2019-03-13,PHO,,UTA,L 97-114,240,36,82,.439,29,63,.460,7,19,.368,18,23,.783,97
432,2019-03-13,UTA,@,PHO,W 114-97,240,42,90,.467,30,57,.526,12,33,.364,18,25,.720,114
433,2019-03-13,ORL,@,WAS,L 90-100,240,35,90,.389,23,57,.404,12,33,.364,8,9,.889,90
434,2019-03-13,WAS,,ORL,W 100-90,240,42,90,.467,34,63,.540,8,27,.296,8,12,.667,100
435,2019-03-12,CHI,,LAL,L 107-123,240,42,91,.462,31,64,.484,11,27,.407,12,12,1.000,107
436,2019-03-12,LAL,@,CHI,W 123-107,240,47,86,.547,34,53,.642,13,33,.394,16,20,.800,123
437,2019-03-12,DAL,,SAS,L 105-112,240,38,82,.463,24,43,.558,14,39,.359,15,26,.577,105
438,2019-03-12,SAS,@,DAL,W 112-105,240,43,82,.524,35,60,.583,8,22,.364,18,18,1.000,112
439,2019-03-12,DEN,,MIN,W 133-107,240,51,85,.600,33,55,.600,18,30,.600,13,15,.867,133
440,2019-03-12,MIN,@,DEN,L 107-133,240,41,89,.461,30,59,.508,11,30,.367,14,14,1.000,107
441,2019-03-12,IND,,NYK,W 103-98,240,37,85,.435,29,57,.509,8,28,.286,21,29,.724,103
442,2019-03-12,NYK,@,IND,L 98-103,240,35,80,.438,22,52,.423,13,28,.464,15,18,.833,98
443,2019-03-12,LAC,,POR,L 104-125,240,38,95,.400,29,80,.363,9,15,.600,19,27,.704,104
444,2019-03-12,POR,@,LAC,W 125-104,240,47,96,.490,35,65,.538,12,31,.387,19,26,.731,125
445,2019-03-12,MIL,@,NOP,W 130-113,240,48,97,.495,38,61,.623,10,36,.278,24,28,.857,130
446,2019-03-12,NOP,,MIL,L 113-130,240,46,107,.430,36,60,.600,10,47,.213,11,16,.688,113
447,2019-03-12,CLE,@,PHI,L 99-106,240,40,101,.396,27,63,.429,13,38,.342,6,8,.750,99
448,2019-03-12,PHI,,CLE,W 106-99,240,42,85,.494,34,62,.548,8,23,.348,14,17,.824,106
449,2019-03-11,BRK,,DET,W 103-75,240,39,79,.494,28,48,.583,11,31,.355,14,22,.636,103
450,2019-03-11,DET,@,BRK,L 75-103,240,27,97,.278,19,63,.302,8,34,.235,13,16,.813,75
451,2019-03-11,CLE,,TOR,W 126-101,240,44,94,.468,26,53,.491,18,41,.439,20,21,.952,126
452,2019-03-11,TOR,@,CLE,L 101-126,240,40,84,.476,29,45,.644,11,39,.282,10,17,.588,101
453,2019-03-11,CHA,@,HOU,L 106-118,240,38,89,.427,22,48,.458,16,41,.390,14,15,.933,106
454,2019-03-11,HOU,,CHO,W 118-106,240,38,91,.418,21,48,.438,17,43,.395,25,27,.926,118
455,2019-03-11,BOS,@,LAC,L 115-140,240,44,91,.484,30,55,.545,14,36,.389,13,19,.684,115
456,2019-03-11,LAC,,BOS,W 140-115,240,53,86,.616,40,58,.690,13,28,.464,21,25,.840,140
457,2019-03-11,OKC,@,UTA,W 98-89,240,36,79,.456,29,57,.509,7,22,.318,19,27,.704,98
458,2019-03-11,UTA,,OKC,L 89-98,240,32,88,.364,19,45,.422,13,43,.302,12,17,.706,89
459,2019-03-11,SAC,@,WAS,L 115-121,240,41,91,.451,32,64,.500,9,27,.333,24,32,.750,115
460,2019-03-11,WAS,,SAC,W 121-115,240,40,86,.465,26,49,.531,14,37,.378,27,33,.818,121
461,2019-03-10,ATL,,NOP,W 128-116,240,48,98,.490,31,61,.508,17,37,.459,15,18,.833,128
462,2019-03-10,NOP,@,ATL,L 116-128,240,45,101,.446,27,60,.450,18,41,.439,8,8,1.000,116
463,2019-03-10,DAL,,HOU,L 93-94,240,31,75,.413,22,43,.512,9,32,.281,22,27,.815,93
464,2019-03-10,HOU,@,DAL,W 94-93,240,32,88,.364,16,36,.444,16,52,.308,14,22,.636,94
465,2019-03-10,CHI,@,DET,L 108-131,240,41,82,.500,32,64,.500,9,18,.500,17,26,.654,108
466,2019-03-10,DET,,CHI,W 131-108,240,49,91,.538,30,56,.536,19,35,.543,14,22,.636,131
467,2019-03-10,GSW,,PHO,L 111-115,240,42,95,.442,32,52,.615,10,43,.233,17,22,.773,111
468,2019-03-10,PHO,@,GSW,W 115-111,240,42,86,.488,32,61,.525,10,25,.400,21,27,.778,115
469,2019-03-10,MEM,,ORL,W 105-97,240,34,82,.415,25,51,.490,9,31,.290,28,31,.903,105
470,2019-03-10,ORL,@,MEM,L 97-105,240,31,87,.356,19,49,.388,12,38,.316,23,27,.852,97
471,2019-03-10,MIA,,TOR,L 104-125,240,42,92,.457,34,65,.523,8,27,.296,12,21,.571,104
472,2019-03-10,TOR,@,MIA,W 125-104,240,42,74,.568,21,34,.618,21,40,.525,20,26,.769,125
473,2019-03-10,MIN,,NYK,W 103-92,240,42,94,.447,33,64,.516,9,30,.300,10,13,.769,103
474,2019-03-10,NYK,@,MIN,L 92-103,240,37,86,.430,27,61,.443,10,25,.400,8,14,.571,92
475,2019-03-10,IND,@,PHI,L 89-106,240,31,83,.373,26,67,.388,5,16,.313,22,37,.595,89
476,2019-03-10,PHI,,IND,W 106-89,240,38,87,.437,31,64,.484,7,23,.304,23,30,.767,106
477,2019-03-10,MIL,@,SAS,L 114-121,240,41,87,.471,27,51,.529,14,36,.389,18,25,.720,114
478,2019-03-10,SAS,,MIL,W 121-114,240,49,100,.490,37,71,.521,12,29,.414,11,15,.733,121
479,2019-03-09,ATL,,BRK,L 112-114,240,39,105,.371,31,64,.484,8,41,.195,26,32,.813,112
480,2019-03-09,BRK,@,ATL,W 114-112,240,33,86,.384,18,42,.429,15,44,.341,33,54,.611,114
481,2019-03-09,BOS,@,LAL,W 120-107,240,48,93,.516,34,55,.618,14,38,.368,10,14,.714,120
482,2019-03-09,LAL,,BOS,L 107-120,240,44,91,.484,39,64,.609,5,27,.185,14,18,.778,107
483,2019-03-09,CHA,@,MIL,L 114-131,240,44,93,.473,29,54,.537,15,39,.385,11,14,.786,114
484,2019-03-09,MIL,,CHO,W 131-114,240,44,90,.489,27,46,.587,17,44,.386,26,30,.867,131
485,2019-03-09,MIN,,WAS,W 135-130 (OT),265,51,114,.447,39,78,.500,12,36,.333,21,24,.875,135
486,2019-03-09,WAS,@,MIN,L 130-135 (OT),265,48,100,.480,32,56,.571,16,44,.364,18,24,.750,130
487,2019-03-09,NYK,,SAC,L 94-102,240,35,94,.372,25,59,.424,10,35,.286,14,21,.667,94
488,2019-03-09,SAC,@,NYK,W 102-94,240,36,95,.379,24,59,.407,12,36,.333,18,22,.818,102
489,2019-03-09,PHO,@,POR,L 120-127,240,43,103,.417,34,76,.447,9,27,.333,25,29,.862,120
490,2019-03-09,POR,,PHO,W 127-120,240,43,86,.500,30,57,.526,13,29,.448,28,36,.778,127
491,2019-03-08,CHI,,DET,L 104-112,240,42,82,.512,37,65,.569,5,17,.294,15,23,.652,104
492,2019-03-08,DET,@,CHI,W 112-104,240,45,83,.542,36,56,.643,9,27,.333,13,21,.619,112
493,2019-03-08,CHA,,WAS,W 112-111,240,40,96,.417,26,55,.473,14,41,.341,18,20,.900,112
494,2019-03-08,WAS,@,CHO,L 111-112,240,40,86,.465,31,59,.525,9,27,.333,22,26,.846,111
495,2019-03-08,DEN,@,GSW,L 105-122,240,33,87,.379,21,54,.389,12,33,.364,27,35,.771,105
496,2019-03-08,GSW,,DEN,W 122-105,240,45,84,.536,27,49,.551,18,35,.514,14,21,.667,122
497,2019-03-08,HOU,,PHI,W 107-91,240,42,85,.494,29,44,.659,13,41,.317,10,15,.667,107
498,2019-03-08,PHI,@,HOU,L 91-107,240,35,95,.368,32,69,.464,3,26,.115,18,23,.783,91
499,2019-03-08,LAC,,OKC,W 118-110,240,39,86,.453,30,61,.492,9,25,.360,31,46,.674,118
500,2019-03-08,OKC,@,LAC,L 110-118,240,41,102,.402,30,58,.517,11,44,.250,17,26,.654,110
501,2019-03-08,MEM,,UTA,W 114-104,240,46,90,.511,37,68,.544,9,22,.409,13,15,.867,114
502,2019-03-08,UTA,@,MEM,L 104-114,240,35,82,.427,17,34,.500,18,48,.375,16,24,.667,104
503,2019-03-08,CLE,@,MIA,L 110-126,240,39,81,.481,20,38,.526,19,43,.442,13,16,.813,110
504,2019-03-08,MIA,,CLE,W 126-110,240,45,79,.570,33,54,.611,12,25,.480,24,33,.727,126
505,2019-03-08,NOP,,TOR,L 104-127,240,43,105,.410,33,66,.500,10,39,.256,8,13,.615,104
506,2019-03-08,TOR,@,NOP,W 127-104,240,53,99,.535,40,62,.645,13,37,.351,8,9,.889,127
507,2019-03-08,DAL,@,ORL,L 106-111,240,42,89,.472,32,55,.582,10,34,.294,12,16,.750,106
508,2019-03-08,ORL,,DAL,W 111-106,240,42,87,.483,28,58,.483,14,29,.483,13,18,.722,111
509,2019-03-07,IND,@,MIL,L 98-117,240,35,90,.389,21,53,.396,14,37,.378,14,20,.700,98
510,2019-03-07,MIL,,IND,W 117-98,240,43,86,.500,29,51,.569,14,35,.400,17,21,.810,117
511,2019-03-07,OKC,@,POR,W 129-121 (OT),265,48,105,.457,40,78,.513,8,27,.296,25,32,.781,129
512,2019-03-07,POR,,OKC,L 121-129 (OT),265,37,94,.394,28,53,.528,9,41,.220,38,47,.809,121
513,2019-03-06,ATL,,SAS,L 104-111,240,36,92,.391,23,49,.469,13,43,.302,19,24,.792,104
514,2019-03-06,SAS,@,ATL,W 111-104,240,44,89,.494,34,56,.607,10,33,.303,13,18,.722,111
515,2019-03-06,BRK,,CLE,W 113-107,240,43,91,.473,31,58,.534,12,33,.364,15,26,.577,113
516,2019-03-06,CLE,@,BRK,L 107-113,240,35,87,.402,19,49,.388,16,38,.421,21,29,.724,107
517,2019-03-06,CHI,,PHI,W 108-107,240,41,93,.441,35,70,.500,6,23,.261,20,27,.741,108
518,2019-03-06,PHI,@,CHI,L 107-108,240,40,87,.460,32,63,.508,8,24,.333,19,24,.792,107
519,2019-03-06,CHA,,MIA,L 84-91,240,30,82,.366,16,46,.348,14,36,.389,10,15,.667,84
520,2019-03-06,MIA,@,CHO,W 91-84,240,38,90,.422,29,64,.453,9,26,.346,6,11,.545,91
521,2019-03-06,DET,,MIN,W 131-114,240,50,93,.538,36,60,.600,14,33,.424,17,22,.773,131
522,2019-03-06,MIN,@,DET,L 114-131,240,41,84,.488,29,57,.509,12,27,.444,20,21,.952,114
523,2019-03-06,DEN,@,LAL,W 115-99,240,45,98,.459,32,56,.571,13,42,.310,12,17,.706,115
524,2019-03-06,LAL,,DEN,L 99-115,240,40,84,.476,33,53,.623,7,31,.226,12,23,.522,99
525,2019-03-06,NOP,,UTA,L 104-114,240,41,89,.461,32,65,.492,9,24,.375,13,20,.650,104
526,2019-03-06,UTA,@,NOP,W 114-104,240,46,88,.523,38,58,.655,8,30,.267,14,22,.636,114
527,2019-03-06,NYK,@,PHO,L 96-107,240,35,77,.455,29,62,.468,6,15,.400,20,25,.800,96
528,2019-03-06,PHO,,NYK,W 107-96,240,39,81,.481,27,52,.519,12,29,.414,17,22,.773,107
529,2019-03-06,BOS,@,SAC,W 111-109,240,40,79,.506,27,46,.587,13,33,.394,18,21,.857,111
530,2019-03-06,SAC,,BOS,L 109-111,240,40,80,.500,27,51,.529,13,29,.448,16,22,.727,109
531,2019-03-06,DAL,@,WAS,L 123-132,240,45,93,.484,30,52,.577,15,41,.366,18,28,.643,123
532,2019-03-06,WAS,,DAL,W 132-123,240,50,93,.538,38,60,.633,12,33,.364,20,25,.800,132
533,2019-03-05,BOS,@,GSW,W 128-95,240,49,96,.510,35,62,.565,14,34,.412,16,17,.941,128
534,2019-03-05,GSW,,BOS,L 95-128,240,34,85,.400,26,50,.520,8,35,.229,19,23,.826,95
535,2019-03-05,CHI,@,IND,L 96-105,240,36,93,.387,32,68,.471,4,25,.160,20,24,.833,96
536,2019-03-05,IND,,CHI,W 105-96,240,38,84,.452,27,59,.458,11,25,.440,18,24,.750,105
537,2019-03-05,MEM,,POR,W 120-111,240,40,75,.533,27,48,.563,13,27,.481,27,36,.750,120
538,2019-03-05,POR,@,MEM,L 111-120,240,42,79,.532,33,50,.660,9,29,.310,18,21,.857,111
539,2019-03-05,MIN,,OKC,W 131-120,240,47,89,.528,36,67,.537,11,22,.500,26,35,.743,131
540,2019-03-05,OKC,@,MIN,L 120-131,240,42,94,.447,24,48,.500,18,46,.391,18,31,.581,120
541,2019-03-05,ORL,@,PHI,L 106-114,240,42,93,.452,29,61,.475,13,32,.406,9,12,.750,106
542,2019-03-05,PHI,,ORL,W 114-106,240,42,89,.472,31,61,.508,11,28,.393,19,21,.905,114
543,2019-03-05,HOU,@,TOR,W 107-95,240,38,85,.447,23,51,.451,15,34,.441,16,18,.889,107
544,2019-03-05,TOR,,HOU,L 95-107,240,37,89,.416,28,57,.491,9,32,.281,12,16,.750,95
545,2019-03-04,BRK,,DAL,W 127-88,240,48,85,.565,31,44,.705,17,41,.415,14,19,.737,127
546,2019-03-04,DAL,@,BRK,L 88-127,240,31,87,.356,19,42,.452,12,45,.267,14,22,.636,88
547,2019-03-04,LAC,@,LAL,W 113-105,240,41,83,.494,30,54,.556,11,29,.379,20,24,.833,113
548,2019-03-04,LAL,,LAC,L 105-113,240,38,91,.418,28,53,.528,10,38,.263,19,24,.792,105
549,2019-03-04,ATL,@,MIA,L 113-114,240,38,91,.418,21,45,.467,17,46,.370,20,25,.800,113
550,2019-03-04,MIA,,ATL,W 114-113,240,44,79,.557,35,56,.625,9,23,.391,17,24,.708,114
551,2019-03-04,MIL,@,PHO,L 105-114,240,35,95,.368,23,53,.434,12,42,.286,23,31,.742,105
552,2019-03-04,PHO,,MIL,W 114-105,240,41,91,.451,34,69,.493,7,22,.318,25,31,.806,114
553,2019-03-04,NYK,@,SAC,L 108-115,240,39,85,.459,27,56,.482,12,29,.414,18,28,.643,108
554,2019-03-04,SAC,,NYK,W 115-108,240,39,83,.470,28,54,.519,11,29,.379,26,33,.788,115
555,2019-03-04,DEN,@,SAS,L 103-104,240,41,95,.432,24,55,.436,17,40,.425,4,4,1.000,103
556,2019-03-04,SAS,,DEN,W 104-103,240,41,85,.482,33,60,.550,8,25,.320,14,19,.737,104
557,2019-03-04,NOP,@,UTA,W 115-112,240,46,96,.479,37,76,.487,9,20,.450,14,18,.778,115
558,2019-03-04,UTA,,NOP,L 112-115,240,43,92,.467,29,54,.537,14,38,.368,12,14,.857,112
559,2019-03-03,BOS,,HOU,L 104-115,240,37,77,.481,29,49,.592,8,28,.286,22,29,.759,104
560,2019-03-03,HOU,@,BOS,W 115-104,240,38,80,.475,17,29,.586,21,51,.412,18,29,.621,115
561,2019-03-03,ATL,@,CHI,W 123-118,240,42,89,.472,21,47,.447,21,42,.500,18,28,.643,123
562,2019-03-03,CHI,,ATL,L 118-123,240,47,92,.511,39,65,.600,8,27,.296,16,21,.762,118
563,2019-03-03,CHA,,POR,L 108-118,240,37,83,.446,23,50,.460,14,33,.424,20,23,.870,108
564,2019-03-03,POR,@,CHO,W 118-108,240,43,96,.448,32,64,.500,11,32,.344,21,23,.913,118
565,2019-03-03,CLE,,ORL,W 107-93,240,36,83,.434,22,40,.550,14,43,.326,21,23,.913,107
566,2019-03-03,ORL,@,CLE,L 93-107,240,39,88,.443,33,62,.532,6,26,.231,9,11,.818,93
567,2019-03-03,DET,,TOR,W 112-107 (OT),265,40,86,.465,28,53,.528,12,33,.364,20,29,.690,112
568,2019-03-03,TOR,@,DET,L 107-112 (OT),265,37,96,.385,23,57,.404,14,39,.359,19,24,.792,107
569,2019-03-03,LAC,,NYK,W 128-107,240,48,98,.490,29,63,.460,19,35,.543,13,17,.765,128
570,2019-03-03,NYK,@,LAC,L 107-128,240,35,88,.398,24,59,.407,11,29,.379,26,34,.765,107
571,2019-03-03,MEM,@,OKC,L 95-99,240,35,79,.443,28,57,.491,7,22,.318,18,19,.947,95
572,2019-03-03,OKC,,MEM,W 99-95,240,33,93,.355,24,63,.381,9,30,.300,24,33,.727,99
573,2019-03-03,MIN,@,WAS,L 121-135,240,52,99,.525,48,72,.667,4,27,.148,13,19,.684,121
574,2019-03-03,WAS,,MIN,W 135-121,240,49,98,.500,38,65,.585,11,33,.333,26,32,.813,135
575,2019-03-02,CLE,,DET,L 93-129,240,27,79,.342,14,45,.311,13,34,.382,26,32,.813,93
576,2019-03-02,DET,@,CLE,W 129-93,240,47,87,.540,27,50,.540,20,37,.541,15,17,.882,129
577,2019-03-02,DAL,,MEM,L 81-111,240,26,85,.306,19,45,.422,7,40,.175,22,33,.667,81
578,2019-03-02,MEM,@,DAL,W 111-81,240,39,78,.500,25,44,.568,14,34,.412,19,24,.792,111
579,2019-03-02,DEN,,NOP,L 112-120,240,39,92,.424,30,60,.500,9,32,.281,25,29,.862,112
580,2019-03-02,NOP,@,DEN,W 120-112,240,45,92,.489,33,62,.532,12,30,.400,18,26,.692,120
581,2019-03-02,IND,,ORL,L 112-117,240,42,77,.545,35,50,.700,7,27,.259,21,24,.875,112
582,2019-03-02,ORL,@,IND,W 117-112,240,46,91,.505,36,63,.571,10,28,.357,15,19,.789,117
583,2019-03-02,BRK,@,MIA,L 88-117,240,31,88,.352,22,46,.478,9,42,.214,17,22,.773,88
584,2019-03-02,MIA,,BRK,W 117-88,240,44,90,.489,30,56,.536,14,34,.412,15,22,.682,117
585,2019-03-02,GSW,@,PHI,W 120-117,240,41,81,.506,27,48,.563,14,33,.424,24,34,.706,120
586,2019-03-02,PHI,,GSW,L 117-120,240,39,87,.448,25,56,.446,14,31,.452,25,29,.862,117
587,2019-03-02,LAL,@,PHO,L 109-118,240,43,89,.483,35,64,.547,8,25,.320,15,23,.652,109
588,2019-03-02,PHO,,LAL,W 118-109,240,39,76,.513,33,50,.660,6,26,.231,34,40,.850,118
589,2019-03-02,OKC,@,SAS,L 102-116,240,40,88,.455,33,59,.559,7,29,.241,15,24,.625,102
590,2019-03-02,SAS,,OKC,W 116-102,240,45,91,.495,37,72,.514,8,19,.421,18,25,.720,116
591,2019-03-02,MIL,@,UTA,L 111-115,240,37,96,.385,22,57,.386,15,39,.385,22,30,.733,111
592,2019-03-02,UTA,,MIL,W 115-111,240,44,96,.458,32,67,.478,12,29,.414,15,26,.577,115
593,2019-03-01,ATL,,CHI,L 161-168 (4OT),340,61,123,.496,39,63,.619,22,60,.367,17,25,.680,161
594,2019-03-01,CHI,@,ATL,W 168-161 (4OT),340,56,119,.471,35,71,.493,21,48,.438,35,48,.729,168
595,2019-03-01,BOS,,WAS,W 107-96,240,42,94,.447,32,59,.542,10,35,.286,13,17,.765,107
596,2019-03-01,WAS,@,BOS,L 96-107,240,36,89,.404,26,51,.510,10,38,.263,14,19,.737,96
597,2019-03-01,BRK,,CHO,L 112-123,240,44,86,.512,34,54,.630,10,32,.313,14,18,.778,112
598,2019-03-01,CHA,@,BRK,W 123-112,240,50,94,.532,41,73,.562,9,21,.429,14,17,.824,123
599,2019-03-01,LAL,,MIL,L 120-131,240,46,96,.479,33,56,.589,13,40,.325,15,18,.833,120
600,2019-03-01,MIL,@,LAL,W 131-120,240,48,93,.516,34,53,.642,14,40,.350,21,24,.875,131
601,2019-03-01,NOP,@,PHO,W 130-116,240,50,87,.575,34,60,.567,16,27,.593,14,20,.700,130
602,2019-03-01,PHO,,NOP,L 116-130,240,40,94,.426,28,60,.467,12,34,.353,24,28,.857,116
603,2019-03-01,LAC,@,SAC,W 116-109,240,40,92,.435,28,61,.459,12,31,.387,24,33,.727,116
604,2019-03-01,SAC,,LAC,L 109-116,240,41,93,.441,35,72,.486,6,21,.286,21,25,.840,109
605,2019-03-01,POR,@,TOR,L 117-119,240,42,85,.494,28,52,.538,14,33,.424,19,23,.826,117
606,2019-03-01,TOR,,POR,W 119-117,240,45,81,.556,35,53,.660,10,28,.357,19,21,.905,119
607,2019-02-28,DEN,,UTA,L 104-111,240,40,99,.404,33,74,.446,7,25,.280,17,24,.708,104
608,2019-02-28,UTA,@,DEN,W 111-104,240,37,84,.440,21,41,.512,16,43,.372,21,33,.636,111
609,2019-02-28,HOU,,MIA,W 121-118,240,38,77,.494,19,31,.613,19,46,.413,26,28,.929,121
610,2019-02-28,MIA,@,HOU,L 118-121,240,42,81,.519,27,53,.509,15,28,.536,19,24,.792,118
611,2019-02-28,IND,,MIN,W 122-115,240,40,84,.476,24,57,.421,16,27,.593,26,31,.839,122
612,2019-02-28,MIN,@,IND,L 115-122,240,42,89,.472,34,63,.540,8,26,.308,23,34,.676,115
613,2019-02-28,CLE,@,NYK,W 125-118,240,41,80,.513,27,46,.587,14,34,.412,29,36,.806,125
614,2019-02-28,NYK,,CLE,L 118-125,240,46,95,.484,35,63,.556,11,32,.344,15,23,.652,118
615,2019-02-28,OKC,,PHI,L 104-108,240,38,87,.437,30,60,.500,8,27,.296,20,28,.714,104
616,2019-02-28,PHI,@,OKC,W 108-104,240,42,91,.462,30,61,.492,12,30,.400,12,19,.632,108
617,2019-02-28,GSW,@,ORL,L 96-103,240,39,97,.402,30,57,.526,9,40,.225,9,10,.900,96
618,2019-02-28,ORL,,GSW,W 103-96,240,40,89,.449,29,58,.500,11,31,.355,12,15,.800,103
619,2019-02-27,ATL,,MIN,W 131-123 (OT),265,46,108,.426,34,79,.430,12,29,.414,27,32,.844,131
620,2019-02-27,MIN,@,ATL,L 123-131 (OT),265,44,102,.431,32,64,.500,12,38,.316,23,33,.697,123
621,2019-02-27,BOS,,POR,L 92-97,240,40,86,.465,35,58,.603,5,28,.179,7,10,.700,92
622,2019-02-27,POR,@,BOS,W 97-92,240,38,90,.422,32,57,.561,6,33,.182,15,20,.750,97
623,2019-02-27,BRK,,WAS,L 116-125,240,39,85,.459,31,50,.620,8,35,.229,30,39,.769,116
624,2019-02-27,WAS,@,BRK,W 125-116,240,44,96,.458,33,59,.559,11,37,.297,26,31,.839,125
625,2019-02-27,CHA,,HOU,L 113-118,240,39,83,.470,27,50,.540,12,33,.364,23,27,.852,113
626,2019-02-27,HOU,@,CHO,W 118-113,240,42,91,.462,29,52,.558,13,39,.333,21,24,.875,118
627,2019-02-27,DAL,,IND,W 110-101,240,40,81,.494,24,44,.545,16,37,.432,14,23,.609,110
628,2019-02-27,IND,@,DAL,L 101-110,240,37,77,.481,27,49,.551,10,28,.357,17,21,.810,101
629,2019-02-27,LAL,,NOP,W 125-119,240,49,94,.521,41,69,.594,8,25,.320,19,31,.613,125
630,2019-02-27,NOP,@,LAL,L 119-125,240,46,102,.451,39,67,.582,7,35,.200,20,27,.741,119
631,2019-02-27,CHI,@,MEM,W 109-107,240,39,82,.476,31,58,.534,8,24,.333,23,25,.920,109
632,2019-02-27,MEM,,CHI,L 107-109,240,41,94,.436,32,67,.478,9,27,.333,16,18,.889,107
633,2019-02-27,GSW,@,MIA,L 125-126,240,44,89,.494,27,41,.659,17,48,.354,20,28,.714,125
634,2019-02-27,MIA,,GSW,W 126-125,240,42,83,.506,24,42,.571,18,41,.439,24,30,.800,126
635,2019-02-27,MIL,@,SAC,W 141-140 (OT),265,54,112,.482,37,67,.552,17,45,.378,16,21,.762,141
636,2019-02-27,SAC,,MIL,L 140-141 (OT),265,53,118,.449,41,85,.482,12,33,.364,22,30,.733,140
637,2019-02-27,DET,@,SAS,L 93-105,240,36,100,.360,21,62,.339,15,38,.395,6,7,.857,93
638,2019-02-27,SAS,,DET,W 105-93,240,42,81,.519,33,64,.516,9,17,.529,12,17,.706,105
639,2019-02-27,LAC,@,UTA,L 105-111,240,37,94,.394,32,68,.471,5,26,.192,26,30,.867,105
640,2019-02-27,UTA,,LAC,W 111-105,240,38,92,.413,27,58,.466,11,34,.324,24,32,.750,111
641,2019-02-26,DEN,,OKC,W 121-112,240,41,88,.466,28,60,.467,13,28,.464,26,35,.743,121
642,2019-02-26,OKC,@,DEN,L 112-121,240,43,95,.453,33,57,.579,10,38,.263,16,25,.640,112
643,2019-02-26,NYK,,ORL,W 108-103,240,38,89,.427,31,65,.477,7,24,.292,25,32,.781,108
644,2019-02-26,ORL,@,NYK,L 103-108,240,39,89,.438,28,57,.491,11,32,.344,14,20,.700,103
645,2019-02-26,BOS,@,TOR,L 95-118,240,33,86,.384,27,56,.482,6,30,.200,23,28,.821,95
646,2019-02-26,TOR,,BOS,W 118-95,240,46,94,.489,29,58,.500,17,36,.472,9,14,.643,118
647,2019-02-25,BRK,,SAS,W 101-85,240,35,81,.432,16,31,.516,19,50,.380,12,16,.750,101
648,2019-02-25,SAS,@,BRK,L 85-101,240,35,96,.365,31,72,.431,4,24,.167,11,12,.917,85
649,2019-02-25,CHI,,MIL,L 106-117,240,41,92,.446,32,66,.485,9,26,.346,15,22,.682,106
650,2019-02-25,MIL,@,CHI,W 117-106,240,42,91,.462,25,42,.595,17,49,.347,16,23,.696,117
651,2019-02-25,CHA,,GSW,L 110-121,240,40,91,.440,33,58,.569,7,33,.212,23,26,.885,110
652,2019-02-25,GSW,@,CHO,W 121-110,240,48,95,.505,34,54,.630,14,41,.341,11,13,.846,121
653,2019-02-25,CLE,,POR,L 110-123,240,37,89,.416,24,55,.436,13,34,.382,23,26,.885,110
654,2019-02-25,POR,@,CLE,W 123-110,240,44,78,.564,26,49,.531,18,29,.621,17,22,.773,123
655,2019-02-25,DET,,IND,W 113-109,240,39,88,.443,21,47,.447,18,41,.439,17,26,.654,113
656,2019-02-25,IND,@,DET,L 109-113,240,40,87,.460,30,61,.492,10,26,.385,19,21,.905,109
657,2019-02-25,ATL,@,HOU,L 111-119,240,39,80,.488,22,42,.524,17,38,.447,16,23,.696,111
658,2019-02-25,HOU,,ATL,W 119-111,240,39,90,.433,24,39,.615,15,51,.294,26,30,.867,119
659,2019-02-25,DAL,@,LAC,L 112-121,240,37,76,.487,23,40,.575,14,36,.389,24,27,.889,112
660,2019-02-25,LAC,,DAL,W 121-112,240,45,100,.450,28,55,.509,17,45,.378,14,18,.778,121
661,2019-02-25,LAL,@,MEM,L 105-110,240,40,89,.449,30,62,.484,10,27,.370,15,20,.750,105
662,2019-02-25,MEM,,LAL,W 110-105,240,41,93,.441,32,57,.561,9,36,.250,19,23,.826,110
663,2019-02-25,MIA,,PHO,L 121-124,240,48,97,.495,39,68,.574,9,29,.310,16,20,.800,121
664,2019-02-25,PHO,@,MIA,W 124-121,240,45,89,.506,32,57,.561,13,32,.406,21,25,.840,124
665,2019-02-25,MIN,,SAC,W 112-105,240,42,83,.506,34,52,.654,8,31,.258,20,28,.714,112
666,2019-02-25,SAC,@,MIN,L 105-112,240,37,95,.389,28,69,.406,9,26,.346,22,29,.759,105
667,2019-02-25,NOP,,PHI,L 110-111,240,44,104,.423,39,76,.513,5,28,.179,17,24,.708,110
668,2019-02-25,PHI,@,NOP,W 111-110,240,44,101,.436,34,70,.486,10,31,.323,13,19,.684,111
669,2019-02-24,DEN,,LAC,W 123-96,240,44,85,.518,32,51,.627,12,34,.353,23,35,.657,123
670,2019-02-24,LAC,@,DEN,L 96-123,240,30,87,.345,27,66,.409,3,21,.143,33,37,.892,96
671,2019-02-24,NYK,,SAS,W 130-118,240,50,98,.510,34,61,.557,16,37,.432,14,19,.737,130
672,2019-02-24,SAS,@,NYK,L 118-130,240,42,94,.447,36,70,.514,6,24,.250,28,31,.903,118
673,2019-02-24,ORL,@,TOR,W 113-98,240,42,91,.462,28,55,.509,14,36,.389,15,20,.750,113
674,2019-02-24,TOR,,ORL,L 98-113,240,38,91,.418,27,63,.429,11,28,.393,11,14,.786,98
675,2019-02-23,ATL,,PHO,W 120-112,240,38,92,.413,26,59,.441,12,33,.364,32,38,.842,120
676,2019-02-23,PHO,@,ATL,L 112-120,240,41,93,.441,28,56,.500,13,37,.351,17,20,.850,112
677,2019-02-23,BOS,@,CHI,L 116-126,240,45,92,.489,35,63,.556,10,29,.345,16,21,.762,116
678,2019-02-23,CHI,,BOS,W 126-116,240,47,88,.534,35,58,.603,12,30,.400,20,21,.952,126
679,2019-02-23,BRK,@,CHO,W 117-115,240,40,87,.460,23,44,.523,17,43,.395,20,26,.769,117
680,2019-02-23,CHA,,BRK,L 115-117,240,39,86,.453,27,51,.529,12,35,.343,25,30,.833,115
681,2019-02-23,CLE,,MEM,W 112-107,240,39,88,.443,23,46,.500,16,42,.381,18,23,.783,112
682,2019-02-23,MEM,@,CLE,L 107-112,240,40,90,.444,35,65,.538,5,25,.200,22,28,.786,107
683,2019-02-23,GSW,,HOU,L 112-118,240,42,90,.467,28,54,.519,14,36,.389,14,20,.700,112
684,2019-02-23,HOU,@,GSW,W 118-112,240,40,92,.435,24,49,.490,16,43,.372,22,24,.917,118
685,2019-02-23,DET,@,MIA,W 119-96,240,42,80,.525,28,47,.596,14,33,.424,21,26,.808,119
686,2019-02-23,MIA,,DET,L 96-119,240,35,82,.427,28,54,.519,7,28,.250,19,27,.704,96
687,2019-02-23,MIL,,MIN,W 140-128,240,50,95,.526,31,52,.596,19,43,.442,21,22,.955,140
688,2019-02-23,MIN,@,MIL,L 128-140,240,50,102,.490,38,76,.500,12,26,.462,16,20,.800,128
689,2019-02-23,LAL,@,NOP,L 115-128,240,44,81,.543,34,52,.654,10,29,.345,17,26,.654,115
690,2019-02-23,NOP,,LAL,W 128-115,240,50,96,.521,35,56,.625,15,40,.375,13,16,.813,128
691,2019-02-23,OKC,,SAC,L 116-119,240,40,105,.381,26,59,.441,14,46,.304,22,28,.786,116
692,2019-02-23,SAC,@,OKC,W 119-116,240,44,97,.454,37,78,.474,7,19,.368,24,34,.706,119
693,2019-02-23,PHI,,POR,L 115-130,240,42,87,.483,33,63,.524,9,24,.375,22,28,.786,115
694,2019-02-23,POR,@,PHI,W 130-115,240,49,99,.495,44,76,.579,5,23,.217,27,29,.931,130
695,2019-02-23,DAL,@,UTA,L 109-125,240,41,97,.423,28,61,.459,13,36,.361,14,18,.778,109
696,2019-02-23,UTA,,DAL,W 125-109,240,41,85,.482,27,47,.574,14,38,.368,29,33,.879,125
697,2019-02-23,IND,@,WAS,W 119-112,240,47,83,.566,36,58,.621,11,25,.440,14,22,.636,119
698,2019-02-23,WAS,,IND,L 112-119,240,42,79,.532,29,44,.659,13,35,.371,15,21,.714,112
699,2019-02-22,ATL,,DET,L 122-125,240,43,88,.489,23,46,.500,20,42,.476,16,19,.842,122
700,2019-02-22,DET,@,ATL,W 125-122,240,46,95,.484,31,55,.564,15,40,.375,18,28,.643,125
701,2019-02-22,CHA,,WAS,W 123-110,240,46,96,.479,33,63,.524,13,33,.394,18,22,.818,123
702,2019-02-22,WAS,@,CHO,L 110-123,240,42,97,.433,32,58,.552,10,39,.256,16,18,.889,110
703,2019-02-22,DAL,,DEN,L 104-114,240,34,84,.405,24,43,.558,10,41,.244,26,33,.788,104
704,2019-02-22,DEN,@,DAL,W 114-104,240,42,103,.408,28,66,.424,14,37,.378,16,25,.640,114
705,2019-02-22,IND,,NOP,W 126-111,240,44,93,.473,30,61,.492,14,32,.438,24,35,.686,126
706,2019-02-22,NOP,@,IND,L 111-126,240,43,93,.462,35,66,.530,8,27,.296,17,30,.567,111
707,2019-02-22,LAC,@,MEM,W 112-106,240,35,75,.467,29,50,.580,6,25,.240,36,42,.857,112
708,2019-02-22,MEM,,LAC,L 106-112,240,33,90,.367,24,58,.414,9,32,.281,31,36,.861,106
709,2019-02-22,MIN,@,NYK,W 115-104,240,41,87,.471,30,63,.476,11,24,.458,22,32,.688,115
710,2019-02-22,NYK,,MIN,L 104-115,240,37,86,.430,26,57,.456,11,29,.379,19,24,.792,104
711,2019-02-22,OKC,,UTA,W 148-147 (2OT),290,55,118,.466,37,74,.500,18,44,.409,20,25,.800,148
712,2019-02-22,UTA,@,OKC,L 147-148 (2OT),290,52,105,.495,34,65,.523,18,40,.450,25,31,.806,147
713,2019-02-22,CHI,@,ORL,W 110-109,240,40,90,.444,28,61,.459,12,29,.414,18,19,.947,110
714,2019-02-22,ORL,,CHI,L 109-110,240,41,81,.506,27,47,.574,14,34,.412,13,24,.542,109
715,2019-02-22,SAS,@,TOR,L 117-120,240,43,89,.483,31,52,.596,12,37,.324,19,22,.864,117
716,2019-02-22,TOR,,SAS,W 120-117,240,40,94,.426,26,64,.406,14,30,.467,26,32,.813,120
717,2019-02-21,BRK,,POR,L 99-113,240,36,92,.391,29,56,.518,7,36,.194,20,26,.769,99
718,2019-02-21,POR,@,BRK,W 113-99,240,46,105,.438,39,73,.534,7,32,.219,14,16,.875,113
719,2019-02-21,CLE,,PHO,W 111-98,240,42,85,.494,29,49,.592,13,36,.361,14,20,.700,111
720,2019-02-21,PHO,@,CLE,L 98-111,240,35,84,.417,25,52,.481,10,32,.313,18,25,.720,98
721,2019-02-21,GSW,,SAC,W 125-123,240,43,94,.457,24,48,.500,19,46,.413,20,24,.833,125
722,2019-02-21,SAC,@,GSW,L 123-125,240,43,99,.434,33,66,.500,10,33,.303,27,34,.794,123
723,2019-02-21,HOU,@,LAL,L 106-111,240,40,88,.455,28,47,.596,12,41,.293,14,15,.933,106
724,2019-02-21,LAL,,HOU,W 111-106,240,38,86,.442,30,56,.536,8,30,.267,27,33,.818,111
725,2019-02-21,BOS,@,MIL,L 97-98,240,39,102,.382,25,62,.403,14,40,.350,5,6,.833,97
726,2019-02-21,MIL,,BOS,W 98-97,240,37,88,.420,23,49,.469,14,39,.359,10,14,.714,98
727,2019-02-21,MIA,@,PHI,L 102-106,240,45,94,.479,39,72,.542,6,22,.273,6,12,.500,102
728,2019-02-21,PHI,,MIA,W 106-102,240,37,82,.451,30,56,.536,7,26,.269,25,35,.714,106
729,2019-02-14,ATL,,NYK,L 91-106,240,33,91,.363,23,53,.434,10,38,.263,15,19,.789,91
730,2019-02-14,NYK,@,ATL,W 106-91,240,38,84,.452,26,53,.491,12,31,.387,18,26,.692,106
731,2019-02-14,NOP,,OKC,W 131-122,240,50,92,.543,38,66,.576,12,26,.462,19,24,.792,131
732,2019-02-14,OKC,@,NOP,L 122-131,240,50,106,.472,40,62,.645,10,44,.227,12,13,.923,122
733,2019-02-14,CHA,@,ORL,L 89-127,240,33,94,.351,29,63,.460,4,31,.129,19,26,.731,89
734,2019-02-14,ORL,,CHO,W 127-89,240,48,92,.522,31,53,.585,17,39,.436,14,18,.778,127
735,2019-02-13,BOS,,DET,W 118-110,240,45,88,.511,29,49,.592,16,39,.410,12,15,.800,118
736,2019-02-13,DET,@,BOS,L 110-118,240,36,84,.429,23,44,.523,13,40,.325,25,34,.735,110
737,2019-02-13,CHI,,MEM,W 122-110,240,45,80,.563,37,60,.617,8,20,.400,24,29,.828,122
738,2019-02-13,MEM,@,CHI,L 110-122,240,43,89,.483,32,58,.552,11,31,.355,13,17,.765,110
739,2019-02-13,BRK,@,CLE,W 148-139 (3OT),315,52,113,.460,34,68,.500,18,45,.400,26,34,.765,148
740,2019-02-13,CLE,,BRK,L 139-148 (3OT),315,54,120,.450,36,78,.462,18,42,.429,13,18,.722,139
741,2019-02-13,DAL,,MIA,L 101-112,240,34,88,.386,19,36,.528,15,52,.288,18,22,.818,101
742,2019-02-13,MIA,@,DAL,W 112-101,240,44,81,.543,32,51,.627,12,30,.400,12,16,.750,112
743,2019-02-13,DEN,,SAC,W 120-118,240,45,99,.455,37,68,.544,8,31,.258,22,25,.880,120
744,2019-02-13,SAC,@,DEN,L 118-120,240,42,93,.452,31,61,.508,11,32,.344,23,28,.821,118
745,2019-02-13,IND,,MIL,L 97-106,240,37,88,.420,27,61,.443,10,27,.370,13,15,.867,97
746,2019-02-13,MIL,@,IND,W 106-97,240,38,86,.442,29,55,.527,9,31,.290,21,29,.724,106
747,2019-02-13,LAC,,PHO,W 134-107,240,50,84,.595,39,62,.629,11,22,.500,23,30,.767,134
748,2019-02-13,PHO,@,LAC,L 107-134,240,40,86,.465,32,56,.571,8,30,.267,19,25,.760,107
749,2019-02-13,HOU,@,MIN,L 111-121,240,40,98,.408,21,45,.467,19,53,.358,12,13,.923,111
750,2019-02-13,MIN,,HOU,W 121-111,240,49,90,.544,39,70,.557,10,20,.500,13,17,.765,121
751,2019-02-13,NYK,,PHI,L 111-126,240,40,100,.400,31,71,.437,9,29,.310,22,27,.815,111
752,2019-02-13,PHI,@,NYK,W 126-111,240,42,78,.538,34,55,.618,8,23,.348,34,43,.791,126
753,2019-02-13,GSW,@,POR,L 107-129,240,39,97,.402,26,59,.441,13,38,.342,16,18,.889,107
754,2019-02-13,POR,,GSW,W 129-107,240,43,93,.462,27,56,.482,16,37,.432,27,34,.794,129
755,2019-02-13,TOR,,WAS,W 129-120,240,44,92,.478,28,54,.519,16,38,.421,25,30,.833,129
756,2019-02-13,WAS,@,TOR,L 120-129,240,37,84,.440,23,44,.523,14,40,.350,32,39,.821,120
757,2019-02-12,ATL,,LAL,W 117-113,240,40,92,.435,24,50,.480,16,42,.381,21,26,.808,117
758,2019-02-12,LAL,@,ATL,L 113-117,240,41,95,.432,27,55,.491,14,40,.350,17,25,.680,113
759,2019-02-12,GSW,,UTA,W 115-108,240,44,89,.494,31,48,.646,13,41,.317,14,21,.667,115
760,2019-02-12,UTA,@,GSW,L 108-115,240,41,87,.471,31,61,.508,10,26,.385,16,21,.762,108
761,2019-02-12,MEM,,SAS,L 107-108,240,44,89,.494,36,65,.554,8,24,.333,11,16,.688,107
762,2019-02-12,SAS,@,MEM,W 108-107,240,36,86,.419,23,65,.354,13,21,.619,23,29,.793,108
763,2019-02-12,NOP,,ORL,L 88-118,240,36,94,.383,26,65,.400,10,29,.345,6,8,.750,88
764,2019-02-12,ORL,@,NOP,W 118-88,240,42,95,.442,29,63,.460,13,32,.406,21,22,.955,118
765,2019-02-12,BOS,@,PHI,W 112-109,240,41,88,.466,28,59,.475,13,29,.448,17,21,.810,112
766,2019-02-12,PHI,,BOS,L 109-112,240,39,80,.488,30,53,.566,9,27,.333,22,31,.710,109
767,2019-02-11,CHI,,MIL,L 99-112,240,37,96,.385,28,68,.412,9,28,.321,16,18,.889,99
768,2019-02-11,MIL,@,CHI,W 112-99,240,38,80,.475,26,42,.619,12,38,.316,24,29,.828,112
769,2019-02-11,CLE,,NYK,W 107-104,240,38,95,.400,24,51,.471,14,44,.318,17,19,.895,107
770,2019-02-11,NYK,@,CLE,L 104-107,240,42,92,.457,35,66,.530,7,26,.269,13,20,.650,104
771,2019-02-11,DEN,,MIA,W 103-87,240,38,89,.427,22,52,.423,16,37,.432,11,13,.846,103
772,2019-02-11,MIA,@,DEN,L 87-103,240,34,82,.415,25,49,.510,9,33,.273,10,16,.625,87
773,2019-02-11,DET,,WAS,W 121-112,240,44,85,.518,29,49,.592,15,36,.417,18,21,.857,121
774,2019-02-11,WAS,@,DET,L 112-121,240,42,84,.500,28,45,.622,14,39,.359,14,19,.737,112
775,2019-02-11,DAL,@,HOU,L 104-120,240,35,73,.479,22,37,.595,13,36,.361,21,27,.778,104
776,2019-02-11,HOU,,DAL,W 120-104,240,42,90,.467,19,30,.633,23,60,.383,13,15,.867,120
777,2019-02-11,CHA,@,IND,L 90-99,240,29,90,.322,22,50,.440,7,40,.175,25,33,.758,90
778,2019-02-11,IND,,CHO,W 99-90,240,38,74,.514,30,49,.612,8,25,.320,15,17,.882,99
779,2019-02-11,LAC,@,MIN,L 120-130,240,37,72,.514,25,43,.581,12,29,.414,34,39,.872,120
780,2019-02-11,MIN,,LAC,W 130-120,240,47,90,.522,41,72,.569,6,18,.333,30,36,.833,130
781,2019-02-11,OKC,,POR,W 120-111,240,41,86,.477,25,51,.490,16,35,.457,22,29,.759,120
782,2019-02-11,POR,@,OKC,L 111-120,240,36,87,.414,25,58,.431,11,29,.379,28,38,.737,111
783,2019-02-11,BRK,@,TOR,L 125-127,240,46,88,.523,26,47,.553,20,41,.488,13,18,.722,125
784,2019-02-11,TOR,,BRK,W 127-125,240,50,92,.543,41,61,.672,9,31,.290,18,20,.900,127
785,2019-02-10,ATL,,ORL,L 108-124,240,37,80,.463,24,48,.500,13,32,.406,21,25,.840,108
786,2019-02-10,ORL,@,ATL,W 124-108,240,43,91,.473,30,54,.556,13,37,.351,25,28,.893,124
787,2019-02-10,DAL,,POR,W 102-101,240,36,87,.414,24,50,.480,12,37,.324,18,23,.783,102
788,2019-02-10,POR,@,DAL,L 101-102,240,42,86,.488,33,57,.579,9,29,.310,8,14,.571,101
789,2019-02-10,GSW,,MIA,W 120-118,240,44,82,.537,31,46,.674,13,36,.361,19,26,.731,120
790,2019-02-10,MIA,@,GSW,L 118-120,240,48,105,.457,30,62,.484,18,43,.419,4,8,.500,118
791,2019-02-10,LAL,@,PHI,L 120-143,240,48,93,.516,38,66,.576,10,27,.370,14,19,.737,120
792,2019-02-10,PHI,,LAL,W 143-120,240,56,97,.577,44,73,.603,12,24,.500,19,22,.864,143
793,2019-02-10,PHO,@,SAC,L 104-117,240,38,91,.418,32,64,.500,6,27,.222,22,30,.733,104
794,2019-02-10,SAC,,PHO,W 117-104,240,38,84,.452,29,53,.547,9,31,.290,32,44,.727,117
795,2019-02-09,ATL,,CHO,L 120-129,240,46,86,.535,32,53,.604,14,33,.424,14,19,.737,120
796,2019-02-09,CHA,@,ATL,W 129-120,240,48,88,.545,29,46,.630,19,42,.452,14,18,.778,129
797,2019-02-09,BOS,,LAC,L 112-123,240,39,92,.424,30,66,.455,9,26,.346,25,31,.806,112
798,2019-02-09,LAC,@,BOS,W 123-112,240,40,84,.476,28,54,.519,12,30,.400,31,40,.775,123
799,2019-02-09,CHI,,WAS,L 125-134,240,49,97,.505,43,74,.581,6,23,.261,21,28,.750,125
800,2019-02-09,WAS,@,CHI,W 134-125,240,55,95,.579,43,68,.632,12,27,.444,12,14,.857,134
801,2019-02-09,HOU,,OKC,L 112-117,240,37,86,.430,21,41,.512,16,45,.356,22,30,.733,112
802,2019-02-09,OKC,@,HOU,W 117-112,240,40,89,.449,27,55,.491,13,34,.382,24,30,.800,117
803,2019-02-09,CLE,@,IND,L 90-105,240,35,79,.443,19,43,.442,16,36,.444,4,9,.444,90
804,2019-02-09,IND,,CLE,W 105-90,240,45,84,.536,36,58,.621,9,26,.346,6,10,.600,105
805,2019-02-09,MEM,,NOP,W 99-90,240,38,88,.432,30,59,.508,8,29,.276,15,18,.833,99
806,2019-02-09,NOP,@,MEM,L 90-99,240,34,86,.395,28,53,.528,6,33,.182,16,27,.593,90
807,2019-02-09,MIL,,ORL,L 83-103,240,31,95,.326,25,60,.417,6,35,.171,15,18,.833,83
808,2019-02-09,ORL,@,MIL,W 103-83,240,44,94,.468,34,67,.507,10,27,.370,5,6,.833,103
809,2019-02-09,NYK,,TOR,L 99-104,240,39,94,.415,29,69,.420,10,25,.400,11,19,.579,99
810,2019-02-09,TOR,@,NYK,W 104-99,240,33,86,.384,19,51,.373,14,35,.400,24,29,.828,104
811,2019-02-09,SAS,@,UTA,L 105-125,240,40,89,.449,33,67,.493,7,22,.318,18,20,.900,105
812,2019-02-09,UTA,,SAS,W 125-105,240,47,90,.522,31,49,.633,16,41,.390,15,20,.750,125
813,2019-02-08,BRK,,CHI,L 106-125,240,39,94,.415,26,53,.491,13,41,.317,15,16,.938,106
814,2019-02-08,CHI,@,BRK,W 125-106,240,46,85,.541,32,57,.561,14,28,.500,19,24,.792,125
815,2019-02-08,DAL,,MIL,L 107-122,240,36,87,.414,14,34,.412,22,53,.415,13,20,.650,107
816,2019-02-08,MIL,@,DAL,W 122-107,240,51,93,.548,41,57,.719,10,36,.278,10,12,.833,122
817,2019-02-08,DET,,NYK,W 120-103,240,42,86,.488,29,56,.518,13,30,.433,23,29,.793,120
818,2019-02-08,NYK,@,DET,L 103-120,240,35,78,.449,28,56,.500,7,22,.318,26,41,.634,103
819,2019-02-08,MIN,@,NOP,L 117-122,240,46,91,.505,37,70,.529,9,21,.429,16,22,.727,117
820,2019-02-08,NOP,,MIN,W 122-117,240,43,91,.473,34,61,.557,9,30,.300,27,28,.964,122
821,2019-02-08,DEN,@,PHI,L 110-117,240,46,94,.489,40,68,.588,6,26,.231,12,13,.923,110
822,2019-02-08,PHI,,DEN,W 117-110,240,39,78,.500,29,56,.518,10,22,.455,29,32,.906,117
823,2019-02-08,GSW,@,PHO,W 117-107,240,41,81,.506,31,52,.596,10,29,.345,25,35,.714,117
824,2019-02-08,PHO,,GSW,L 107-117,240,39,101,.386,33,70,.471,6,31,.194,23,30,.767,107
825,2019-02-08,MIA,@,SAC,L 96-102,240,38,88,.432,27,55,.491,11,33,.333,9,19,.474,96
826,2019-02-08,SAC,,MIA,W 102-96,240,37,90,.411,28,64,.438,9,26,.346,19,25,.760,102
827,2019-02-08,CLE,@,WAS,L 106-119,240,36,96,.375,24,58,.414,12,38,.316,22,25,.880,106
828,2019-02-08,WAS,,CLE,W 119-106,240,46,92,.500,34,57,.596,12,35,.343,15,16,.938,119
829,2019-02-07,ATL,,TOR,L 101-119,240,36,80,.450,20,45,.444,16,35,.457,13,25,.520,101
830,2019-02-07,TOR,@,ATL,W 119-101,240,40,87,.460,27,47,.574,13,40,.325,26,33,.788,119
831,2019-02-07,BOS,,LAL,L 128-129,240,46,94,.489,30,56,.536,16,38,.421,20,20,1.000,128
832,2019-02-07,LAL,@,BOS,W 129-128,240,50,97,.515,28,56,.500,22,41,.537,7,18,.389,129
833,2019-02-07,IND,,LAC,W 116-92,240,49,87,.563,40,65,.615,9,22,.409,9,11,.818,116
834,2019-02-07,LAC,@,IND,L 92-116,240,37,85,.435,31,68,.456,6,17,.353,12,19,.632,92
835,2019-02-07,MEM,@,OKC,L 95-117,240,34,77,.442,27,53,.509,7,24,.292,20,23,.870,95
836,2019-02-07,OKC,,MEM,W 117-95,240,43,90,.478,26,46,.565,17,44,.386,14,22,.636,117
837,2019-02-07,MIN,@,ORL,L 112-122,240,46,99,.465,36,73,.493,10,26,.385,10,12,.833,112
838,2019-02-07,ORL,,MIN,W 122-112,240,45,83,.542,34,57,.596,11,26,.423,21,23,.913,122
839,2019-02-07,POR,,SAS,W 127-118,240,49,91,.538,38,60,.633,11,31,.355,18,18,1.000,127
840,2019-02-07,SAS,@,POR,L 118-127,240,48,91,.527,36,70,.514,12,21,.571,10,14,.714,118
841,2019-02-06,BRK,,DEN,W 135-130,240,46,90,.511,27,56,.482,19,34,.559,24,33,.727,135
842,2019-02-06,DEN,@,BRK,L 130-135,240,50,99,.505,37,64,.578,13,35,.371,17,21,.810,130
843,2019-02-06,CHI,,NOP,L 120-125,240,45,91,.495,29,55,.527,16,36,.444,14,19,.737,120
844,2019-02-06,NOP,@,CHI,W 125-120,240,45,85,.529,30,50,.600,15,35,.429,20,30,.667,125
845,2019-02-06,CHA,@,DAL,L 93-99,240,36,89,.404,27,52,.519,9,37,.243,12,17,.706,93
846,2019-02-06,DAL,,CHO,W 99-93,240,38,94,.404,27,58,.466,11,36,.306,12,17,.706,99
847,2019-02-06,GSW,,SAS,W 141-102,240,55,95,.579,39,61,.639,16,34,.471,15,21,.714,141
848,2019-02-06,SAS,@,GSW,L 102-141,240,35,81,.432,23,49,.469,12,32,.375,20,21,.952,102
849,2019-02-06,MIL,,WAS,W 148-129,240,56,93,.602,37,63,.587,19,30,.633,17,26,.654,148
850,2019-02-06,WAS,@,MIL,L 129-148,240,48,92,.522,31,55,.564,17,37,.459,16,19,.842,129
851,2019-02-06,HOU,@,SAC,W 127-101,240,45,100,.450,25,49,.510,20,51,.392,17,18,.944,127
852,2019-02-06,SAC,,HOU,L 101-127,240,39,91,.429,28,58,.483,11,33,.333,12,20,.600,101
853,2019-02-06,PHO,@,UTA,L 88-116,240,35,75,.467,32,58,.552,3,17,.176,15,19,.789,88
854,2019-02-06,UTA,,PHO,W 116-88,240,42,84,.500,31,56,.554,11,28,.393,21,32,.656,116
855,2019-02-05,CHA,,LAC,L 115-117,240,39,93,.419,24,51,.471,15,42,.357,22,26,.846,115
856,2019-02-05,LAC,@,CHO,W 117-115,240,42,87,.483,24,63,.381,18,24,.750,15,17,.882,117
857,2019-02-05,BOS,@,CLE,W 103-96,240,40,82,.488,31,56,.554,9,26,.346,14,14,1.000,103
858,2019-02-05,CLE,,BOS,L 96-103,240,40,96,.417,31,63,.492,9,33,.273,7,8,.875,96
859,2019-02-05,IND,,LAL,W 136-94,240,56,98,.571,37,64,.578,19,34,.559,5,8,.625,136
860,2019-02-05,LAL,@,IND,L 94-136,240,35,75,.467,31,54,.574,4,21,.190,20,26,.769,94
861,2019-02-05,MEM,,MIN,W 108-106,240,36,86,.419,21,52,.404,15,34,.441,21,29,.724,108
862,2019-02-05,MIN,@,MEM,L 106-108,240,39,87,.448,30,58,.517,9,29,.310,19,20,.950,106
863,2019-02-05,DET,@,NYK,W 105-92,240,37,79,.468,25,45,.556,12,34,.353,19,24,.792,105
864,2019-02-05,NYK,,DET,L 92-105,240,36,90,.400,27,57,.474,9,33,.273,11,15,.733,92
865,2019-02-05,OKC,,ORL,W 132-122,240,46,92,.500,33,62,.532,13,30,.433,27,37,.730,132
866,2019-02-05,ORL,@,OKC,L 122-132,240,42,90,.467,31,53,.585,11,37,.297,27,34,.794,122
867,2019-02-05,PHI,,TOR,L 107-119,240,31,70,.443,24,46,.522,7,24,.292,38,41,.927,107
868,2019-02-05,TOR,@,PHI,W 119-107,240,41,89,.461,30,58,.517,11,31,.355,26,32,.813,119
869,2019-02-05,MIA,@,POR,W 118-108,240,45,83,.542,38,61,.623,7,22,.318,21,25,.840,118
870,2019-02-05,POR,,MIA,L 108-118,240,42,93,.452,27,54,.500,15,39,.385,9,12,.750,108
871,2019-02-04,BRK,,MIL,L 94-113,240,33,102,.324,28,60,.467,5,42,.119,23,28,.821,94
872,2019-02-04,MIL,@,BRK,W 113-94,240,43,101,.426,33,62,.532,10,39,.256,17,25,.680,113
873,2019-02-04,DEN,@,DET,L 103-129,240,41,92,.446,32,64,.500,9,28,.321,12,22,.545,103
874,2019-02-04,DET,,DEN,W 129-103,240,48,88,.545,32,51,.627,16,37,.432,17,20,.850,129
875,2019-02-04,IND,@,NOP,W 109-107,240,41,91,.451,31,63,.492,10,28,.357,17,24,.708,109
876,2019-02-04,NOP,,IND,L 107-109,240,39,90,.433,30,52,.577,9,38,.237,20,24,.833,107
877,2019-02-04,HOU,@,PHO,W 118-110,240,43,87,.494,30,46,.652,13,41,.317,19,25,.760,118
878,2019-02-04,PHO,,HOU,L 110-118,240,45,84,.536,38,59,.644,7,25,.280,13,18,.722,110
879,2019-02-04,SAC,,SAS,W 127-112,240,50,90,.556,37,58,.638,13,32,.406,14,23,.609,127
880,2019-02-04,SAS,@,SAC,L 112-127,240,42,98,.429,33,66,.500,9,32,.281,19,21,.905,112
881,2019-02-04,ATL,@,WAS,W 137-129,240,46,91,.505,26,51,.510,20,40,.500,25,29,.862,137
882,2019-02-04,WAS,,ATL,L 129-137,240,48,97,.495,36,59,.610,12,38,.316,21,29,.724,129
883,2019-02-03,BOS,,OKC,W 134-129,240,54,91,.593,41,57,.719,13,34,.382,13,17,.765,134
884,2019-02-03,OKC,@,BOS,L 129-134,240,45,92,.489,31,57,.544,14,35,.400,25,34,.735,129
885,2019-02-03,MEM,@,NYK,W 96-84,240,37,91,.407,28,65,.431,9,26,.346,13,18,.722,96
886,2019-02-03,NYK,,MEM,L 84-96,240,28,74,.378,16,34,.471,12,40,.300,16,22,.727,84
887,2019-02-03,LAC,@,TOR,L 103-121,240,38,89,.427,36,77,.468,2,12,.167,25,29,.862,103
888,2019-02-03,TOR,,LAC,W 121-103,240,43,94,.457,34,61,.557,9,33,.273,26,31,.839,121
889,2019-02-02,CHI,@,CHO,L 118-125,240,42,81,.519,33,57,.579,9,24,.375,25,25,1.000,118
890,2019-02-02,CHA,,CHI,W 125-118,240,43,82,.524,29,50,.580,14,32,.438,25,29,.862,125
891,2019-02-02,CLE,,DAL,L 98-111,240,34,85,.400,30,62,.484,4,23,.174,26,33,.788,98
892,2019-02-02,DAL,@,CLE,W 111-98,240,40,84,.476,24,45,.533,16,39,.410,15,19,.789,111
893,2019-02-02,DET,,LAC,L 101-111,240,35,83,.422,18,41,.439,17,42,.405,14,20,.700,101
894,2019-02-02,LAC,@,DET,W 111-101,240,40,82,.488,30,62,.484,10,20,.500,21,34,.618,111
895,2019-02-02,GSW,,LAL,W 115-101,240,43,91,.473,32,57,.561,11,34,.324,18,19,.947,115
896,2019-02-02,LAL,@,GSW,L 101-115,240,42,96,.438,35,69,.507,7,27,.259,10,17,.588,101
897,2019-02-02,IND,@,MIA,W 95-88,240,38,89,.427,31,65,.477,7,24,.292,12,17,.706,95
898,2019-02-02,MIA,,IND,L 88-95,240,30,71,.423,21,41,.512,9,30,.300,19,26,.731,88
899,2019-02-02,DEN,@,MIN,W 107-106,240,42,89,.472,29,56,.518,13,33,.394,10,14,.714,107
900,2019-02-02,MIN,,DEN,L 106-107,240,42,89,.472,31,55,.564,11,34,.324,11,16,.688,106
901,2019-02-02,BRK,@,ORL,L 89-102,240,33,91,.363,23,53,.434,10,38,.263,13,16,.813,89
902,2019-02-02,ORL,,BRK,W 102-89,240,41,94,.436,31,67,.463,10,27,.370,10,12,.833,102
903,2019-02-02,ATL,@,PHO,W 118-112,240,43,84,.512,29,52,.558,14,32,.438,18,26,.692,118
904,2019-02-02,PHO,,ATL,L 112-118,240,45,96,.469,33,64,.516,12,32,.375,10,18,.556,112
905,2019-02-02,PHI,@,SAC,L 108-115,240,41,93,.441,34,60,.567,7,33,.212,19,25,.760,108
906,2019-02-02,SAC,,PHI,W 115-108,240,42,92,.457,31,62,.500,11,30,.367,20,24,.833,115
907,2019-02-02,NOP,@,SAS,L 108-113,240,43,96,.448,33,61,.541,10,35,.286,12,12,1.000,108
908,2019-02-02,SAS,,NOP,W 113-108,240,44,92,.478,35,69,.507,9,23,.391,16,18,.889,113
909,2019-02-02,HOU,@,UTA,W 125-98,240,40,87,.460,25,48,.521,15,39,.385,30,37,.811,125
910,2019-02-02,UTA,,HOU,L 98-125,240,31,86,.360,20,45,.444,11,41,.268,25,36,.694,98
911,2019-02-02,MIL,@,WAS,W 131-115,240,45,91,.495,28,52,.538,17,39,.436,24,24,1.000,131
912,2019-02-02,WAS,,MIL,L 115-131,240,43,93,.462,33,60,.550,10,33,.303,19,26,.731,115
913,2019-02-01,CHA,,MEM,W 100-92,240,32,73,.438,20,44,.455,12,29,.414,24,28,.857,100
914,2019-02-01,MEM,@,CHO,L 92-100,240,35,80,.438,26,51,.510,9,29,.310,13,17,.765,92
915,2019-02-01,DEN,,HOU,W 136-122,240,51,82,.622,37,51,.725,14,31,.452,20,23,.870,136
916,2019-02-01,HOU,@,DEN,L 122-136,240,45,85,.529,29,41,.707,16,44,.364,16,21,.762,122
917,2019-02-01,MIA,,OKC,L 102-118,240,41,92,.446,30,56,.536,11,36,.306,9,14,.643,102
918,2019-02-01,OKC,@,MIA,W 118-102,240,44,91,.484,28,61,.459,16,30,.533,14,19,.737,118
919,2019-02-01,BOS,@,NYK,W 113-99,240,46,100,.460,33,63,.524,13,37,.351,8,10,.800,113
920,2019-02-01,NYK,,BOS,L 99-113,240,39,86,.453,30,55,.545,9,31,.290,12,12,1.000,99
921,2019-02-01,ATL,@,UTA,L 112-128,240,39,98,.398,25,52,.481,14,46,.304,20,24,.833,112
922,2019-02-01,UTA,,ATL,W 128-112,240,46,87,.529,34,52,.654,12,35,.343,24,30,.800,128
923,2019-01-31,DAL,@,DET,L 89-93,240,36,88,.409,29,63,.460,7,25,.280,10,14,.714,89
924,2019-01-31,DET,,DAL,W 93-89,240,33,86,.384,24,53,.453,9,33,.273,18,23,.783,93
925,2019-01-31,GSW,,PHI,L 104-113,240,41,88,.466,30,50,.600,11,38,.289,11,16,.688,104
926,2019-01-31,PHI,@,GSW,W 113-104,240,41,88,.466,29,51,.569,12,37,.324,19,24,.792,113
927,2019-01-31,LAC,,LAL,L 120-123 (OT),265,46,104,.442,32,61,.525,14,43,.326,14,26,.538,120
928,2019-01-31,LAL,@,LAC,W 123-120 (OT),265,42,92,.457,31,66,.470,11,26,.423,28,35,.800,123
929,2019-01-31,IND,@,ORL,L 100-107,240,41,91,.451,37,72,.514,4,19,.211,14,16,.875,100
930,2019-01-31,ORL,,IND,W 107-100,240,38,82,.463,27,57,.474,11,25,.440,20,22,.909,107
931,2019-01-31,BRK,@,SAS,L 114-117,240,42,89,.472,31,55,.564,11,34,.324,19,29,.655,114
932,2019-01-31,SAS,,BRK,W 117-114,240,40,100,.400,28,67,.418,12,33,.364,25,29,.862,117
933,2019-01-31,MIL,@,TOR,W 105-92,240,39,79,.494,25,41,.610,14,38,.368,13,17,.765,105
934,2019-01-31,TOR,,MIL,L 92-105,240,37,93,.398,30,66,.455,7,27,.259,11,13,.846,92
935,2019-01-30,BOS,,CHO,W 126-94,240,50,90,.556,38,61,.623,12,29,.414,14,16,.875,126
936,2019-01-30,CHA,@,BOS,L 94-126,240,39,89,.438,26,49,.531,13,40,.325,3,7,.429,94
937,2019-01-30,CHI,@,MIA,W 105-89,240,40,78,.513,32,59,.542,8,19,.421,17,21,.810,105
938,2019-01-30,MIA,,CHI,L 89-105,240,34,89,.382,22,47,.468,12,42,.286,9,13,.692,89
939,2019-01-30,MEM,@,MIN,L 97-99 (OT),265,36,87,.414,30,64,.469,6,23,.261,19,22,.864,97
940,2019-01-30,MIN,,MEM,W 99-97 (OT),265,37,95,.389,29,60,.483,8,35,.229,17,22,.773,99
941,2019-01-30,DEN,@,NOP,W 105-99,240,42,89,.472,33,59,.559,9,30,.300,12,19,.632,105
942,2019-01-30,NOP,,DEN,L 99-105,240,37,89,.416,22,53,.415,15,36,.417,10,13,.769,99
943,2019-01-30,DAL,@,NYK,W 114-90,240,45,84,.536,30,46,.652,15,38,.395,9,11,.818,114
944,2019-01-30,NYK,,DAL,L 90-114,240,32,78,.410,26,52,.500,6,26,.231,20,28,.714,90
945,2019-01-30,POR,,UTA,W 132-105,240,48,90,.533,32,58,.552,16,32,.500,20,23,.870,132
946,2019-01-30,UTA,@,POR,L 105-132,240,38,85,.447,27,51,.529,11,34,.324,18,21,.857,105
947,2019-01-30,ATL,@,SAC,L 113-135,240,38,86,.442,22,40,.550,16,46,.348,21,25,.840,113
948,2019-01-30,SAC,,ATL,W 135-113,240,54,99,.545,43,64,.672,11,35,.314,16,21,.762,135
949,2019-01-30,IND,@,WAS,L 89-107,240,33,84,.393,24,53,.453,9,31,.290,14,18,.778,89
950,2019-01-30,WAS,,IND,W 107-89,240,41,78,.526,29,50,.580,12,28,.429,13,21,.619,107
951,2019-01-29,BRK,,CHI,W 122-117,240,42,94,.447,32,59,.542,10,35,.286,28,40,.700,122
952,2019-01-29,CHI,@,BRK,L 117-122,240,47,94,.500,38,66,.576,9,28,.321,14,19,.737,117
953,2019-01-29,CLE,,WAS,W 116-113,240,45,84,.536,30,50,.600,15,34,.441,11,24,.458,116
954,2019-01-29,WAS,@,CLE,L 113-116,240,42,87,.483,30,51,.588,12,36,.333,17,23,.739,113
955,2019-01-29,DET,,MIL,L 105-115,240,42,89,.472,30,52,.577,12,37,.324,9,12,.750,105
956,2019-01-29,MIL,@,DET,W 115-105,240,47,87,.540,34,55,.618,13,32,.406,8,10,.800,115
957,2019-01-29,HOU,,NOP,L 116-121,240,40,101,.396,21,45,.467,19,56,.339,17,24,.708,116
958,2019-01-29,NOP,@,HOU,W 121-116,240,46,90,.511,37,59,.627,9,31,.290,20,25,.800,121
959,2019-01-29,LAL,,PHI,L 105-121,240,43,92,.467,36,69,.522,7,23,.304,12,16,.750,105
960,2019-01-29,PHI,@,LAL,W 121-105,240,42,93,.452,27,57,.474,15,36,.417,22,28,.786,121
961,2019-01-29,OKC,@,ORL,W 126-117,240,49,91,.538,40,70,.571,9,21,.429,19,26,.731,126
962,2019-01-29,ORL,,OKC,L 117-126,240,44,102,.431,30,61,.492,14,41,.341,15,18,.833,117
963,2019-01-29,PHO,@,SAS,L 124-126,240,48,80,.600,35,51,.686,13,29,.448,15,19,.789,124
964,2019-01-29,SAS,,PHO,W 126-124,240,47,100,.470,32,66,.485,15,34,.441,17,20,.850,126
965,2019-01-28,BOS,,BRK,W 112-104,240,45,100,.450,32,60,.533,13,40,.325,9,10,.900,112
966,2019-01-28,BRK,@,BOS,L 104-112,240,39,103,.379,26,69,.377,13,34,.382,13,16,.813,104
967,2019-01-28,CHA,,NYK,W 101-92,240,39,94,.415,28,60,.467,11,34,.324,12,16,.750,101
968,2019-01-28,NYK,@,CHO,L 92-101,240,34,85,.400,27,62,.435,7,23,.304,17,26,.654,92
969,2019-01-28,GSW,@,IND,W 132-100,240,53,98,.541,40,67,.597,13,31,.419,13,16,.813,132
970,2019-01-28,IND,,GSW,L 100-132,240,40,94,.426,28,64,.438,12,30,.400,8,10,.800,100
971,2019-01-28,ATL,@,LAC,W 123-118,240,44,87,.506,34,53,.642,10,34,.294,25,29,.862,123
972,2019-01-28,LAC,,ATL,L 118-123,240,41,85,.482,31,58,.534,10,27,.370,26,28,.929,118
973,2019-01-28,DEN,@,MEM,W 95-92,240,37,84,.440,29,48,.604,8,36,.222,13,14,.929,95
974,2019-01-28,MEM,,DEN,L 92-95,240,35,78,.449,26,46,.565,9,32,.281,13,19,.684,92
975,2019-01-27,CHI,,CLE,L 101-104,240,39,88,.443,30,62,.484,9,26,.346,14,17,.824,101
976,2019-01-27,CLE,@,CHI,W 104-101,240,39,92,.424,26,58,.448,13,34,.382,13,15,.867,104
977,2019-01-27,DAL,,TOR,L 120-123,240,43,88,.489,32,52,.615,11,36,.306,23,34,.676,120
978,2019-01-27,TOR,@,DAL,W 123-120,240,37,83,.446,20,49,.408,17,34,.500,32,38,.842,123
979,2019-01-27,HOU,,ORL,W 103-98,240,38,80,.475,26,44,.591,12,36,.333,15,21,.714,103
980,2019-01-27,ORL,@,HOU,L 98-103,240,39,97,.402,29,62,.468,10,35,.286,10,17,.588,98
981,2019-01-27,LAC,,SAC,W 122-108,240,42,88,.477,31,59,.525,11,29,.379,27,29,.931,122
982,2019-01-27,SAC,@,LAC,L 108-122,240,37,93,.398,29,57,.509,8,36,.222,26,30,.867,108
983,2019-01-27,LAL,,PHO,W 116-102,240,47,89,.528,37,66,.561,10,23,.435,12,18,.667,116
984,2019-01-27,PHO,@,LAL,L 102-116,240,34,85,.400,27,59,.458,7,26,.269,27,32,.844,102
985,2019-01-27,MIN,,UTA,L 111-125,240,37,77,.481,20,41,.488,17,36,.472,20,23,.870,111
986,2019-01-27,UTA,@,MIN,W 125-111,240,46,86,.535,31,47,.660,15,39,.385,18,25,.720,125
987,2019-01-27,MIA,@,NYK,W 106-97,240,39,84,.464,27,51,.529,12,33,.364,16,18,.889,106
988,2019-01-27,NYK,,MIA,L 97-106,240,36,84,.429,29,58,.500,7,26,.269,18,24,.750,97
989,2019-01-27,MIL,@,OKC,L 112-118,240,39,91,.429,24,54,.444,15,37,.405,19,28,.679,112
990,2019-01-27,OKC,,MIL,W 118-112,240,44,94,.468,28,62,.452,16,32,.500,14,25,.560,118
991,2019-01-27,SAS,,WAS,W 132-119,240,49,86,.570,33,52,.635,16,34,.471,18,21,.857,132
992,2019-01-27,WAS,@,SAS,L 119-132,240,40,89,.449,22,43,.512,18,46,.391,21,29,.724,119
993,2019-01-26,BOS,,GSW,L 111-115,240,41,99,.414,26,59,.441,15,40,.375,14,15,.933,111
994,2019-01-26,GSW,@,BOS,W 115-111,240,37,83,.446,25,50,.500,12,33,.364,29,34,.853,115
995,2019-01-26,DEN,,PHI,W 126-110,240,48,94,.511,40,70,.571,8,24,.333,22,29,.759,126
996,2019-01-26,PHI,@,DEN,L 110-126,240,38,91,.418,24,55,.436,14,36,.389,20,27,.741,110
997,2019-01-26,IND,@,MEM,L 103-106,240,32,74,.432,23,47,.489,9,27,.333,30,36,.833,103
998,2019-01-26,MEM,,IND,W 106-103,240,39,80,.488,30,52,.577,9,28,.321,19,28,.679,106
999,2019-01-26,NOP,,SAS,L 114-126,240,45,96,.469,38,69,.551,7,27,.259,17,24,.708,114
1000,2019-01-26,SAS,@,NOP,W 126-114,240,47,91,.516,36,67,.537,11,24,.458,21,25,.840,126
1001,2019-01-26,ATL,@,POR,L 111-120,240,42,92,.457,30,59,.508,12,33,.364,15,20,.750,111
1002,2019-01-26,POR,,ATL,W 120-111,240,41,82,.500,30,52,.577,11,30,.367,27,30,.900,120
1003,2019-01-25,BRK,,NYK,W 109-99,240,34,84,.405,25,51,.490,9,33,.273,32,47,.681,109
1004,2019-01-25,NYK,@,BRK,L 99-109,240,37,87,.425,29,56,.518,8,31,.258,17,26,.654,99
1005,2019-01-25,CHI,,LAC,L 101-106,240,40,102,.392,30,67,.448,10,35,.286,11,12,.917,101
1006,2019-01-25,LAC,@,CHI,W 106-101,240,38,82,.463,30,61,.492,8,21,.381,22,29,.759,106
1007,2019-01-25,CLE,,MIA,L 94-100,240,37,85,.435,27,55,.491,10,30,.333,10,13,.769,94
1008,2019-01-25,MIA,@,CLE,W 100-94,240,37,79,.468,28,56,.500,9,23,.391,17,25,.680,100
1009,2019-01-25,DAL,,DET,W 106-101,240,37,81,.457,23,45,.511,14,36,.389,18,30,.600,106
1010,2019-01-25,DET,@,DAL,L 101-106,240,35,85,.412,23,47,.489,12,38,.316,19,25,.760,101
1011,2019-01-25,DEN,,PHO,W 132-95,240,47,94,.500,32,58,.552,15,36,.417,23,29,.793,132
1012,2019-01-25,PHO,@,DEN,L 95-132,240,32,76,.421,25,46,.543,7,30,.233,24,26,.923,95
1013,2019-01-25,HOU,,TOR,W 121-119,240,41,91,.451,31,45,.689,10,46,.217,29,33,.879,121
1014,2019-01-25,TOR,@,HOU,L 119-121,240,44,91,.484,30,55,.545,14,36,.389,17,18,.944,119
1015,2019-01-25,MEM,,SAC,L 96-99,240,34,80,.425,28,60,.467,6,20,.300,22,27,.815,96
1016,2019-01-25,SAC,@,MEM,W 99-96,240,37,91,.407,25,58,.431,12,33,.364,13,17,.765,99
1017,2019-01-25,CHA,@,MIL,L 99-108,240,36,90,.400,26,51,.510,10,39,.256,17,25,.680,99
1018,2019-01-25,MIL,,CHO,W 108-99,240,41,89,.461,35,58,.603,6,31,.194,20,23,.870,108
1019,2019-01-25,ORL,,WAS,L 91-95,240,38,84,.452,31,51,.608,7,33,.212,8,12,.667,91
1020,2019-01-25,WAS,@,ORL,W 95-91,240,35,79,.443,20,52,.385,15,27,.556,10,12,.833,95
1021,2019-01-25,MIN,@,UTA,L 102-106,240,38,90,.422,30,64,.469,8,26,.308,18,21,.857,102
1022,2019-01-25,UTA,,MIN,W 106-102,240,37,94,.394,24,54,.444,13,40,.325,19,25,.760,106
1023,2019-01-24,LAL,,MIN,L 105-120,240,44,87,.506,36,59,.610,8,28,.286,9,14,.643,105
1024,2019-01-24,MIN,@,LAL,W 120-105,240,44,102,.431,34,69,.493,10,33,.303,22,25,.880,120
1025,2019-01-24,NOP,@,OKC,L 116-122,240,49,101,.485,39,65,.600,10,36,.278,8,12,.667,116
1026,2019-01-24,OKC,,NOP,W 122-116,240,50,101,.495,36,69,.522,14,32,.438,8,16,.500,122
1027,2019-01-24,PHO,,POR,L 106-120,240,36,88,.409,23,50,.460,13,38,.342,21,27,.778,106
1028,2019-01-24,POR,@,PHO,W 120-106,240,44,94,.468,32,68,.471,12,26,.462,20,20,1.000,120
1029,2019-01-24,GSW,@,WAS,W 126-118,240,50,88,.568,43,68,.632,7,20,.350,19,21,.905,126
1030,2019-01-24,WAS,,GSW,L 118-126,240,44,95,.463,29,53,.547,15,42,.357,15,21,.714,118
1031,2019-01-23,BOS,,CLE,W 123-103,240,45,86,.523,33,61,.541,12,25,.480,21,23,.913,123
1032,2019-01-23,CLE,@,BOS,L 103-123,240,38,87,.437,25,57,.439,13,30,.433,14,20,.700,103
1033,2019-01-23,BRK,,ORL,W 114-110,240,43,90,.478,33,58,.569,10,32,.313,18,23,.783,114
1034,2019-01-23,ORL,@,BRK,L 110-114,240,38,89,.427,27,55,.491,11,34,.324,23,28,.821,110
1035,2019-01-23,ATL,@,CHI,W 121-101,240,45,90,.500,30,50,.600,15,40,.375,16,21,.762,121
1036,2019-01-23,CHI,,ATL,L 101-121,240,35,79,.443,27,53,.509,8,26,.308,23,27,.852,101
1037,2019-01-23,IND,,TOR,W 110-106,240,40,92,.435,31,66,.470,9,26,.346,21,25,.840,110
1038,2019-01-23,TOR,@,IND,L 106-110,240,38,92,.413,26,53,.491,12,39,.308,18,23,.783,106
1039,2019-01-23,CHA,@,MEM,W 118-107,240,41,77,.532,29,47,.617,12,30,.400,24,31,.774,118
1040,2019-01-23,MEM,,CHO,L 107-118,240,38,81,.469,29,50,.580,9,31,.290,22,24,.917,107
1041,2019-01-23,LAC,@,MIA,W 111-99,240,45,85,.529,38,63,.603,7,22,.318,14,21,.667,111
1042,2019-01-23,MIA,,LAC,L 99-111,240,39,83,.470,31,55,.564,8,28,.286,13,22,.591,99
1043,2019-01-23,DET,@,NOP,W 98-94,240,36,89,.404,23,50,.460,13,39,.333,13,19,.684,98
1044,2019-01-23,NOP,,DET,L 94-98,240,42,91,.462,36,69,.522,6,22,.273,4,9,.444,94
1045,2019-01-23,HOU,@,NYK,W 114-110,240,37,90,.411,26,46,.565,11,44,.250,29,38,.763,114
1046,2019-01-23,NYK,,HOU,L 110-114,240,37,81,.457,26,51,.510,11,30,.367,25,30,.833,110
1047,2019-01-23,PHI,,SAS,W 122-120,240,47,93,.505,30,57,.526,17,36,.472,11,14,.786,122
1048,2019-01-23,SAS,@,PHI,L 120-122,240,47,82,.573,34,55,.618,13,27,.481,13,15,.867,120
1049,2019-01-23,DEN,@,UTA,L 108-114,240,42,88,.477,34,61,.557,8,27,.296,16,20,.800,108
1050,2019-01-23,UTA,,DEN,W 114-108,240,38,88,.432,19,42,.452,19,46,.413,19,27,.704,114
1051,2019-01-22,DAL,,LAC,W 106-98,240,38,81,.469,28,47,.596,10,34,.294,20,29,.690,106
1052,2019-01-22,LAC,@,DAL,L 98-106,240,33,91,.363,23,55,.418,10,36,.278,22,29,.759,98
1053,2019-01-22,OKC,,POR,W 123-114,240,43,85,.506,32,62,.516,11,23,.478,26,33,.788,123
1054,2019-01-22,POR,@,OKC,L 114-123,240,43,95,.453,33,59,.559,10,36,.278,18,22,.818,114
1055,2019-01-22,MIN,@,PHO,W 118-91,240,45,103,.437,30,61,.492,15,42,.357,13,19,.684,118
1056,2019-01-22,PHO,,MIN,L 91-118,240,37,87,.425,30,53,.566,7,34,.206,10,18,.556,91
1057,2019-01-22,SAC,@,TOR,L 105-120,240,41,91,.451,34,70,.486,7,21,.333,16,22,.727,105
1058,2019-01-22,TOR,,SAC,W 120-105,240,40,91,.440,24,51,.471,16,40,.400,24,35,.686,120
1059,2019-01-21,ATL,,ORL,L 103-122,240,39,86,.453,30,56,.536,9,30,.300,16,23,.696,103
1060,2019-01-21,ORL,@,ATL,W 122-103,240,46,91,.505,35,62,.565,11,29,.379,19,21,.905,122
1061,2019-01-21,BOS,,MIA,W 107-99,240,43,87,.494,31,57,.544,12,30,.400,9,10,.900,107
1062,2019-01-21,MIA,@,BOS,L 99-107,240,36,86,.419,25,51,.490,11,35,.314,16,18,.889,99
1063,2019-01-21,BRK,,SAC,W 123-94,240,45,90,.500,32,55,.582,13,35,.371,20,24,.833,123
1064,2019-01-21,SAC,@,BRK,L 94-123,240,39,93,.419,29,68,.426,10,25,.400,6,11,.545,94
1065,2019-01-21,CHI,@,CLE,W 104-88,240,36,76,.474,21,46,.457,15,30,.500,17,22,.773,104
1066,2019-01-21,CLE,,CHI,L 88-104,240,31,87,.356,25,60,.417,6,27,.222,20,29,.690,88
1067,2019-01-21,GSW,@,LAL,W 130-111,240,50,98,.510,34,61,.557,16,37,.432,14,19,.737,130
1068,2019-01-21,LAL,,GSW,L 111-130,240,42,84,.500,37,64,.578,5,20,.250,22,38,.579,111
1069,2019-01-21,MEM,,NOP,L 85-105,240,33,88,.375,24,53,.453,9,35,.257,10,17,.588,85
1070,2019-01-21,NOP,@,MEM,W 105-85,240,39,74,.527,30,48,.625,9,26,.346,18,26,.692,105
1071,2019-01-21,DAL,@,MIL,L 106-116,240,41,99,.414,27,59,.458,14,40,.350,10,17,.588,106
1072,2019-01-21,MIL,,DAL,W 116-106,240,42,91,.462,30,59,.508,12,32,.375,20,22,.909,116
1073,2019-01-21,NYK,,OKC,L 109-127,240,39,87,.448,32,64,.500,7,23,.304,24,32,.750,109
1074,2019-01-21,OKC,@,NYK,W 127-109,240,45,83,.542,30,54,.556,15,29,.517,22,27,.815,127
1075,2019-01-21,HOU,@,PHI,L 93-121,240,31,86,.360,20,44,.455,11,42,.262,20,26,.769,93
1076,2019-01-21,PHI,,HOU,W 121-93,240,43,88,.489,35,65,.538,8,23,.348,27,33,.818,121
1077,2019-01-21,POR,@,UTA,W 109-104,240,45,90,.500,37,72,.514,8,18,.444,11,15,.733,109
1078,2019-01-21,UTA,,POR,L 104-109,240,36,91,.396,29,58,.500,7,33,.212,25,31,.806,104
1079,2019-01-21,DET,@,WAS,L 87-101,240,31,77,.403,20,43,.465,11,34,.324,14,18,.778,87
1080,2019-01-21,WAS,,DET,W 101-87,240,36,79,.456,28,56,.500,8,23,.348,21,27,.778,101
1081,2019-01-20,CHA,@,IND,L 95-120,240,33,82,.402,21,47,.447,12,35,.343,17,25,.680,95
1082,2019-01-20,IND,,CHO,W 120-95,240,47,100,.470,33,73,.452,14,27,.519,12,12,1.000,120
1083,2019-01-20,MIN,,PHO,W 116-114,240,39,91,.429,33,67,.493,6,24,.250,32,40,.800,116
1084,2019-01-20,PHO,@,MIN,L 114-116,240,40,86,.465,28,47,.596,12,39,.308,22,32,.688,114
1085,2019-01-20,LAC,@,SAS,W 103-95,240,39,85,.459,28,64,.438,11,21,.524,14,24,.583,103
1086,2019-01-20,SAS,,LAC,L 95-103,240,39,84,.464,31,65,.477,8,19,.421,9,17,.529,95
1087,2019-01-19,ATL,,BOS,L 105-113,240,40,92,.435,28,51,.549,12,41,.293,13,14,.929,105
1088,2019-01-19,BOS,@,ATL,W 113-105,240,39,88,.443,27,56,.482,12,32,.375,23,25,.920,113
1089,2019-01-19,CHI,,MIA,L 103-117,240,35,89,.393,23,62,.371,12,27,.444,21,26,.808,103
1090,2019-01-19,MIA,@,CHI,W 117-103,240,45,79,.570,32,47,.681,13,32,.406,14,23,.609,117
1091,2019-01-19,CHA,,PHO,W 135-115,240,48,88,.545,32,54,.593,16,34,.471,23,27,.852,135
1092,2019-01-19,PHO,@,CHO,L 115-135,240,39,87,.448,28,54,.519,11,33,.333,26,33,.788,115
1093,2019-01-19,CLE,@,DEN,L 102-124,240,35,72,.486,25,43,.581,10,29,.345,22,26,.846,102
1094,2019-01-19,DEN,,CLE,W 124-102,240,50,89,.562,35,52,.673,15,37,.405,9,11,.818,124
1095,2019-01-19,DET,,SAC,L 101-103,240,36,82,.439,26,53,.491,10,29,.345,19,25,.760,101
1096,2019-01-19,SAC,@,DET,W 103-101,240,40,89,.449,30,64,.469,10,25,.400,13,18,.722,103
1097,2019-01-19,HOU,,LAL,W 138-134 (OT),265,42,100,.420,17,32,.531,25,68,.368,29,36,.806,138
1098,2019-01-19,LAL,@,HOU,L 134-138 (OT),265,50,96,.521,40,59,.678,10,37,.270,24,30,.800,134
1099,2019-01-19,DAL,@,IND,L 99-111,240,37,88,.420,28,51,.549,9,37,.243,16,20,.800,99
1100,2019-01-19,IND,,DAL,W 111-99,240,42,85,.494,34,61,.557,8,24,.333,19,24,.792,111
1101,2019-01-19,MIL,@,ORL,W 118-108,240,47,85,.553,35,55,.636,12,30,.400,12,15,.800,118
1102,2019-01-19,ORL,,MIL,L 108-118,240,44,93,.473,30,61,.492,14,32,.438,6,9,.667,108
1103,2019-01-19,OKC,@,PHI,W 117-115,240,41,93,.441,29,62,.468,12,31,.387,23,26,.885,117
1104,2019-01-19,PHI,,OKC,L 115-117,240,38,81,.469,27,49,.551,11,32,.344,28,39,.718,115
1105,2019-01-19,MEM,@,TOR,L 90-119,240,34,80,.425,24,51,.471,10,29,.345,12,15,.800,90
1106,2019-01-19,TOR,,MEM,W 119-90,240,44,90,.489,27,54,.500,17,36,.472,14,16,.875,119
1107,2019-01-18,BOS,,MEM,W 122-116,240,44,86,.512,27,48,.563,17,38,.447,17,22,.773,122
1108,2019-01-18,MEM,@,BOS,L 116-122,240,41,92,.446,25,57,.439,16,35,.457,18,20,.900,116
1109,2019-01-18,DET,,MIA,W 98-93,240,35,82,.427,22,49,.449,13,33,.394,15,18,.833,98
1110,2019-01-18,MIA,@,DET,L 93-98,240,39,77,.506,29,48,.604,10,29,.345,5,19,.263,93
1111,2019-01-18,GSW,@,LAC,W 112-94,240,42,86,.488,33,49,.673,9,37,.243,19,27,.704,112
1112,2019-01-18,LAC,,GSW,L 94-112,240,31,85,.365,27,60,.450,4,25,.160,28,35,.800,94
1113,2019-01-18,MIN,,SAS,L 113-116,240,37,84,.440,30,58,.517,7,26,.269,32,38,.842,113
1114,2019-01-18,SAS,@,MIN,W 116-113,240,41,82,.500,30,58,.517,11,24,.458,23,29,.793,116
1115,2019-01-18,BRK,@,ORL,W 117-115,240,44,97,.454,25,51,.490,19,46,.413,10,15,.667,117
1116,2019-01-18,ORL,,BRK,L 115-117,240,47,94,.500,37,68,.544,10,26,.385,11,14,.786,115
1117,2019-01-18,NOP,@,POR,L 112-128,240,41,84,.488,33,59,.559,8,25,.320,22,27,.815,112
1118,2019-01-18,POR,,NOP,W 128-112,240,48,103,.466,37,69,.536,11,34,.324,21,26,.808,128
1119,2019-01-18,CLE,@,UTA,L 99-115,240,36,87,.414,29,63,.460,7,24,.292,20,26,.769,99
1120,2019-01-18,UTA,,CLE,W 115-99,240,44,85,.518,31,48,.646,13,37,.351,14,15,.933,115
1121,2019-01-17,CHA,,SAC,W 114-95,240,39,87,.448,28,49,.571,11,38,.289,25,29,.862,114
1122,2019-01-17,SAC,@,CHO,L 95-114,240,39,88,.443,28,55,.509,11,33,.333,6,13,.462,95
1123,2019-01-17,CHI,@,DEN,L 105-135,240,44,93,.473,34,65,.523,10,28,.357,7,11,.636,105
1124,2019-01-17,DEN,,CHI,W 135-105,240,50,96,.521,30,56,.536,20,40,.500,15,20,.750,135
1125,2019-01-17,IND,,PHI,L 96-120,240,39,97,.402,30,68,.441,9,29,.310,9,12,.750,96
1126,2019-01-17,PHI,@,IND,W 120-96,240,46,87,.529,28,53,.528,18,34,.529,10,11,.909,120
1127,2019-01-17,LAL,@,OKC,W 138-128 (OT),265,50,99,.505,31,59,.525,19,40,.475,19,21,.905,138
1128,2019-01-17,OKC,,LAL,L 128-138 (OT),265,41,104,.394,19,50,.380,22,54,.407,24,36,.667,128
1129,2019-01-17,PHO,@,TOR,L 109-111,240,36,84,.429,27,54,.500,9,30,.300,28,36,.778,109
1130,2019-01-17,TOR,,PHO,W 111-109,240,43,86,.500,36,58,.621,7,28,.250,18,25,.720,111
1131,2019-01-17,NYK,@,WAS,L 100-101,240,39,87,.448,27,58,.466,12,29,.414,10,12,.833,100
1132,2019-01-17,WAS,,NYK,W 101-100,240,40,92,.435,33,65,.508,7,27,.259,14,20,.700,101
1133,2019-01-16,BOS,,TOR,W 117-108,240,46,92,.500,32,62,.516,14,30,.467,11,13,.846,117
1134,2019-01-16,TOR,@,BOS,L 108-117,240,41,92,.446,34,63,.540,7,29,.241,19,21,.905,108
1135,2019-01-16,DAL,,SAS,L 101-105,240,37,86,.430,22,44,.500,15,42,.357,12,16,.750,101
1136,2019-01-16,SAS,@,DAL,W 105-101,240,41,83,.494,28,53,.528,13,30,.433,10,12,.833,105
1137,2019-01-16,DET,,ORL,W 120-115 (OT),265,44,92,.478,32,62,.516,12,30,.400,20,25,.800,120
1138,2019-01-16,ORL,@,DET,L 115-120 (OT),265,47,94,.500,33,55,.600,14,39,.359,7,13,.538,115
1139,2019-01-16,GSW,,NOP,W 147-140,240,49,102,.480,25,53,.472,24,49,.490,25,31,.806,147
1140,2019-01-16,NOP,@,GSW,L 140-147,240,47,98,.480,28,61,.459,19,37,.514,27,33,.818,140
1141,2019-01-16,BRK,@,HOU,W 145-142 (OT),265,56,108,.519,40,72,.556,16,36,.444,17,22,.773,145
1142,2019-01-16,HOU,,BRK,L 142-145 (OT),265,45,105,.429,22,35,.629,23,70,.329,29,34,.853,142
1143,2019-01-16,LAC,,UTA,L 109-129,240,45,98,.459,35,76,.461,10,22,.455,9,14,.643,109
1144,2019-01-16,UTA,@,LAC,W 129-109,240,44,86,.512,33,53,.623,11,33,.333,30,37,.811,129
1145,2019-01-16,MEM,,MIL,L 101-111,240,37,95,.389,27,64,.422,10,31,.323,17,25,.680,101
1146,2019-01-16,MIL,@,MEM,W 111-101,240,40,84,.476,28,50,.560,12,34,.353,19,22,.864,111
1147,2019-01-16,CLE,@,POR,L 112-129,240,45,95,.474,39,76,.513,6,19,.316,16,19,.842,112
1148,2019-01-16,POR,,CLE,W 129-112,240,47,89,.528,31,60,.517,16,29,.552,19,23,.826,129
1149,2019-01-15,ATL,,OKC,W 142-126,240,56,90,.622,38,53,.717,18,37,.486,12,16,.750,142
1150,2019-01-15,OKC,@,ATL,L 126-142,240,43,94,.457,34,62,.548,9,32,.281,31,41,.756,126
1151,2019-01-15,DEN,,GSW,L 111-142,240,42,92,.457,28,58,.483,14,34,.412,13,16,.813,111
1152,2019-01-15,GSW,@,DEN,W 142-111,240,57,95,.600,36,56,.643,21,39,.538,7,10,.700,142
1153,2019-01-15,IND,,PHO,W 131-97,240,46,89,.517,34,64,.531,12,25,.480,27,36,.750,131
1154,2019-01-15,PHO,@,IND,L 97-131,240,40,95,.421,32,68,.471,8,27,.296,9,18,.500,97
1155,2019-01-15,CHI,@,LAL,L 100-107,240,37,92,.402,28,61,.459,9,31,.290,17,24,.708,100
1156,2019-01-15,LAL,,CHI,W 107-100,240,38,82,.463,30,56,.536,8,26,.308,23,34,.676,107
1157,2019-01-15,MIA,@,MIL,L 86-124,240,36,86,.419,28,52,.538,8,34,.235,6,8,.750,86
1158,2019-01-15,MIL,,MIA,W 124-86,240,48,96,.500,31,57,.544,17,39,.436,11,18,.611,124
1159,2019-01-15,MIN,@,PHI,L 107-149,240,35,90,.389,27,67,.403,8,23,.348,29,35,.829,107
1160,2019-01-15,PHI,,MIN,W 149-107,240,55,92,.598,34,49,.694,21,43,.488,18,21,.857,149
1161,2019-01-14,BOS,@,BRK,L 102-109,240,37,91,.407,26,55,.473,11,36,.306,17,23,.739,102
1162,2019-01-14,BRK,,BOS,W 109-102,240,37,86,.430,24,48,.500,13,38,.342,22,25,.880,109
1163,2019-01-14,HOU,,MEM,W 112-94,240,37,84,.440,19,36,.528,18,48,.375,20,22,.909,112
1164,2019-01-14,MEM,@,HOU,L 94-112,240,36,71,.507,26,49,.531,10,22,.455,12,22,.545,94
1165,2019-01-14,LAC,,NOP,L 117-121,240,41,86,.477,23,50,.460,18,36,.500,17,24,.708,117
1166,2019-01-14,NOP,@,LAC,W 121-117,240,46,105,.438,38,80,.475,8,25,.320,21,28,.750,121
1167,2019-01-14,POR,@,SAC,L 107-115,240,37,92,.402,27,61,.443,10,31,.323,23,29,.793,107
1168,2019-01-14,SAC,,POR,W 115-107,240,43,87,.494,33,61,.541,10,26,.385,19,24,.792,115
1169,2019-01-14,CHA,@,SAS,W 108-93,240,43,92,.467,30,56,.536,13,36,.361,9,11,.818,108
1170,2019-01-14,SAS,,CHO,L 93-108,240,38,82,.463,31,62,.500,7,20,.350,10,12,.833,93
1171,2019-01-14,DET,@,UTA,L 94-100,240,35,90,.389,24,54,.444,11,36,.306,13,16,.813,94
1172,2019-01-14,UTA,,DET,W 100-94,240,31,80,.388,19,43,.442,12,37,.324,26,36,.722,100
1173,2019-01-13,ATL,,MIL,L 114-133,240,39,96,.406,27,58,.466,12,38,.316,24,30,.800,114
1174,2019-01-13,MIL,@,ATL,W 133-114,240,49,92,.533,38,62,.613,11,30,.367,24,33,.727,133
1175,2019-01-13,DAL,,GSW,L 114-119,240,38,91,.418,22,53,.415,16,38,.421,22,29,.759,114
1176,2019-01-13,GSW,@,DAL,W 119-114,240,45,99,.455,26,54,.481,19,45,.422,10,12,.833,119
1177,2019-01-13,DEN,,POR,W 116-113,240,45,81,.556,36,59,.610,9,22,.409,17,20,.850,116
1178,2019-01-13,POR,@,DEN,L 113-116,240,40,88,.455,28,54,.519,12,34,.353,21,22,.955,113
1179,2019-01-13,CLE,@,LAL,W 101-95,240,38,89,.427,30,68,.441,8,21,.381,17,23,.739,101
1180,2019-01-13,LAL,,CLE,L 95-101,240,36,91,.396,29,57,.509,7,34,.206,16,27,.593,95
1181,2019-01-13,NYK,,PHI,L 105-108,240,37,86,.430,27,55,.491,10,31,.323,21,30,.700,105
1182,2019-01-13,PHI,@,NYK,W 108-105,240,40,87,.460,34,67,.507,6,20,.300,22,30,.733,108
1183,2019-01-13,HOU,@,ORL,L 109-116,240,38,86,.442,28,44,.636,10,42,.238,23,27,.852,109
1184,2019-01-13,ORL,,HOU,W 116-109,240,41,85,.482,32,61,.525,9,24,.375,25,28,.893,116
1185,2019-01-13,TOR,@,WAS,W 140-138 (2OT),290,49,104,.471,36,68,.529,13,36,.361,29,36,.806,140
1186,2019-01-13,WAS,,TOR,L 138-140 (2OT),290,54,118,.458,35,74,.473,19,44,.432,11,18,.611,138
1187,2019-01-12,DET,@,LAC,W 109-104,240,37,85,.435,21,48,.438,16,37,.432,19,22,.864,109
1188,2019-01-12,LAC,,DET,L 104-109,240,36,74,.486,27,56,.482,9,18,.500,23,29,.793,104
1189,2019-01-12,MEM,@,MIA,L 108-112,240,39,81,.481,30,52,.577,9,29,.310,21,27,.778,108
1190,2019-01-12,MIA,,MEM,W 112-108,240,40,80,.500,25,49,.510,15,31,.484,17,24,.708,112
1191,2019-01-12,MIN,,NOP,W 110-106,240,40,93,.430,29,54,.537,11,39,.282,19,24,.792,110
1192,2019-01-12,NOP,@,MIN,L 106-110,240,40,87,.460,35,63,.556,5,24,.208,21,24,.875,106
1193,2019-01-12,OKC,,SAS,W 122-112,240,43,93,.462,32,70,.457,11,23,.478,25,29,.862,122
1194,2019-01-12,SAS,@,OKC,L 112-122,240,44,96,.458,34,65,.523,10,31,.323,14,20,.700,112
1195,2019-01-12,BOS,@,ORL,L 103-105,240,38,90,.422,30,58,.517,8,32,.250,19,28,.679,103
1196,2019-01-12,ORL,,BOS,W 105-103,240,36,84,.429,25,46,.543,11,38,.289,22,24,.917,105
1197,2019-01-12,DEN,@,PHO,L 93-102,240,34,88,.386,24,57,.421,10,31,.323,15,22,.682,93
1198,2019-01-12,PHO,,DEN,W 102-93,240,38,92,.413,30,66,.455,8,26,.308,18,25,.720,102
1199,2019-01-12,CHA,@,SAC,L 97-104,240,36,88,.409,24,52,.462,12,36,.333,13,22,.591,97
1200,2019-01-12,SAC,,CHO,W 104-97,240,41,99,.414,27,62,.435,14,37,.378,8,12,.667,104
1201,2019-01-12,CHI,@,UTA,L 102-110,240,40,97,.412,33,72,.458,7,25,.280,15,17,.882,102
1202,2019-01-12,UTA,,CHI,W 110-102,240,38,88,.432,22,43,.512,16,45,.356,18,25,.720,110
1203,2019-01-11,CHI,@,GSW,L 109-146,240,35,78,.449,26,58,.448,9,20,.450,30,34,.882,109
1204,2019-01-11,GSW,,CHI,W 146-109,240,53,92,.576,35,53,.660,18,39,.462,22,26,.846,146
1205,2019-01-11,CLE,@,HOU,L 113-141,240,40,89,.449,31,56,.554,9,33,.273,24,26,.923,113
1206,2019-01-11,HOU,,CLE,W 141-113,240,46,89,.517,26,37,.703,20,52,.385,29,32,.906,141
1207,2019-01-11,DAL,@,MIN,W 119-115,240,44,97,.454,31,59,.525,13,38,.342,18,24,.750,119
1208,2019-01-11,MIN,,DAL,L 115-119,240,47,102,.461,37,78,.474,10,24,.417,11,13,.846,115
1209,2019-01-11,IND,@,NYK,W 121-106,240,49,94,.521,37,68,.544,12,26,.462,11,11,1.000,121
1210,2019-01-11,NYK,,IND,L 106-121,240,39,88,.443,25,49,.510,14,39,.359,14,16,.875,106
1211,2019-01-11,ATL,@,PHI,W 123-121,240,45,81,.556,33,56,.589,12,25,.480,21,27,.778,123
1212,2019-01-11,PHI,,ATL,L 121-123,240,45,87,.517,34,54,.630,11,33,.333,20,27,.741,121
1213,2019-01-11,CHA,@,POR,L 96-127,240,36,90,.400,23,60,.383,13,30,.433,11,16,.688,96
1214,2019-01-11,POR,,CHO,W 127-96,240,52,93,.559,37,53,.698,15,40,.375,8,9,.889,127
1215,2019-01-11,BRK,@,TOR,L 105-122,240,37,88,.420,26,58,.448,11,30,.367,20,30,.667,105
1216,2019-01-11,TOR,,BRK,W 122-105,240,48,105,.457,37,70,.529,11,35,.314,15,24,.625,122
1217,2019-01-11,LAL,@,UTA,L 95-113,240,37,103,.359,32,76,.421,5,27,.185,16,24,.667,95
1218,2019-01-11,UTA,,LAL,W 113-95,240,38,96,.396,23,54,.426,15,42,.357,22,32,.688,113
1219,2019-01-11,MIL,@,WAS,L 106-113,240,40,89,.449,27,49,.551,13,40,.325,13,17,.765,106
1220,2019-01-11,WAS,,MIL,W 113-106,240,40,82,.488,22,49,.449,18,33,.545,15,20,.750,113
1221,2019-01-10,DEN,,LAC,W 121-100,240,50,99,.505,39,71,.549,11,28,.393,10,13,.769,121
1222,2019-01-10,LAC,@,DEN,L 100-121,240,38,87,.437,32,63,.508,6,24,.250,18,26,.692,100
1223,2019-01-10,BOS,@,MIA,L 99-115,240,36,89,.404,24,55,.436,12,34,.353,15,17,.882,99
1224,2019-01-10,MIA,,BOS,W 115-99,240,46,96,.479,28,57,.491,18,39,.462,5,8,.625,115
1225,2019-01-10,DET,@,SAC,L 102-112,240,35,82,.427,24,44,.545,11,38,.289,21,24,.875,102
1226,2019-01-10,SAC,,DET,W 112-102,240,44,86,.512,35,64,.547,9,22,.409,15,20,.750,112
1227,2019-01-10,OKC,@,SAS,L 147-154 (2OT),290,58,114,.509,43,79,.544,15,35,.429,16,24,.667,147
1228,2019-01-10,SAS,,OKC,W 154-147 (2OT),290,56,99,.566,40,80,.500,16,19,.842,26,29,.897,154
1229,2019-01-09,BOS,,IND,W 135-108,240,50,88,.568,36,56,.643,14,32,.438,21,24,.875,135
1230,2019-01-09,IND,@,BOS,L 108-135,240,39,91,.429,30,63,.476,9,28,.321,21,33,.636,108
1231,2019-01-09,ATL,@,BRK,L 100-116,240,36,99,.364,30,64,.469,6,35,.171,22,25,.880,100
1232,2019-01-09,BRK,,ATL,W 116-100,240,43,95,.453,33,65,.508,10,30,.333,20,26,.769,116
1233,2019-01-09,DAL,,PHO,W 104-94,240,30,70,.429,18,36,.500,12,34,.353,32,45,.711,104
1234,2019-01-09,PHO,@,DAL,L 94-104,240,36,84,.429,29,59,.492,7,25,.280,15,21,.714,94
1235,2019-01-09,HOU,,MIL,L 109-116,240,32,85,.376,14,37,.378,18,48,.375,27,32,.844,109
1236,2019-01-09,MIL,@,HOU,W 116-109,240,44,91,.484,36,64,.563,8,27,.296,20,24,.833,116
1237,2019-01-09,DET,@,LAL,L 100-113,240,39,86,.453,25,42,.595,14,44,.318,8,14,.571,100
1238,2019-01-09,LAL,,DET,W 113-100,240,46,82,.561,38,59,.644,8,23,.348,13,18,.722,113
1239,2019-01-09,MEM,,SAS,W 96-86,240,37,90,.411,29,57,.509,8,33,.242,14,20,.700,96
1240,2019-01-09,SAS,@,MEM,L 86-96,240,30,83,.361,19,56,.339,11,27,.407,15,23,.652,86
1241,2019-01-09,CLE,@,NOP,L 124-140,240,42,88,.477,28,58,.483,14,30,.467,26,30,.867,124
1242,2019-01-09,NOP,,CLE,W 140-124,240,46,84,.548,34,55,.618,12,29,.414,36,39,.923,140
1243,2019-01-09,CHI,@,POR,L 112-124,240,43,93,.462,34,71,.479,9,22,.409,17,19,.895,112
1244,2019-01-09,POR,,CHI,W 124-112,240,47,83,.566,36,57,.632,11,26,.423,19,21,.905,124
1245,2019-01-09,ORL,@,UTA,L 93-106,240,33,83,.398,20,50,.400,13,33,.394,14,20,.700,93
1246,2019-01-09,UTA,,ORL,W 106-93,240,41,84,.488,29,51,.569,12,33,.364,12,14,.857,106
1247,2019-01-09,PHI,@,WAS,L 106-123,240,37,86,.430,29,59,.492,8,27,.296,24,31,.774,106
1248,2019-01-09,WAS,,PHI,W 123-106,240,47,87,.540,34,60,.567,13,27,.481,16,21,.762,123
1249,2019-01-08,CLE,,IND,L 115-123,240,41,76,.539,28,47,.596,13,29,.448,20,23,.870,115
1250,2019-01-08,IND,@,CLE,W 123-115,240,49,91,.538,39,65,.600,10,26,.385,15,19,.789,123
1251,2019-01-08,GSW,,NYK,W 122-95,240,49,96,.510,35,51,.686,14,45,.311,10,12,.833,122
1252,2019-01-08,NYK,@,GSW,L 95-122,240,35,88,.398,29,64,.453,6,24,.250,19,21,.905,95
1253,2019-01-08,CHA,@,LAC,L 109-128,240,36,90,.400,24,57,.421,12,33,.364,25,29,.862,109
1254,2019-01-08,LAC,,CHO,W 128-109,240,48,93,.516,34,63,.540,14,30,.467,18,21,.857,128
1255,2019-01-08,DEN,@,MIA,W 103-99,240,41,87,.471,32,60,.533,9,27,.333,12,17,.706,103
1256,2019-01-08,MIA,,DEN,L 99-103,240,38,83,.458,30,52,.577,8,31,.258,15,25,.600,99
1257,2019-01-08,MIN,@,OKC,W 119-117,240,38,90,.422,27,59,.458,11,31,.355,32,40,.800,119
1258,2019-01-08,OKC,,MIN,L 117-119,240,43,85,.506,31,55,.564,12,30,.400,19,26,.731,117
1259,2019-01-08,PHI,,WAS,W 132-115,240,49,88,.557,32,55,.582,17,33,.515,17,25,.680,132
1260,2019-01-08,WAS,@,PHI,L 115-132,240,42,84,.500,28,52,.538,14,32,.438,17,21,.810,115
1261,2019-01-08,PHO,,SAC,W 115-111,240,45,88,.511,35,63,.556,10,25,.400,15,19,.789,115
1262,2019-01-08,SAC,@,PHO,L 111-115,240,38,80,.475,23,51,.451,15,29,.517,20,29,.690,111
1263,2019-01-08,ATL,@,TOR,L 101-104,240,40,87,.460,30,60,.500,10,27,.370,11,16,.688,101
1264,2019-01-08,TOR,,ATL,W 104-101,240,37,80,.463,27,48,.563,10,32,.313,20,27,.741,104
1265,2019-01-07,BOS,,BRK,W 116-95,240,47,93,.505,35,61,.574,12,32,.375,10,12,.833,116
1266,2019-01-07,BRK,@,BOS,L 95-116,240,32,79,.405,21,37,.568,11,42,.262,20,22,.909,95
1267,2019-01-07,DAL,,LAL,L 97-107,240,36,86,.419,28,56,.500,8,30,.267,17,24,.708,97
1268,2019-01-07,LAL,@,DAL,W 107-97,240,41,94,.436,33,65,.508,8,29,.276,17,27,.630,107
1269,2019-01-07,DET,,SAS,L 107-119,240,42,85,.494,33,53,.623,9,32,.281,14,17,.824,107
1270,2019-01-07,SAS,@,DET,W 119-107,240,43,79,.544,36,59,.610,7,20,.350,26,32,.813,119
1271,2019-01-07,DEN,@,HOU,L 113-125,240,44,93,.473,37,64,.578,7,29,.241,18,21,.857,113
1272,2019-01-07,HOU,,DEN,W 125-113,240,38,76,.500,16,29,.552,22,47,.468,27,34,.794,125
1273,2019-01-07,MIL,,UTA,W 114-102,240,46,98,.469,37,73,.507,9,25,.360,13,16,.813,114
1274,2019-01-07,UTA,@,MIL,L 102-114,240,36,86,.419,22,49,.449,14,37,.378,16,23,.696,102
1275,2019-01-07,MEM,@,NOP,L 95-114,240,35,78,.449,25,48,.521,10,30,.333,15,18,.833,95
1276,2019-01-07,NOP,,MEM,W 114-95,240,44,79,.557,38,62,.613,6,17,.353,20,29,.690,114
1277,2019-01-07,NYK,@,POR,L 101-111,240,36,89,.404,29,66,.439,7,23,.304,22,27,.815,101
1278,2019-01-07,POR,,NYK,W 111-101,240,40,85,.471,29,54,.537,11,31,.355,20,29,.690,111
1279,2019-01-07,ORL,@,SAC,L 95-111,240,32,87,.368,19,50,.380,13,37,.351,18,24,.750,95
1280,2019-01-07,SAC,,ORL,W 111-95,240,45,98,.459,35,64,.547,10,34,.294,11,20,.550,111
1281,2019-01-06,ATL,,MIA,W 106-82,240,43,91,.473,33,67,.493,10,24,.417,10,13,.769,106
1282,2019-01-06,MIA,@,ATL,L 82-106,240,31,87,.356,26,53,.491,5,34,.147,15,27,.556,82
1283,2019-01-06,BRK,@,CHI,W 117-100,240,42,83,.506,26,37,.703,16,46,.348,17,22,.773,117
1284,2019-01-06,CHI,,BRK,L 100-117,240,41,88,.466,34,70,.486,7,18,.389,11,15,.733,100
1285,2019-01-06,LAC,,ORL,W 106-96,240,40,93,.430,32,71,.451,8,22,.364,18,23,.783,106
1286,2019-01-06,ORL,@,LAC,L 96-106,240,33,89,.371,24,58,.414,9,31,.290,21,29,.724,96
1287,2019-01-06,LAL,@,MIN,L 86-108,240,32,87,.368,27,65,.415,5,22,.227,17,28,.607,86
1288,2019-01-06,MIN,,LAL,W 108-86,240,41,89,.461,30,57,.526,11,32,.344,15,21,.714,108
1289,2019-01-06,OKC,,WAS,L 98-116,240,38,88,.432,28,63,.444,10,25,.400,12,19,.632,98
1290,2019-01-06,WAS,@,OKC,W 116-98,240,44,101,.436,34,64,.531,10,37,.270,18,22,.818,116
1291,2019-01-06,CHA,@,PHO,W 119-113,240,44,91,.484,37,66,.561,7,25,.280,24,34,.706,119
1292,2019-01-06,PHO,,CHO,L 113-119,240,43,83,.518,33,58,.569,10,25,.400,17,19,.895,113
1293,2019-01-06,IND,@,TOR,L 105-121,240,43,94,.457,39,77,.506,4,17,.235,15,20,.750,105
1294,2019-01-06,TOR,,IND,W 121-105,240,44,85,.518,27,52,.519,17,33,.515,16,17,.941,121
1295,2019-01-05,CLE,,NOP,L 98-133,240,36,88,.409,24,55,.436,12,33,.364,14,18,.778,98
1296,2019-01-05,NOP,@,CLE,W 133-98,240,47,81,.580,33,54,.611,14,27,.519,25,29,.862,133
1297,2019-01-05,CHA,@,DEN,L 110-123,240,39,82,.476,28,53,.528,11,29,.379,21,26,.808,110
1298,2019-01-05,DEN,,CHO,W 123-110,240,47,102,.461,33,63,.524,14,39,.359,15,20,.750,123
1299,2019-01-05,DET,,UTA,L 105-110,240,39,82,.476,28,57,.491,11,25,.440,16,20,.800,105
1300,2019-01-05,UTA,@,DET,W 110-105,240,39,82,.476,32,61,.525,7,21,.333,25,32,.781,110
1301,2019-01-05,MIL,,TOR,L 116-123,240,40,81,.494,26,44,.591,14,37,.378,22,27,.815,116
1302,2019-01-05,TOR,@,MIL,W 123-116,240,42,82,.512,28,51,.549,14,31,.452,25,31,.806,123
1303,2019-01-05,DAL,@,PHI,L 100-106,240,38,88,.432,29,57,.509,9,31,.290,15,23,.652,100
1304,2019-01-05,PHI,,DAL,W 106-100,240,39,83,.470,33,57,.579,6,26,.231,22,33,.667,106
1305,2019-01-05,HOU,@,POR,L 101-110,240,39,84,.464,26,46,.565,13,38,.342,10,12,.833,101
1306,2019-01-05,POR,,HOU,W 110-101,240,43,94,.457,34,66,.515,9,28,.321,15,20,.750,110
1307,2019-01-05,GSW,@,SAC,W 127-123,240,47,93,.505,26,46,.565,21,47,.447,12,14,.857,127
1308,2019-01-05,SAC,,GSW,L 123-127,240,46,97,.474,26,61,.426,20,36,.556,11,14,.786,123
1309,2019-01-05,MEM,@,SAS,L 88-108,240,31,82,.378,20,54,.370,11,28,.393,15,19,.789,88
1310,2019-01-05,SAS,,MEM,W 108-88,240,36,73,.493,29,51,.569,7,22,.318,29,35,.829,108
1311,2019-01-04,BOS,,DAL,W 114-93,240,42,96,.438,21,51,.412,21,45,.467,9,11,.818,114
1312,2019-01-04,DAL,@,BOS,L 93-114,240,34,88,.386,23,44,.523,11,44,.250,14,19,.737,93
1313,2019-01-04,CHI,,IND,L 116-119 (OT),265,47,91,.516,35,63,.556,12,28,.429,10,13,.769,116
1314,2019-01-04,IND,@,CHI,W 119-116 (OT),265,49,93,.527,40,65,.615,9,28,.321,12,17,.706,119
1315,2019-01-04,CLE,,UTA,L 91-117,240,32,82,.390,21,61,.344,11,21,.524,16,17,.941,91
1316,2019-01-04,UTA,@,CLE,W 117-91,240,42,82,.512,28,47,.596,14,35,.400,19,22,.864,117
1317,2019-01-04,LAL,,NYK,L 112-119,240,43,98,.439,32,61,.525,11,37,.297,15,20,.750,112
1318,2019-01-04,NYK,@,LAL,W 119-112,240,37,99,.374,26,62,.419,11,37,.297,34,41,.829,119
1319,2019-01-04,BRK,@,MEM,W 109-100,240,36,79,.456,23,45,.511,13,34,.382,24,26,.923,109
1320,2019-01-04,MEM,,BRK,L 100-109,240,42,93,.452,37,69,.536,5,24,.208,11,15,.733,100
1321,2019-01-04,MIA,,WAS,W 115-109,240,44,91,.484,35,62,.565,9,29,.310,18,25,.720,115
1322,2019-01-04,WAS,@,MIA,L 109-115,240,42,98,.429,32,62,.516,10,36,.278,15,19,.789,109
1323,2019-01-04,ATL,@,MIL,L 112-144,240,37,85,.435,23,44,.523,14,41,.341,24,35,.686,112
1324,2019-01-04,MIL,,ATL,W 144-112,240,55,100,.550,41,60,.683,14,40,.350,20,28,.714,144
1325,2019-01-04,MIN,,ORL,W 120-103,240,47,91,.516,38,65,.585,9,26,.346,17,23,.739,120
1326,2019-01-04,ORL,@,MIN,L 103-120,240,42,88,.477,33,61,.541,9,27,.333,10,19,.526,103
1327,2019-01-04,LAC,@,PHO,W 121-111,240,43,84,.512,33,60,.550,10,24,.417,25,32,.781,121
1328,2019-01-04,PHO,,LAC,L 111-121,240,41,77,.532,32,58,.552,9,19,.474,20,27,.741,111
1329,2019-01-04,OKC,@,POR,W 111-109,240,40,94,.426,32,69,.464,8,25,.320,23,26,.885,111
1330,2019-01-04,POR,,OKC,L 109-111,240,41,95,.432,32,64,.500,9,31,.290,18,21,.857,109
1331,2019-01-03,GSW,,HOU,L 134-135 (OT),265,53,102,.520,39,65,.600,14,37,.378,14,15,.933,134
1332,2019-01-03,HOU,@,GSW,W 135-134 (OT),265,45,99,.455,24,45,.533,21,54,.389,24,28,.857,135
1333,2019-01-03,DEN,@,SAC,W 117-113,240,41,89,.461,27,50,.540,14,39,.359,21,30,.700,117
1334,2019-01-03,SAC,,DEN,L 113-117,240,45,90,.500,32,59,.542,13,31,.419,10,15,.667,113
1335,2019-01-03,SAS,,TOR,W 125-107,240,47,85,.553,34,58,.586,13,27,.481,18,20,.900,125
1336,2019-01-03,TOR,@,SAS,L 107-125,240,39,87,.448,33,57,.579,6,30,.200,23,29,.793,107
1337,2019-01-02,BOS,,MIN,W 115-102,240,45,76,.592,33,46,.717,12,30,.400,13,15,.867,115
1338,2019-01-02,MIN,@,BOS,L 102-115,240,40,84,.476,33,61,.541,7,23,.304,15,21,.714,102
1339,2019-01-02,BRK,,NOP,W 126-121,240,47,93,.505,31,62,.500,16,31,.516,16,21,.762,126
1340,2019-01-02,NOP,@,BRK,L 121-126,240,46,87,.529,36,64,.563,10,23,.435,19,27,.704,121
1341,2019-01-02,CHI,,ORL,L 84-112,240,36,86,.419,29,66,.439,7,20,.350,5,8,.625,84
1342,2019-01-02,ORL,@,CHI,W 112-84,240,44,76,.579,33,50,.660,11,26,.423,13,18,.722,112
1343,2019-01-02,CHA,,DAL,L 84-122,240,32,90,.356,26,58,.448,6,32,.188,14,19,.737,84
1344,2019-01-02,DAL,@,CHO,W 122-84,240,44,95,.463,26,50,.520,18,45,.400,16,18,.889,122
1345,2019-01-02,CLE,,MIA,L 92-117,240,34,75,.453,21,44,.477,13,31,.419,11,13,.846,92
1346,2019-01-02,MIA,@,CLE,W 117-92,240,44,86,.512,28,55,.509,16,31,.516,13,17,.765,117
1347,2019-01-02,LAL,,OKC,L 100-107,240,37,89,.416,30,62,.484,7,27,.259,19,32,.594,100
1348,2019-01-02,OKC,@,LAL,W 107-100,240,40,105,.381,33,74,.446,7,31,.226,20,31,.645,107
1349,2019-01-02,DET,@,MEM,W 101-94,240,36,83,.434,20,43,.465,16,40,.400,13,22,.591,101
1350,2019-01-02,MEM,,DET,L 94-101,240,36,78,.462,32,60,.533,4,18,.222,18,21,.857,94
1351,2019-01-02,PHI,@,PHO,W 132-127,240,40,74,.541,29,50,.580,11,24,.458,41,54,.759,132
1352,2019-01-02,PHO,,PHI,L 127-132,240,43,95,.453,32,61,.525,11,34,.324,30,36,.833,127
1353,2019-01-02,ATL,@,WAS,L 98-114,240,40,95,.421,30,64,.469,10,31,.323,8,13,.615,98
1354,2019-01-02,WAS,,ATL,W 114-98,240,43,92,.467,32,63,.508,11,29,.379,17,23,.739,114
1355,2019-01-01,DEN,,NYK,W 115-108,240,44,95,.463,32,61,.525,12,34,.353,15,23,.652,115
1356,2019-01-01,NYK,@,DEN,L 108-115,240,42,93,.452,31,66,.470,11,27,.407,13,18,.722,108
1357,2019-01-01,LAC,,PHI,L 113-119,240,42,91,.462,37,66,.561,5,25,.200,24,34,.706,113
1358,2019-01-01,PHI,@,LAC,W 119-113,240,42,87,.483,30,61,.492,12,26,.462,23,33,.697,119
1359,2019-01-01,DET,@,MIL,L 98-121,240,35,92,.380,23,59,.390,12,33,.364,16,21,.762,98
1360,2019-01-01,MIL,,DET,W 121-98,240,47,79,.595,37,52,.712,10,27,.370,17,26,.654,121
1361,2019-01-01,POR,@,SAC,W 113-108 (OT),265,39,90,.433,30,58,.517,9,32,.281,26,30,.867,113
1362,2019-01-01,SAC,,POR,L 108-113 (OT),265,44,115,.383,33,82,.402,11,33,.333,9,12,.750,108
1363,2019-01-01,TOR,,UTA,W 122-116,240,45,82,.549,38,62,.613,7,20,.350,25,35,.714,122
1364,2019-01-01,UTA,@,TOR,L 116-122,240,42,97,.433,33,65,.508,9,32,.281,23,29,.793,116
1365,2018-12-31,CHA,,ORL,W 125-100,240,42,85,.494,31,61,.508,11,24,.458,30,33,.909,125
1366,2018-12-31,ORL,@,CHO,L 100-125,240,38,92,.413,28,57,.491,10,35,.286,14,19,.737,100
1367,2018-12-31,HOU,,MEM,W 113-101,240,31,70,.443,13,29,.448,18,41,.439,33,45,.733,113
1368,2018-12-31,MEM,@,HOU,L 101-113,240,38,82,.463,32,57,.561,6,25,.240,19,30,.633,101
1369,2018-12-31,ATL,@,IND,L 108-116,240,41,95,.432,28,63,.444,13,32,.406,13,19,.684,108
1370,2018-12-31,IND,,ATL,W 116-108,240,42,84,.500,31,60,.517,11,24,.458,21,29,.724,116
1371,2018-12-31,MIN,@,NOP,L 114-123,240,43,93,.462,34,65,.523,9,28,.321,19,23,.826,114
1372,2018-12-31,NOP,,MIN,W 123-114,240,45,87,.517,31,62,.500,14,25,.560,19,21,.905,123
1373,2018-12-31,DAL,@,OKC,L 102-122,240,31,74,.419,17,36,.472,14,38,.368,26,34,.765,102
1374,2018-12-31,OKC,,DAL,W 122-102,240,46,103,.447,40,79,.506,6,24,.250,24,35,.686,122
1375,2018-12-31,GSW,@,PHO,W 132-109,240,46,84,.548,32,56,.571,14,28,.500,26,32,.813,132
1376,2018-12-31,PHO,,GSW,L 109-132,240,37,85,.435,28,59,.475,9,26,.346,26,30,.867,109
1377,2018-12-31,BOS,@,SAS,L 111-120,240,43,88,.489,32,54,.593,11,34,.324,14,20,.700,111
1378,2018-12-31,SAS,,BOS,W 120-111,240,45,91,.495,31,65,.477,14,26,.538,16,18,.889,120
1379,2018-12-30,DAL,,OKC,W 105-103,240,37,81,.457,23,42,.548,14,39,.359,17,22,.773,105
1380,2018-12-30,OKC,@,DAL,L 103-105,240,40,93,.430,31,55,.564,9,38,.237,14,21,.667,103
1381,2018-12-30,LAL,,SAC,W 121-114,240,47,98,.480,32,54,.593,15,44,.341,12,20,.600,121
1382,2018-12-30,SAC,@,LAL,L 114-121,240,46,95,.484,33,61,.541,13,34,.382,9,12,.750,114
1383,2018-12-30,MIA,,MIN,L 104-113,240,37,90,.411,29,66,.439,8,24,.333,22,28,.786,104
1384,2018-12-30,MIN,@,MIA,W 113-104,240,38,94,.404,30,70,.429,8,24,.333,29,36,.806,113
1385,2018-12-30,DET,@,ORL,L 107-109,240,39,92,.424,31,61,.508,8,31,.258,21,23,.913,107
1386,2018-12-30,ORL,,DET,W 109-107,240,40,85,.471,33,61,.541,7,24,.292,22,24,.917,109
1387,2018-12-30,PHI,@,POR,L 95-129,240,34,96,.354,26,53,.491,8,43,.186,19,27,.704,95
1388,2018-12-30,POR,,PHI,W 129-95,240,49,83,.590,37,61,.607,12,22,.545,19,25,.760,129
1389,2018-12-30,CHI,@,TOR,L 89-95,240,33,80,.413,26,60,.433,7,20,.350,16,18,.889,89
1390,2018-12-30,TOR,,CHI,W 95-89,240,34,92,.370,25,59,.424,9,33,.273,18,20,.900,95
1391,2018-12-29,ATL,,CLE,W 111-108,240,43,98,.439,33,61,.541,10,37,.270,15,25,.600,111
1392,2018-12-29,CLE,@,ATL,L 108-111,240,40,85,.471,35,62,.565,5,23,.217,23,29,.793,108
1393,2018-12-29,LAC,,SAS,L 111-122,240,36,82,.439,27,62,.435,9,20,.450,30,38,.789,111
1394,2018-12-29,SAS,@,LAC,W 122-111,240,44,87,.506,38,64,.594,6,23,.261,28,31,.903,122
1395,2018-12-29,BOS,@,MEM,W 112-103,240,40,80,.500,24,44,.545,16,36,.444,16,18,.889,112
1396,2018-12-29,MEM,,BOS,L 103-112,240,36,76,.474,29,50,.580,7,26,.269,24,29,.828,103
1397,2018-12-29,BRK,@,MIL,L 115-129,240,38,79,.481,23,44,.523,15,35,.429,24,35,.686,115
1398,2018-12-29,MIL,,BRK,W 129-115,240,47,96,.490,26,45,.578,21,51,.412,14,16,.875,129
1399,2018-12-29,HOU,@,NOP,W 108-104,240,35,81,.432,19,35,.543,16,46,.348,22,28,.786,108
1400,2018-12-29,NOP,,HOU,L 104-108,240,41,92,.446,32,64,.500,9,28,.321,13,17,.765,104
1401,2018-12-29,DEN,@,PHO,W 122-118,240,42,76,.553,24,41,.585,18,35,.514,20,26,.769,122
1402,2018-12-29,PHO,,DEN,L 118-122,240,49,91,.538,38,62,.613,11,29,.379,9,14,.643,118
1403,2018-12-29,GSW,@,POR,W 115-105,240,40,80,.500,28,55,.509,12,25,.480,23,28,.821,115
1404,2018-12-29,POR,,GSW,L 105-115,240,39,91,.429,30,60,.500,9,31,.290,18,22,.818,105
1405,2018-12-29,NYK,@,UTA,L 97-129,240,32,86,.372,17,54,.315,15,32,.469,18,22,.818,97
1406,2018-12-29,UTA,,NYK,W 129-97,240,51,93,.548,35,57,.614,16,36,.444,11,14,.786,129
1407,2018-12-29,CHA,@,WAS,L 126-130,240,47,90,.522,34,59,.576,13,31,.419,19,24,.792,126
1408,2018-12-29,WAS,,CHO,W 130-126,240,48,93,.516,35,56,.625,13,37,.351,21,24,.875,130
1409,2018-12-28,BRK,@,CHO,L 87-100,240,33,83,.398,29,56,.518,4,27,.148,17,20,.850,87
1410,2018-12-28,CHA,,BRK,W 100-87,240,41,100,.410,30,67,.448,11,33,.333,7,10,.700,100
1411,2018-12-28,DEN,,SAS,W 102-99,240,39,85,.459,29,56,.518,10,29,.345,14,17,.824,102
1412,2018-12-28,SAS,@,DEN,L 99-102,240,40,89,.449,32,62,.516,8,27,.296,11,20,.550,99
1413,2018-12-28,DET,@,IND,L 88-125,240,34,91,.374,25,55,.455,9,36,.250,11,12,.917,88
1414,2018-12-28,IND,,DET,W 125-88,240,53,87,.609,48,68,.706,5,19,.263,14,20,.700,125
1415,2018-12-28,LAC,@,LAL,W 118-107,240,40,91,.440,34,72,.472,6,19,.316,32,34,.941,118
1416,2018-12-28,LAL,,LAC,L 107-118,240,36,87,.414,25,57,.439,11,30,.367,24,35,.686,107
1417,2018-12-28,CLE,@,MIA,L 94-118,240,31,81,.383,18,44,.409,13,37,.351,19,22,.864,94
1418,2018-12-28,MIA,,CLE,W 118-94,240,48,91,.527,38,60,.633,10,31,.323,12,16,.750,118
1419,2018-12-28,ATL,@,MIN,W 123-120 (OT),265,47,100,.470,31,65,.477,16,35,.457,13,20,.650,123
1420,2018-12-28,MIN,,ATL,L 120-123 (OT),265,44,98,.449,33,66,.500,11,32,.344,21,38,.553,120
1421,2018-12-28,DAL,@,NOP,L 112-114,240,37,78,.474,22,46,.478,15,32,.469,23,33,.697,112
1422,2018-12-28,NOP,,DAL,W 114-112,240,44,96,.458,40,73,.548,4,23,.174,22,27,.815,114
1423,2018-12-28,ORL,,TOR,W 116-87,240,44,93,.473,35,67,.522,9,26,.346,19,22,.864,116
1424,2018-12-28,TOR,@,ORL,L 87-116,240,28,95,.295,16,61,.262,12,34,.353,19,24,.792,87
1425,2018-12-28,OKC,@,PHO,W 118-102,240,51,95,.537,44,75,.587,7,20,.350,9,13,.692,118
1426,2018-12-28,PHO,,OKC,L 102-118,240,39,90,.433,30,61,.492,9,29,.310,15,16,.938,102
1427,2018-12-28,CHI,@,WAS,W 101-92,240,37,79,.468,29,57,.509,8,22,.364,19,25,.760,101
1428,2018-12-28,WAS,,CHI,L 92-101,240,34,85,.400,25,55,.455,9,30,.300,15,18,.833,92
1429,2018-12-27,GSW,,POR,L 109-110 (OT),265,45,106,.425,32,62,.516,13,44,.295,6,15,.400,109
1430,2018-12-27,POR,@,GSW,W 110-109 (OT),265,38,105,.362,25,65,.385,13,40,.325,21,23,.913,110
1431,2018-12-27,BOS,@,HOU,L 113-127,240,38,81,.469,26,50,.520,12,31,.387,25,31,.806,113
1432,2018-12-27,HOU,,BOS,W 127-113,240,41,86,.477,23,41,.561,18,45,.400,27,35,.771,127
1433,2018-12-27,MIL,,NYK,W 112-96,240,42,93,.452,31,61,.508,11,32,.344,17,21,.810,112
1434,2018-12-27,NYK,@,MIL,L 96-112,240,36,97,.371,23,66,.348,13,31,.419,11,16,.688,96
1435,2018-12-27,LAL,@,SAC,L 116-117,240,45,88,.511,35,63,.556,10,25,.400,16,23,.696,116
1436,2018-12-27,SAC,,LAL,W 117-116,240,45,101,.446,35,72,.486,10,29,.345,17,21,.810,117
1437,2018-12-27,PHI,@,UTA,W 114-97,240,43,86,.500,30,51,.588,13,35,.371,15,18,.833,114
1438,2018-12-27,UTA,,PHI,L 97-114,240,33,86,.384,22,51,.431,11,35,.314,20,27,.741,97
1439,2018-12-26,ATL,,IND,L 121-129,240,45,89,.506,28,53,.528,17,36,.472,14,18,.778,121
1440,2018-12-26,IND,@,ATL,W 129-121,240,46,83,.554,33,56,.589,13,27,.481,24,33,.727,129
1441,2018-12-26,BRK,,CHO,W 134-132 (2OT),290,51,104,.490,32,57,.561,19,47,.404,13,18,.722,134
1442,2018-12-26,CHA,@,BRK,L 132-134 (2OT),290,47,106,.443,32,75,.427,15,31,.484,23,30,.767,132
1443,2018-12-26,CHI,,MIN,L 94-119,240,39,95,.411,33,72,.458,6,23,.261,10,16,.625,94
1444,2018-12-26,MIN,@,CHI,W 119-94,240,46,93,.495,35,61,.574,11,32,.344,16,19,.842,119
1445,2018-12-26,DAL,,NOP,W 122-119,240,39,81,.481,27,46,.587,12,35,.343,32,38,.842,122
1446,2018-12-26,NOP,@,DAL,L 119-122,240,42,90,.467,30,63,.476,12,27,.444,23,30,.767,119
1447,2018-12-26,DET,,WAS,W 106-95,240,37,80,.463,23,43,.535,14,37,.378,18,19,.947,106
1448,2018-12-26,WAS,@,DET,L 95-106,240,38,83,.458,29,50,.580,9,33,.273,10,13,.769,95
1449,2018-12-26,LAC,,SAC,W 127-118,240,48,96,.500,36,68,.529,12,28,.429,19,23,.826,127
1450,2018-12-26,SAC,@,LAC,L 118-127,240,49,104,.471,39,74,.527,10,30,.333,10,15,.667,118
1451,2018-12-26,CLE,@,MEM,L 87-95,240,33,93,.355,24,64,.375,9,29,.310,12,15,.800,87
1452,2018-12-26,MEM,,CLE,W 95-87,240,36,72,.500,31,50,.620,5,22,.227,18,24,.750,95
1453,2018-12-26,MIA,,TOR,L 104-106,240,43,83,.518,31,54,.574,12,29,.414,6,12,.500,104
1454,2018-12-26,TOR,@,MIA,W 106-104,240,37,79,.468,24,49,.490,13,30,.433,19,23,.826,106
1455,2018-12-26,ORL,,PHO,L 120-122 (OT),265,44,96,.458,30,60,.500,14,36,.389,18,22,.818,120
1456,2018-12-26,PHO,@,ORL,W 122-120 (OT),265,48,95,.505,35,71,.493,13,24,.542,13,17,.765,122
1457,2018-12-26,DEN,@,SAS,L 103-111,240,35,90,.389,17,50,.340,18,40,.450,15,23,.652,103
1458,2018-12-26,SAS,,DEN,W 111-103,240,42,90,.467,32,58,.552,10,32,.313,17,22,.773,111
1459,2018-12-25,BOS,,PHI,W 121-114 (OT),265,45,108,.417,31,67,.463,14,41,.341,17,20,.850,121
1460,2018-12-25,PHI,@,BOS,L 114-121 (OT),265,38,92,.413,23,52,.442,15,40,.375,23,29,.793,114
1461,2018-12-25,GSW,,LAL,L 101-127,240,38,93,.409,29,57,.509,9,36,.250,16,21,.762,101
1462,2018-12-25,LAL,@,GSW,W 127-101,240,47,85,.553,34,52,.654,13,33,.394,20,27,.741,127
1463,2018-12-25,HOU,,OKC,W 113-109,240,44,97,.454,30,53,.566,14,44,.318,11,17,.647,113
1464,2018-12-25,OKC,@,HOU,L 109-113,240,43,98,.439,34,68,.500,9,30,.300,14,21,.667,109
1465,2018-12-25,MIL,@,NYK,W 109-95,240,40,89,.449,34,57,.596,6,32,.188,23,34,.676,109
1466,2018-12-25,NYK,,MIL,L 95-109,240,35,97,.361,27,68,.397,8,29,.276,17,21,.810,95
1467,2018-12-25,POR,@,UTA,L 96-117,240,35,89,.393,26,66,.394,9,23,.391,17,26,.654,96
1468,2018-12-25,UTA,,POR,W 117-96,240,46,83,.554,33,54,.611,13,29,.448,12,23,.522,117
1469,2018-12-23,BOS,,CHO,W 119-103,240,43,86,.500,30,47,.638,13,39,.333,20,25,.800,119
1470,2018-12-23,CHA,@,BOS,L 103-119,240,38,88,.432,30,56,.536,8,32,.250,19,26,.731,103
1471,2018-12-23,BRK,,PHO,W 111-103,240,40,85,.471,30,58,.517,10,27,.370,21,33,.636,111
1472,2018-12-23,PHO,@,BRK,L 103-111,240,43,89,.483,40,72,.556,3,17,.176,14,16,.875,103
1473,2018-12-23,CHI,@,CLE,W 112-92,240,43,78,.551,32,56,.571,11,22,.500,15,17,.882,112
1474,2018-12-23,CLE,,CHI,L 92-112,240,38,84,.452,31,61,.508,7,23,.304,9,14,.643,92
1475,2018-12-23,ATL,@,DET,W 98-95,240,36,91,.396,30,68,.441,6,23,.261,20,25,.800,98
1476,2018-12-23,DET,,ATL,L 95-98,240,34,83,.410,24,54,.444,10,29,.345,17,27,.630,95
1477,2018-12-23,GSW,,LAC,W 129-127,240,42,93,.452,28,53,.528,14,40,.350,31,36,.861,129
1478,2018-12-23,LAC,@,GSW,L 127-129,240,43,80,.538,25,57,.439,18,23,.783,23,29,.793,127
1479,2018-12-23,IND,,WAS,W 105-89,240,43,97,.443,34,67,.507,9,30,.300,10,12,.833,105
1480,2018-12-23,WAS,@,IND,L 89-105,240,28,76,.368,19,41,.463,9,35,.257,24,26,.923,89
1481,2018-12-23,LAL,,MEM,L 99-107,240,37,75,.493,27,45,.600,10,30,.333,15,22,.682,99
1482,2018-12-23,MEM,@,LAL,W 107-99,240,42,90,.467,28,64,.438,14,26,.538,9,14,.643,107
1483,2018-12-23,MIN,@,OKC,W 114-112,240,41,83,.494,27,56,.482,14,27,.519,18,27,.667,114
1484,2018-12-23,OKC,,MIN,L 112-114,240,43,90,.478,34,65,.523,9,25,.360,17,22,.773,112
1485,2018-12-23,MIA,@,ORL,W 115-91,240,43,85,.506,27,54,.500,16,31,.516,13,19,.684,115
1486,2018-12-23,ORL,,MIA,L 91-115,240,29,70,.414,19,42,.452,10,28,.357,23,32,.719,91
1487,2018-12-23,DAL,@,POR,L 118-121 (OT),265,43,103,.417,31,69,.449,12,34,.353,20,28,.714,118
1488,2018-12-23,POR,,DAL,W 121-118 (OT),265,49,104,.471,38,66,.576,11,38,.289,12,17,.706,121
1489,2018-12-23,NOP,@,SAC,L 117-122,240,44,94,.468,38,68,.559,6,26,.231,23,28,.821,117
1490,2018-12-23,SAC,,NOP,W 122-117,240,42,100,.420,28,69,.406,14,31,.452,24,33,.727,122
1491,2018-12-22,DAL,@,GSW,L 116-120,240,42,92,.457,28,53,.528,14,39,.359,18,28,.643,116
1492,2018-12-22,GSW,,DAL,W 120-116,240,45,98,.459,30,55,.545,15,43,.349,15,16,.938,120
1493,2018-12-22,HOU,,SAS,W 108-101,240,37,95,.389,18,41,.439,19,54,.352,15,21,.714,108
1494,2018-12-22,SAS,@,HOU,L 101-108,240,42,88,.477,32,64,.500,10,24,.417,7,11,.636,101
1495,2018-12-22,DEN,@,LAC,L 111-132,240,41,97,.423,32,66,.485,9,31,.290,20,25,.800,111
1496,2018-12-22,LAC,,DEN,W 132-111,240,53,92,.576,43,72,.597,10,20,.500,16,17,.941,132
1497,2018-12-22,MIA,,MIL,W 94-87,240,34,89,.382,24,57,.421,10,32,.313,16,23,.696,94
1498,2018-12-22,MIL,@,MIA,L 87-94,240,31,84,.369,22,41,.537,9,43,.209,16,22,.727,87
1499,2018-12-22,PHI,,TOR,W 126-101,240,46,85,.541,38,61,.623,8,24,.333,26,35,.743,126
1500,2018-12-22,TOR,@,PHI,L 101-126,240,37,95,.389,27,55,.491,10,40,.250,17,19,.895,101
1501,2018-12-22,OKC,@,UTA,W 107-106,240,42,89,.472,33,64,.516,9,25,.360,14,22,.636,107
1502,2018-12-22,UTA,,OKC,L 106-107,240,42,93,.452,31,59,.525,11,34,.324,11,18,.611,106
1503,2018-12-22,PHO,@,WAS,L 146-149 (3OT),315,55,115,.478,44,80,.550,11,35,.314,25,33,.758,146
1504,2018-12-22,WAS,,PHO,W 149-146 (3OT),315,56,111,.505,43,75,.573,13,36,.361,24,27,.889,149
1505,2018-12-21,BOS,,MIL,L 107-120,240,35,91,.385,25,57,.439,10,34,.294,27,36,.750,107
1506,2018-12-21,MIL,@,BOS,W 120-107,240,41,80,.513,25,40,.625,16,40,.400,22,28,.786,120
1507,2018-12-21,BRK,,IND,L 106-114,240,33,72,.458,17,41,.415,16,31,.516,24,34,.706,106
1508,2018-12-21,IND,@,BRK,W 114-106,240,44,82,.537,33,56,.589,11,26,.423,15,18,.833,114
1509,2018-12-21,CHI,,ORL,W 90-80,240,33,75,.440,28,58,.483,5,17,.294,19,26,.731,90
1510,2018-12-21,ORL,@,CHI,L 80-90,240,28,86,.326,20,53,.377,8,33,.242,16,24,.667,80
1511,2018-12-21,CHA,,DET,W 98-86,240,33,75,.440,21,51,.412,12,24,.500,20,28,.714,98
1512,2018-12-21,DET,@,CHO,L 86-98,240,32,82,.390,24,48,.500,8,34,.235,14,22,.636,86
1513,2018-12-21,LAL,,NOP,W 112-104,240,43,92,.467,35,60,.583,8,32,.250,18,25,.720,112
1514,2018-12-21,NOP,@,LAL,L 104-112,240,44,102,.431,36,75,.480,8,27,.296,8,16,.500,104
1515,2018-12-21,ATL,@,NYK,W 114-107,240,43,91,.473,33,62,.532,10,29,.345,18,24,.750,114
1516,2018-12-21,NYK,,ATL,L 107-114,240,41,84,.488,33,57,.579,8,27,.296,17,24,.708,107
1517,2018-12-21,POR,,UTA,L 90-120,240,35,87,.402,25,55,.455,10,32,.313,10,18,.556,90
1518,2018-12-21,UTA,@,POR,W 120-90,240,47,85,.553,31,54,.574,16,31,.516,10,17,.588,120
1519,2018-12-21,MEM,@,SAC,L 99-102,240,37,80,.463,21,48,.438,16,32,.500,9,10,.900,99
1520,2018-12-21,SAC,,MEM,W 102-99,240,33,88,.375,18,47,.383,15,41,.366,21,29,.724,102
1521,2018-12-21,MIN,@,SAS,L 98-124,240,33,83,.398,27,62,.435,6,21,.286,26,31,.839,98
1522,2018-12-21,SAS,,MIN,W 124-98,240,46,87,.529,27,54,.500,19,33,.576,13,18,.722,124
1523,2018-12-21,CLE,@,TOR,L 110-126,240,39,82,.476,30,58,.517,9,24,.375,23,30,.767,110
1524,2018-12-21,TOR,,CLE,W 126-110,240,48,91,.527,39,60,.650,9,31,.290,21,26,.808,126
1525,2018-12-20,DAL,@,LAC,L 121-125,240,43,92,.467,33,64,.516,10,28,.357,25,33,.758,121
1526,2018-12-20,LAC,,DAL,W 125-121,240,47,83,.566,41,63,.651,6,20,.300,25,31,.806,125
1527,2018-12-20,HOU,@,MIA,L 99-101,240,29,82,.354,11,28,.393,18,54,.333,23,30,.767,99
1528,2018-12-20,MIA,,HOU,W 101-99,240,36,93,.387,27,54,.500,9,39,.231,20,34,.588,101
1529,2018-12-19,BOS,,PHO,L 103-111,240,38,85,.447,23,46,.500,15,39,.385,12,14,.857,103
1530,2018-12-19,PHO,@,BOS,W 111-103,240,41,96,.427,30,69,.435,11,27,.407,18,22,.818,111
1531,2018-12-19,BRK,@,CHI,W 96-93,240,34,74,.459,26,49,.531,8,25,.320,20,25,.800,96
1532,2018-12-19,CHI,,BRK,L 93-96,240,40,91,.440,34,72,.472,6,19,.316,7,10,.700,93
1533,2018-12-19,CHA,,CLE,W 110-99,240,47,92,.511,37,67,.552,10,25,.400,6,9,.667,110
1534,2018-12-19,CLE,@,CHO,L 99-110,240,41,85,.482,31,62,.500,10,23,.435,7,12,.583,99
1535,2018-12-19,HOU,,WAS,W 136-118,240,47,85,.553,21,30,.700,26,55,.473,16,21,.762,136
1536,2018-12-19,WAS,@,HOU,L 118-136,240,45,84,.536,35,54,.648,10,30,.333,18,23,.783,118
1537,2018-12-19,MIL,,NOP,W 123-115,240,43,85,.506,30,52,.577,13,33,.394,24,30,.800,123
1538,2018-12-19,NOP,@,MIL,L 115-123,240,43,92,.467,24,50,.480,19,42,.452,10,15,.667,115
1539,2018-12-19,DET,@,MIN,W 129-123 (OT),265,46,94,.489,26,46,.565,20,48,.417,17,28,.607,129
1540,2018-12-19,MIN,,DET,L 123-129 (OT),265,45,103,.437,36,70,.514,9,33,.273,24,29,.828,123
1541,2018-12-19,ORL,,SAS,L 90-129,240,34,89,.382,22,58,.379,12,31,.387,10,17,.588,90
1542,2018-12-19,SAS,@,ORL,W 129-90,240,50,77,.649,38,58,.655,12,19,.632,17,21,.810,129
1543,2018-12-19,NYK,@,PHI,L 109-131,240,37,86,.430,27,55,.491,10,31,.323,25,31,.806,109
1544,2018-12-19,PHI,,NYK,W 131-109,240,47,88,.534,32,58,.552,15,30,.500,22,25,.880,131
1545,2018-12-19,MEM,@,POR,L 92-99,240,33,78,.423,24,51,.471,9,27,.333,17,19,.895,92
1546,2018-12-19,POR,,MEM,W 99-92,240,35,75,.467,24,49,.490,11,26,.423,18,20,.900,99
1547,2018-12-19,OKC,@,SAC,W 132-113,240,51,102,.500,38,70,.543,13,32,.406,17,27,.630,132
1548,2018-12-19,SAC,,OKC,L 113-132,240,39,93,.419,26,59,.441,13,34,.382,22,33,.667,113
1549,2018-12-19,IND,@,TOR,L 96-99,240,38,80,.475,29,60,.483,9,20,.450,11,16,.688,96
1550,2018-12-19,TOR,,IND,W 99-96,240,38,93,.409,31,63,.492,7,30,.233,16,21,.762,99
1551,2018-12-19,GSW,@,UTA,L 103-108,240,38,95,.400,28,64,.438,10,31,.323,17,18,.944,103
1552,2018-12-19,UTA,,GSW,W 108-103,240,37,93,.398,21,51,.412,16,42,.381,18,22,.818,108
1553,2018-12-18,ATL,,WAS,W 118-110,240,37,79,.468,25,47,.532,12,32,.375,32,39,.821,118
1554,2018-12-18,WAS,@,ATL,L 110-118,240,36,83,.434,23,43,.535,13,40,.325,25,36,.694,110
1555,2018-12-18,BRK,,LAL,W 115-110,240,44,91,.484,30,57,.526,14,34,.412,13,19,.684,115
1556,2018-12-18,LAL,@,BRK,L 110-115,240,42,90,.467,29,50,.580,13,40,.325,13,23,.565,110
1557,2018-12-18,DAL,@,DEN,L 118-126,240,40,86,.465,25,49,.510,15,37,.405,23,30,.767,118
1558,2018-12-18,DEN,,DAL,W 126-118,240,50,90,.556,38,61,.623,12,29,.414,14,18,.778,126
1559,2018-12-18,CLE,@,IND,W 92-91,240,38,91,.418,32,60,.533,6,31,.194,10,13,.769,92
1560,2018-12-18,IND,,CLE,L 91-92,240,37,93,.398,33,71,.465,4,22,.182,13,21,.619,91
1561,2018-12-17,DET,,MIL,L 104-107,240,39,88,.443,25,53,.472,14,35,.400,12,15,.800,104
1562,2018-12-17,MIL,@,DET,W 107-104,240,44,88,.500,35,63,.556,9,25,.360,10,15,.667,107
1563,2018-12-17,GSW,,MEM,W 110-93,240,37,85,.435,25,54,.463,12,31,.387,24,27,.889,110
1564,2018-12-17,MEM,@,GSW,L 93-110,240,36,79,.456,29,54,.537,7,25,.280,14,18,.778,93
1565,2018-12-17,HOU,,UTA,W 102-97,240,32,86,.372,20,49,.408,12,37,.324,26,31,.839,102
1566,2018-12-17,UTA,@,HOU,L 97-102,240,32,82,.390,22,47,.468,10,35,.286,23,31,.742,97
1567,2018-12-17,LAC,,POR,L 127-131,240,42,83,.506,32,56,.571,10,27,.370,33,39,.846,127
1568,2018-12-17,POR,@,LAC,W 131-127,240,47,86,.547,37,66,.561,10,20,.500,27,31,.871,131
1569,2018-12-17,MIN,,SAC,W 132-105,240,48,96,.500,38,69,.551,10,27,.370,26,30,.867,132
1570,2018-12-17,SAC,@,MIN,L 105-132,240,38,90,.422,24,52,.462,14,38,.368,15,23,.652,105
1571,2018-12-17,NYK,,PHO,L 110-128,240,40,99,.404,31,64,.484,9,35,.257,21,29,.724,110
1572,2018-12-17,PHO,@,NYK,W 128-110,240,48,92,.522,39,65,.600,9,27,.333,23,27,.852,128
1573,2018-12-17,CHI,@,OKC,L 96-121,240,38,85,.447,30,63,.476,8,22,.364,12,16,.750,96
1574,2018-12-17,OKC,,CHI,W 121-96,240,43,89,.483,35,68,.515,8,21,.381,27,33,.818,121
1575,2018-12-17,PHI,@,SAS,L 96-123,240,40,98,.408,29,61,.475,11,37,.297,5,7,.714,96
1576,2018-12-17,SAS,,PHI,W 123-96,240,49,87,.563,40,64,.625,9,23,.391,16,17,.941,123
1577,2018-12-16,ATL,@,BRK,L 127-144,240,47,85,.553,33,56,.589,14,29,.483,19,25,.760,127
1578,2018-12-16,BRK,,ATL,W 144-127,240,49,88,.557,33,48,.688,16,40,.400,30,33,.909,144
1579,2018-12-16,CLE,,PHI,L 105-128,240,41,88,.466,29,58,.500,12,30,.400,11,17,.647,105
1580,2018-12-16,PHI,@,CLE,W 128-105,240,51,91,.560,40,64,.625,11,27,.407,15,20,.750,128
1581,2018-12-16,DAL,,SAC,L 113-120,240,40,96,.417,31,61,.508,9,35,.257,24,31,.774,113
1582,2018-12-16,SAC,@,DAL,W 120-113,240,46,98,.469,37,67,.552,9,31,.290,19,21,.905,120
1583,2018-12-16,DEN,,TOR,W 95-86,240,36,85,.424,26,55,.473,10,30,.333,13,16,.813,95
1584,2018-12-16,TOR,@,DEN,L 86-95,240,35,88,.398,28,53,.528,7,35,.200,9,14,.643,86
1585,2018-12-16,IND,,NYK,W 110-99,240,40,87,.460,28,53,.528,12,34,.353,18,23,.783,110
1586,2018-12-16,NYK,@,IND,L 99-110,240,37,89,.416,27,57,.474,10,32,.313,15,22,.682,99
1587,2018-12-16,MIA,@,NOP,W 102-96,240,38,91,.418,28,56,.500,10,35,.286,16,23,.696,102
1588,2018-12-16,NOP,,MIA,L 96-102,240,35,86,.407,22,50,.440,13,36,.361,13,17,.765,96
1589,2018-12-16,LAL,@,WAS,L 110-128,240,44,91,.484,33,55,.600,11,36,.306,11,18,.611,110
1590,2018-12-16,WAS,,LAL,W 128-110,240,54,106,.509,41,75,.547,13,31,.419,7,10,.700,128
1591,2018-12-15,CHA,,LAL,L 100-128,240,39,92,.424,32,63,.508,7,29,.241,15,18,.833,100
1592,2018-12-15,LAL,@,CHO,W 128-100,240,49,92,.533,35,58,.603,14,34,.412,16,24,.667,128
1593,2018-12-15,BOS,@,DET,L 104-113,240,39,94,.415,30,61,.492,9,33,.273,17,23,.739,104
1594,2018-12-15,DET,,BOS,W 113-104,240,39,80,.488,29,50,.580,10,30,.333,25,35,.714,113
1595,2018-12-15,HOU,@,MEM,W 105-97,240,35,73,.479,22,36,.611,13,37,.351,22,25,.880,105
1596,2018-12-15,MEM,,HOU,L 97-105,240,40,75,.533,35,52,.673,5,23,.217,12,17,.706,97
1597,2018-12-15,LAC,@,OKC,L 104-110,240,38,75,.507,25,50,.500,13,25,.520,15,22,.682,104
1598,2018-12-15,OKC,,LAC,W 110-104,240,42,90,.467,33,68,.485,9,22,.409,17,24,.708,110
1599,2018-12-15,ORL,,UTA,W 96-89,240,34,72,.472,23,48,.479,11,24,.458,17,20,.850,96
1600,2018-12-15,UTA,@,ORL,L 89-96,240,28,89,.315,21,60,.350,7,29,.241,26,28,.929,89
1601,2018-12-15,MIN,@,PHO,L 99-107,240,39,96,.406,32,61,.525,7,35,.200,14,19,.737,99
1602,2018-12-15,PHO,,MIN,W 107-99,240,41,90,.456,32,62,.516,9,28,.321,16,20,.800,107
1603,2018-12-15,CHI,@,SAS,W 98-93,240,37,86,.430,31,57,.544,6,29,.207,18,21,.857,98
1604,2018-12-15,SAS,,CHI,L 93-98,240,32,73,.438,25,52,.481,7,21,.333,22,26,.846,93
1605,2018-12-14,ATL,@,BOS,L 108-129,240,36,86,.419,20,48,.417,16,38,.421,20,32,.625,108
1606,2018-12-14,BOS,,ATL,W 129-108,240,46,95,.484,27,56,.482,19,39,.487,18,20,.900,129
1607,2018-12-14,BRK,,WAS,W 125-118,240,44,84,.524,33,53,.623,11,31,.355,26,31,.839,125
1608,2018-12-14,WAS,@,BRK,L 118-125,240,49,90,.544,38,61,.623,11,29,.379,9,16,.563,118
1609,2018-12-14,CHA,,NYK,L 124-126 (OT),265,48,102,.471,28,54,.519,20,48,.417,8,10,.800,124
1610,2018-12-14,NYK,@,CHO,W 126-124 (OT),265,47,98,.480,35,64,.547,12,34,.353,20,31,.645,126
1611,2018-12-14,CLE,,MIL,L 102-114,240,35,87,.402,22,51,.431,13,36,.361,19,21,.905,102
1612,2018-12-14,MIL,@,CLE,W 114-102,240,40,94,.426,28,53,.528,12,41,.293,22,28,.786,114
1613,2018-12-14,DEN,,OKC,W 109-98,240,42,83,.506,31,49,.633,11,34,.324,14,15,.933,109
1614,2018-12-14,OKC,@,DEN,L 98-109,240,37,90,.411,30,71,.423,7,19,.368,17,29,.586,98
1615,2018-12-14,MEM,,MIA,L 97-100,240,35,83,.422,27,54,.500,8,29,.276,19,25,.760,97
1616,2018-12-14,MIA,@,MEM,W 100-97,240,36,82,.439,21,43,.488,15,39,.385,13,18,.722,100
1617,2018-12-14,IND,@,PHI,W 113-101,240,42,95,.442,34,75,.453,8,20,.400,21,24,.875,113
1618,2018-12-14,PHI,,IND,L 101-113,240,36,88,.409,27,52,.519,9,36,.250,20,27,.741,101
1619,2018-12-14,POR,,TOR,W 128-122,240,48,94,.511,35,67,.522,13,27,.481,19,21,.905,128
1620,2018-12-14,TOR,@,POR,L 122-128,240,43,78,.551,25,47,.532,18,31,.581,18,21,.857,122
1621,2018-12-14,GSW,@,SAC,W 130-125,240,44,96,.458,29,56,.518,15,40,.375,27,36,.750,130
1622,2018-12-14,SAC,,GSW,L 125-130,240,45,96,.469,30,52,.577,15,44,.341,20,25,.800,125
1623,2018-12-13,HOU,,LAL,W 126-111,240,42,85,.494,27,51,.529,15,34,.441,27,32,.844,126
1624,2018-12-13,LAL,@,HOU,L 111-126,240,43,80,.538,33,48,.688,10,32,.313,15,27,.556,111
1625,2018-12-13,CHI,@,ORL,L 91-97,240,34,71,.479,24,53,.453,10,18,.556,13,20,.650,91
1626,2018-12-13,ORL,,CHI,W 97-91,240,34,82,.415,23,49,.469,11,33,.333,18,23,.783,97
1627,2018-12-13,DAL,@,PHO,L 89-99,240,31,78,.397,26,45,.578,5,33,.152,22,33,.667,89
1628,2018-12-13,PHO,,DAL,W 99-89,240,37,92,.402,27,65,.415,10,27,.370,15,18,.833,99
1629,2018-12-13,LAC,@,SAS,L 87-125,240,30,84,.357,20,53,.377,10,31,.323,17,24,.708,87
1630,2018-12-13,SAS,,LAC,W 125-87,240,48,83,.578,38,61,.623,10,22,.455,19,24,.792,125
1631,2018-12-12,CHA,,DET,W 108-107,240,35,85,.412,26,57,.456,9,28,.321,29,37,.784,108
1632,2018-12-12,DET,@,CHO,L 107-108,240,40,86,.465,27,52,.519,13,34,.382,14,21,.667,107
1633,2018-12-12,CLE,,NYK,W 113-106,240,43,91,.473,33,57,.579,10,34,.294,17,21,.810,113
1634,2018-12-12,NYK,@,CLE,L 106-113,240,41,94,.436,30,67,.448,11,27,.407,13,14,.929,106
1635,2018-12-12,ATL,@,DAL,L 107-114,240,43,93,.462,32,60,.533,11,33,.333,10,14,.714,107
1636,2018-12-12,DAL,,ATL,W 114-107,240,35,75,.467,23,41,.561,12,34,.353,32,43,.744,114
1637,2018-12-12,GSW,,TOR,L 93-113,240,39,82,.476,33,56,.589,6,26,.231,9,13,.692,93
1638,2018-12-12,TOR,@,GSW,W 113-93,240,44,91,.484,35,63,.556,9,28,.321,16,19,.842,113
1639,2018-12-12,IND,,MIL,W 113-97,240,43,91,.473,31,61,.508,12,30,.400,15,20,.750,113
1640,2018-12-12,MIL,@,IND,L 97-113,240,38,91,.418,27,48,.563,11,43,.256,10,15,.667,97
1641,2018-12-12,MEM,,POR,W 92-83,240,34,82,.415,26,58,.448,8,24,.333,16,24,.667,92
1642,2018-12-12,POR,@,MEM,L 83-92,240,32,87,.368,26,65,.400,6,22,.273,13,16,.813,83
1643,2018-12-12,NOP,,OKC,W 118-114,240,45,97,.464,41,79,.519,4,18,.222,24,30,.800,118
1644,2018-12-12,OKC,@,NOP,L 114-118,240,42,87,.483,29,44,.659,13,43,.302,17,27,.630,114
1645,2018-12-12,BRK,@,PHI,W 127-124,240,38,74,.514,24,46,.522,14,28,.500,37,43,.860,127
1646,2018-12-12,PHI,,BRK,L 124-127,240,50,91,.549,38,63,.603,12,28,.429,12,16,.750,124
1647,2018-12-12,MIN,@,SAC,L 130-141,240,50,93,.538,41,71,.577,9,22,.409,21,27,.778,130
1648,2018-12-12,SAC,,MIN,W 141-130,240,50,86,.581,31,48,.646,19,38,.500,22,32,.688,141
1649,2018-12-12,MIA,@,UTA,L 84-111,240,29,77,.377,17,44,.386,12,33,.364,14,24,.583,84
1650,2018-12-12,UTA,,MIA,W 111-84,240,40,76,.526,24,44,.545,16,32,.500,15,21,.714,111
1651,2018-12-12,BOS,@,WAS,W 130-125 (OT),265,47,104,.452,36,66,.545,11,38,.289,25,25,1.000,130
1652,2018-12-12,WAS,,BOS,L 125-130 (OT),265,46,91,.505,34,58,.586,12,33,.364,21,29,.724,125
1653,2018-12-11,HOU,,POR,W 111-104,240,42,85,.494,33,56,.589,9,29,.310,18,27,.667,111
1654,2018-12-11,POR,@,HOU,L 104-111,240,38,87,.437,28,62,.452,10,25,.400,18,21,.857,104
1655,2018-12-11,LAC,,TOR,L 99-123,240,38,86,.442,31,61,.508,7,25,.280,16,19,.842,99
1656,2018-12-11,TOR,@,LAC,W 123-99,240,50,96,.521,36,67,.537,14,29,.483,9,12,.750,123
1657,2018-12-11,PHO,@,SAS,L 86-111,240,33,82,.402,25,54,.463,8,28,.286,12,14,.857,86
1658,2018-12-11,SAS,,PHO,W 111-86,240,41,83,.494,28,62,.452,13,21,.619,16,19,.842,111
1659,2018-12-10,BOS,,NOP,W 113-100,240,44,90,.489,32,51,.627,12,39,.308,13,19,.684,113
1660,2018-12-10,NOP,@,BOS,L 100-113,240,39,87,.448,31,61,.508,8,26,.308,14,19,.737,100
1661,2018-12-10,CHI,,SAC,L 89-108,240,34,76,.447,26,48,.542,8,28,.286,13,13,1.000,89
1662,2018-12-10,SAC,@,CHI,W 108-89,240,40,88,.455,24,51,.471,16,37,.432,12,15,.800,108
1663,2018-12-10,DAL,,ORL,W 101-76,240,35,82,.427,25,47,.532,10,35,.286,21,25,.840,101
1664,2018-12-10,ORL,@,DAL,L 76-101,240,32,89,.360,24,61,.393,8,28,.286,4,5,.800,76
1665,2018-12-10,DEN,,MEM,W 105-99,240,39,77,.506,30,49,.612,9,28,.321,18,23,.783,105
1666,2018-12-10,MEM,@,DEN,L 99-105,240,37,74,.500,28,47,.596,9,27,.333,16,17,.941,99
1667,2018-12-10,GSW,,MIN,W 116-108,240,39,93,.419,20,50,.400,19,43,.442,19,21,.905,116
1668,2018-12-10,MIN,@,GSW,L 108-116,240,38,83,.458,31,58,.534,7,25,.280,25,31,.806,108
1669,2018-12-10,IND,,WAS,W 109-101,240,41,76,.539,31,56,.554,10,20,.500,17,22,.773,109
1670,2018-12-10,WAS,@,IND,L 101-109,240,37,88,.420,27,58,.466,10,30,.333,17,24,.708,101
1671,2018-12-10,LAL,,MIA,W 108-105,240,41,90,.456,27,58,.466,14,32,.438,12,20,.600,108
1672,2018-12-10,MIA,@,LAL,L 105-108,240,42,94,.447,31,60,.517,11,34,.324,10,13,.769,105
1673,2018-12-10,CLE,@,MIL,L 92-108,240,36,96,.375,26,66,.394,10,30,.333,10,15,.667,92
1674,2018-12-10,MIL,,CLE,W 108-92,240,42,96,.438,27,60,.450,15,36,.417,9,11,.818,108
1675,2018-12-10,OKC,,UTA,W 122-113,240,43,85,.506,35,64,.547,8,21,.381,28,39,.718,122
1676,2018-12-10,UTA,@,OKC,L 113-122,240,43,84,.512,35,55,.636,8,29,.276,19,30,.633,113
1677,2018-12-10,DET,@,PHI,L 102-116,240,41,84,.488,32,63,.508,9,21,.429,11,21,.524,102
1678,2018-12-10,PHI,,DET,W 116-102,240,39,88,.443,24,51,.471,15,37,.405,23,35,.657,116
1679,2018-12-10,LAC,@,PHO,W 123-119 (OT),265,45,85,.529,38,64,.594,7,21,.333,26,33,.788,123
1680,2018-12-10,PHO,,LAC,L 119-123 (OT),265,47,94,.500,38,69,.551,9,25,.360,16,20,.800,119
1681,2018-12-09,DET,,NOP,L 108-116,240,43,98,.439,34,69,.493,9,29,.310,13,24,.542,108
1682,2018-12-09,NOP,@,DET,W 116-108,240,42,79,.532,30,49,.612,12,30,.400,20,23,.870,116
1683,2018-12-09,CHA,@,NYK,W 119-107,240,42,87,.483,30,53,.566,12,34,.353,23,27,.852,119
1684,2018-12-09,NYK,,CHO,L 107-119,240,44,93,.473,31,67,.463,13,26,.500,6,7,.857,107
1685,2018-12-09,SAS,,UTA,W 110-97,240,47,89,.528,42,75,.560,5,14,.357,11,12,.917,110
1686,2018-12-09,UTA,@,SAS,L 97-110,240,37,85,.435,28,56,.500,9,29,.310,14,19,.737,97
1687,2018-12-09,MIL,@,TOR,W 104-99,240,36,87,.414,21,48,.438,15,39,.385,17,20,.850,104
1688,2018-12-09,TOR,,MIL,L 99-104,240,39,94,.415,24,50,.480,15,44,.341,6,7,.857,99
1689,2018-12-08,ATL,,DEN,W 106-98,240,40,93,.430,25,51,.490,15,42,.357,11,16,.688,106
1690,2018-12-08,DEN,@,ATL,L 98-106,240,36,97,.371,27,61,.443,9,36,.250,17,21,.810,98
1691,2018-12-08,BOS,@,CHI,W 133-77,240,50,93,.538,28,50,.560,22,43,.512,11,15,.733,133
1692,2018-12-08,CHI,,BOS,L 77-133,240,31,81,.383,25,57,.439,6,24,.250,9,14,.643,77
1693,2018-12-08,CLE,,WAS,W 116-101,240,47,89,.528,32,58,.552,15,31,.484,7,10,.700,116
1694,2018-12-08,WAS,@,CLE,L 101-116,240,38,86,.442,24,48,.500,14,38,.368,11,16,.688,101
1695,2018-12-08,DAL,,HOU,W 107-104,240,41,83,.494,29,53,.547,12,30,.400,13,16,.813,107
1696,2018-12-08,HOU,@,DAL,L 104-107,240,39,86,.453,24,39,.615,15,47,.319,11,13,.846,104
1697,2018-12-08,IND,,SAC,W 107-97,240,40,92,.435,32,62,.516,8,30,.267,19,22,.864,107
1698,2018-12-08,SAC,@,IND,L 97-107,240,38,90,.422,29,58,.500,9,32,.281,12,15,.800,97
1699,2018-12-08,LAC,,MIA,L 98-121,240,33,89,.371,26,60,.433,7,29,.241,25,31,.806,98
1700,2018-12-08,MIA,@,LAC,W 121-98,240,40,92,.435,27,53,.509,13,39,.333,28,39,.718,121
1701,2018-12-08,LAL,@,MEM,W 111-88,240,43,97,.443,27,57,.474,16,40,.400,9,12,.750,111
1702,2018-12-08,MEM,,LAL,L 88-111,240,34,84,.405,28,54,.519,6,30,.200,14,18,.778,88
1703,2018-12-08,BRK,@,NYK,W 112-104,240,43,88,.489,32,66,.485,11,22,.500,15,25,.600,112
1704,2018-12-08,NYK,,BRK,L 104-112,240,39,83,.470,31,57,.544,8,26,.308,18,30,.600,104
1705,2018-12-08,MIN,@,POR,L 105-113,240,40,91,.440,33,75,.440,7,16,.438,18,22,.818,105
1706,2018-12-08,POR,,MIN,W 113-105,240,39,83,.470,29,50,.580,10,33,.303,25,30,.833,113
1707,2018-12-07,BRK,,TOR,W 106-105 (OT),265,43,98,.439,32,63,.508,11,35,.314,9,13,.692,106
1708,2018-12-07,TOR,@,BRK,L 105-106 (OT),265,35,89,.393,24,54,.444,11,35,.314,24,29,.828,105
1709,2018-12-07,CHI,,OKC,W 114-112,240,43,82,.524,31,57,.544,12,25,.480,16,23,.696,114
1710,2018-12-07,OKC,@,CHI,L 112-114,240,43,94,.457,33,66,.500,10,28,.357,16,24,.667,112
1711,2018-12-07,CHA,,DEN,W 113-107,240,33,86,.384,20,51,.392,13,35,.371,34,38,.895,113
1712,2018-12-07,DEN,@,CHO,L 107-113,240,39,101,.386,31,66,.470,8,35,.229,21,26,.808,107
1713,2018-12-07,CLE,,SAC,L 110-129,240,43,81,.531,33,55,.600,10,26,.385,14,19,.737,110
1714,2018-12-07,SAC,@,CLE,W 129-110,240,56,98,.571,43,69,.623,13,29,.448,4,7,.571,129
1715,2018-12-07,DET,,PHI,L 111-117,240,37,89,.416,30,61,.492,7,28,.250,30,37,.811,111
1716,2018-12-07,PHI,@,DET,W 117-111,240,44,90,.489,35,58,.603,9,32,.281,20,21,.952,117
1717,2018-12-07,GSW,@,MIL,W 105-95,240,40,89,.449,21,43,.488,19,46,.413,6,7,.857,105
1718,2018-12-07,MIL,,GSW,L 95-105,240,36,92,.391,29,53,.547,7,39,.179,16,23,.696,95
1719,2018-12-07,MEM,@,NOP,W 107-103,240,39,83,.470,31,64,.484,8,19,.421,21,28,.750,107
1720,2018-12-07,NOP,,MEM,L 103-107,240,38,84,.452,31,55,.564,7,29,.241,20,24,.833,103
1721,2018-12-07,IND,@,ORL,W 112-90,240,44,93,.473,35,67,.522,9,26,.346,15,18,.833,112
1722,2018-12-07,ORL,,IND,L 90-112,240,36,89,.404,28,56,.500,8,33,.242,10,13,.769,90
1723,2018-12-07,MIA,@,PHO,W 115-98,240,42,86,.488,27,49,.551,15,37,.405,16,18,.889,115
1724,2018-12-07,PHO,,MIA,L 98-115,240,36,79,.456,22,45,.489,14,34,.412,12,16,.750,98
1725,2018-12-07,LAL,@,SAS,L 120-133,240,46,100,.460,35,64,.547,11,36,.306,17,21,.810,120
1726,2018-12-07,SAS,,LAL,W 133-120,240,46,91,.505,33,60,.550,13,31,.419,28,33,.848,133
1727,2018-12-06,BOS,,NYK,W 128-100,240,49,92,.533,36,54,.667,13,38,.342,17,20,.850,128
1728,2018-12-06,NYK,@,BOS,L 100-128,240,36,91,.396,24,56,.429,12,35,.343,16,20,.800,100
1729,2018-12-06,PHO,@,POR,L 86-108,240,35,91,.385,30,64,.469,5,27,.185,11,14,.786,86
1730,2018-12-06,POR,,PHO,W 108-86,240,41,85,.482,32,58,.552,9,27,.333,17,27,.630,108
1731,2018-12-06,HOU,@,UTA,L 91-118,240,34,88,.386,26,52,.500,8,36,.222,15,17,.882,91
1732,2018-12-06,UTA,,HOU,W 118-91,240,45,89,.506,37,57,.649,8,32,.250,20,27,.741,118
1733,2018-12-05,ATL,,WAS,L 117-131,240,41,92,.446,29,54,.537,12,38,.316,23,31,.742,117
1734,2018-12-05,WAS,@,ATL,W 131-117,240,46,95,.484,34,57,.596,12,38,.316,27,32,.844,131
1735,2018-12-05,BRK,,OKC,L 112-114,240,37,86,.430,22,50,.440,15,36,.417,23,30,.767,112
1736,2018-12-05,OKC,@,BRK,W 114-112,240,43,99,.434,30,61,.492,13,38,.342,15,26,.577,114
1737,2018-12-05,CLE,,GSW,L 105-129,240,39,89,.438,28,57,.491,11,32,.344,16,23,.696,105
1738,2018-12-05,GSW,@,CLE,W 129-105,240,45,85,.529,27,51,.529,18,34,.529,21,24,.875,129
1739,2018-12-05,LAL,,SAS,W 121-113,240,42,88,.477,28,49,.571,14,39,.359,23,33,.697,121
1740,2018-12-05,SAS,@,LAL,L 113-121,240,43,96,.448,36,69,.522,7,27,.259,20,20,1.000,113
1741,2018-12-05,LAC,@,MEM,L 86-96,240,25,74,.338,17,51,.333,8,23,.348,28,35,.800,86
1742,2018-12-05,MEM,,LAC,W 96-86,240,37,85,.435,30,57,.526,7,28,.250,15,24,.625,96
1743,2018-12-05,DET,@,MIL,L 92-115,240,35,95,.368,26,57,.456,9,38,.237,13,19,.684,92
1744,2018-12-05,MIL,,DET,W 115-92,240,38,82,.463,24,41,.585,14,41,.341,25,30,.833,115
1745,2018-12-05,CHA,@,MIN,L 104-121,240,40,98,.408,28,65,.431,12,33,.364,12,15,.800,104
1746,2018-12-05,MIN,,CHO,W 121-104,240,48,89,.539,36,65,.554,12,24,.500,13,20,.650,121
1747,2018-12-05,DAL,@,NOP,L 106-132,240,39,91,.429,25,45,.556,14,46,.304,14,21,.667,106
1748,2018-12-05,NOP,,DAL,W 132-106,240,51,92,.554,34,63,.540,17,29,.586,13,20,.650,132
1749,2018-12-05,DEN,@,ORL,W 124-118 (OT),265,45,82,.549,34,63,.540,11,19,.579,23,37,.622,124
1750,2018-12-05,ORL,,DEN,L 118-124 (OT),265,45,95,.474,25,46,.543,20,49,.408,8,8,1.000,118
1751,2018-12-05,PHI,@,TOR,L 102-113,240,40,88,.455,29,53,.547,11,35,.314,11,14,.786,102
1752,2018-12-05,TOR,,PHI,W 113-102,240,43,100,.430,35,71,.493,8,29,.276,19,22,.864,113
1753,2018-12-04,DAL,,POR,W 111-102,240,38,88,.432,27,58,.466,11,30,.367,24,35,.686,111
1754,2018-12-04,POR,@,DAL,L 102-111,240,38,84,.452,31,60,.517,7,24,.292,19,23,.826,102
1755,2018-12-04,CHI,@,IND,L 90-96,240,37,94,.394,26,63,.413,11,31,.355,5,5,1.000,90
1756,2018-12-04,IND,,CHI,W 96-90,240,35,76,.461,29,54,.537,6,22,.273,20,24,.833,96
1757,2018-12-04,MIA,,ORL,L 90-105,240,38,91,.418,26,56,.464,12,35,.343,2,5,.400,90
1758,2018-12-04,ORL,@,MIA,W 105-90,240,38,86,.442,24,58,.414,14,28,.500,15,20,.750,105
1759,2018-12-04,PHO,,SAC,L 105-122,240,38,87,.437,26,44,.591,12,43,.279,17,21,.810,105
1760,2018-12-04,SAC,@,PHO,W 122-105,240,45,84,.536,34,60,.567,11,24,.458,21,32,.656,122
1761,2018-12-04,SAS,@,UTA,L 105-139,240,44,90,.489,37,68,.544,7,22,.318,10,11,.909,105
1762,2018-12-04,UTA,,SAS,W 139-105,240,51,84,.607,31,51,.608,20,33,.606,17,20,.850,139
1763,2018-12-03,ATL,,GSW,L 111-128,240,44,90,.489,39,64,.609,5,26,.192,18,24,.750,111
1764,2018-12-03,GSW,@,ATL,W 128-111,240,48,82,.585,35,58,.603,13,24,.542,19,22,.864,128
1765,2018-12-03,BRK,,CLE,L 97-99,240,39,99,.394,29,59,.492,10,40,.250,9,16,.563,97
1766,2018-12-03,CLE,@,BRK,W 99-97,240,38,88,.432,34,73,.466,4,15,.267,19,20,.950,99
1767,2018-12-03,DET,,OKC,L 83-110,240,31,94,.330,25,62,.403,6,32,.188,15,19,.789,83
1768,2018-12-03,OKC,@,DET,W 110-83,240,43,85,.506,36,60,.600,7,25,.280,17,20,.850,110
1769,2018-12-03,HOU,@,MIN,L 91-103,240,32,74,.432,21,35,.600,11,39,.282,16,19,.842,91
1770,2018-12-03,MIN,,HOU,W 103-91,240,36,82,.439,25,60,.417,11,22,.500,20,28,.714,103
1771,2018-12-03,LAC,@,NOP,W 129-126,240,49,83,.590,41,63,.651,8,20,.400,23,30,.767,129
1772,2018-12-03,NOP,,LAC,L 126-129,240,49,92,.533,36,58,.621,13,34,.382,15,22,.682,126
1773,2018-12-03,NYK,,WAS,L 107-110,240,37,90,.411,25,56,.446,12,34,.353,21,28,.750,107
1774,2018-12-03,WAS,@,NYK,W 110-107,240,44,92,.478,31,60,.517,13,32,.406,9,12,.750,110
1775,2018-12-03,DEN,@,TOR,W 106-103,240,40,89,.449,29,61,.475,11,28,.393,15,24,.625,106
1776,2018-12-03,TOR,,DEN,L 103-106,240,40,87,.460,29,46,.630,11,41,.268,12,12,1.000,103
1777,2018-12-02,CHA,,NOP,L 109-119,240,39,91,.429,29,55,.527,10,36,.278,21,28,.750,109
1778,2018-12-02,NOP,@,CHO,W 119-109,240,44,86,.512,33,54,.611,11,32,.344,20,24,.833,119
1779,2018-12-02,DAL,,LAC,W 114-110,240,42,95,.442,34,72,.472,8,23,.348,22,26,.846,114
1780,2018-12-02,LAC,@,DAL,L 110-114,240,42,95,.442,33,71,.465,9,24,.375,17,22,.773,110
1781,2018-12-02,LAL,,PHO,W 120-96,240,46,92,.500,35,65,.538,11,27,.407,17,23,.739,120
1782,2018-12-02,PHO,@,LAL,L 96-120,240,37,93,.398,24,60,.400,13,33,.394,9,11,.818,96
1783,2018-12-02,MIA,,UTA,W 102-100,240,36,91,.396,23,60,.383,13,31,.419,17,24,.708,102
1784,2018-12-02,UTA,@,MIA,L 100-102,240,39,89,.438,28,56,.500,11,33,.333,11,15,.733,100
1785,2018-12-02,MEM,@,PHI,L 95-103,240,33,79,.418,22,51,.431,11,28,.393,18,23,.783,95
1786,2018-12-02,PHI,,MEM,W 103-95,240,36,74,.486,28,52,.538,8,22,.364,23,30,.767,103
1787,2018-12-02,POR,@,SAS,L 118-131,240,45,86,.523,33,57,.579,12,29,.414,16,16,1.000,118
1788,2018-12-02,SAS,,POR,W 131-118,240,50,83,.602,39,68,.574,11,15,.733,20,22,.909,131
1789,2018-12-01,CLE,,TOR,L 95-106,240,34,88,.386,29,66,.439,5,22,.227,22,25,.880,95
1790,2018-12-01,TOR,@,CLE,W 106-95,240,39,80,.488,32,54,.593,7,26,.269,21,25,.840,106
1791,2018-12-01,DET,,GSW,W 111-102,240,43,98,.439,31,63,.492,12,35,.343,13,20,.650,111
1792,2018-12-01,GSW,@,DET,L 102-111,240,39,85,.459,33,59,.559,6,26,.231,18,21,.857,102
1793,2018-12-01,CHI,@,HOU,L 105-121,240,39,88,.443,31,56,.554,8,32,.250,19,24,.792,105
1794,2018-12-01,HOU,,CHI,W 121-105,240,42,84,.500,26,43,.605,16,41,.390,21,30,.700,121
1795,2018-12-01,BOS,@,MIN,W 118-109,240,40,85,.471,23,41,.561,17,44,.386,21,21,1.000,118
1796,2018-12-01,MIN,,BOS,L 109-118,240,37,82,.451,28,54,.519,9,28,.321,26,32,.813,109
1797,2018-12-01,MIL,@,NYK,L 134-136 (OT),265,46,94,.489,28,52,.538,18,42,.429,24,31,.774,134
1798,2018-12-01,NYK,,MIL,W 136-134 (OT),265,51,96,.531,31,62,.500,20,34,.588,14,21,.667,136
1799,2018-12-01,IND,@,SAC,L 110-111,240,43,82,.524,33,58,.569,10,24,.417,14,18,.778,110
1800,2018-12-01,SAC,,IND,W 111-110,240,41,91,.451,28,62,.452,13,29,.448,16,24,.667,111
1801,2018-12-01,BRK,@,WAS,L 88-102,240,30,81,.370,22,48,.458,8,33,.242,20,25,.800,88
1802,2018-12-01,WAS,,BRK,W 102-88,240,41,79,.519,33,53,.623,8,26,.308,12,18,.667,102
1803,2018-11-30,BOS,,CLE,W 128-95,240,49,92,.533,32,61,.525,17,31,.548,13,16,.813,128
1804,2018-11-30,CLE,@,BOS,L 95-128,240,30,77,.390,23,55,.418,7,22,.318,28,35,.800,95
1805,2018-11-30,BRK,,MEM,L 125-131 (2OT),290,42,94,.447,26,50,.520,16,44,.364,25,30,.833,125
1806,2018-11-30,MEM,@,BRK,W 131-125 (2OT),290,50,101,.495,38,71,.535,12,30,.400,19,22,.864,131
1807,2018-11-30,CHA,,UTA,L 111-119,240,47,95,.495,38,67,.567,9,28,.321,8,13,.615,111
1808,2018-11-30,UTA,@,CHO,W 119-111,240,44,81,.543,26,41,.634,18,40,.450,13,18,.722,119
1809,2018-11-30,CHI,@,DET,L 88-107,240,37,86,.430,34,65,.523,3,21,.143,11,14,.786,88
1810,2018-11-30,DET,,CHI,W 107-88,240,41,92,.446,28,58,.483,13,34,.382,12,16,.750,107
1811,2018-11-30,DAL,@,LAL,L 103-114,240,34,86,.395,24,47,.511,10,39,.256,25,34,.735,103
1812,2018-11-30,LAL,,DAL,W 114-103,240,42,86,.488,33,56,.589,9,30,.300,21,32,.656,114
1813,2018-11-30,MIA,,NOP,W 106-101,240,40,93,.430,29,60,.483,11,33,.333,15,24,.625,106
1814,2018-11-30,NOP,@,MIA,L 101-106,240,35,82,.427,29,54,.537,6,28,.214,25,29,.862,101
1815,2018-11-30,ATL,@,OKC,L 109-124,240,43,96,.448,32,60,.533,11,36,.306,12,20,.600,109
1816,2018-11-30,OKC,,ATL,W 124-109,240,46,88,.523,28,47,.596,18,41,.439,14,15,.933,124
1817,2018-11-30,PHI,,WAS,W 123-98,240,43,98,.439,31,60,.517,12,38,.316,25,33,.758,123
1818,2018-11-30,WAS,@,PHI,L 98-123,240,37,92,.402,29,64,.453,8,28,.286,16,19,.842,98
1819,2018-11-30,ORL,@,PHO,W 99-85,240,39,82,.476,31,55,.564,8,27,.296,13,18,.722,99
1820,2018-11-30,PHO,,ORL,L 85-99,240,34,84,.405,27,56,.482,7,28,.250,10,14,.714,85
1821,2018-11-30,DEN,@,POR,W 113-112,240,40,87,.460,26,57,.456,14,30,.467,19,26,.731,113
1822,2018-11-30,POR,,DEN,L 112-113,240,45,85,.529,39,63,.619,6,22,.273,16,21,.762,112
1823,2018-11-30,HOU,@,SAS,W 136-105,240,49,98,.500,27,44,.614,22,54,.407,16,20,.800,136
1824,2018-11-30,SAS,,HOU,L 105-136,240,39,86,.453,29,58,.500,10,28,.357,17,20,.850,105
1825,2018-11-29,IND,@,LAL,L 96-104,240,32,86,.372,22,63,.349,10,23,.435,22,27,.815,96
1826,2018-11-29,LAL,,IND,W 104-96,240,42,86,.488,35,62,.565,7,24,.292,13,23,.565,104
1827,2018-11-29,LAC,@,SAC,W 133-121,240,50,90,.556,38,62,.613,12,28,.429,21,28,.750,133
1828,2018-11-29,SAC,,LAC,L 121-133,240,46,96,.479,39,72,.542,7,24,.292,22,26,.846,121
1829,2018-11-29,GSW,@,TOR,L 128-131 (OT),265,50,103,.485,39,73,.534,11,30,.367,17,20,.850,128
1830,2018-11-29,TOR,,GSW,W 131-128 (OT),265,47,90,.522,32,52,.615,15,38,.395,22,24,.917,131
1831,2018-11-28,BRK,,UTA,L 91-101,240,30,86,.349,19,56,.339,11,30,.367,20,28,.714,91
1832,2018-11-28,UTA,@,BRK,W 101-91,240,39,82,.476,30,54,.556,9,28,.321,14,21,.667,101
1833,2018-11-28,ATL,@,CHO,L 94-108,240,32,93,.344,21,49,.429,11,44,.250,19,22,.864,94
1834,2018-11-28,CHA,,ATL,W 108-94,240,38,83,.458,34,63,.540,4,20,.200,28,37,.757,108
1835,2018-11-28,DAL,@,HOU,W 128-108,240,46,85,.541,29,51,.569,17,34,.500,19,24,.792,128
1836,2018-11-28,HOU,,DAL,L 108-128,240,40,87,.460,27,42,.643,13,45,.289,15,23,.652,108
1837,2018-11-28,LAC,,PHO,W 115-99,240,40,86,.465,29,65,.446,11,21,.524,24,32,.750,115
1838,2018-11-28,PHO,@,LAC,L 99-115,240,39,89,.438,31,63,.492,8,26,.308,13,18,.722,99
1839,2018-11-28,CHI,@,MIL,L 113-116,240,40,89,.449,29,52,.558,11,37,.297,22,29,.759,113
1840,2018-11-28,MIL,,CHI,W 116-113,240,43,87,.494,31,52,.596,12,35,.343,18,24,.750,116
1841,2018-11-28,MIN,,SAS,W 128-89,240,50,99,.505,32,58,.552,18,41,.439,10,15,.667,128
1842,2018-11-28,SAS,@,MIN,L 89-128,240,34,87,.391,26,60,.433,8,27,.296,13,13,1.000,89
1843,2018-11-28,NOP,,WAS,W 125-104,240,46,95,.484,35,59,.593,11,36,.306,22,28,.786,125
1844,2018-11-28,WAS,@,NOP,L 104-125,240,41,95,.432,28,56,.500,13,39,.333,9,16,.563,104
1845,2018-11-28,CLE,@,OKC,L 83-100,240,35,89,.393,26,66,.394,9,23,.391,4,9,.444,83
1846,2018-11-28,OKC,,CLE,W 100-83,240,41,86,.477,35,59,.593,6,27,.222,12,15,.800,100
1847,2018-11-28,NYK,@,PHI,L 91-117,240,32,92,.348,26,63,.413,6,29,.207,21,22,.955,91
1848,2018-11-28,PHI,,NYK,W 117-91,240,47,87,.540,35,62,.565,12,25,.480,11,16,.688,117
1849,2018-11-28,ORL,@,POR,L 112-115,240,42,81,.519,28,51,.549,14,30,.467,14,15,.933,112
1850,2018-11-28,POR,,ORL,W 115-112,240,37,85,.435,18,46,.391,19,39,.487,22,32,.688,115
1851,2018-11-27,DEN,,LAL,W 117-85,240,47,97,.485,38,72,.528,9,25,.360,14,15,.933,117
1852,2018-11-27,LAL,@,DEN,L 85-117,240,34,87,.391,29,52,.558,5,35,.143,12,18,.667,85
1853,2018-11-27,DET,,NYK,W 115-108,240,38,80,.475,31,56,.554,7,24,.292,32,45,.711,115
1854,2018-11-27,NYK,@,DET,L 108-115,240,36,91,.396,27,64,.422,9,27,.333,27,32,.844,108
1855,2018-11-27,MEM,,TOR,L 114-122,240,43,85,.506,33,56,.589,10,29,.345,18,21,.857,114
1856,2018-11-27,TOR,@,MEM,W 122-114,240,42,69,.609,24,36,.667,18,33,.545,20,28,.714,122
1857,2018-11-27,ATL,@,MIA,W 115-113,240,38,80,.475,26,49,.531,12,31,.387,27,32,.844,115
1858,2018-11-27,MIA,,ATL,L 113-115,240,40,87,.460,27,49,.551,13,38,.342,20,30,.667,113
1859,2018-11-27,IND,@,PHO,W 109-104,240,38,90,.422,27,64,.422,11,26,.423,22,29,.759,109
1860,2018-11-27,PHO,,IND,L 104-109,240,41,92,.446,31,62,.500,10,30,.333,12,18,.667,104
1861,2018-11-26,CHI,,SAS,L 107-108,240,42,90,.467,28,57,.491,14,33,.424,9,11,.818,107
1862,2018-11-26,SAS,@,CHI,W 108-107,240,45,93,.484,35,63,.556,10,30,.333,8,9,.889,108
1863,2018-11-26,CHA,,MIL,W 110-107,240,38,81,.469,25,52,.481,13,29,.448,21,30,.700,110
1864,2018-11-26,MIL,@,CHO,L 107-110,240,37,90,.411,21,44,.477,16,46,.348,17,21,.810,107
1865,2018-11-26,CLE,,MIN,L 95-102,240,36,86,.419,26,55,.473,10,31,.323,13,14,.929,95
1866,2018-11-26,MIN,@,CLE,W 102-95,240,40,86,.465,32,60,.533,8,26,.308,14,19,.737,102
1867,2018-11-26,GSW,,ORL,W 116-110,240,41,84,.488,28,49,.571,13,35,.371,21,23,.913,116
1868,2018-11-26,ORL,@,GSW,L 110-116,240,40,90,.444,26,60,.433,14,30,.467,16,21,.762,110
1869,2018-11-26,BOS,@,NOP,W 124-107,240,48,97,.495,29,58,.500,19,39,.487,9,10,.900,124
1870,2018-11-26,NOP,,BOS,L 107-124,240,34,77,.442,22,45,.489,12,32,.375,27,29,.931,107
1871,2018-11-26,IND,@,UTA,W 121-88,240,49,84,.583,40,66,.606,9,18,.500,14,17,.824,121
1872,2018-11-26,UTA,,IND,L 88-121,240,34,81,.420,26,50,.520,8,31,.258,12,17,.706,88
1873,2018-11-26,HOU,@,WAS,L 131-135 (OT),265,46,97,.474,28,49,.571,18,48,.375,21,27,.778,131
1874,2018-11-26,WAS,,HOU,W 135-131 (OT),265,50,89,.562,39,60,.650,11,29,.379,24,32,.750,135
1875,2018-11-25,ATL,,CHO,W 124-123,240,50,94,.532,34,55,.618,16,39,.410,8,11,.727,124
1876,2018-11-25,CHA,@,ATL,L 123-124,240,41,92,.446,23,47,.489,18,45,.400,23,28,.821,123
1877,2018-11-25,BRK,,PHI,L 125-127,240,50,88,.568,40,63,.635,10,25,.400,15,20,.750,125
1878,2018-11-25,PHI,@,BRK,W 127-125,240,44,91,.484,32,62,.516,12,29,.414,27,33,.818,127
1879,2018-11-25,DET,,PHO,W 118-107,240,43,93,.462,27,52,.519,16,41,.390,16,25,.640,118
1880,2018-11-25,PHO,@,DET,L 107-118,240,42,82,.512,34,57,.596,8,25,.320,15,21,.714,107
1881,2018-11-25,LAL,,ORL,L 104-108,240,37,79,.468,27,53,.509,10,26,.385,20,31,.645,104
1882,2018-11-25,ORL,@,LAL,W 108-104,240,42,93,.452,31,62,.500,11,31,.355,13,14,.929,108
1883,2018-11-25,MEM,,NYK,L 98-103,240,38,86,.442,27,56,.482,11,30,.367,11,19,.579,98
1884,2018-11-25,NYK,@,MEM,W 103-98,240,34,91,.374,26,69,.377,8,22,.364,27,32,.844,103
1885,2018-11-25,LAC,@,POR,W 104-100,240,38,90,.422,33,65,.508,5,25,.200,23,34,.676,104
1886,2018-11-25,POR,,LAC,L 100-104,240,42,97,.433,34,59,.576,8,38,.211,8,10,.800,100
1887,2018-11-25,SAC,,UTA,L 112-133,240,40,85,.471,31,62,.500,9,23,.391,23,31,.742,112
1888,2018-11-25,UTA,@,SAC,W 133-112,240,49,92,.533,39,62,.629,10,30,.333,25,33,.758,133
1889,2018-11-25,MIA,@,TOR,L 115-125,240,39,95,.411,24,59,.407,15,36,.417,22,32,.688,115
1890,2018-11-25,TOR,,MIA,W 125-115,240,47,90,.522,36,55,.655,11,35,.314,20,25,.800,125
1891,2018-11-24,CLE,,HOU,W 117-108,240,44,90,.489,37,68,.544,7,22,.318,22,29,.759,117
1892,2018-11-24,HOU,@,CLE,L 108-117,240,37,74,.500,22,35,.629,15,39,.385,19,28,.679,108
1893,2018-11-24,BOS,@,DAL,L 104-113,240,41,86,.477,31,58,.534,10,28,.357,12,13,.923,104
1894,2018-11-24,DAL,,BOS,W 113-104,240,42,87,.483,26,46,.565,16,41,.390,13,21,.619,113
1895,2018-11-24,GSW,,SAC,W 117-116,240,41,88,.466,31,54,.574,10,34,.294,25,29,.862,117
1896,2018-11-24,SAC,@,GSW,L 116-117,240,42,97,.433,31,69,.449,11,28,.393,21,29,.724,116
1897,2018-11-24,MIL,,SAS,W 135-129,240,49,86,.570,34,46,.739,15,40,.375,22,29,.759,135
1898,2018-11-24,SAS,@,MIL,L 129-135,240,49,92,.533,39,71,.549,10,21,.476,21,28,.750,129
1899,2018-11-24,CHI,@,MIN,L 96-111,240,32,81,.395,22,48,.458,10,33,.303,22,31,.710,96
1900,2018-11-24,MIN,,CHI,W 111-96,240,42,103,.408,35,69,.507,7,34,.206,20,23,.870,111
1901,2018-11-24,DEN,@,OKC,W 105-98,240,39,95,.411,29,65,.446,10,30,.333,17,24,.708,105
1902,2018-11-24,OKC,,DEN,L 98-105,240,37,103,.359,28,64,.438,9,39,.231,15,23,.652,98
1903,2018-11-24,NOP,@,WAS,L 114-124,240,43,90,.478,32,59,.542,11,31,.355,17,21,.810,114
1904,2018-11-24,WAS,,NOP,W 124-114,240,51,90,.567,41,61,.672,10,29,.345,12,23,.522,124
1905,2018-11-23,ATL,,BOS,L 96-114,240,35,81,.432,29,46,.630,6,35,.171,20,29,.690,96
1906,2018-11-23,BOS,@,ATL,W 114-96,240,42,91,.462,29,51,.569,13,40,.325,17,21,.810,114
1907,2018-11-23,BRK,,MIN,L 102-112,240,33,79,.418,19,34,.559,14,45,.311,22,26,.846,102
1908,2018-11-23,MIN,@,BRK,W 112-102,240,44,92,.478,35,67,.522,9,25,.360,15,17,.882,112
1909,2018-11-23,CHI,,MIA,L 96-103,240,35,94,.372,28,66,.424,7,28,.250,19,20,.950,96
1910,2018-11-23,MIA,@,CHI,W 103-96,240,37,87,.425,27,53,.509,10,34,.294,19,31,.613,103
1911,2018-11-23,DEN,,ORL,W 112-87,240,44,93,.473,35,65,.538,9,28,.321,15,17,.882,112
1912,2018-11-23,ORL,@,DEN,L 87-112,240,32,79,.405,24,47,.511,8,32,.250,15,19,.789,87
1913,2018-11-23,DET,,HOU,W 116-111 (OT),265,40,88,.455,33,61,.541,7,27,.259,29,40,.725,116
1914,2018-11-23,HOU,@,DET,L 111-116 (OT),265,41,98,.418,31,62,.500,10,36,.278,19,21,.905,111
1915,2018-11-23,GSW,,POR,W 125-97,240,48,85,.565,31,53,.585,17,32,.531,12,16,.750,125
1916,2018-11-23,POR,@,GSW,L 97-125,240,38,93,.409,29,69,.420,9,24,.375,12,22,.545,97
1917,2018-11-23,IND,,SAS,L 100-111,240,46,99,.465,43,75,.573,3,24,.125,5,9,.556,100
1918,2018-11-23,SAS,@,IND,W 111-100,240,42,83,.506,32,62,.516,10,21,.476,17,24,.708,111
1919,2018-11-23,LAC,,MEM,W 112-107 (OT),265,40,94,.426,32,71,.451,8,23,.348,24,27,.889,112
1920,2018-11-23,MEM,@,LAC,L 107-112 (OT),265,42,92,.457,33,65,.508,9,27,.333,14,18,.778,107
1921,2018-11-23,LAL,,UTA,W 90-83,240,36,79,.456,29,56,.518,7,23,.304,11,18,.611,90
1922,2018-11-23,UTA,@,LAL,L 83-90,240,33,85,.388,29,62,.468,4,23,.174,13,17,.765,83
1923,2018-11-23,MIL,,PHO,L 114-116,240,42,87,.483,32,43,.744,10,44,.227,20,30,.667,114
1924,2018-11-23,PHO,@,MIL,W 116-114,240,45,90,.500,36,64,.563,9,26,.346,17,22,.773,116
1925,2018-11-23,NOP,@,NYK,L 109-114,240,40,101,.396,33,73,.452,7,28,.250,22,29,.759,109
1926,2018-11-23,NYK,,NOP,W 114-109,240,41,91,.451,29,58,.500,12,33,.364,20,27,.741,114
1927,2018-11-23,CHA,@,OKC,L 104-109,240,43,94,.457,37,63,.587,6,31,.194,12,14,.857,104
1928,2018-11-23,OKC,,CHO,W 109-104,240,41,93,.441,30,60,.500,11,33,.333,16,24,.667,109
1929,2018-11-23,CLE,@,PHI,W 121-112,240,49,93,.527,38,71,.535,11,22,.500,12,16,.750,121
1930,2018-11-23,PHI,,CLE,L 112-121,240,40,75,.533,28,42,.667,12,33,.364,20,26,.769,112
1931,2018-11-23,TOR,,WAS,W 125-107,240,46,93,.495,29,54,.537,17,39,.436,16,19,.842,125
1932,2018-11-23,WAS,@,TOR,L 107-125,240,40,100,.400,31,54,.574,9,46,.196,18,19,.947,107
1933,2018-11-21,ATL,,TOR,L 108-124,240,42,93,.452,32,57,.561,10,36,.278,14,18,.778,108
1934,2018-11-21,TOR,@,ATL,W 124-108,240,48,90,.533,37,61,.607,11,29,.379,17,23,.739,124
1935,2018-11-21,BOS,,NYK,L 109-117,240,38,97,.392,28,64,.438,10,33,.303,23,32,.719,109
1936,2018-11-21,NYK,@,BOS,W 117-109,240,44,89,.494,29,59,.492,15,30,.500,14,17,.824,117
1937,2018-11-21,CHI,,PHO,W 124-116,240,46,81,.568,35,56,.625,11,25,.440,21,24,.875,124
1938,2018-11-21,PHO,@,CHI,L 116-124,240,48,98,.490,38,64,.594,10,34,.294,10,10,1.000,116
1939,2018-11-21,CHA,,IND,W 127-109,240,45,80,.563,27,51,.529,18,29,.621,19,22,.864,127
1940,2018-11-21,IND,@,CHO,L 109-127,240,41,84,.488,30,51,.588,11,33,.333,16,17,.941,109
1941,2018-11-21,CLE,,LAL,L 105-109,240,39,102,.382,26,68,.382,13,34,.382,14,15,.933,105
1942,2018-11-21,LAL,@,CLE,W 109-105,240,40,78,.513,31,53,.585,9,25,.360,20,28,.714,109
1943,2018-11-21,BRK,@,DAL,L 113-119,240,42,94,.447,28,52,.538,14,42,.333,15,21,.714,113
1944,2018-11-21,DAL,,BRK,W 119-113,240,38,78,.487,27,51,.529,11,27,.407,32,41,.780,119
1945,2018-11-21,GSW,,OKC,L 95-123,240,36,83,.434,29,54,.537,7,29,.241,16,24,.667,95
1946,2018-11-21,OKC,@,GSW,W 123-95,240,51,106,.481,38,71,.535,13,35,.371,8,15,.533,123
1947,2018-11-21,DET,@,HOU,L 124-126,240,40,85,.471,24,51,.471,16,34,.471,28,37,.757,124
1948,2018-11-21,HOU,,DET,W 126-124,240,40,72,.556,27,39,.692,13,33,.394,33,36,.917,126
1949,2018-11-21,MIL,,POR,W 143-100,240,57,108,.528,42,63,.667,15,45,.333,14,17,.824,143
1950,2018-11-21,POR,@,MIL,L 100-143,240,34,93,.366,25,52,.481,9,41,.220,23,28,.821,100
1951,2018-11-21,DEN,@,MIN,W 103-101,240,42,89,.472,28,54,.519,14,35,.400,5,6,.833,103
1952,2018-11-21,MIN,,DEN,L 101-103,240,35,79,.443,26,47,.553,9,32,.281,22,26,.846,101
1953,2018-11-21,NOP,@,PHI,L 120-121,240,42,98,.429,31,68,.456,11,30,.367,25,33,.758,120
1954,2018-11-21,PHI,,NOP,W 121-120,240,44,98,.449,34,69,.493,10,29,.345,23,26,.885,121
1955,2018-11-21,MEM,@,SAS,W 104-103,240,39,81,.481,31,56,.554,8,25,.320,18,21,.857,104
1956,2018-11-21,SAS,,MEM,L 103-104,240,35,82,.427,28,60,.467,7,22,.318,26,30,.867,103
1957,2018-11-21,SAC,@,UTA,W 119-110,240,47,89,.528,36,64,.563,11,25,.440,14,19,.737,119
1958,2018-11-21,UTA,,SAC,L 110-119,240,38,88,.432,26,49,.531,12,39,.308,22,31,.710,110
1959,2018-11-20,BRK,@,MIA,W 104-92,240,38,88,.432,30,57,.526,8,31,.258,20,26,.769,104
1960,2018-11-20,MIA,,BRK,L 92-104,240,36,100,.360,29,68,.426,7,32,.219,13,20,.650,92
1961,2018-11-20,NYK,,POR,L 114-118,240,42,83,.506,29,54,.537,13,29,.448,17,22,.773,114
1962,2018-11-20,POR,@,NYK,W 118-114,240,45,95,.474,29,60,.483,16,35,.457,12,17,.706,118
1963,2018-11-20,ORL,,TOR,L 91-93,240,34,84,.405,26,54,.481,8,30,.267,15,19,.789,91
1964,2018-11-20,TOR,@,ORL,W 93-91,240,39,87,.448,30,53,.566,9,34,.265,6,8,.750,93
1965,2018-11-20,LAC,@,WAS,L 118-125,240,46,89,.517,35,62,.565,11,27,.407,15,18,.833,118
1966,2018-11-20,WAS,,LAC,W 125-118,240,40,93,.430,27,54,.500,13,39,.333,32,39,.821,125
1967,2018-11-19,ATL,,LAC,L 119-127,240,45,101,.446,33,63,.524,12,38,.316,17,19,.895,119
1968,2018-11-19,LAC,@,ATL,W 127-119,240,40,93,.430,30,60,.500,10,33,.303,37,47,.787,127
1969,2018-11-19,BOS,@,CHO,L 112-117,240,45,89,.506,36,57,.632,9,32,.281,13,18,.722,112
1970,2018-11-19,CHA,,BOS,W 117-112,240,43,89,.483,28,48,.583,15,41,.366,16,22,.727,117
1971,2018-11-19,CLE,@,DET,L 102-113,240,35,79,.443,27,58,.466,8,21,.381,24,34,.706,102
1972,2018-11-19,DET,,CLE,W 113-102,240,41,89,.461,28,51,.549,13,38,.342,18,19,.947,113
1973,2018-11-19,IND,,UTA,W 121-94,240,49,93,.527,37,68,.544,12,25,.480,11,17,.647,121
1974,2018-11-19,UTA,@,IND,L 94-121,240,36,74,.486,25,49,.510,11,25,.440,11,16,.688,94
1975,2018-11-19,DAL,@,MEM,L 88-98,240,30,88,.341,20,56,.357,10,32,.313,18,21,.857,88
1976,2018-11-19,MEM,,DAL,W 98-88,240,37,79,.468,25,49,.510,12,30,.400,12,14,.857,98
1977,2018-11-19,DEN,@,MIL,L 98-104,240,40,94,.426,28,53,.528,12,41,.293,6,9,.667,98
1978,2018-11-19,MIL,,DEN,W 104-98,240,40,88,.455,29,52,.558,11,36,.306,13,22,.591,104
1979,2018-11-19,NOP,,SAS,W 140-126,240,59,102,.578,49,76,.645,10,26,.385,12,14,.857,140
1980,2018-11-19,SAS,@,NOP,L 126-140,240,45,94,.479,33,70,.471,12,24,.500,24,30,.800,126
1981,2018-11-19,PHI,,PHO,W 119-114,240,41,84,.488,35,62,.565,6,22,.273,31,42,.738,119
1982,2018-11-19,PHO,@,PHI,L 114-119,240,44,87,.506,31,54,.574,13,33,.394,13,24,.542,114
1983,2018-11-19,OKC,@,SAC,L 113-117,240,45,108,.417,33,67,.493,12,41,.293,11,16,.688,113
1984,2018-11-19,SAC,,OKC,W 117-113,240,45,102,.441,29,64,.453,16,38,.421,11,17,.647,117
1985,2018-11-18,LAL,@,MIA,W 113-97,240,42,95,.442,31,68,.456,11,27,.407,18,21,.857,113
1986,2018-11-18,MIA,,LAL,L 97-113,240,35,87,.402,22,55,.400,13,32,.406,14,19,.737,97
1987,2018-11-18,MEM,@,MIN,W 100-87,240,35,82,.427,23,54,.426,12,28,.429,18,25,.720,100
1988,2018-11-18,MIN,,MEM,L 87-100,240,31,80,.388,19,51,.373,12,29,.414,13,16,.813,87
1989,2018-11-18,NYK,@,ORL,L 117-131,240,40,87,.460,32,63,.508,8,24,.333,29,35,.829,117
1990,2018-11-18,ORL,,NYK,W 131-117,240,48,84,.571,35,52,.673,13,32,.406,22,26,.846,131
1991,2018-11-18,GSW,@,SAS,L 92-104,240,35,86,.407,30,60,.500,5,26,.192,17,21,.810,92
1992,2018-11-18,SAS,,GSW,W 104-92,240,41,92,.446,31,68,.456,10,24,.417,12,17,.706,104
1993,2018-11-18,POR,@,WAS,W 119-109,240,39,86,.453,28,56,.500,11,30,.367,30,35,.857,119
1994,2018-11-18,WAS,,POR,L 109-119,240,43,96,.448,30,64,.469,13,32,.406,10,21,.476,109
1995,2018-11-17,BOS,,UTA,L 86-98,240,35,91,.385,30,58,.517,5,33,.152,11,20,.550,86
1996,2018-11-17,UTA,@,BOS,W 98-86,240,35,78,.449,24,40,.600,11,38,.289,17,27,.630,98
1997,2018-11-17,BRK,,LAC,L 119-127,240,40,88,.455,27,60,.450,13,28,.464,26,34,.765,119
1998,2018-11-17,LAC,@,BRK,W 127-119,240,48,95,.505,37,72,.514,11,23,.478,20,24,.833,127
1999,2018-11-17,CHI,,TOR,L 83-122,240,30,86,.349,22,59,.373,8,27,.296,15,21,.714,83
2000,2018-11-17,TOR,@,CHI,W 122-83,240,48,89,.539,34,54,.630,14,35,.400,12,13,.923,122
2001,2018-11-17,CHA,,PHI,L 119-122 (OT),265,42,99,.424,32,68,.471,10,31,.323,25,27,.926,119
2002,2018-11-17,PHI,@,CHO,W 122-119 (OT),265,39,93,.419,28,58,.483,11,35,.314,33,38,.868,122
2003,2018-11-17,DAL,,GSW,W 112-109,240,40,86,.465,30,52,.577,10,34,.294,22,34,.647,112
2004,2018-11-17,GSW,@,DAL,L 109-112,240,42,94,.447,33,61,.541,9,33,.273,16,17,.941,109
2005,2018-11-17,HOU,,SAC,W 132-112,240,46,81,.568,26,34,.765,20,47,.426,20,24,.833,132
2006,2018-11-17,SAC,@,HOU,L 112-132,240,46,102,.451,35,67,.522,11,35,.314,9,12,.750,112
2007,2018-11-17,ATL,@,IND,L 89-97,240,31,87,.356,23,58,.397,8,29,.276,19,27,.704,89
2008,2018-11-17,IND,,ATL,W 97-89,240,35,87,.402,23,57,.404,12,30,.400,15,21,.714,97
2009,2018-11-17,DEN,@,NOP,L 115-125,240,46,95,.484,31,56,.554,15,39,.385,8,13,.615,115
2010,2018-11-17,NOP,,DEN,W 125-115,240,42,87,.483,32,62,.516,10,25,.400,31,34,.912,125
2011,2018-11-17,LAL,@,ORL,L 117-130,240,43,90,.478,33,60,.550,10,30,.333,21,25,.840,117
2012,2018-11-17,ORL,,LAL,W 130-117,240,50,93,.538,39,61,.639,11,32,.344,19,23,.826,130
2013,2018-11-17,OKC,@,PHO,W 110-100,240,38,85,.447,31,61,.508,7,24,.292,27,32,.844,110
2014,2018-11-17,PHO,,OKC,L 100-110,240,37,82,.451,25,53,.472,12,29,.414,14,21,.667,100
2015,2018-11-16,BOS,,TOR,W 123-116 (OT),265,47,89,.528,38,63,.603,9,26,.346,20,24,.833,123
2016,2018-11-16,TOR,@,BOS,L 116-123 (OT),265,42,97,.433,34,68,.500,8,29,.276,24,29,.828,116
2017,2018-11-16,IND,,MIA,W 99-91,240,36,81,.444,22,54,.407,14,27,.519,13,15,.867,99
2018,2018-11-16,MIA,@,IND,L 91-99,240,35,93,.376,21,57,.368,14,36,.389,7,10,.700,91
2019,2018-11-16,MEM,,SAC,W 112-104,240,43,85,.506,32,60,.533,11,25,.440,15,24,.625,112
2020,2018-11-16,SAC,@,MEM,L 104-112,240,37,80,.463,25,47,.532,12,33,.364,18,24,.750,104
2021,2018-11-16,CHI,@,MIL,L 104-123,240,41,94,.436,28,61,.459,13,33,.394,9,13,.692,104
2022,2018-11-16,MIL,,CHI,W 123-104,240,47,93,.505,29,50,.580,18,43,.419,11,17,.647,123
2023,2018-11-16,MIN,,POR,W 112-96,240,46,92,.500,34,64,.531,12,28,.429,8,11,.727,112
2024,2018-11-16,POR,@,MIN,L 96-112,240,37,88,.420,29,59,.492,8,29,.276,14,20,.700,96
2025,2018-11-16,NOP,,NYK,W 129-124,240,48,99,.485,38,65,.585,10,34,.294,23,32,.719,129
2026,2018-11-16,NYK,@,NOP,L 124-129,240,48,98,.490,37,64,.578,11,34,.324,17,24,.708,124
2027,2018-11-16,PHI,,UTA,W 113-107,240,41,81,.506,30,58,.517,11,23,.478,20,32,.625,113
2028,2018-11-16,UTA,@,PHI,L 107-113,240,41,88,.466,37,66,.561,4,22,.182,21,37,.568,107
2029,2018-11-16,BRK,@,WAS,W 115-104,240,38,90,.422,29,57,.509,9,33,.273,30,38,.789,115
2030,2018-11-16,WAS,,BRK,L 104-115,240,37,87,.425,34,69,.493,3,18,.167,27,34,.794,104
2031,2018-11-15,ATL,@,DEN,L 93-138,240,32,92,.348,23,50,.460,9,42,.214,20,27,.741,93
2032,2018-11-15,DEN,,ATL,W 138-93,240,53,94,.564,40,63,.635,13,31,.419,19,25,.760,138
2033,2018-11-15,GSW,@,HOU,L 86-107,240,32,76,.421,28,58,.483,4,18,.222,18,22,.818,86
2034,2018-11-15,HOU,,GSW,W 107-86,240,35,87,.402,19,40,.475,16,47,.340,21,26,.808,107
2035,2018-11-15,LAC,,SAS,W 116-111,240,40,85,.471,32,62,.516,8,23,.348,28,35,.800,116
2036,2018-11-15,SAS,@,LAC,L 111-116,240,41,102,.402,32,73,.438,9,29,.310,20,25,.800,111
2037,2018-11-14,BOS,,CHI,W 111-82,240,42,90,.467,27,56,.482,15,34,.441,12,14,.857,111
2038,2018-11-14,CHI,@,BOS,L 82-111,240,33,84,.393,26,61,.426,7,23,.304,9,9,1.000,82
2039,2018-11-14,BRK,,MIA,L 107-120,240,41,101,.406,33,73,.452,8,28,.286,17,24,.708,107
2040,2018-11-14,MIA,@,BRK,W 120-107,240,46,85,.541,38,56,.679,8,29,.276,20,28,.714,120
2041,2018-11-14,DAL,,UTA,W 118-68,240,45,77,.584,33,49,.673,12,28,.429,16,24,.667,118
2042,2018-11-14,UTA,@,DAL,L 68-118,240,25,81,.309,19,46,.413,6,35,.171,12,19,.632,68
2043,2018-11-14,LAL,,POR,W 126-117,240,44,93,.473,29,61,.475,15,32,.469,23,26,.885,126
2044,2018-11-14,POR,@,LAL,L 117-126,240,41,93,.441,27,60,.450,14,33,.424,21,23,.913,117
2045,2018-11-14,MEM,@,MIL,W 116-113,240,42,83,.506,28,47,.596,14,36,.389,18,24,.750,116
2046,2018-11-14,MIL,,MEM,L 113-116,240,41,81,.506,32,46,.696,9,35,.257,22,27,.815,113
2047,2018-11-14,MIN,,NOP,W 107-100,240,37,90,.411,23,58,.397,14,32,.438,19,24,.792,107
2048,2018-11-14,NOP,@,MIN,L 100-107,240,40,94,.426,31,66,.470,9,28,.321,11,18,.611,100
2049,2018-11-14,NYK,@,OKC,L 103-128,240,39,88,.443,32,62,.516,7,26,.269,18,23,.783,103
2050,2018-11-14,OKC,,NYK,W 128-103,240,51,95,.537,35,62,.565,16,33,.485,10,12,.833,128
2051,2018-11-14,ORL,,PHI,W 111-106,240,40,80,.500,28,52,.538,12,28,.429,19,22,.864,111
2052,2018-11-14,PHI,@,ORL,L 106-111,240,41,86,.477,27,57,.474,14,29,.483,10,15,.667,106
2053,2018-11-14,PHO,,SAS,W 116-96,240,47,84,.560,32,53,.604,15,31,.484,7,8,.875,116
2054,2018-11-14,SAS,@,PHO,L 96-116,240,35,83,.422,28,60,.467,7,23,.304,19,24,.792,96
2055,2018-11-14,DET,@,TOR,W 106-104,240,44,91,.484,34,58,.586,10,33,.303,8,13,.615,106
2056,2018-11-14,TOR,,DET,L 104-106,240,45,92,.489,41,72,.569,4,20,.200,10,17,.588,104
2057,2018-11-14,CLE,@,WAS,L 95-119,240,35,77,.455,31,56,.554,4,21,.190,21,31,.677,95
2058,2018-11-14,WAS,,CLE,W 119-95,240,44,92,.478,31,52,.596,13,40,.325,18,26,.692,119
2059,2018-11-13,CHA,@,CLE,L 89-113,240,33,95,.347,25,54,.463,8,41,.195,15,19,.789,89
2060,2018-11-13,CLE,,CHO,W 113-89,240,45,85,.529,32,61,.525,13,24,.542,10,12,.833,113
2061,2018-11-13,DEN,,HOU,L 99-109,240,38,76,.500,27,51,.529,11,25,.440,12,16,.750,99
2062,2018-11-13,HOU,@,DEN,W 109-99,240,39,71,.549,26,34,.765,13,37,.351,18,26,.692,109
2063,2018-11-13,ATL,@,GSW,L 103-110,240,40,89,.449,28,57,.491,12,32,.375,11,15,.733,103
2064,2018-11-13,GSW,,ATL,W 110-103,240,39,91,.429,27,64,.422,12,27,.444,20,21,.952,110
2065,2018-11-12,CHI,,DAL,L 98-103,240,35,89,.393,27,56,.482,8,33,.242,20,22,.909,98
2066,2018-11-12,DAL,@,CHI,W 103-98,240,37,79,.468,27,46,.587,10,33,.303,19,29,.655,103
2067,2018-11-12,GSW,@,LAC,L 116-121 (OT),265,44,94,.468,32,63,.508,12,31,.387,16,23,.696,116
2068,2018-11-12,LAC,,GSW,W 121-116 (OT),265,43,91,.473,38,71,.535,5,20,.250,30,34,.882,121
2069,2018-11-12,MEM,,UTA,L 88-96,240,33,79,.418,29,55,.527,4,24,.167,18,23,.783,88
2070,2018-11-12,UTA,@,MEM,W 96-88,240,32,82,.390,23,50,.460,9,32,.281,23,30,.767,96
2071,2018-11-12,MIA,,PHI,L 114-124,240,37,77,.481,24,46,.522,13,31,.419,27,33,.818,114
2072,2018-11-12,PHI,@,MIA,W 124-114,240,39,83,.470,24,47,.511,15,36,.417,31,39,.795,124
2073,2018-11-12,BRK,@,MIN,L 113-120,240,40,101,.396,22,51,.431,18,50,.360,15,22,.682,113
2074,2018-11-12,MIN,,BRK,W 120-113,240,42,80,.525,32,57,.561,10,23,.435,26,31,.839,120
2075,2018-11-12,OKC,,PHO,W 118-101,240,43,92,.467,30,65,.462,13,27,.481,19,20,.950,118
2076,2018-11-12,PHO,@,OKC,L 101-118,240,39,81,.481,32,55,.582,7,26,.269,16,19,.842,101
2077,2018-11-12,SAC,,SAS,W 104-99,240,43,86,.500,32,62,.516,11,24,.458,7,12,.583,104
2078,2018-11-12,SAS,@,SAC,L 99-104,240,38,87,.437,28,56,.500,10,31,.323,13,16,.813,99
2079,2018-11-12,NOP,@,TOR,W 126-110,240,54,99,.545,44,72,.611,10,27,.370,8,13,.615,126
2080,2018-11-12,TOR,,NOP,L 110-126,240,39,97,.402,26,52,.500,13,45,.289,19,22,.864,110
2081,2018-11-12,ORL,@,WAS,L 109-117,240,43,89,.483,28,59,.475,15,30,.500,8,11,.727,109
2082,2018-11-12,WAS,,ORL,W 117-109,240,40,79,.506,27,46,.587,13,33,.394,24,33,.727,117
2083,2018-11-11,DEN,,MIL,L 114-121,240,41,89,.461,23,51,.451,18,38,.474,14,20,.700,114
2084,2018-11-11,MIL,@,DEN,W 121-114,240,48,84,.571,31,50,.620,17,34,.500,8,13,.615,121
2085,2018-11-11,CHA,@,DET,W 113-103,240,43,85,.506,32,57,.561,11,28,.393,16,18,.889,113
2086,2018-11-11,DET,,CHO,L 103-113,240,38,104,.365,26,60,.433,12,44,.273,15,19,.789,103
2087,2018-11-11,HOU,,IND,W 115-103,240,36,74,.486,16,27,.593,20,47,.426,23,32,.719,115
2088,2018-11-11,IND,@,HOU,L 103-115,240,36,78,.462,25,49,.510,11,29,.379,20,26,.769,103
2089,2018-11-11,ATL,@,LAL,L 106-107,240,41,95,.432,28,58,.483,13,37,.351,11,13,.846,106
2090,2018-11-11,LAL,,ATL,W 107-106,240,39,92,.424,25,54,.463,14,38,.368,15,24,.625,107
2091,2018-11-11,NYK,,ORL,L 89-115,240,31,88,.352,26,60,.433,5,28,.179,22,30,.733,89
2092,2018-11-11,ORL,@,NYK,W 115-89,240,44,98,.449,27,56,.482,17,42,.405,10,11,.909,115
2093,2018-11-11,BOS,@,POR,L 94-100,240,36,93,.387,22,51,.431,14,42,.333,8,10,.800,94
2094,2018-11-11,POR,,BOS,W 100-94,240,39,86,.453,25,50,.500,14,36,.389,8,10,.800,100
2095,2018-11-10,CHI,,CLE,W 99-98,240,39,82,.476,32,64,.500,7,18,.389,14,21,.667,99
2096,2018-11-10,CLE,@,CHI,L 98-99,240,39,91,.429,31,70,.443,8,21,.381,12,18,.667,98
2097,2018-11-10,DAL,,OKC,W 111-96,240,43,77,.558,29,48,.604,14,29,.483,11,17,.647,111
2098,2018-11-10,OKC,@,DAL,L 96-111,240,38,97,.392,29,63,.460,9,34,.265,11,18,.611,96
2099,2018-11-10,BRK,@,GSW,L 100-116,240,36,77,.468,29,53,.547,7,24,.292,21,29,.724,100
2100,2018-11-10,GSW,,BRK,W 116-100,240,46,83,.554,39,67,.582,7,16,.438,17,21,.810,116
2101,2018-11-10,LAC,,MIL,W 128-126 (OT),265,46,99,.465,32,65,.492,14,34,.412,22,27,.815,128
2102,2018-11-10,MIL,@,LAC,L 126-128 (OT),265,47,105,.448,31,59,.525,16,46,.348,16,23,.696,126
2103,2018-11-10,MEM,,PHI,W 112-106 (OT),265,45,103,.437,34,73,.466,11,30,.367,11,15,.733,112
2104,2018-11-10,PHI,@,MEM,L 106-112 (OT),265,44,85,.518,36,54,.667,8,31,.258,10,16,.625,106
2105,2018-11-10,MIA,,WAS,L 110-116,240,39,88,.443,27,55,.491,12,33,.364,20,26,.769,110
2106,2018-11-10,WAS,@,MIA,W 116-110,240,40,83,.482,32,61,.525,8,22,.364,28,38,.737,116
2107,2018-11-10,NOP,,PHO,W 119-99,240,42,86,.488,31,61,.508,11,25,.440,24,29,.828,119
2108,2018-11-10,PHO,@,NOP,L 99-119,240,35,86,.407,25,50,.500,10,36,.278,19,20,.950,99
2109,2018-11-10,LAL,@,SAC,W 101-86,240,41,99,.414,29,61,.475,12,38,.316,7,17,.412,101
2110,2018-11-10,SAC,,LAL,L 86-101,240,32,92,.348,26,67,.388,6,25,.240,16,20,.800,86
2111,2018-11-10,HOU,@,SAS,L 89-96,240,30,90,.333,21,49,.429,9,41,.220,20,29,.690,89
2112,2018-11-10,SAS,,HOU,W 96-89,240,33,74,.446,23,54,.426,10,20,.500,20,27,.741,96
2113,2018-11-10,NYK,@,TOR,L 112-128,240,44,96,.458,38,74,.514,6,22,.273,18,22,.818,112
2114,2018-11-10,TOR,,NYK,W 128-112,240,42,79,.532,28,44,.636,14,35,.400,30,40,.750,128
2115,2018-11-09,ATL,,DET,L 109-124,240,36,79,.456,29,51,.569,7,28,.250,30,40,.750,109
2116,2018-11-09,DET,@,ATL,W 124-109,240,46,97,.474,26,50,.520,20,47,.426,12,19,.632,124
2117,2018-11-09,BRK,@,DEN,W 112-110,240,36,88,.409,24,55,.436,12,33,.364,28,42,.667,112
2118,2018-11-09,DEN,,BRK,L 110-112,240,40,87,.460,35,69,.507,5,18,.278,25,34,.735,110
2119,2018-11-09,IND,@,MIA,W 110-102,240,43,79,.544,36,59,.610,7,20,.350,17,29,.586,110
2120,2018-11-09,MIA,,IND,L 102-110,240,36,80,.450,22,53,.415,14,27,.519,16,27,.593,102
2121,2018-11-09,ORL,,WAS,W 117-108,240,44,86,.512,31,55,.564,13,31,.419,16,19,.842,117
2122,2018-11-09,WAS,@,ORL,L 108-117,240,42,82,.512,31,55,.564,11,27,.407,13,19,.684,108
2123,2018-11-09,CHA,@,PHI,L 132-133 (OT),265,43,110,.391,27,70,.386,16,40,.400,30,40,.750,132
2124,2018-11-09,PHI,,CHO,W 133-132 (OT),265,45,94,.479,33,57,.579,12,37,.324,31,41,.756,133
2125,2018-11-09,MIN,@,SAC,L 110-121,240,39,94,.415,32,69,.464,7,25,.280,25,31,.806,110
2126,2018-11-09,SAC,,MIN,W 121-110,240,43,95,.453,31,63,.492,12,32,.375,23,29,.793,121
2127,2018-11-09,BOS,@,UTA,L 115-123,240,39,88,.443,22,45,.489,17,43,.395,20,22,.909,115
2128,2018-11-09,UTA,,BOS,W 123-115,240,43,77,.558,30,43,.698,13,34,.382,24,30,.800,123
2129,2018-11-08,GSW,,MIL,L 111-134,240,42,87,.483,32,59,.542,10,28,.357,17,22,.773,111
2130,2018-11-08,MIL,@,GSW,W 134-111,240,52,101,.515,43,66,.652,9,35,.257,21,27,.778,134
2131,2018-11-08,HOU,@,OKC,L 80-98,240,31,82,.378,20,40,.500,11,42,.262,7,10,.700,80
2132,2018-11-08,OKC,,HOU,W 98-80,240,36,81,.444,27,44,.614,9,37,.243,17,24,.708,98
2133,2018-11-08,BOS,@,PHO,W 116-109 (OT),265,39,97,.402,25,60,.417,14,37,.378,24,31,.774,116
2134,2018-11-08,PHO,,BOS,L 109-116 (OT),265,41,93,.441,30,58,.517,11,35,.314,16,19,.842,109
2135,2018-11-08,LAC,@,POR,L 105-116,240,41,89,.461,33,66,.500,8,23,.348,15,20,.750,105
2136,2018-11-08,POR,,LAC,W 116-105,240,40,97,.412,30,71,.423,10,26,.385,26,28,.929,116
2137,2018-11-07,ATL,,NYK,L 107-112,240,37,92,.402,26,54,.481,11,38,.289,22,29,.759,107
2138,2018-11-07,NYK,@,ATL,W 112-107,240,34,77,.442,23,47,.489,11,30,.367,33,47,.702,112
2139,2018-11-07,CLE,,OKC,L 86-95,240,33,89,.371,24,58,.414,9,31,.290,11,13,.846,86
2140,2018-11-07,OKC,@,CLE,W 95-86,240,35,84,.417,28,57,.491,7,27,.259,18,26,.692,95
2141,2018-11-07,IND,,PHI,L 94-100,240,37,94,.394,29,63,.460,8,31,.258,12,17,.706,94
2142,2018-11-07,PHI,@,IND,W 100-94,240,36,79,.456,26,47,.553,10,32,.313,18,22,.818,100
2143,2018-11-07,LAL,,MIN,W 114-110,240,44,91,.484,29,57,.509,15,34,.441,11,14,.786,114
2144,2018-11-07,MIN,@,LAL,L 110-114,240,41,91,.451,21,51,.412,20,40,.500,8,9,.889,110
2145,2018-11-07,DEN,@,MEM,L 87-89,240,32,82,.390,24,50,.480,8,32,.250,15,19,.789,87
2146,2018-11-07,MEM,,DEN,W 89-87,240,30,70,.429,22,49,.449,8,21,.381,21,25,.840,89
2147,2018-11-07,MIA,,SAS,W 95-88,240,36,93,.387,26,61,.426,10,32,.313,13,18,.722,95
2148,2018-11-07,SAS,@,MIA,L 88-95,240,31,94,.330,18,62,.290,13,32,.406,13,14,.929,88
2149,2018-11-07,CHI,@,NOP,L 98-107,240,38,96,.396,29,65,.446,9,31,.290,13,17,.765,98
2150,2018-11-07,NOP,,CHI,W 107-98,240,42,94,.447,31,64,.484,11,30,.367,12,17,.706,107
2151,2018-11-07,DET,@,ORL,W 103-96,240,37,90,.411,26,53,.491,11,37,.297,18,20,.900,103
2152,2018-11-07,ORL,,DET,L 96-103,240,40,87,.460,31,60,.517,9,27,.333,7,9,.778,96
2153,2018-11-07,SAC,,TOR,L 105-114,240,42,88,.477,34,65,.523,8,23,.348,13,18,.722,105
2154,2018-11-07,TOR,@,SAC,W 114-105,240,41,89,.461,30,53,.566,11,36,.306,21,23,.913,114
2155,2018-11-07,DAL,@,UTA,L 102-117,240,29,73,.397,21,49,.429,8,24,.333,36,40,.900,102
2156,2018-11-07,UTA,,DAL,W 117-102,240,43,89,.483,30,52,.577,13,37,.351,18,26,.692,117
2157,2018-11-06,ATL,@,CHO,L 102-113,240,41,85,.482,35,55,.636,6,30,.200,14,18,.778,102
2158,2018-11-06,CHA,,ATL,W 113-102,240,45,92,.489,32,61,.525,13,31,.419,10,18,.556,113
2159,2018-11-06,DAL,,WAS,W 119-100,240,39,82,.476,24,48,.500,15,34,.441,26,27,.963,119
2160,2018-11-06,WAS,@,DAL,L 100-119,240,37,87,.425,26,52,.500,11,35,.314,15,20,.750,100
2161,2018-11-06,BRK,@,PHO,W 104-82,240,41,92,.446,32,56,.571,9,36,.250,13,19,.684,104
2162,2018-11-06,PHO,,BRK,L 82-104,240,28,81,.346,19,56,.339,9,25,.360,17,20,.850,82
2163,2018-11-06,MIL,@,POR,L 103-118,240,40,92,.435,24,50,.480,16,42,.381,7,8,.875,103
2164,2018-11-06,POR,,MIL,W 118-103,240,48,91,.527,31,48,.646,17,43,.395,5,8,.625,118
2165,2018-11-05,BOS,@,DEN,L 107-115,240,44,87,.506,35,56,.625,9,31,.290,10,12,.833,107
2166,2018-11-05,DEN,,BOS,W 115-107,240,41,90,.456,28,56,.500,13,34,.382,20,28,.714,115
2167,2018-11-05,DET,,MIA,L 115-120 (OT),265,43,105,.410,32,70,.457,11,35,.314,18,28,.643,115
2168,2018-11-05,MIA,@,DET,W 120-115 (OT),265,44,98,.449,32,67,.478,12,31,.387,20,31,.645,120
2169,2018-11-05,GSW,,MEM,W 117-101,240,41,81,.506,28,57,.491,13,24,.542,22,23,.957,117
2170,2018-11-05,MEM,@,GSW,L 101-117,240,38,83,.458,29,56,.518,9,27,.333,16,21,.762,101
2171,2018-11-05,HOU,@,IND,W 98-94,240,34,76,.447,19,29,.655,15,47,.319,15,16,.938,98
2172,2018-11-05,IND,,HOU,L 94-98,240,33,75,.440,25,47,.532,8,28,.286,20,30,.667,94
2173,2018-11-05,LAC,,MIN,W 120-109,240,43,88,.489,29,57,.509,14,31,.452,20,22,.909,120
2174,2018-11-05,MIN,@,LAC,L 109-120,240,40,85,.471,35,64,.547,5,21,.238,24,30,.800,109
2175,2018-11-05,CHI,@,NYK,W 116-115 (2OT),290,43,95,.453,35,65,.538,8,30,.267,22,30,.733,116
2176,2018-11-05,NYK,,CHI,L 115-116 (2OT),290,41,106,.387,34,80,.425,7,26,.269,26,29,.897,115
2177,2018-11-05,NOP,@,OKC,L 116-122,240,41,84,.488,32,55,.582,9,29,.310,25,30,.833,116
2178,2018-11-05,OKC,,NOP,W 122-116,240,45,93,.484,35,66,.530,10,27,.370,22,31,.710,122
2179,2018-11-05,CLE,@,ORL,L 100-102,240,41,80,.513,31,57,.544,10,23,.435,8,12,.667,100
2180,2018-11-05,ORL,,CLE,W 102-100,240,39,87,.448,28,53,.528,11,34,.324,13,15,.867,102
2181,2018-11-05,TOR,@,UTA,W 124-111,240,49,86,.570,36,53,.679,13,33,.394,13,14,.929,124
2182,2018-11-05,UTA,,TOR,L 111-124,240,38,86,.442,30,55,.545,8,31,.258,27,41,.659,111
2183,2018-11-04,BRK,,PHI,W 122-97,240,50,105,.476,41,77,.532,9,28,.321,13,18,.722,122
2184,2018-11-04,PHI,@,BRK,L 97-122,240,31,65,.477,27,45,.600,4,20,.200,31,41,.756,97
2185,2018-11-04,LAL,,TOR,L 107-121,240,39,85,.459,33,61,.541,6,24,.250,23,29,.793,107
2186,2018-11-04,TOR,@,LAL,W 121-107,240,49,98,.500,39,63,.619,10,35,.286,13,14,.929,121
2187,2018-11-04,MIL,,SAC,W 144-109,240,46,95,.484,24,39,.615,22,56,.393,30,33,.909,144
2188,2018-11-04,SAC,@,MIL,L 109-144,240,42,95,.442,28,59,.475,14,36,.389,11,22,.500,109
2189,2018-11-04,MEM,@,PHO,L 100-102,240,36,76,.474,29,53,.547,7,23,.304,21,29,.724,100
2190,2018-11-04,PHO,,MEM,W 102-100,240,33,64,.516,19,32,.594,14,32,.438,22,26,.846,102
2191,2018-11-04,MIN,@,POR,L 81-111,240,29,93,.312,22,63,.349,7,30,.233,16,21,.762,81
2192,2018-11-04,POR,,MIN,W 111-81,240,38,86,.442,31,58,.534,7,28,.250,28,32,.875,111
2193,2018-11-04,ORL,@,SAS,W 117-110,240,46,91,.505,34,59,.576,12,32,.375,13,18,.722,117
2194,2018-11-04,SAS,,ORL,L 110-117,240,38,88,.432,26,53,.491,12,35,.343,22,25,.880,110
2195,2018-11-04,NYK,@,WAS,L 95-108,240,39,93,.419,34,66,.515,5,27,.185,12,16,.750,95
2196,2018-11-04,WAS,,NYK,W 108-95,240,36,83,.434,30,57,.526,6,26,.231,30,39,.769,108
2197,2018-11-03,ATL,,MIA,W 123-118,240,46,88,.523,33,56,.589,13,32,.406,18,23,.783,123
2198,2018-11-03,MIA,@,ATL,L 118-123,240,41,85,.482,25,45,.556,16,40,.400,20,26,.769,118
2199,2018-11-03,CHI,,HOU,L 88-96,240,28,71,.394,22,48,.458,6,23,.261,26,27,.963,88
2200,2018-11-03,HOU,@,CHI,W 96-88,240,35,83,.422,22,41,.537,13,42,.310,13,20,.650,96
2201,2018-11-03,CHA,,CLE,W 126-94,240,52,91,.571,42,61,.689,10,30,.333,12,13,.923,126
2202,2018-11-03,CLE,@,CHO,L 94-126,240,35,81,.432,25,55,.455,10,26,.385,14,15,.933,94
2203,2018-11-03,DEN,,UTA,W 103-88,240,41,83,.494,32,55,.582,9,28,.321,12,19,.632,103
2204,2018-11-03,UTA,@,DEN,L 88-103,240,33,81,.407,27,50,.540,6,31,.194,16,24,.667,88
2205,2018-11-03,BOS,@,IND,L 101-102,240,38,88,.432,19,42,.452,19,46,.413,6,9,.667,101
2206,2018-11-03,IND,,BOS,W 102-101,240,36,86,.419,25,54,.463,11,32,.344,19,25,.760,102
2207,2018-11-03,DET,@,PHI,L 99-109,240,33,83,.398,28,53,.528,5,30,.167,28,41,.683,99
2208,2018-11-03,PHI,,DET,W 109-99,240,28,69,.406,19,40,.475,9,29,.310,44,51,.863,109
2209,2018-11-03,LAL,@,POR,W 114-110,240,45,86,.523,37,65,.569,8,21,.381,16,25,.640,114
2210,2018-11-03,POR,,LAL,L 110-114,240,44,104,.423,38,69,.551,6,35,.171,16,22,.727,110
2211,2018-11-03,NOP,@,SAS,L 95-109,240,36,77,.468,30,56,.536,6,21,.286,17,30,.567,95
2212,2018-11-03,SAS,,NOP,W 109-95,240,45,96,.469,37,73,.507,8,23,.348,11,14,.786,109
2213,2018-11-02,BRK,,HOU,L 111-119,240,42,85,.494,27,51,.529,15,34,.441,12,20,.600,111
2214,2018-11-02,HOU,@,BRK,W 119-111,240,41,83,.494,26,44,.591,15,39,.385,22,32,.688,119
2215,2018-11-02,CHI,,IND,L 105-107,240,42,89,.472,29,58,.500,13,31,.419,8,9,.889,105
2216,2018-11-02,IND,@,CHI,W 107-105,240,40,85,.471,33,59,.559,7,26,.269,20,22,.909,107
2217,2018-11-02,DAL,,NYK,L 106-118,240,40,81,.494,29,52,.558,11,29,.379,15,24,.625,106
2218,2018-11-02,NYK,@,DAL,W 118-106,240,46,84,.548,39,55,.709,7,29,.241,19,26,.731,118
2219,2018-11-02,GSW,,MIN,W 116-99,240,43,88,.489,30,54,.556,13,34,.382,17,22,.773,116
2220,2018-11-02,MIN,@,GSW,L 99-116,240,38,101,.376,25,56,.446,13,45,.289,10,14,.714,99
2221,2018-11-02,LAC,@,ORL,W 120-95,240,41,86,.477,28,60,.467,13,26,.500,25,33,.758,120
2222,2018-11-02,ORL,,LAC,L 95-120,240,40,90,.444,36,73,.493,4,17,.235,11,19,.579,95
2223,2018-11-02,PHO,,TOR,L 98-107,240,40,91,.440,32,65,.492,8,26,.308,10,18,.556,98
2224,2018-11-02,TOR,@,PHO,W 107-98,240,41,81,.506,29,48,.604,12,33,.364,13,21,.619,107
2225,2018-11-02,MEM,@,UTA,W 110-100,240,38,75,.507,25,49,.510,13,26,.500,21,34,.618,110
2226,2018-11-02,UTA,,MEM,L 100-110,240,36,77,.468,22,41,.537,14,36,.389,14,25,.560,100
2227,2018-11-02,OKC,@,WAS,W 134-111,240,49,86,.570,34,54,.630,15,32,.469,21,26,.808,134
2228,2018-11-02,WAS,,OKC,L 111-134,240,44,86,.512,35,56,.625,9,30,.300,14,18,.778,111
2229,2018-11-01,ATL,,SAC,L 115-146,240,42,87,.483,34,56,.607,8,31,.258,23,34,.676,115
2230,2018-11-01,SAC,@,ATL,W 146-115,240,53,98,.541,39,63,.619,14,35,.400,26,32,.813,146
2231,2018-11-01,BOS,,MIL,W 117-113,240,41,92,.446,17,37,.459,24,55,.436,11,13,.846,117
2232,2018-11-01,MIL,@,BOS,L 113-117,240,41,85,.482,32,56,.571,9,29,.310,22,30,.733,113
2233,2018-11-01,CHA,,OKC,L 107-111,240,38,93,.409,27,52,.519,11,41,.268,20,22,.909,107
2234,2018-11-01,OKC,@,CHO,W 111-107,240,41,96,.427,33,59,.559,8,37,.216,21,29,.724,111
2235,2018-11-01,CLE,,DEN,L 91-110,240,34,83,.410,29,65,.446,5,18,.278,18,19,.947,91
2236,2018-11-01,DEN,@,CLE,W 110-91,240,41,85,.482,31,59,.525,10,26,.385,18,21,.857,110
2237,2018-11-01,LAC,@,PHI,L 113-122,240,38,86,.442,29,63,.460,9,23,.391,28,33,.848,113
2238,2018-11-01,PHI,,LAC,W 122-113,240,44,93,.473,31,66,.470,13,27,.481,21,28,.750,122
2239,2018-11-01,NOP,@,POR,L 119-132,240,40,94,.426,32,65,.492,8,29,.276,31,37,.838,119
2240,2018-11-01,POR,,NOP,W 132-119,240,44,87,.506,26,52,.500,18,35,.514,26,31,.839,132
2241,2018-10-31,BRK,,DET,W 120-119 (OT),265,43,101,.426,31,63,.492,12,38,.316,22,30,.733,120
2242,2018-10-31,DET,@,BRK,L 119-120 (OT),265,39,93,.419,28,59,.475,11,34,.324,30,39,.769,119
2243,2018-10-31,CHI,,DEN,L 107-108 (OT),265,39,92,.424,23,58,.397,16,34,.471,13,18,.722,107
2244,2018-10-31,DEN,@,CHI,W 108-107 (OT),265,45,99,.455,38,73,.521,7,26,.269,11,18,.611,108
2245,2018-10-31,GSW,,NOP,W 131-121,240,47,89,.528,31,57,.544,16,32,.500,21,30,.700,131
2246,2018-10-31,NOP,@,GSW,L 121-131,240,44,92,.478,32,57,.561,12,35,.343,21,27,.778,121
2247,2018-10-31,DAL,@,LAL,L 113-114,240,43,86,.500,30,57,.526,13,29,.448,14,19,.737,113
2248,2018-10-31,LAL,,DAL,W 114-113,240,43,84,.512,33,67,.493,10,17,.588,18,24,.750,114
2249,2018-10-31,MIN,,UTA,W 128-125,240,50,86,.581,38,61,.623,12,25,.480,16,24,.667,128
2250,2018-10-31,UTA,@,MIN,L 125-128,240,47,97,.485,34,67,.507,13,30,.433,18,30,.600,125
2251,2018-10-31,IND,@,NYK,W 107-101,240,45,83,.542,39,63,.619,6,20,.300,11,17,.647,107
2252,2018-10-31,NYK,,IND,L 101-107,240,34,79,.430,22,54,.407,12,25,.480,21,24,.875,101
2253,2018-10-31,PHO,,SAS,L 90-120,240,35,90,.389,29,66,.439,6,24,.250,14,18,.778,90
2254,2018-10-31,SAS,@,PHO,W 120-90,240,46,83,.554,42,65,.646,4,18,.222,24,26,.923,120
2255,2018-10-30,BOS,,DET,W 108-105,240,37,84,.440,28,53,.528,9,31,.290,25,32,.781,108
2256,2018-10-30,DET,@,BOS,L 105-108,240,37,88,.420,29,58,.500,8,30,.267,23,27,.852,105
2257,2018-10-30,CHA,,MIA,W 125-113,240,44,81,.543,31,53,.585,13,28,.464,24,29,.828,125
2258,2018-10-30,MIA,@,CHO,L 113-125,240,41,87,.471,30,59,.508,11,28,.393,20,24,.833,113
2259,2018-10-30,ATL,@,CLE,L 114-136,240,44,82,.537,29,47,.617,15,35,.429,11,17,.647,114
2260,2018-10-30,CLE,,ATL,W 136-114,240,45,90,.500,32,65,.492,13,25,.520,33,43,.767,136
2261,2018-10-30,HOU,,POR,L 85-104,240,31,96,.323,21,53,.396,10,43,.233,13,23,.565,85
2262,2018-10-30,POR,@,HOU,W 104-85,240,38,80,.475,30,60,.500,8,20,.400,20,23,.870,104
2263,2018-10-30,MEM,,WAS,W 107-95,240,36,74,.486,23,46,.500,13,28,.464,22,31,.710,107
2264,2018-10-30,WAS,@,MEM,L 95-107,240,32,74,.432,18,39,.462,14,35,.400,17,20,.850,95
2265,2018-10-30,LAC,@,OKC,L 110-128,240,35,74,.473,28,54,.519,7,20,.350,33,43,.767,110
2266,2018-10-30,OKC,,LAC,W 128-110,240,48,94,.511,39,77,.506,9,17,.529,23,32,.719,128
2267,2018-10-30,ORL,,SAC,L 99-107,240,36,91,.396,25,48,.521,11,43,.256,16,22,.727,99
2268,2018-10-30,SAC,@,ORL,W 107-99,240,41,84,.488,33,62,.532,8,22,.364,17,26,.654,107
2269,2018-10-30,PHI,@,TOR,L 112-129,240,38,91,.418,24,51,.471,14,40,.350,22,30,.733,112
2270,2018-10-30,TOR,,PHI,W 129-112,240,47,92,.511,36,65,.554,11,27,.407,24,28,.857,129
2271,2018-10-29,CHI,,GSW,L 124-149,240,46,94,.489,35,59,.593,11,35,.314,21,34,.618,124
2272,2018-10-29,GSW,@,CHI,W 149-124,240,53,96,.552,29,51,.569,24,45,.533,19,26,.731,149
2273,2018-10-29,DEN,,NOP,W 116-111,240,42,93,.452,31,58,.534,11,35,.314,21,23,.913,116
2274,2018-10-29,NOP,@,DEN,L 111-116,240,43,82,.524,32,58,.552,11,24,.458,14,20,.700,111
2275,2018-10-29,IND,,POR,L 93-103,240,37,90,.411,31,71,.437,6,19,.316,13,20,.650,93
2276,2018-10-29,POR,@,IND,W 103-93,240,38,78,.487,28,52,.538,10,26,.385,17,18,.944,103
2277,2018-10-29,MIA,,SAC,L 113-123,240,38,92,.413,25,53,.472,13,39,.333,24,34,.706,113
2278,2018-10-29,SAC,@,MIA,W 123-113,240,48,97,.495,36,71,.507,12,26,.462,15,25,.600,123
2279,2018-10-29,MIL,,TOR,W 124-109,240,45,92,.489,26,47,.553,19,45,.422,15,19,.789,124
2280,2018-10-29,TOR,@,MIL,L 109-124,240,39,103,.379,30,58,.517,9,45,.200,22,28,.786,109
2281,2018-10-29,LAL,@,MIN,L 120-124,240,49,104,.471,37,71,.521,12,33,.364,10,15,.667,120
2282,2018-10-29,MIN,,LAL,W 124-120,240,42,98,.429,28,69,.406,14,29,.483,26,30,.867,124
2283,2018-10-29,BRK,@,NYK,L 96-115,240,34,84,.405,23,46,.500,11,38,.289,17,22,.773,96
2284,2018-10-29,NYK,,BRK,W 115-96,240,45,92,.489,36,68,.529,9,24,.375,16,18,.889,115
2285,2018-10-29,ATL,@,PHI,L 92-113,240,35,94,.372,27,57,.474,8,37,.216,14,21,.667,92
2286,2018-10-29,PHI,,ATL,W 113-92,240,41,99,.414,27,52,.519,14,47,.298,17,18,.944,113
2287,2018-10-29,DAL,@,SAS,L 108-113 (OT),265,43,91,.473,33,57,.579,10,34,.294,12,17,.706,108
2288,2018-10-29,SAS,,DAL,W 113-108 (OT),265,42,91,.462,33,71,.465,9,20,.450,20,21,.952,113
2289,2018-10-28,BRK,,GSW,L 114-120,240,42,87,.483,22,45,.489,20,42,.476,10,15,.667,114
2290,2018-10-28,GSW,@,BRK,W 120-114,240,44,89,.494,33,56,.589,11,33,.333,21,24,.875,120
2291,2018-10-28,DAL,,UTA,L 104-113,240,38,91,.418,29,63,.460,9,28,.321,19,25,.760,104
2292,2018-10-28,UTA,@,DAL,W 113-104,240,42,80,.525,32,55,.582,10,25,.400,19,22,.864,113
2293,2018-10-28,LAC,,WAS,W 136-104,240,56,103,.544,40,74,.541,16,29,.552,8,13,.615,136
2294,2018-10-28,WAS,@,LAC,L 104-136,240,38,97,.392,33,70,.471,5,27,.185,23,28,.821,104
2295,2018-10-28,OKC,,PHO,W 117-110,240,43,85,.506,36,61,.590,7,24,.292,24,35,.686,117
2296,2018-10-28,PHO,@,OKC,L 110-117,240,38,86,.442,30,59,.508,8,27,.296,26,27,.963,110
2297,2018-10-27,ATL,,CHI,L 85-97,240,27,84,.321,15,44,.341,12,40,.300,19,23,.826,85
2298,2018-10-27,CHI,@,ATL,W 97-85,240,36,83,.434,24,50,.480,12,33,.364,13,16,.813,97
2299,2018-10-27,CLE,,IND,L 107-119,240,40,86,.465,33,61,.541,7,25,.280,20,22,.909,107
2300,2018-10-27,IND,@,CLE,W 119-107,240,48,74,.649,43,61,.705,5,13,.385,18,26,.692,119
2301,2018-10-27,BOS,@,DET,W 109-89,240,39,86,.453,25,52,.481,14,34,.412,17,25,.680,109
2302,2018-10-27,DET,,BOS,L 89-109,240,33,89,.371,26,52,.500,7,37,.189,16,20,.800,89
2303,2018-10-27,MEM,,PHO,W 117-96,240,44,79,.557,35,53,.660,9,26,.346,20,22,.909,117
2304,2018-10-27,PHO,@,MEM,L 96-117,240,36,78,.462,27,45,.600,9,33,.273,15,19,.789,96
2305,2018-10-27,MIA,,POR,W 120-111,240,44,96,.458,29,57,.509,15,39,.385,17,26,.654,120
2306,2018-10-27,POR,@,MIA,L 111-120,240,37,88,.420,25,55,.455,12,33,.364,25,28,.893,111
2307,2018-10-27,MIL,,ORL,W 113-91,240,41,82,.500,31,52,.596,10,30,.333,21,23,.913,113
2308,2018-10-27,ORL,@,MIL,L 91-113,240,33,101,.327,23,58,.397,10,43,.233,15,17,.882,91
2309,2018-10-27,NOP,,UTA,L 111-132,240,40,95,.421,31,61,.508,9,34,.265,22,29,.759,111
2310,2018-10-27,UTA,@,NOP,W 132-111,240,46,88,.523,36,56,.643,10,32,.313,30,37,.811,132
2311,2018-10-27,CHA,@,PHI,L 103-105,240,37,95,.389,28,60,.467,9,35,.257,20,24,.833,103
2312,2018-10-27,PHI,,CHO,W 105-103,240,35,91,.385,25,63,.397,10,28,.357,25,30,.833,105
2313,2018-10-27,LAL,@,SAS,L 106-110,240,41,86,.477,28,53,.528,13,33,.394,11,18,.611,106
2314,2018-10-27,SAS,,LAL,W 110-106,240,44,91,.484,41,75,.547,3,16,.188,19,24,.792,110
2315,2018-10-26,CHI,@,CHO,L 106-135,240,37,85,.435,21,49,.429,16,36,.444,16,22,.727,106
2316,2018-10-26,CHA,,CHI,W 135-106,240,53,93,.570,39,61,.639,14,32,.438,15,16,.938,135
2317,2018-10-26,HOU,,LAC,L 113-133,240,38,98,.388,23,57,.404,15,41,.366,22,25,.880,113
2318,2018-10-26,LAC,@,HOU,W 133-113,240,43,79,.544,31,56,.554,12,23,.522,35,38,.921,133
2319,2018-10-26,MIL,@,MIN,W 125-95,240,49,92,.533,30,46,.652,19,46,.413,8,11,.727,125
2320,2018-10-26,MIN,,MIL,L 95-125,240,36,112,.321,26,69,.377,10,43,.233,13,18,.722,95
2321,2018-10-26,BRK,@,NOP,L 115-117,240,43,98,.439,24,58,.414,19,40,.475,10,15,.667,115
2322,2018-10-26,NOP,,BRK,W 117-115,240,44,98,.449,35,75,.467,9,23,.391,20,26,.769,117
2323,2018-10-26,GSW,@,NYK,W 128-100,240,51,87,.586,35,54,.648,16,33,.485,10,12,.833,128
2324,2018-10-26,NYK,,GSW,L 100-128,240,39,90,.433,26,51,.510,13,39,.333,9,12,.750,100
2325,2018-10-26,SAC,,WAS,W 116-112,240,44,95,.463,30,58,.517,14,37,.378,14,23,.609,116
2326,2018-10-26,WAS,@,SAC,L 112-116,240,40,86,.465,26,44,.591,14,42,.333,18,23,.783,112
2327,2018-10-26,DAL,@,TOR,L 107-116,240,38,92,.413,26,62,.419,12,30,.400,19,24,.792,107
2328,2018-10-26,TOR,,DAL,W 116-107,240,44,91,.484,33,64,.516,11,27,.407,17,20,.850,116
2329,2018-10-25,CLE,@,DET,L 103-110,240,41,89,.461,33,65,.508,8,24,.333,13,15,.867,103
2330,2018-10-25,DET,,CLE,W 110-103,240,41,78,.526,30,50,.600,11,28,.393,17,29,.586,110
2331,2018-10-25,DEN,@,LAL,L 114-121,240,46,92,.500,40,69,.580,6,23,.261,16,20,.800,114
2332,2018-10-25,LAL,,DEN,W 121-114,240,46,92,.500,36,63,.571,10,29,.345,19,23,.826,121
2333,2018-10-25,BOS,@,OKC,W 101-95,240,33,86,.384,22,54,.407,11,32,.344,24,33,.727,101
2334,2018-10-25,OKC,,BOS,L 95-101,240,37,94,.394,30,66,.455,7,28,.250,14,25,.560,95
2335,2018-10-25,ORL,,POR,L 114-128,240,43,86,.500,31,56,.554,12,30,.400,16,20,.800,114
2336,2018-10-25,POR,@,ORL,W 128-114,240,48,87,.552,37,60,.617,11,27,.407,21,26,.808,128
2337,2018-10-24,ATL,,DAL,W 111-104,240,37,91,.407,22,53,.415,15,38,.395,22,31,.710,111
2338,2018-10-24,DAL,@,ATL,L 104-111,240,38,91,.418,26,51,.510,12,40,.300,16,26,.615,104
2339,2018-10-24,CHI,,CHO,W 112-110,240,37,77,.481,27,48,.563,10,29,.345,28,35,.800,112
2340,2018-10-24,CHA,@,CHI,L 110-112,240,37,85,.435,27,50,.540,10,35,.286,26,29,.897,110
2341,2018-10-24,BRK,@,CLE,W 102-86,240,38,87,.437,24,53,.453,14,34,.412,12,15,.800,102
2342,2018-10-24,CLE,,BRK,L 86-102,240,34,89,.382,31,71,.437,3,18,.167,15,16,.938,86
2343,2018-10-24,GSW,,WAS,W 144-122,240,53,92,.576,38,59,.644,15,33,.455,23,25,.920,144
2344,2018-10-24,WAS,@,GSW,L 122-144,240,42,93,.452,30,51,.588,12,42,.286,26,28,.929,122
2345,2018-10-24,HOU,,UTA,L 89-100,240,35,87,.402,24,47,.511,11,40,.275,8,14,.571,89
2346,2018-10-24,UTA,@,HOU,W 100-89,240,34,78,.436,24,49,.490,10,29,.345,22,28,.786,100
2347,2018-10-24,MIA,,NYK,W 110-87,240,39,82,.476,26,53,.491,13,29,.448,19,28,.679,110
2348,2018-10-24,NYK,@,MIA,L 87-110,240,33,91,.363,21,58,.362,12,33,.364,9,14,.643,87
2349,2018-10-24,MIL,,PHI,W 123-108,240,41,100,.410,28,57,.491,13,43,.302,28,30,.933,123
2350,2018-10-24,PHI,@,MIL,L 108-123,240,38,92,.413,27,58,.466,11,34,.324,21,30,.700,108
2351,2018-10-24,LAL,@,PHO,W 131-113,240,52,100,.520,42,72,.583,10,28,.357,17,23,.739,131
2352,2018-10-24,PHO,,LAL,L 113-131,240,44,84,.524,34,53,.642,10,31,.323,15,21,.714,113
2353,2018-10-24,MEM,@,SAC,L 92-97,240,36,94,.383,26,57,.456,10,37,.270,10,13,.769,92
2354,2018-10-24,SAC,,MEM,W 97-92,240,35,83,.422,29,65,.446,6,18,.333,21,33,.636,97
2355,2018-10-24,IND,@,SAS,W 116-96,240,46,87,.529,29,55,.527,17,32,.531,7,8,.875,116
2356,2018-10-24,SAS,,IND,L 96-116,240,35,87,.402,29,68,.426,6,19,.316,20,21,.952,96
2357,2018-10-24,MIN,@,TOR,L 105-112,240,40,96,.417,25,66,.379,15,30,.500,10,16,.625,105
2358,2018-10-24,TOR,,MIN,W 112-105,240,46,89,.517,35,57,.614,11,32,.344,9,12,.750,112
2359,2018-10-23,DEN,,SAC,W 126-112,240,51,99,.515,40,69,.580,11,30,.367,13,15,.867,126
2360,2018-10-23,SAC,@,DEN,L 112-126,240,45,86,.523,32,55,.582,13,31,.419,9,20,.450,112
2361,2018-10-23,DET,,PHI,W 133-132 (OT),265,51,108,.472,39,75,.520,12,33,.364,19,27,.704,133
2362,2018-10-23,PHI,@,DET,L 132-133 (OT),265,49,98,.500,35,55,.636,14,43,.326,20,28,.714,132
2363,2018-10-23,LAC,@,NOP,L 109-116,240,41,87,.471,36,67,.537,5,20,.250,22,27,.815,109
2364,2018-10-23,NOP,,LAC,W 116-109,240,40,93,.430,34,69,.493,6,24,.250,30,40,.750,116
2365,2018-10-22,BOS,,ORL,L 90-93,240,37,91,.407,28,51,.549,9,40,.225,7,9,.778,90
2366,2018-10-22,ORL,@,BOS,W 93-90,240,38,93,.409,28,58,.483,10,35,.286,7,10,.700,93
2367,2018-10-22,CHI,@,DAL,L 109-115,240,41,80,.513,28,57,.491,13,23,.565,14,21,.667,109
2368,2018-10-22,DAL,,CHI,W 115-109,240,40,93,.430,25,46,.543,15,47,.319,20,21,.952,115
2369,2018-10-22,GSW,,PHO,W 123-103,240,45,88,.511,31,51,.608,14,37,.378,19,26,.731,123
2370,2018-10-22,PHO,@,GSW,L 103-123,240,39,86,.453,30,52,.577,9,34,.265,16,18,.889,103
2371,2018-10-22,LAL,,SAS,L 142-143 (OT),265,55,107,.514,41,68,.603,14,39,.359,18,26,.692,142
2372,2018-10-22,SAS,@,LAL,W 143-142 (OT),265,50,97,.515,35,69,.507,15,28,.536,28,38,.737,143
2373,2018-10-22,MIL,,NYK,W 124-113,240,45,96,.469,28,56,.500,17,40,.425,17,24,.708,124
2374,2018-10-22,NYK,@,MIL,L 113-124,240,45,99,.455,35,70,.500,10,29,.345,13,15,.867,113
2375,2018-10-22,IND,@,MIN,L 91-101,240,36,92,.391,28,66,.424,8,26,.308,11,16,.688,91
2376,2018-10-22,MIN,,IND,W 101-91,240,36,85,.424,29,52,.558,7,33,.212,22,24,.917,101
2377,2018-10-22,POR,,WAS,L 124-125 (OT),265,43,108,.398,32,69,.464,11,39,.282,27,31,.871,124
2378,2018-10-22,WAS,@,POR,W 125-124 (OT),265,46,110,.418,31,73,.425,15,37,.405,18,26,.692,125
2379,2018-10-22,CHA,@,TOR,L 106-127,240,41,97,.423,32,69,.464,9,28,.321,15,18,.833,106
2380,2018-10-22,TOR,,CHO,W 127-106,240,50,87,.575,35,48,.729,15,39,.385,12,14,.857,127
2381,2018-10-22,MEM,@,UTA,W 92-84,240,31,84,.369,22,56,.393,9,28,.321,21,26,.808,92
2382,2018-10-22,UTA,,MEM,L 84-92,240,29,82,.354,21,50,.420,8,32,.250,18,23,.783,84
2383,2018-10-21,ATL,@,CLE,W 133-111,240,48,98,.490,26,51,.510,22,47,.468,15,19,.789,133
2384,2018-10-21,CLE,,ATL,L 111-133,240,46,99,.465,36,72,.500,10,27,.370,9,14,.643,111
2385,2018-10-21,DEN,,GSW,W 100-98,240,35,86,.407,29,54,.537,6,32,.188,24,42,.571,100
2386,2018-10-21,GSW,@,DEN,L 98-100,240,36,79,.456,29,50,.580,7,29,.241,19,24,.792,98
2387,2018-10-21,HOU,@,LAC,L 112-115,240,43,89,.483,28,54,.519,15,35,.429,11,15,.733,112
2388,2018-10-21,LAC,,HOU,W 115-112,240,42,89,.472,37,64,.578,5,25,.200,26,26,1.000,115
2389,2018-10-21,OKC,,SAC,L 120-131,240,46,104,.442,37,65,.569,9,39,.231,19,30,.633,120
2390,2018-10-21,SAC,@,OKC,W 131-120,240,50,91,.549,40,69,.580,10,22,.455,21,28,.750,131
2391,2018-10-20,CHI,,DET,L 116-118,240,44,87,.506,37,66,.561,7,21,.333,21,26,.808,116
2392,2018-10-20,DET,@,CHI,W 118-116,240,41,101,.406,23,61,.377,18,40,.450,18,23,.783,118
2393,2018-10-20,DAL,,MIN,W 140-136,240,49,98,.500,32,48,.667,17,50,.340,25,34,.735,140
2394,2018-10-20,MIN,@,DAL,L 136-140,240,44,84,.524,30,57,.526,14,27,.519,34,40,.850,136
2395,2018-10-20,DEN,,PHO,W 119-91,240,43,85,.506,34,57,.596,9,28,.321,24,29,.828,119
2396,2018-10-20,PHO,@,DEN,L 91-119,240,29,77,.377,18,38,.474,11,39,.282,22,35,.629,91
2397,2018-10-20,BRK,@,IND,L 112-132,240,41,86,.477,25,49,.510,16,37,.432,14,22,.636,112
2398,2018-10-20,IND,,BRK,W 132-112,240,51,92,.554,35,68,.515,16,24,.667,14,22,.636,132
2399,2018-10-20,HOU,@,LAL,W 124-115,240,44,96,.458,28,54,.519,16,42,.381,20,30,.667,124
2400,2018-10-20,LAL,,HOU,L 115-124,240,48,100,.480,40,68,.588,8,32,.250,11,18,.611,115
2401,2018-10-20,CHA,@,MIA,W 113-112,240,41,93,.441,25,51,.490,16,42,.381,15,23,.652,113
2402,2018-10-20,MIA,,CHO,L 112-113,240,41,89,.461,30,55,.545,11,34,.324,19,27,.704,112
2403,2018-10-20,BOS,@,NYK,W 103-101,240,33,82,.402,24,57,.421,9,25,.360,28,33,.848,103
2404,2018-10-20,NYK,,BOS,L 101-103,240,36,87,.414,24,52,.462,12,35,.343,17,27,.630,101
2405,2018-10-20,ORL,@,PHI,L 115-116,240,41,90,.456,25,61,.410,16,29,.552,17,22,.773,115
2406,2018-10-20,PHI,,ORL,W 116-115,240,45,94,.479,28,61,.459,17,33,.515,9,10,.900,116
2407,2018-10-20,POR,,SAS,W 121-108,240,45,84,.536,30,52,.577,15,32,.469,16,19,.842,121
2408,2018-10-20,SAS,@,POR,L 108-121,240,42,100,.420,29,70,.414,13,30,.433,11,14,.786,108
2409,2018-10-20,TOR,@,WAS,W 117-113,240,39,88,.443,29,59,.492,10,29,.345,29,36,.806,117
2410,2018-10-20,WAS,,TOR,L 113-117,240,37,89,.416,24,50,.480,13,39,.333,26,32,.813,113
2411,2018-10-19,BRK,,NYK,W 107-105,240,37,75,.493,25,45,.556,12,30,.400,21,24,.875,107
2412,2018-10-19,NYK,@,BRK,L 105-107,240,39,97,.402,30,69,.435,9,28,.321,18,20,.900,105
2413,2018-10-19,LAC,,OKC,W 108-92,240,35,81,.432,24,55,.436,11,26,.423,27,36,.750,108
2414,2018-10-19,OKC,@,LAC,L 92-108,240,34,95,.358,27,62,.435,7,33,.212,17,23,.739,92
2415,2018-10-19,ATL,@,MEM,L 117-131,240,41,83,.494,27,53,.509,14,30,.467,21,36,.583,117
2416,2018-10-19,MEM,,ATL,W 131-117,240,44,81,.543,31,55,.564,13,26,.500,30,43,.698,131
2417,2018-10-19,IND,@,MIL,L 101-118,240,38,87,.437,32,69,.464,6,18,.333,19,27,.704,101
2418,2018-10-19,MIL,,IND,W 118-101,240,44,93,.473,27,47,.574,17,46,.370,13,21,.619,118
2419,2018-10-19,CLE,@,MIN,L 123-131,240,45,93,.484,37,70,.529,8,23,.348,25,29,.862,123
2420,2018-10-19,MIN,,CLE,W 131-123,240,44,87,.506,34,62,.548,10,25,.400,33,35,.943,131
2421,2018-10-19,NOP,,SAC,W 149-129,240,56,95,.589,40,64,.625,16,31,.516,21,33,.636,149
2422,2018-10-19,SAC,@,NOP,L 129-149,240,50,96,.521,40,71,.563,10,25,.400,19,26,.731,129
2423,2018-10-19,CHA,@,ORL,W 120-88,240,43,92,.467,26,54,.481,17,38,.447,17,20,.850,120
2424,2018-10-19,ORL,,CHO,L 88-120,240,36,94,.383,30,63,.476,6,31,.194,10,14,.714,88
2425,2018-10-19,BOS,@,TOR,L 101-113,240,40,99,.404,26,63,.413,14,36,.389,7,10,.700,101
2426,2018-10-19,TOR,,BOS,W 113-101,240,43,92,.467,30,57,.526,13,35,.371,14,19,.737,113
2427,2018-10-19,GSW,@,UTA,W 124-123,240,49,87,.563,39,68,.574,10,19,.526,16,18,.889,124
2428,2018-10-19,UTA,,GSW,L 123-124,240,40,89,.449,21,43,.488,19,46,.413,24,29,.828,123
2429,2018-10-18,CHI,@,PHI,L 108-127,240,44,101,.436,33,68,.485,11,33,.333,9,12,.750,108
2430,2018-10-18,PHI,,CHI,W 127-108,240,44,93,.473,32,57,.561,12,36,.333,27,30,.900,127
2431,2018-10-18,LAL,@,POR,L 119-128,240,45,93,.484,38,63,.603,7,30,.233,22,29,.759,119
2432,2018-10-18,POR,,LAL,W 128-119,240,44,100,.440,31,63,.492,13,37,.351,27,29,.931,128
2433,2018-10-18,MIA,@,WAS,W 113-112,240,38,97,.392,26,62,.419,12,35,.343,25,34,.735,113
2434,2018-10-18,WAS,,MIA,L 112-113,240,38,81,.469,31,55,.564,7,26,.269,29,39,.744,112
2435,2018-10-17,CHA,,MIL,L 112-113,240,41,92,.446,25,54,.463,16,38,.421,14,22,.636,112
2436,2018-10-17,MIL,@,CHO,W 113-112,240,42,85,.494,28,51,.549,14,34,.412,15,20,.750,113
2437,2018-10-17,BRK,@,DET,L 100-103,240,40,82,.488,35,55,.636,5,27,.185,15,22,.682,100
2438,2018-10-17,DET,,BRK,W 103-100,240,39,92,.424,33,68,.485,6,24,.250,19,22,.864,103
2439,2018-10-17,HOU,,NOP,L 112-131,240,39,92,.424,23,44,.523,16,48,.333,18,24,.750,112
2440,2018-10-17,NOP,@,HOU,W 131-112,240,52,98,.531,42,73,.575,10,25,.400,17,22,.773,131
2441,2018-10-17,IND,,MEM,W 111-83,240,47,83,.566,37,57,.649,10,26,.385,7,13,.538,111
2442,2018-10-17,MEM,@,IND,L 83-111,240,25,84,.298,15,55,.273,10,29,.345,23,28,.821,83
2443,2018-10-17,DEN,@,LAC,W 107-98,240,33,87,.379,25,63,.397,8,24,.333,33,42,.786,107
2444,2018-10-17,LAC,,DEN,L 98-107,240,35,88,.398,27,60,.450,8,28,.286,20,24,.833,98
2445,2018-10-17,ATL,@,NYK,L 107-126,240,41,90,.456,31,54,.574,10,36,.278,15,18,.833,107
2446,2018-10-17,NYK,,ATL,W 126-107,240,45,99,.455,33,66,.500,12,33,.364,24,31,.774,126
2447,2018-10-17,MIA,@,ORL,L 101-104,240,38,97,.392,29,64,.453,9,33,.273,16,22,.727,101
2448,2018-10-17,ORL,,MIA,W 104-101,240,39,94,.415,32,69,.464,7,25,.280,19,31,.613,104
2449,2018-10-17,DAL,@,PHO,L 100-121,240,38,88,.432,28,55,.509,10,33,.303,14,20,.700,100
2450,2018-10-17,PHO,,DAL,W 121-100,240,44,81,.543,25,47,.532,19,34,.559,14,16,.875,121
2451,2018-10-17,SAC,,UTA,L 117-123,240,49,95,.516,42,76,.553,7,19,.368,12,18,.667,117
2452,2018-10-17,UTA,@,SAC,W 123-117,240,41,79,.519,28,52,.538,13,27,.481,28,38,.737,123
2453,2018-10-17,MIN,@,SAS,L 108-112,240,39,91,.429,33,72,.458,6,19,.316,24,27,.889,108
2454,2018-10-17,SAS,,MIN,W 112-108,240,40,93,.430,29,68,.426,11,25,.440,21,29,.724,112
2455,2018-10-17,CLE,@,TOR,L 104-116,240,34,85,.400,27,66,.409,7,19,.368,29,39,.744,104
2456,2018-10-17,TOR,,CLE,W 116-104,240,45,92,.489,31,59,.525,14,33,.424,12,20,.600,116
2457,2018-10-16,BOS,,PHI,W 105-87,240,42,97,.433,31,60,.517,11,37,.297,10,14,.714,105
2458,2018-10-16,PHI,@,BOS,L 87-105,240,34,87,.391,29,61,.475,5,26,.192,14,23,.609,87
2459,2018-10-16,GSW,,OKC,W 108-100,240,42,95,.442,35,69,.507,7,26,.269,17,18,.944,108
2460,2018-10-16,OKC,@,GSW,L 100-108,240,33,91,.363,23,54,.426,10,37,.270,24,37,.649,100
2461,2018-04-11,BOS,,BRK,W 110-97,240,46,102,.451,40,78,.513,6,24,.250,12,15,.800,110
2462,2018-04-11,BRK,@,BOS,L 97-110,240,37,91,.407,26,51,.510,11,40,.275,12,16,.750,97
2463,2018-04-11,CHI,,DET,L 87-119,240,32,86,.372,21,52,.404,11,34,.324,12,18,.667,87
2464,2018-04-11,DET,@,CHI,W 119-87,240,47,89,.528,32,54,.593,15,35,.429,10,10,1.000,119
2465,2018-04-11,CLE,,NYK,L 98-110,240,37,94,.394,31,70,.443,6,24,.250,18,28,.643,98
2466,2018-04-11,NYK,@,CLE,W 110-98,240,43,85,.506,31,58,.534,12,27,.444,12,13,.923,110
2467,2018-04-11,LAC,,LAL,L 100-115,240,41,83,.494,35,65,.538,6,18,.333,12,28,.429,100
2468,2018-04-11,LAL,@,LAC,W 115-100,240,42,88,.477,25,49,.510,17,39,.436,14,16,.875,115
2469,2018-04-11,MIA,,TOR,W 116-109 (OT),265,46,106,.434,35,80,.438,11,26,.423,13,20,.650,116
2470,2018-04-11,TOR,@,MIA,L 109-116 (OT),265,42,92,.457,33,62,.532,9,30,.300,16,21,.762,109
2471,2018-04-11,DEN,@,MIN,L 106-112 (OT),265,41,90,.456,28,58,.483,13,32,.406,11,18,.611,106
2472,2018-04-11,MIN,,DEN,W 112-106 (OT),265,42,89,.472,33,66,.500,9,23,.391,19,25,.760,112
2473,2018-04-11,NOP,,SAS,W 122-98,240,52,88,.591,47,69,.681,5,19,.263,13,19,.684,122
2474,2018-04-11,SAS,@,NOP,L 98-122,240,37,92,.402,29,68,.426,8,24,.333,16,19,.842,98
2475,2018-04-11,MEM,@,OKC,L 123-137,240,44,91,.484,31,60,.517,13,31,.419,22,24,.917,123
2476,2018-04-11,OKC,,MEM,W 137-123,240,47,85,.553,27,42,.643,20,43,.465,23,32,.719,137
2477,2018-04-11,ORL,,WAS,W 101-92,240,33,77,.429,20,45,.444,13,32,.406,22,27,.815,101
2478,2018-04-11,WAS,@,ORL,L 92-101,240,33,95,.347,23,61,.377,10,34,.294,16,27,.593,92
2479,2018-04-11,MIL,@,PHI,L 95-130,240,37,90,.411,30,65,.462,7,25,.280,14,16,.875,95
2480,2018-04-11,PHI,,MIL,W 130-95,240,52,105,.495,37,69,.536,15,36,.417,11,15,.733,130
2481,2018-04-11,POR,,UTA,W 102-93,240,41,89,.461,32,65,.492,9,24,.375,11,16,.688,102
2482,2018-04-11,UTA,@,POR,L 93-102,240,33,89,.371,25,66,.379,8,23,.348,19,24,.792,93
2483,2018-04-11,HOU,@,SAC,L 83-96,240,31,82,.378,18,36,.500,13,46,.283,8,12,.667,83
2484,2018-04-11,SAC,,HOU,W 96-83,240,38,80,.475,31,54,.574,7,26,.269,13,20,.650,96
2485,2018-04-10,ATL,,PHI,L 113-121,240,41,98,.418,28,61,.459,13,37,.351,18,26,.692,113
2486,2018-04-10,PHI,@,ATL,W 121-113,240,43,87,.494,26,50,.520,17,37,.459,18,30,.600,121
2487,2018-04-10,DAL,,PHO,L 97-124,240,37,97,.381,29,64,.453,8,33,.242,15,22,.682,97
2488,2018-04-10,PHO,@,DAL,W 124-97,240,48,76,.632,35,50,.700,13,26,.500,15,21,.714,124
2489,2018-04-10,CHA,@,IND,W 119-93,240,46,99,.465,28,57,.491,18,42,.429,9,12,.750,119
2490,2018-04-10,IND,,CHO,L 93-119,240,40,99,.404,32,68,.471,8,31,.258,5,8,.625,93
2491,2018-04-10,HOU,@,LAL,W 105-99,240,37,88,.420,21,41,.512,16,47,.340,15,16,.938,105
2492,2018-04-10,LAL,,HOU,L 99-105,240,38,90,.422,28,54,.519,10,36,.278,13,15,.867,99
2493,2018-04-10,GSW,@,UTA,L 79-119,240,30,86,.349,25,67,.373,5,19,.263,14,16,.875,79
2494,2018-04-10,UTA,,GSW,W 119-79,240,48,90,.533,35,55,.636,13,35,.371,10,13,.769,119
2495,2018-04-10,BOS,@,WAS,L 101-113,240,33,87,.379,20,54,.370,13,33,.394,22,27,.815,101
2496,2018-04-10,WAS,,BOS,W 113-101,240,41,83,.494,26,53,.491,15,30,.500,16,20,.800,113
2497,2018-04-09,BRK,,CHI,W 114-105,240,41,82,.500,23,40,.575,18,42,.429,14,15,.933,114
2498,2018-04-09,CHI,@,BRK,L 105-114,240,43,89,.483,31,61,.508,12,28,.429,7,12,.583,105
2499,2018-04-09,DEN,,POR,W 88-82,240,31,83,.373,25,57,.439,6,26,.231,20,26,.769,88
2500,2018-04-09,POR,@,DEN,L 82-88,240,31,94,.330,24,61,.393,7,33,.212,13,18,.722,82
2501,2018-04-09,DET,,TOR,L 98-108,240,35,78,.449,26,48,.542,9,30,.300,19,25,.760,98
2502,2018-04-09,TOR,@,DET,W 108-98,240,46,87,.529,34,48,.708,12,39,.308,4,4,1.000,108
2503,2018-04-09,LAC,,NOP,L 100-113,240,45,98,.459,43,81,.531,2,17,.118,8,19,.421,100
2504,2018-04-09,NOP,@,LAC,W 113-100,240,44,95,.463,33,65,.508,11,30,.367,14,20,.700,113
2505,2018-04-09,MIA,,OKC,L 93-115,240,40,87,.460,35,65,.538,5,22,.227,8,14,.571,93
2506,2018-04-09,OKC,@,MIA,W 115-93,240,35,81,.432,21,46,.457,14,35,.400,31,38,.816,115
2507,2018-04-09,MIL,,ORL,W 102-86,240,39,91,.429,30,65,.462,9,26,.346,15,18,.833,102
2508,2018-04-09,ORL,@,MIL,L 86-102,240,34,82,.415,29,58,.500,5,24,.208,13,20,.650,86
2509,2018-04-09,MEM,@,MIN,L 94-113,240,35,85,.412,30,67,.448,5,18,.278,19,21,.905,94
2510,2018-04-09,MIN,,MEM,W 113-94,240,42,87,.483,35,65,.538,7,22,.318,22,26,.846,113
2511,2018-04-09,CLE,@,NYK,W 123-109,240,40,85,.471,21,40,.525,19,45,.422,24,28,.857,123
2512,2018-04-09,NYK,,CLE,L 109-123,240,46,87,.529,35,57,.614,11,30,.367,6,12,.500,109
2513,2018-04-09,SAC,@,SAS,L 85-98,240,33,81,.407,25,63,.397,8,18,.444,11,17,.647,85
2514,2018-04-09,SAS,,SAC,W 98-85,240,34,82,.415,28,55,.509,6,27,.222,24,29,.828,98
2515,2018-04-08,ATL,@,BOS,W 112-106,240,43,86,.500,28,51,.549,15,35,.429,11,14,.786,112
2516,2018-04-08,BOS,,ATL,L 106-112,240,42,82,.512,33,59,.559,9,23,.391,13,20,.650,106
2517,2018-04-08,CHA,,IND,L 117-123,240,40,80,.500,29,50,.580,11,30,.367,26,30,.867,117
2518,2018-04-08,IND,@,CHO,W 123-117,240,50,93,.538,41,68,.603,9,25,.360,14,18,.778,123
2519,2018-04-08,LAL,,UTA,L 97-112,240,37,93,.398,32,68,.471,5,25,.200,18,22,.818,97
2520,2018-04-08,UTA,@,LAL,W 112-97,240,42,83,.506,29,47,.617,13,36,.361,15,22,.682,112
2521,2018-04-08,DET,@,MEM,L 117-130,240,38,93,.409,15,46,.326,23,47,.489,18,23,.783,117
2522,2018-04-08,MEM,,DET,W 130-117,240,48,83,.578,32,50,.640,16,33,.485,18,24,.750,130
2523,2018-04-08,DAL,@,PHI,L 97-109,240,40,94,.426,29,54,.537,11,40,.275,6,13,.462,97
2524,2018-04-08,PHI,,DAL,W 109-97,240,46,91,.505,38,64,.594,8,27,.296,9,14,.643,109
2525,2018-04-08,GSW,@,PHO,W 117-100,240,47,90,.522,34,58,.586,13,32,.406,10,15,.667,117
2526,2018-04-08,PHO,,GSW,L 100-117,240,39,92,.424,29,57,.509,10,35,.286,12,16,.750,100
2527,2018-04-08,ORL,@,TOR,L 101-112,240,42,89,.472,35,66,.530,7,23,.304,10,17,.588,101
2528,2018-04-08,TOR,,ORL,W 112-101,240,39,78,.500,22,38,.579,17,40,.425,17,24,.708,112
2529,2018-04-07,BRK,@,CHI,W 124-96,240,46,92,.500,22,37,.595,24,55,.436,8,11,.727,124
2530,2018-04-07,CHI,,BRK,L 96-124,240,36,88,.409,30,59,.508,6,29,.207,18,21,.857,96
2531,2018-04-07,GSW,,NOP,L 120-126,240,49,90,.544,34,57,.596,15,33,.455,7,11,.636,120
2532,2018-04-07,NOP,@,GSW,W 126-120,240,49,87,.563,38,60,.633,11,27,.407,17,22,.773,126
2533,2018-04-07,HOU,,OKC,L 102-108,240,36,76,.474,22,39,.564,14,37,.378,16,23,.696,102
2534,2018-04-07,OKC,@,HOU,W 108-102,240,36,91,.396,26,58,.448,10,33,.303,26,33,.788,108
2535,2018-04-07,DEN,@,LAC,W 134-115,240,53,85,.624,41,56,.732,12,29,.414,16,23,.696,134
2536,2018-04-07,LAC,,DEN,L 115-134,240,43,87,.494,37,70,.529,6,17,.353,23,34,.676,115
2537,2018-04-07,MIL,@,NYK,W 115-102,240,45,93,.484,35,68,.515,10,25,.400,15,17,.882,115
2538,2018-04-07,NYK,,MIL,L 102-115,240,41,95,.432,32,74,.432,9,21,.429,11,11,1.000,102
2539,2018-04-07,POR,@,SAS,L 105-116,240,42,88,.477,31,60,.517,11,28,.393,10,11,.909,105
2540,2018-04-07,SAS,,POR,W 116-105,240,47,84,.560,40,63,.635,7,21,.333,15,21,.714,116
2541,2018-04-06,BOS,,CHI,W 111-104,240,45,81,.556,31,47,.660,14,34,.412,7,17,.412,111
2542,2018-04-06,CHI,@,BOS,L 104-111,240,40,86,.465,26,56,.464,14,30,.467,10,17,.588,104
2543,2018-04-06,DAL,@,DET,L 106-113 (OT),265,40,92,.435,27,53,.509,13,39,.333,13,18,.722,106
2544,2018-04-06,DET,,DAL,W 113-106 (OT),265,46,92,.500,34,62,.548,12,30,.400,9,17,.529,113
2545,2018-04-06,LAL,,MIN,L 96-113,240,31,79,.392,23,55,.418,8,24,.333,26,32,.813,96
2546,2018-04-06,MIN,@,LAL,W 113-96,240,43,100,.430,35,74,.473,8,26,.308,19,26,.731,113
2547,2018-04-06,MEM,,SAC,L 93-94,240,37,84,.440,31,60,.517,6,24,.250,13,18,.722,93
2548,2018-04-06,SAC,@,MEM,W 94-93,240,40,85,.471,34,61,.557,6,24,.250,8,12,.667,94
2549,2018-04-06,MIA,@,NYK,L 98-122,240,35,88,.398,28,61,.459,7,27,.259,21,22,.955,98
2550,2018-04-06,NYK,,MIA,W 122-98,240,45,89,.506,27,52,.519,18,37,.486,14,21,.667,122
2551,2018-04-06,CHA,@,ORL,W 137-100,240,48,86,.558,31,55,.564,17,31,.548,24,26,.923,137
2552,2018-04-06,ORL,,CHO,L 100-137,240,42,94,.447,33,71,.465,9,23,.391,7,13,.538,100
2553,2018-04-06,CLE,@,PHI,L 130-132,240,45,87,.517,29,53,.547,16,34,.471,24,33,.727,130
2554,2018-04-06,PHI,,CLE,W 132-130,240,50,101,.495,36,62,.581,14,39,.359,18,21,.857,132
2555,2018-04-06,NOP,@,PHO,W 122-103,240,45,99,.455,29,61,.475,16,38,.421,16,20,.800,122
2556,2018-04-06,PHO,,NOP,L 103-122,240,37,94,.394,28,61,.459,9,33,.273,20,26,.769,103
2557,2018-04-06,IND,@,TOR,L 73-92,240,26,87,.299,19,66,.288,7,21,.333,14,20,.700,73
2558,2018-04-06,TOR,,IND,W 92-73,240,36,84,.429,27,54,.500,9,30,.300,11,16,.688,92
2559,2018-04-06,ATL,@,WAS,W 103-97,240,38,79,.481,27,46,.587,11,33,.333,16,23,.696,103
2560,2018-04-06,WAS,,ATL,L 97-103,240,35,87,.402,26,62,.419,9,25,.360,18,23,.783,97
2561,2018-04-05,CLE,,WAS,W 119-115,240,42,77,.545,29,50,.580,13,27,.481,22,28,.786,119
2562,2018-04-05,WAS,@,CLE,L 115-119,240,47,94,.500,38,73,.521,9,21,.429,12,14,.857,115
2563,2018-04-05,DEN,,MIN,W 100-96,240,35,89,.393,24,53,.453,11,36,.306,19,22,.864,100
2564,2018-04-05,MIN,@,DEN,L 96-100,240,39,91,.429,33,67,.493,6,24,.250,12,16,.750,96
2565,2018-04-05,HOU,,POR,W 96-94,240,34,73,.466,21,36,.583,13,37,.351,15,24,.625,96
2566,2018-04-05,POR,@,HOU,L 94-96,240,39,85,.459,32,63,.508,7,22,.318,9,14,.643,94
2567,2018-04-05,GSW,@,IND,L 106-126,240,37,83,.446,28,54,.519,9,29,.310,23,24,.958,106
2568,2018-04-05,IND,,GSW,W 126-106,240,50,93,.538,35,64,.547,15,29,.517,11,15,.733,126
2569,2018-04-05,BRK,@,MIL,W 119-111,240,41,75,.547,22,36,.611,19,39,.487,18,21,.857,119
2570,2018-04-05,MIL,,BRK,L 111-119,240,41,93,.441,36,73,.493,5,20,.250,24,30,.800,111
2571,2018-04-05,LAC,@,UTA,L 95-117,240,35,79,.443,32,62,.516,3,17,.176,22,28,.786,95
2572,2018-04-05,UTA,,LAC,W 117-95,240,44,83,.530,34,56,.607,10,27,.370,19,28,.679,117
2573,2018-04-04,ATL,,MIA,L 86-115,240,33,90,.367,24,60,.400,9,30,.300,11,17,.647,86
2574,2018-04-04,MIA,@,ATL,W 115-86,240,42,94,.447,25,56,.446,17,38,.447,14,17,.824,115
2575,2018-04-04,DET,,PHI,L 108-115,240,39,88,.443,23,52,.442,16,36,.444,14,23,.609,108
2576,2018-04-04,PHI,@,DET,W 115-108,240,44,89,.494,31,59,.525,13,30,.433,14,19,.737,115
2577,2018-04-04,LAL,,SAS,W 122-112 (OT),265,47,86,.547,34,62,.548,13,24,.542,15,18,.833,122
2578,2018-04-04,SAS,@,LAL,L 112-122 (OT),265,42,97,.433,33,74,.446,9,23,.391,19,27,.704,112
2579,2018-04-04,MEM,@,NOP,L 95-123,240,37,93,.398,27,61,.443,10,32,.313,11,15,.733,95
2580,2018-04-04,NOP,,MEM,W 123-95,240,45,86,.523,29,50,.580,16,36,.444,17,19,.895,123
2581,2018-04-04,DAL,@,ORL,L 100-105,240,39,89,.438,29,59,.492,10,30,.333,12,17,.706,100
2582,2018-04-04,ORL,,DAL,W 105-100,240,39,86,.453,31,57,.544,8,29,.276,19,27,.704,105
2583,2018-04-04,BOS,@,TOR,L 78-96,240,25,75,.333,22,53,.415,3,22,.136,25,28,.893,78
2584,2018-04-04,TOR,,BOS,W 96-78,240,40,92,.435,30,59,.508,10,33,.303,6,8,.750,96
2585,2018-04-03,CHI,,CHO,W 120-114,240,46,99,.465,31,65,.477,15,34,.441,13,18,.722,120
2586,2018-04-03,CHA,@,CHI,L 114-120,240,40,81,.494,27,47,.574,13,34,.382,21,28,.750,114
2587,2018-04-03,CLE,,TOR,W 112-106,240,38,77,.494,25,47,.532,13,30,.433,23,26,.885,112
2588,2018-04-03,TOR,@,CLE,L 106-112,240,42,94,.447,31,60,.517,11,34,.324,11,14,.786,106
2589,2018-04-03,DAL,,POR,W 115-109,240,42,92,.457,25,48,.521,17,44,.386,14,20,.700,115
2590,2018-04-03,POR,@,DAL,L 109-115,240,39,87,.448,29,47,.617,10,40,.250,21,24,.875,109
2591,2018-04-03,DEN,,IND,W 107-104,240,41,89,.461,31,57,.544,10,32,.313,15,20,.750,107
2592,2018-04-03,IND,@,DEN,L 104-107,240,41,84,.488,32,65,.492,9,19,.474,13,16,.813,104
2593,2018-04-03,HOU,,WAS,W 120-104,240,43,84,.512,27,38,.711,16,46,.348,18,27,.667,120
2594,2018-04-03,WAS,@,HOU,L 104-120,240,38,72,.528,26,47,.553,12,25,.480,16,23,.696,104
2595,2018-04-03,LAC,,SAS,W 113-110,240,37,82,.451,32,66,.485,5,16,.313,34,43,.791,113
2596,2018-04-03,SAS,@,LAC,L 110-113,240,39,88,.443,31,64,.484,8,24,.333,24,28,.857,110
2597,2018-04-03,ATL,@,MIA,L 98-101,240,37,88,.420,24,55,.436,13,33,.394,11,15,.733,98
2598,2018-04-03,MIA,,ATL,W 101-98,240,41,91,.451,33,58,.569,8,33,.242,11,13,.846,101
2599,2018-04-03,BOS,@,MIL,L 102-106,240,38,81,.469,31,58,.534,7,23,.304,19,24,.792,102
2600,2018-04-03,MIL,,BOS,W 106-102,240,43,79,.544,38,59,.644,5,20,.250,15,21,.714,106
2601,2018-04-03,NYK,,ORL,L 73-97,240,30,86,.349,26,59,.441,4,27,.148,9,12,.750,73
2602,2018-04-03,ORL,@,NYK,W 97-73,240,37,88,.420,26,52,.500,11,36,.306,12,18,.667,97
2603,2018-04-03,GSW,@,OKC,W 111-107,240,41,83,.494,33,54,.611,8,29,.276,21,24,.875,111
2604,2018-04-03,OKC,,GSW,L 107-111,240,35,93,.376,26,55,.473,9,38,.237,28,37,.757,107
2605,2018-04-03,BRK,@,PHI,L 95-121,240,34,81,.420,17,39,.436,17,42,.405,10,23,.435,95
2606,2018-04-03,PHI,,BRK,W 121-95,240,50,91,.549,41,70,.586,9,21,.429,12,18,.667,121
2607,2018-04-03,PHO,,SAC,W 97-94,240,35,77,.455,29,60,.483,6,17,.353,21,33,.636,97
2608,2018-04-03,SAC,@,PHO,L 94-97,240,33,89,.371,22,62,.355,11,27,.407,17,23,.739,94
2609,2018-04-03,LAL,@,UTA,L 110-117,240,36,74,.486,22,46,.478,14,28,.500,24,36,.667,110
2610,2018-04-03,UTA,,LAL,W 117-110,240,43,89,.483,29,56,.518,14,33,.424,17,27,.630,117
2611,2018-04-01,ATL,,ORL,W 94-88,240,41,85,.482,30,49,.612,11,36,.306,1,1,1.000,94
2612,2018-04-01,ORL,@,ATL,L 88-94,240,33,96,.344,23,60,.383,10,36,.278,12,13,.923,88
2613,2018-04-01,BRK,,DET,L 96-108,240,37,87,.425,25,44,.568,12,43,.279,10,15,.667,96
2614,2018-04-01,DET,@,BRK,W 108-96,240,38,84,.452,31,65,.477,7,19,.368,25,32,.781,108
2615,2018-04-01,CHI,,WAS,W 113-94,240,43,82,.524,25,48,.521,18,34,.529,9,13,.692,113
2616,2018-04-01,WAS,@,CHI,L 94-113,240,37,81,.457,29,51,.569,8,30,.267,12,12,1.000,94
2617,2018-04-01,CHA,,PHI,L 102-119,240,33,82,.402,24,52,.462,9,30,.300,27,34,.794,102
2618,2018-04-01,PHI,@,CHO,W 119-102,240,48,94,.511,34,62,.548,14,32,.438,9,10,.900,119
2619,2018-04-01,CLE,,DAL,W 98-87,240,35,85,.412,24,59,.407,11,26,.423,17,23,.739,98
2620,2018-04-01,DAL,@,CLE,L 87-98,240,32,79,.405,19,42,.452,13,37,.351,10,11,.909,87
2621,2018-04-01,DEN,,MIL,W 128-125 (OT),265,40,90,.444,29,54,.537,11,36,.306,37,46,.804,128
2622,2018-04-01,MIL,@,DEN,L 125-128 (OT),265,45,100,.450,33,67,.493,12,33,.364,23,27,.852,125
2623,2018-04-01,GSW,,PHO,W 117-107,240,48,89,.539,35,61,.574,13,28,.464,8,9,.889,117
2624,2018-04-01,PHO,@,GSW,L 107-117,240,41,90,.456,30,59,.508,11,31,.355,14,16,.875,107
2625,2018-04-01,IND,@,LAC,W 111-104,240,42,86,.488,31,58,.534,11,28,.393,16,21,.762,111
2626,2018-04-01,LAC,,IND,L 104-111,240,42,82,.512,33,57,.579,9,25,.360,11,14,.786,104
2627,2018-04-01,LAL,,SAC,L 83-84,240,30,75,.400,23,43,.535,7,32,.219,16,25,.640,83
2628,2018-04-01,SAC,@,LAL,W 84-83,240,35,92,.380,28,68,.412,7,24,.292,7,14,.500,84
2629,2018-04-01,MIN,,UTA,L 97-121,240,38,90,.422,30,66,.455,8,24,.333,13,14,.929,97
2630,2018-04-01,UTA,@,MIN,W 121-97,240,46,76,.605,35,48,.729,11,28,.393,18,25,.720,121
2631,2018-04-01,NOP,,OKC,L 104-109,240,38,83,.458,27,51,.529,11,32,.344,17,23,.739,104
2632,2018-04-01,OKC,@,NOP,W 109-104,240,41,95,.432,32,64,.500,9,31,.290,18,25,.720,109
2633,2018-04-01,MEM,@,POR,L 98-113,240,40,88,.455,31,67,.463,9,21,.429,9,12,.750,98
2634,2018-04-01,POR,,MEM,W 113-98,240,39,84,.464,27,46,.587,12,38,.316,23,25,.920,113
2635,2018-04-01,HOU,@,SAS,L 83-100,240,26,77,.338,19,46,.413,7,31,.226,24,29,.828,83
2636,2018-04-01,SAS,,HOU,W 100-83,240,40,81,.494,34,64,.531,6,17,.353,14,21,.667,100
2637,2018-03-31,BOS,,TOR,W 110-99,240,40,88,.455,33,71,.465,7,17,.412,23,27,.852,110
2638,2018-03-31,TOR,@,BOS,L 99-110,240,37,80,.463,29,45,.644,8,35,.229,17,22,.773,99
2639,2018-03-31,BRK,@,MIA,W 110-109 (OT),265,39,91,.429,29,56,.518,10,35,.286,22,28,.786,110
2640,2018-03-31,MIA,,BRK,L 109-110 (OT),265,43,95,.453,36,78,.462,7,17,.412,16,21,.762,109
2641,2018-03-31,DET,@,NYK,W 115-109,240,44,85,.518,34,61,.557,10,24,.417,17,22,.773,115
2642,2018-03-31,NYK,,DET,L 109-115,240,43,91,.473,30,62,.484,13,29,.448,10,12,.833,109
2643,2018-03-31,GSW,@,SAC,W 112-96,240,41,83,.494,32,57,.561,9,26,.346,21,28,.750,112
2644,2018-03-31,SAC,,GSW,L 96-112,240,36,87,.414,28,59,.475,8,28,.286,16,19,.842,96
2645,2018-03-31,CHA,@,WAS,L 93-107,240,35,77,.455,29,54,.537,6,23,.261,17,27,.630,93
2646,2018-03-31,WAS,,CHO,W 107-93,240,40,88,.455,22,49,.449,18,39,.462,9,12,.750,107
2647,2018-03-30,ATL,,PHI,L 91-101,240,36,101,.356,27,62,.435,9,39,.231,10,15,.667,91
2648,2018-03-30,PHI,@,ATL,W 101-91,240,42,95,.442,34,57,.596,8,38,.211,9,13,.692,101
2649,2018-03-30,CLE,,NOP,W 107-102,240,43,90,.478,33,66,.500,10,24,.417,11,15,.733,107
2650,2018-03-30,NOP,@,CLE,L 102-107,240,43,89,.483,32,63,.508,11,26,.423,5,6,.833,102
2651,2018-03-30,DAL,,MIN,L 92-93,240,38,86,.442,27,58,.466,11,28,.393,5,7,.714,92
2652,2018-03-30,MIN,@,DAL,W 93-92,240,35,83,.422,27,58,.466,8,25,.320,15,17,.882,93
2653,2018-03-30,HOU,,PHO,W 104-103,240,35,81,.432,21,43,.488,14,38,.368,20,29,.690,104
2654,2018-03-30,PHO,@,HOU,L 103-104,240,41,84,.488,29,52,.558,12,32,.375,9,13,.692,103
2655,2018-03-30,LAL,,MIL,L 122-124 (OT),265,48,94,.511,40,67,.597,8,27,.296,18,25,.720,122
2656,2018-03-30,MIL,@,LAL,W 124-122 (OT),265,45,94,.479,34,65,.523,11,29,.379,23,28,.821,124
2657,2018-03-30,DEN,@,OKC,W 126-125 (OT),265,49,94,.521,39,64,.609,10,30,.333,18,21,.857,126
2658,2018-03-30,OKC,,DEN,L 125-126 (OT),265,45,108,.417,25,64,.391,20,44,.455,15,27,.556,125
2659,2018-03-30,CHI,@,ORL,W 90-82,240,30,84,.357,16,43,.372,14,41,.341,16,23,.696,90
2660,2018-03-30,ORL,,CHI,L 82-90,240,31,94,.330,24,55,.436,7,39,.179,13,14,.929,82
2661,2018-03-30,LAC,@,POR,L 96-105,240,36,89,.404,32,76,.421,4,13,.308,20,35,.571,96
2662,2018-03-30,POR,,LAC,W 105-96,240,41,95,.432,33,65,.508,8,30,.267,15,16,.938,105
2663,2018-03-30,MEM,@,UTA,L 97-107,240,39,81,.481,30,58,.517,9,23,.391,10,15,.667,97
2664,2018-03-30,UTA,,MEM,W 107-97,240,40,74,.541,28,43,.651,12,31,.387,15,26,.577,107
2665,2018-03-29,DET,,WAS,W 103-92,240,41,84,.488,35,63,.556,6,21,.286,15,20,.750,103
2666,2018-03-29,WAS,@,DET,L 92-103,240,37,89,.416,31,57,.544,6,32,.188,12,15,.800,92
2667,2018-03-29,GSW,,MIL,L 107-116,240,41,75,.547,31,55,.564,10,20,.500,15,15,1.000,107
2668,2018-03-29,MIL,@,GSW,W 116-107,240,48,87,.552,37,67,.552,11,20,.550,9,10,.900,116
2669,2018-03-29,CHI,@,MIA,L 92-103,240,33,90,.367,27,64,.422,6,26,.231,20,26,.769,92
2670,2018-03-29,MIA,,CHI,W 103-92,240,37,82,.451,30,55,.545,7,27,.259,22,24,.917,103
2671,2018-03-29,IND,@,SAC,W 106-103,240,40,80,.500,32,54,.593,8,26,.308,18,20,.900,106
2672,2018-03-29,SAC,,IND,L 103-106,240,42,78,.538,29,47,.617,13,31,.419,6,9,.667,103
2673,2018-03-29,OKC,@,SAS,L 99-103,240,37,85,.435,26,55,.473,11,30,.367,14,21,.667,99
2674,2018-03-29,SAS,,OKC,W 103-99,240,34,81,.420,21,50,.420,13,31,.419,22,30,.733,103
2675,2018-03-28,CHA,,CLE,L 105-118,240,39,76,.513,34,55,.618,5,21,.238,22,24,.917,105
2676,2018-03-28,CLE,@,CHO,W 118-105,240,45,93,.484,34,65,.523,11,28,.393,17,20,.850,118
2677,2018-03-28,DAL,@,LAL,L 93-103,240,33,84,.393,20,40,.500,13,44,.295,14,19,.737,93
2678,2018-03-28,LAL,,DAL,W 103-93,240,36,77,.468,27,44,.614,9,33,.273,22,32,.688,103
2679,2018-03-28,MEM,,POR,W 108-103,240,41,84,.488,28,59,.475,13,25,.520,13,23,.565,108
2680,2018-03-28,POR,@,MEM,L 103-108,240,38,79,.481,30,49,.612,8,30,.267,19,30,.633,103
2681,2018-03-28,ATL,@,MIN,L 114-126,240,41,77,.532,28,50,.560,13,27,.481,19,23,.826,114
2682,2018-03-28,MIN,,ATL,W 126-114,240,48,90,.533,35,60,.583,13,30,.433,17,21,.810,126
2683,2018-03-28,BRK,@,ORL,W 111-104,240,40,87,.460,28,53,.528,12,34,.353,19,22,.864,111
2684,2018-03-28,ORL,,BRK,L 104-111,240,40,92,.435,29,61,.475,11,31,.355,13,16,.813,104
2685,2018-03-28,NYK,@,PHI,L 101-118,240,36,94,.383,27,63,.429,9,31,.290,20,26,.769,101
2686,2018-03-28,PHI,,NYK,W 118-101,240,45,98,.459,36,67,.537,9,31,.290,19,27,.704,118
2687,2018-03-28,LAC,@,PHO,W 111-99,240,43,80,.538,35,63,.556,8,17,.471,17,25,.680,111
2688,2018-03-28,PHO,,LAC,L 99-111,240,38,88,.432,28,54,.519,10,34,.294,13,18,.722,99
2689,2018-03-28,BOS,@,UTA,W 97-94,240,35,79,.443,23,58,.397,12,21,.571,15,20,.750,97
2690,2018-03-28,UTA,,BOS,L 94-97,240,34,82,.415,25,49,.510,9,33,.273,17,21,.810,94
2691,2018-03-27,GSW,,IND,L 81-92,240,35,86,.407,30,69,.435,5,17,.294,6,9,.667,81
2692,2018-03-27,IND,@,GSW,W 92-81,240,39,81,.481,33,60,.550,6,21,.286,8,12,.667,92
2693,2018-03-27,CHI,@,HOU,L 86-118,240,34,89,.382,26,52,.500,8,37,.216,10,17,.588,86
2694,2018-03-27,HOU,,CHI,W 118-86,240,41,93,.441,23,36,.639,18,57,.316,18,21,.857,118
2695,2018-03-27,LAC,,MIL,W 105-98,240,40,86,.465,25,58,.431,15,28,.536,10,18,.556,105
2696,2018-03-27,MIL,@,LAC,L 98-105,240,38,83,.458,32,60,.533,6,23,.261,16,23,.696,98
2697,2018-03-27,CLE,@,MIA,L 79-98,240,31,85,.365,27,59,.458,4,26,.154,13,19,.684,79
2698,2018-03-27,MIA,,CLE,W 98-79,240,37,78,.474,28,49,.571,9,29,.310,15,20,.750,98
2699,2018-03-27,NOP,,POR,L 103-107,240,43,94,.457,39,70,.557,4,24,.167,13,14,.929,103
2700,2018-03-27,POR,@,NOP,W 107-103,240,44,105,.419,34,73,.466,10,32,.313,9,10,.900,107
2701,2018-03-27,DAL,@,SAC,W 103-97,240,36,80,.450,22,40,.550,14,40,.350,17,25,.680,103
2702,2018-03-27,SAC,,DAL,L 97-103,240,38,93,.409,32,70,.457,6,23,.261,15,19,.789,97
2703,2018-03-27,DEN,@,TOR,L 110-114,240,42,89,.472,29,59,.492,13,30,.433,13,14,.929,110
2704,2018-03-27,TOR,,DEN,W 114-110,240,47,92,.511,34,58,.586,13,34,.382,7,9,.778,114
2705,2018-03-27,SAS,@,WAS,L 106-116,240,39,87,.448,29,62,.468,10,25,.400,18,33,.545,106
2706,2018-03-27,WAS,,SAS,W 116-106,240,46,85,.541,36,61,.590,10,24,.417,14,18,.778,116
2707,2018-03-26,CHA,,NYK,W 137-128 (OT),265,51,93,.548,40,65,.615,11,28,.393,24,28,.857,137
2708,2018-03-26,NYK,@,CHO,L 128-137 (OT),265,54,105,.514,45,75,.600,9,30,.300,11,11,1.000,128
2709,2018-03-26,DET,,LAL,W 112-106,240,44,100,.440,31,67,.463,13,33,.394,11,15,.733,112
2710,2018-03-26,LAL,@,DET,L 106-112,240,40,85,.471,34,62,.548,6,23,.261,20,25,.800,106
2711,2018-03-26,MEM,@,MIN,W 101-93,240,40,84,.476,25,53,.472,15,31,.484,6,9,.667,101
2712,2018-03-26,MIN,,MEM,L 93-101,240,33,79,.418,25,55,.455,8,24,.333,19,24,.792,93
2713,2018-03-26,DEN,@,PHI,L 104-123,240,36,84,.429,25,52,.481,11,32,.344,21,34,.618,104
2714,2018-03-26,PHI,,DEN,W 123-104,240,46,91,.505,33,62,.532,13,29,.448,18,25,.720,123
2715,2018-03-26,BOS,@,PHO,W 102-94,240,37,87,.425,23,58,.397,14,29,.483,14,14,1.000,102
2716,2018-03-26,PHO,,BOS,L 94-102,240,36,81,.444,24,46,.522,12,35,.343,10,19,.526,94
2717,2018-03-25,BRK,,CLE,L 114-121,240,38,83,.458,21,46,.457,17,37,.459,21,26,.808,114
2718,2018-03-25,CLE,@,BRK,W 121-114,240,44,87,.506,32,59,.542,12,28,.429,21,26,.808,121
2719,2018-03-25,GSW,,UTA,L 91-110,240,38,91,.418,32,76,.421,6,15,.400,9,10,.900,91
2720,2018-03-25,UTA,@,GSW,W 110-91,240,42,87,.483,30,59,.508,12,28,.429,14,18,.778,110
2721,2018-03-25,ATL,@,HOU,L 99-118,240,39,88,.443,28,48,.583,11,40,.275,10,11,.909,99
2722,2018-03-25,HOU,,ATL,W 118-99,240,44,90,.489,24,38,.632,20,52,.385,10,11,.909,118
2723,2018-03-25,IND,,MIA,W 113-107 (OT),265,44,90,.489,36,67,.537,8,23,.348,17,21,.810,113
2724,2018-03-25,MIA,@,IND,L 107-113 (OT),265,41,86,.477,27,51,.529,14,35,.400,11,14,.786,107
2725,2018-03-25,MIL,,SAS,W 106-103,240,42,86,.488,33,59,.559,9,27,.333,13,18,.722,106
2726,2018-03-25,SAS,@,MIL,L 103-106,240,41,92,.446,37,75,.493,4,17,.235,17,21,.810,103
2727,2018-03-25,OKC,,POR,L 105-108,240,37,84,.440,29,57,.509,8,27,.296,23,28,.821,105
2728,2018-03-25,POR,@,OKC,W 108-105,240,42,90,.467,33,56,.589,9,34,.265,15,19,.789,108
2729,2018-03-25,BOS,@,SAC,W 104-93,240,40,72,.556,28,50,.560,12,22,.545,12,17,.706,104
2730,2018-03-25,SAC,,BOS,L 93-104,240,38,82,.463,31,56,.554,7,26,.269,10,10,1.000,93
2731,2018-03-25,LAC,@,TOR,W 117-106,240,44,95,.463,36,77,.468,8,18,.444,21,27,.778,117
2732,2018-03-25,TOR,,LAC,L 106-117,240,41,92,.446,25,56,.446,16,36,.444,8,14,.571,106
2733,2018-03-25,NYK,@,WAS,W 101-97,240,41,88,.466,35,66,.530,6,22,.273,13,15,.867,101
2734,2018-03-25,WAS,,NYK,L 97-101,240,37,87,.425,31,68,.456,6,19,.316,17,23,.739,97
2735,2018-03-24,CHA,@,DAL,W 102-98,240,35,92,.380,23,67,.343,12,25,.480,20,29,.690,102
2736,2018-03-24,DAL,,CHO,L 98-102,240,36,91,.396,24,50,.480,12,41,.293,14,19,.737,98
2737,2018-03-24,CHI,@,DET,L 95-117,240,39,97,.402,28,62,.452,11,35,.314,6,9,.667,95
2738,2018-03-24,DET,,CHI,W 117-95,240,43,87,.494,27,45,.600,16,42,.381,15,18,.833,117
2739,2018-03-24,HOU,,NOP,W 114-91,240,45,93,.484,27,46,.587,18,47,.383,6,8,.750,114
2740,2018-03-24,NOP,@,HOU,L 91-114,240,38,96,.396,32,75,.427,6,21,.286,9,12,.750,91
2741,2018-03-24,LAL,@,MEM,W 100-93,240,35,86,.407,22,48,.458,13,38,.342,17,25,.680,100
2742,2018-03-24,MEM,,LAL,L 93-100,240,35,84,.417,30,55,.545,5,29,.172,18,22,.818,93
2743,2018-03-24,ORL,,PHO,W 105-99,240,37,84,.440,26,54,.481,11,30,.367,20,27,.741,105
2744,2018-03-24,PHO,@,ORL,L 99-105,240,36,89,.404,29,60,.483,7,29,.241,20,26,.769,99
2745,2018-03-24,MIN,@,PHI,L 108-120,240,37,96,.385,31,73,.425,6,23,.261,28,38,.737,108
2746,2018-03-24,PHI,,MIN,W 120-108,240,42,88,.477,29,51,.569,13,37,.351,23,36,.639,120
2747,2018-03-23,CHI,,MIL,L 105-118,240,36,87,.414,24,61,.393,12,26,.462,21,23,.913,105
2748,2018-03-23,MIL,@,CHI,W 118-105,240,43,87,.494,28,57,.491,15,30,.500,17,19,.895,118
2749,2018-03-23,CLE,,PHO,W 120-95,240,47,95,.495,39,66,.591,8,29,.276,18,24,.750,120
2750,2018-03-23,PHO,@,CLE,L 95-120,240,38,87,.437,31,59,.525,7,28,.250,12,20,.600,95
2751,2018-03-23,ATL,@,GSW,L 94-106,240,37,84,.440,26,52,.500,11,32,.344,9,20,.450,94
2752,2018-03-23,GSW,,ATL,W 106-94,240,42,93,.452,30,63,.476,12,30,.400,10,11,.909,106
2753,2018-03-23,IND,,LAC,W 109-104,240,43,93,.462,32,62,.516,11,31,.355,12,14,.857,109
2754,2018-03-23,LAC,@,IND,L 104-109,240,42,76,.553,32,50,.640,10,26,.385,10,14,.714,104
2755,2018-03-23,MIN,@,NYK,W 108-104,240,35,75,.467,25,49,.510,10,26,.385,28,32,.875,108
2756,2018-03-23,NYK,,MIN,L 104-108,240,40,92,.435,28,64,.438,12,28,.429,12,17,.706,104
2757,2018-03-23,MIA,@,OKC,L 99-105,240,34,87,.391,21,57,.368,13,30,.433,18,20,.900,99
2758,2018-03-23,OKC,,MIA,W 105-99,240,36,84,.429,28,58,.483,8,26,.308,25,33,.758,105
2759,2018-03-23,BOS,@,POR,W 105-100,240,35,77,.455,24,59,.407,11,18,.611,24,26,.923,105
2760,2018-03-23,POR,,BOS,L 100-105,240,40,91,.440,32,58,.552,8,33,.242,12,15,.800,100
2761,2018-03-23,SAS,,UTA,W 124-120 (OT),265,47,92,.511,40,75,.533,7,17,.412,23,27,.852,124
2762,2018-03-23,UTA,@,SAS,L 120-124 (OT),265,43,88,.489,32,60,.533,11,28,.393,23,29,.793,120
2763,2018-03-23,BRK,@,TOR,L 112-116,240,41,84,.488,30,57,.526,11,27,.407,19,31,.613,112
2764,2018-03-23,TOR,,BRK,W 116-112,240,41,86,.477,27,58,.466,14,28,.500,20,29,.690,116
2765,2018-03-23,DEN,@,WAS,W 108-100,240,37,85,.435,20,51,.392,17,34,.500,17,18,.944,108
2766,2018-03-23,WAS,,DEN,L 100-108,240,38,80,.475,24,52,.462,14,28,.500,10,14,.714,100
2767,2018-03-22,CHA,,MEM,W 140-79,240,49,92,.533,30,52,.577,19,40,.475,23,27,.852,140
2768,2018-03-22,MEM,@,CHO,L 79-140,240,30,78,.385,26,60,.433,4,18,.222,15,21,.714,79
2769,2018-03-22,DAL,,UTA,L 112-119,240,42,85,.494,25,53,.472,17,32,.531,11,14,.786,112
2770,2018-03-22,UTA,@,DAL,W 119-112,240,46,87,.529,34,58,.586,12,29,.414,15,16,.938,119
2771,2018-03-22,DET,@,HOU,L 96-100 (OT),265,40,95,.421,34,57,.596,6,38,.158,10,19,.526,96
2772,2018-03-22,HOU,,DET,W 100-96 (OT),265,35,99,.354,23,48,.479,12,51,.235,18,28,.643,100
2773,2018-03-22,LAL,@,NOP,L 125-128,240,43,87,.494,26,48,.542,17,39,.436,22,28,.786,125
2774,2018-03-22,NOP,,LAL,W 128-125,240,52,95,.547,46,71,.648,6,24,.250,18,22,.818,128
2775,2018-03-22,ORL,,PHI,L 98-118,240,37,91,.407,27,58,.466,10,33,.303,14,22,.636,98
2776,2018-03-22,PHI,@,ORL,W 118-98,240,42,89,.472,27,52,.519,15,37,.405,19,24,.792,118
2777,2018-03-22,ATL,@,SAC,L 90-105,240,33,84,.393,21,48,.438,12,36,.333,12,18,.667,90
2778,2018-03-22,SAC,,ATL,W 105-90,240,43,93,.462,33,72,.458,10,21,.476,9,9,1.000,105
2779,2018-03-21,BRK,,CHO,L 105-111,240,39,93,.419,26,56,.464,13,37,.351,14,21,.667,105
2780,2018-03-21,CHA,@,BRK,W 111-105,240,36,94,.383,33,78,.423,3,16,.188,36,47,.766,111
2781,2018-03-21,CHI,,DEN,L 102-135,240,39,89,.438,26,51,.510,13,38,.342,11,14,.786,102
2782,2018-03-21,DEN,@,CHI,W 135-102,240,51,83,.614,31,48,.646,20,35,.571,13,16,.813,135
2783,2018-03-21,CLE,,TOR,W 132-129,240,47,78,.603,32,54,.593,15,24,.625,23,28,.821,132
2784,2018-03-21,TOR,@,CLE,L 129-132,240,47,88,.534,32,54,.593,15,34,.441,20,23,.870,129
2785,2018-03-21,MIA,,NYK,W 119-98,240,45,81,.556,30,47,.638,15,34,.441,14,19,.737,119
2786,2018-03-21,NYK,@,MIA,L 98-119,240,39,89,.438,29,58,.500,10,31,.323,10,12,.833,98
2787,2018-03-21,LAC,@,MIL,W 127-120,240,45,86,.523,30,56,.536,15,30,.500,22,29,.759,127
2788,2018-03-21,MIL,,LAC,L 120-127,240,50,91,.549,42,65,.646,8,26,.308,12,17,.706,120
2789,2018-03-21,IND,@,NOP,L 92-96,240,34,93,.366,27,71,.380,7,22,.318,17,18,.944,92
2790,2018-03-21,NOP,,IND,W 96-92,240,34,79,.430,26,56,.464,8,23,.348,20,24,.833,96
2791,2018-03-21,MEM,@,PHI,L 105-119,240,40,99,.404,31,72,.431,9,27,.333,16,20,.800,105
2792,2018-03-21,PHI,,MEM,W 119-105,240,46,84,.548,35,53,.660,11,31,.355,16,20,.800,119
2793,2018-03-21,SAS,,WAS,W 98-90,240,39,79,.494,32,56,.571,7,23,.304,13,18,.722,98
2794,2018-03-21,WAS,@,SAS,L 90-98,240,35,83,.422,27,58,.466,8,25,.320,12,16,.750,90
2795,2018-03-20,BOS,,OKC,W 100-99,240,36,87,.414,23,51,.451,13,36,.361,15,16,.938,100
2796,2018-03-20,OKC,@,BOS,L 99-100,240,35,85,.412,25,58,.431,10,27,.370,19,29,.655,99
2797,2018-03-20,LAC,@,MIN,L 109-123,240,40,93,.430,32,69,.464,8,24,.333,21,26,.808,109
2798,2018-03-20,MIN,,LAC,W 123-109,240,45,86,.523,35,61,.574,10,25,.400,23,24,.958,123
2799,2018-03-20,DAL,@,NOP,L 105-115,240,43,90,.478,33,55,.600,10,35,.286,9,11,.818,105
2800,2018-03-20,NOP,,DAL,W 115-105,240,48,91,.527,38,66,.576,10,25,.400,9,15,.600,115
2801,2018-03-20,ORL,,TOR,L 86-93,240,37,90,.411,28,65,.431,9,25,.360,3,5,.600,86
2802,2018-03-20,TOR,@,ORL,W 93-86,240,35,77,.455,21,41,.512,14,36,.389,9,17,.529,93
2803,2018-03-20,DET,@,PHO,W 115-88,240,43,97,.443,28,61,.459,15,36,.417,14,16,.875,115
2804,2018-03-20,PHO,,DET,L 88-115,240,34,90,.378,27,56,.482,7,34,.206,13,20,.650,88
2805,2018-03-20,HOU,@,POR,W 115-111,240,38,79,.481,19,43,.442,19,36,.528,20,29,.690,115
2806,2018-03-20,POR,,HOU,L 111-115,240,40,81,.494,29,53,.547,11,28,.393,20,27,.741,111
2807,2018-03-20,ATL,@,UTA,W 99-94,240,38,94,.404,29,61,.475,9,33,.273,14,19,.737,99
2808,2018-03-20,UTA,,ATL,L 94-99,240,33,89,.371,27,55,.491,6,34,.176,22,25,.880,94
2809,2018-03-19,BRK,,MEM,W 118-115,240,36,72,.500,20,32,.625,16,40,.400,30,40,.750,118
2810,2018-03-19,MEM,@,BRK,L 115-118,240,46,88,.523,36,65,.554,10,23,.435,13,20,.650,115
2811,2018-03-19,CLE,,MIL,W 124-117,240,43,87,.494,28,49,.571,15,38,.395,23,27,.852,124
2812,2018-03-19,MIL,@,CLE,L 117-124,240,45,88,.511,37,57,.649,8,31,.258,19,20,.950,117
2813,2018-03-19,IND,,LAL,W 110-100,240,43,87,.494,37,66,.561,6,21,.286,18,19,.947,110
2814,2018-03-19,LAL,@,IND,L 100-110,240,38,86,.442,30,53,.566,8,33,.242,16,23,.696,100
2815,2018-03-19,DEN,@,MIA,L 141-149 (2OT),290,46,100,.460,28,62,.452,18,38,.474,31,37,.838,141
2816,2018-03-19,MIA,,DEN,W 149-141 (2OT),290,56,102,.549,36,66,.545,20,36,.556,17,27,.630,149
2817,2018-03-19,CHI,@,NYK,L 92-110,240,33,92,.359,30,62,.484,3,30,.100,23,31,.742,92
2818,2018-03-19,NYK,,CHI,W 110-92,240,43,96,.448,32,61,.525,11,35,.314,13,17,.765,110
2819,2018-03-19,CHA,@,PHI,L 94-108,240,32,84,.381,26,62,.419,6,22,.273,24,30,.800,94
2820,2018-03-19,PHI,,CHO,W 108-94,240,42,93,.452,24,49,.490,18,44,.409,6,8,.750,108
2821,2018-03-19,DET,@,SAC,W 106-90,240,37,79,.468,23,50,.460,14,29,.483,18,22,.818,106
2822,2018-03-19,SAC,,DET,L 90-106,240,40,88,.455,34,65,.523,6,23,.261,4,9,.444,90
2823,2018-03-19,GSW,@,SAS,L 75-89,240,30,74,.405,27,55,.491,3,19,.158,12,16,.750,75
2824,2018-03-19,SAS,,GSW,W 89-75,240,33,82,.402,25,59,.424,8,23,.348,15,21,.714,89
2825,2018-03-18,LAC,,POR,L 109-122,240,40,89,.449,31,66,.470,9,23,.391,20,27,.741,109
2826,2018-03-18,POR,@,LAC,W 122-109,240,46,92,.500,32,63,.508,14,29,.483,16,20,.800,122
2827,2018-03-18,HOU,@,MIN,W 129-120,240,43,78,.551,27,43,.628,16,35,.457,27,36,.750,129
2828,2018-03-18,MIN,,HOU,L 120-129,240,45,86,.523,35,66,.530,10,20,.500,20,26,.769,120
2829,2018-03-18,BOS,@,NOP,L 89-108,240,35,87,.402,26,61,.426,9,26,.346,10,20,.500,89
2830,2018-03-18,NOP,,BOS,W 108-89,240,41,82,.500,35,64,.547,6,18,.333,20,25,.800,108
2831,2018-03-18,OKC,@,TOR,W 132-125,240,49,88,.557,39,67,.582,10,21,.476,24,34,.706,132
2832,2018-03-18,TOR,,OKC,L 125-132,240,46,81,.568,31,51,.608,15,30,.500,18,23,.783,125
2833,2018-03-17,BRK,,DAL,W 114-106,240,43,84,.512,29,48,.604,14,36,.389,14,19,.737,114
2834,2018-03-17,DAL,@,BRK,L 106-114,240,41,92,.446,29,70,.414,12,22,.545,12,14,.857,106
2835,2018-03-17,CHI,,CLE,L 109-114,240,41,91,.451,25,57,.439,16,34,.471,11,15,.733,109
2836,2018-03-17,CLE,@,CHI,W 114-109,240,44,87,.506,31,50,.620,13,37,.351,13,20,.650,114
2837,2018-03-17,DEN,@,MEM,L 94-101,240,32,87,.368,23,54,.426,9,33,.273,21,29,.724,94
2838,2018-03-17,MEM,,DEN,W 101-94,240,33,81,.407,20,49,.408,13,32,.406,22,28,.786,101
2839,2018-03-17,ATL,@,MIL,L 117-122,240,39,85,.459,27,49,.551,12,36,.333,27,28,.964,117
2840,2018-03-17,MIL,,ATL,W 122-117,240,41,86,.477,30,61,.492,11,25,.440,29,32,.906,122
2841,2018-03-17,HOU,@,NOP,W 107-101,240,39,93,.419,24,52,.462,15,41,.366,14,18,.778,107
2842,2018-03-17,NOP,,HOU,L 101-107,240,41,83,.494,33,59,.559,8,24,.333,11,12,.917,101
2843,2018-03-17,CHA,@,NYK,L 101-124,240,33,90,.367,24,57,.421,9,33,.273,26,32,.813,101
2844,2018-03-17,NYK,,CHO,W 124-101,240,49,100,.490,37,74,.500,12,26,.462,14,18,.778,124
2845,2018-03-17,GSW,@,PHO,W 124-109,240,50,95,.526,37,64,.578,13,31,.419,11,14,.786,124
2846,2018-03-17,PHO,,GSW,L 109-124,240,39,82,.476,28,58,.483,11,24,.458,20,29,.690,109
2847,2018-03-17,DET,@,POR,L 87-100,240,31,80,.388,21,55,.382,10,25,.400,15,20,.750,87
2848,2018-03-17,POR,,DET,W 100-87,240,38,87,.437,30,56,.536,8,31,.258,16,18,.889,100
2849,2018-03-17,MIN,@,SAS,L 101-117,240,39,81,.481,32,69,.464,7,12,.583,16,20,.800,101
2850,2018-03-17,SAS,,MIN,W 117-101,240,49,96,.510,43,70,.614,6,26,.231,13,14,.929,117
2851,2018-03-17,SAC,@,UTA,L 97-103,240,37,86,.430,23,65,.354,14,21,.667,9,14,.643,97
2852,2018-03-17,UTA,,SAC,W 103-97,240,33,74,.446,27,50,.540,6,24,.250,31,38,.816,103
2853,2018-03-17,IND,@,WAS,L 102-109,240,39,86,.453,27,62,.435,12,24,.500,12,15,.800,102
2854,2018-03-17,WAS,,IND,W 109-102,240,40,74,.541,30,54,.556,10,20,.500,19,23,.826,109
2855,2018-03-16,GSW,,SAC,L 93-98,240,34,81,.420,22,55,.400,12,26,.462,13,18,.722,93
2856,2018-03-16,SAC,@,GSW,W 98-93,240,36,83,.434,22,52,.423,14,31,.452,12,17,.706,98
2857,2018-03-16,LAL,,MIA,L 91-92,240,32,76,.421,23,57,.404,9,19,.474,18,22,.818,91
2858,2018-03-16,MIA,@,LAL,W 92-91,240,36,94,.383,26,58,.448,10,36,.278,10,14,.714,92
2859,2018-03-16,LAC,@,OKC,L 113-121,240,42,86,.488,31,60,.517,11,26,.423,18,23,.783,113
2860,2018-03-16,OKC,,LAC,W 121-113,240,46,94,.489,35,62,.565,11,32,.344,18,22,.818,121
2861,2018-03-16,BOS,@,ORL,W 92-83,240,31,82,.378,22,56,.393,9,26,.346,21,28,.750,92
2862,2018-03-16,ORL,,BOS,L 83-92,240,34,87,.391,29,59,.492,5,28,.179,10,11,.909,83
2863,2018-03-16,BRK,@,PHI,L 116-120,240,40,89,.449,25,59,.424,15,30,.500,21,27,.778,116
2864,2018-03-16,PHI,,BRK,W 120-116,240,43,95,.453,31,68,.456,12,27,.444,22,26,.846,120
2865,2018-03-16,DAL,@,TOR,L 115-122 (OT),265,48,91,.527,42,69,.609,6,22,.273,13,18,.722,115
2866,2018-03-16,TOR,,DAL,W 122-115 (OT),265,43,91,.473,33,61,.541,10,30,.333,26,31,.839,122
2867,2018-03-15,ATL,,CHO,L 117-129,240,42,90,.467,26,54,.481,16,36,.444,17,26,.654,117
2868,2018-03-15,CHA,@,ATL,W 129-117,240,46,87,.529,29,54,.537,17,33,.515,20,30,.667,129
2869,2018-03-15,DEN,,DET,W 120-113,240,43,85,.506,31,57,.544,12,28,.429,22,28,.786,120
2870,2018-03-15,DET,@,DEN,L 113-120,240,44,92,.478,30,65,.462,14,27,.519,11,17,.647,113
2871,2018-03-15,HOU,,LAC,W 101-96,240,35,90,.389,23,49,.469,12,41,.293,19,23,.826,101
2872,2018-03-15,LAC,@,HOU,L 96-101,240,44,97,.454,40,79,.506,4,18,.222,4,8,.500,96
2873,2018-03-15,IND,,TOR,L 99-106,240,40,93,.430,33,69,.478,7,24,.292,12,17,.706,99
2874,2018-03-15,TOR,@,IND,W 106-99,240,35,79,.443,23,47,.489,12,32,.375,24,28,.857,106
2875,2018-03-15,CHI,@,MEM,W 111-110,240,35,80,.438,20,39,.513,15,41,.366,26,33,.788,111
2876,2018-03-15,MEM,,CHI,L 110-111,240,38,87,.437,25,52,.481,13,35,.371,21,25,.840,110
2877,2018-03-15,NYK,,PHI,L 110-118,240,45,87,.517,40,67,.597,5,20,.250,15,24,.625,110
2878,2018-03-15,PHI,@,NYK,W 118-110,240,41,91,.451,26,54,.481,15,37,.405,21,34,.618,118
2879,2018-03-15,CLE,@,POR,L 105-113,240,41,80,.513,30,47,.638,11,33,.333,12,21,.571,105
2880,2018-03-15,POR,,CLE,W 113-105,240,43,96,.448,31,61,.508,12,35,.343,15,19,.789,113
2881,2018-03-15,NOP,@,SAS,L 93-98,240,36,90,.400,30,74,.405,6,16,.375,15,16,.938,93
2882,2018-03-15,SAS,,NOP,W 98-93,240,37,99,.374,30,73,.411,7,26,.269,17,19,.895,98
2883,2018-03-15,PHO,@,UTA,L 88-116,240,32,83,.386,25,67,.373,7,16,.438,17,24,.708,88
2884,2018-03-15,UTA,,PHO,W 116-88,240,42,97,.433,30,61,.492,12,36,.333,20,32,.625,116
2885,2018-03-14,BOS,,WAS,L 124-125 (2OT),290,48,99,.485,36,73,.493,12,26,.462,16,23,.696,124
2886,2018-03-14,WAS,@,BOS,W 125-124 (2OT),290,46,97,.474,34,65,.523,12,32,.375,21,28,.750,125
2887,2018-03-14,GSW,,LAL,W 117-106,240,44,81,.543,38,61,.623,6,20,.300,23,28,.821,117
2888,2018-03-14,LAL,@,GSW,L 106-117,240,38,84,.452,26,46,.565,12,38,.316,18,28,.643,106
2889,2018-03-14,MIL,@,ORL,L 117-126,240,49,98,.500,39,74,.527,10,24,.417,9,12,.750,117
2890,2018-03-14,ORL,,MIL,W 126-117,240,44,87,.506,26,53,.491,18,34,.529,20,23,.870,126
2891,2018-03-14,MIA,@,SAC,L 119-123 (OT),265,41,99,.414,23,56,.411,18,43,.419,19,21,.905,119
2892,2018-03-14,SAC,,MIA,W 123-119 (OT),265,48,94,.511,40,70,.571,8,24,.333,19,25,.760,123
2893,2018-03-13,ATL,,OKC,L 107-119,240,37,87,.425,24,56,.429,13,31,.419,20,24,.833,107
2894,2018-03-13,OKC,@,ATL,W 119-107,240,42,89,.472,26,54,.481,16,35,.457,19,25,.760,119
2895,2018-03-13,BRK,,TOR,L 102-116,240,35,86,.407,20,50,.400,15,36,.417,17,19,.895,102
2896,2018-03-13,TOR,@,BRK,W 116-102,240,44,91,.484,33,60,.550,11,31,.355,17,21,.810,116
2897,2018-03-13,CHI,,LAC,L 106-112,240,43,101,.426,36,72,.500,7,29,.241,13,15,.867,106
2898,2018-03-13,LAC,@,CHI,W 112-106,240,37,76,.487,29,47,.617,8,29,.276,30,41,.732,112
2899,2018-03-13,DEN,@,LAL,L 103-112,240,38,86,.442,25,46,.543,13,40,.325,14,19,.737,103
2900,2018-03-13,LAL,,DEN,W 112-103,240,40,90,.444,25,50,.500,15,40,.375,17,25,.680,112
2901,2018-03-13,CHA,@,NOP,L 115-119,240,45,93,.484,38,67,.567,7,26,.269,18,22,.818,115
2902,2018-03-13,NOP,,CHO,W 119-115,240,52,104,.500,43,82,.524,9,22,.409,6,8,.750,119
2903,2018-03-13,DAL,@,NYK,W 110-97,240,40,89,.449,26,54,.481,14,35,.400,16,18,.889,110
2904,2018-03-13,NYK,,DAL,L 97-110,240,40,82,.488,32,57,.561,8,25,.320,9,12,.750,97
2905,2018-03-13,IND,@,PHI,W 101-98,240,38,95,.400,33,71,.465,5,24,.208,20,25,.800,101
2906,2018-03-13,PHI,,IND,L 98-101,240,35,75,.467,25,45,.556,10,30,.333,18,22,.818,98
2907,2018-03-13,CLE,@,PHO,W 129-107,240,43,87,.494,26,52,.500,17,35,.486,26,30,.867,129
2908,2018-03-13,PHO,,CLE,L 107-129,240,38,98,.388,32,66,.485,6,32,.188,25,30,.833,107
2909,2018-03-13,ORL,@,SAS,L 72-108,240,28,82,.341,21,59,.356,7,23,.304,9,9,1.000,72
2910,2018-03-13,SAS,,ORL,W 108-72,240,40,84,.476,31,65,.477,9,19,.474,19,23,.826,108
2911,2018-03-13,DET,@,UTA,L 79-110,240,30,80,.375,25,55,.455,5,25,.200,14,19,.737,79
2912,2018-03-13,UTA,,DET,W 110-79,240,42,76,.553,29,42,.690,13,34,.382,13,23,.565,110
2913,2018-03-13,MIN,@,WAS,W 116-111,240,46,87,.529,39,66,.591,7,21,.333,17,19,.895,116
2914,2018-03-13,WAS,,MIN,L 111-116,240,42,82,.512,34,62,.548,8,20,.400,19,25,.760,111
2915,2018-03-12,HOU,,SAS,W 109-93,240,39,80,.488,26,36,.722,13,44,.295,18,23,.783,109
2916,2018-03-12,SAS,@,HOU,L 93-109,240,33,81,.407,22,53,.415,11,28,.393,16,23,.696,93
2917,2018-03-12,MEM,,MIL,L 103-121,240,42,89,.472,33,62,.532,9,27,.333,10,19,.526,103
2918,2018-03-12,MIL,@,MEM,W 121-103,240,47,81,.580,35,56,.625,12,25,.480,15,22,.682,121
2919,2018-03-12,OKC,,SAC,W 106-101,240,38,84,.452,22,48,.458,16,36,.444,14,18,.778,106
2920,2018-03-12,SAC,@,OKC,L 101-106,240,38,93,.409,26,60,.433,12,33,.364,13,16,.813,101
2921,2018-03-12,MIA,@,POR,L 99-115,240,39,91,.429,29,60,.483,10,31,.323,11,16,.688,99
2922,2018-03-12,POR,,MIA,W 115-99,240,38,83,.458,24,47,.511,14,36,.389,25,30,.833,115
2923,2018-03-11,ATL,,CHI,L 122-129,240,42,82,.512,23,42,.548,19,40,.475,19,22,.864,122
2924,2018-03-11,CHI,@,ATL,W 129-122,240,48,98,.490,31,61,.508,17,37,.459,16,19,.842,129
2925,2018-03-11,BOS,,IND,L 97-99,240,34,81,.420,22,44,.500,12,37,.324,17,21,.810,97
2926,2018-03-11,IND,@,BOS,W 99-97,240,39,81,.481,27,59,.458,12,22,.545,9,10,.900,99
2927,2018-03-11,BRK,,PHI,L 97-120,240,33,85,.388,23,57,.404,10,28,.357,21,24,.875,97
2928,2018-03-11,PHI,@,BRK,W 120-97,240,50,95,.526,41,69,.594,9,26,.346,11,18,.611,120
2929,2018-03-11,DAL,,HOU,L 82-105,240,33,94,.351,28,63,.444,5,31,.161,11,18,.611,82
2930,2018-03-11,HOU,@,DAL,W 105-82,240,39,84,.464,22,39,.564,17,45,.378,10,14,.714,105
2931,2018-03-11,DEN,,SAC,W 130-104,240,50,89,.562,35,52,.673,15,37,.405,15,21,.714,130
2932,2018-03-11,SAC,@,DEN,L 104-130,240,39,91,.429,33,60,.550,6,31,.194,20,26,.769,104
2933,2018-03-11,CLE,@,LAL,L 113-127,240,41,88,.466,29,57,.509,12,31,.387,19,23,.826,113
2934,2018-03-11,LAL,,CLE,W 127-113,240,48,96,.500,35,62,.565,13,34,.382,18,20,.900,127
2935,2018-03-11,GSW,@,MIN,L 103-109,240,37,91,.407,27,55,.491,10,36,.278,19,21,.905,103
2936,2018-03-11,MIN,,GSW,W 109-103,240,44,95,.463,38,75,.507,6,20,.300,15,21,.714,109
2937,2018-03-11,NOP,,UTA,L 99-116,240,41,93,.441,35,72,.486,6,21,.286,11,13,.846,99
2938,2018-03-11,UTA,@,NOP,W 116-99,240,40,96,.417,28,64,.438,12,32,.375,24,25,.960,116
2939,2018-03-11,NYK,,TOR,L 106-132,240,40,88,.455,33,67,.493,7,21,.333,19,24,.792,106
2940,2018-03-11,TOR,@,NYK,W 132-106,240,47,93,.505,31,58,.534,16,35,.457,22,25,.880,132
2941,2018-03-10,CHA,,PHO,W 122-115,240,44,87,.506,31,55,.564,13,32,.406,21,27,.778,122
2942,2018-03-10,PHO,@,CHO,L 115-122,240,42,83,.506,24,51,.471,18,32,.563,13,19,.684,115
2943,2018-03-10,DAL,,MEM,W 114-80,240,37,77,.481,27,48,.563,10,29,.345,30,35,.857,114
2944,2018-03-10,MEM,@,DAL,L 80-114,240,30,84,.357,23,66,.348,7,18,.389,13,17,.765,80
2945,2018-03-10,LAC,,ORL,W 113-105,240,41,78,.526,34,60,.567,7,18,.389,24,28,.857,113
2946,2018-03-10,ORL,@,LAC,L 105-113,240,38,84,.452,30,60,.500,8,24,.333,21,27,.778,105
2947,2018-03-10,MIA,,WAS,W 129-102,240,52,88,.591,42,60,.700,10,28,.357,15,21,.714,129
2948,2018-03-10,WAS,@,MIA,L 102-129,240,34,77,.442,27,57,.474,7,20,.350,27,34,.794,102
2949,2018-03-10,OKC,,SAS,W 104-94,240,39,85,.459,29,57,.509,10,28,.357,16,24,.667,104
2950,2018-03-10,SAS,@,OKC,L 94-104,240,40,86,.465,30,66,.455,10,20,.500,4,7,.571,94
2951,2018-03-09,DEN,,LAL,W 125-116,240,42,83,.506,27,52,.519,15,31,.484,26,30,.867,125
2952,2018-03-09,LAL,@,DEN,L 116-125,240,45,92,.489,31,57,.544,14,35,.400,12,16,.750,116
2953,2018-03-09,CHI,@,DET,L 83-99,240,33,93,.355,24,62,.387,9,31,.290,8,10,.800,83
2954,2018-03-09,DET,,CHI,W 99-83,240,38,81,.469,29,54,.537,9,27,.333,14,18,.778,99
2955,2018-03-09,ATL,@,IND,L 87-112,240,34,82,.415,24,49,.490,10,33,.303,9,10,.900,87
2956,2018-03-09,IND,,ATL,W 112-87,240,45,91,.495,31,63,.492,14,28,.500,8,10,.800,112
2957,2018-03-09,CLE,@,LAC,L 102-116,240,39,87,.448,27,51,.529,12,36,.333,12,18,.667,102
2958,2018-03-09,LAC,,CLE,W 116-102,240,43,89,.483,32,61,.525,11,28,.393,19,30,.633,116
2959,2018-03-09,MEM,,UTA,L 78-95,240,31,83,.373,25,61,.410,6,22,.273,10,14,.714,78
2960,2018-03-09,UTA,@,MEM,W 95-78,240,33,74,.446,20,42,.476,13,32,.406,16,22,.727,95
2961,2018-03-09,MIL,,NYK,W 120-112,240,41,73,.562,33,55,.600,8,18,.444,30,39,.769,120
2962,2018-03-09,NYK,@,MIL,L 112-120,240,47,98,.480,40,70,.571,7,28,.250,11,14,.786,112
2963,2018-03-09,NOP,,WAS,L 97-116,240,38,82,.463,32,62,.516,6,20,.300,15,18,.833,97
2964,2018-03-09,WAS,@,NOP,W 116-97,240,46,96,.479,37,70,.529,9,26,.346,15,20,.750,116
2965,2018-03-09,GSW,@,POR,L 108-125,240,38,78,.487,26,50,.520,12,28,.429,20,24,.833,108
2966,2018-03-09,POR,,GSW,W 125-108,240,44,89,.494,28,50,.560,16,39,.410,21,27,.778,125
2967,2018-03-09,ORL,@,SAC,L 88-94,240,33,78,.423,24,49,.490,9,29,.310,13,16,.813,88
2968,2018-03-09,SAC,,ORL,W 94-88,240,36,83,.434,27,58,.466,9,25,.360,13,15,.867,94
2969,2018-03-09,HOU,@,TOR,L 105-108,240,40,81,.494,31,54,.574,9,27,.333,16,23,.696,105
2970,2018-03-09,TOR,,HOU,W 108-105,240,41,85,.482,26,47,.553,15,38,.395,11,14,.786,108
2971,2018-03-08,BRK,@,CHO,W 125-111,240,47,92,.511,36,60,.600,11,32,.344,20,22,.909,125
2972,2018-03-08,CHA,,BRK,L 111-125,240,41,85,.482,37,66,.561,4,19,.211,25,30,.833,111
2973,2018-03-08,GSW,,SAS,W 110-107,240,41,95,.432,33,65,.508,8,30,.267,20,23,.870,110
2974,2018-03-08,SAS,@,GSW,L 107-110,240,43,95,.453,37,73,.507,6,22,.273,15,18,.833,107
2975,2018-03-08,MIA,,PHI,W 108-99,240,42,89,.472,28,63,.444,14,26,.538,10,18,.556,108
2976,2018-03-08,PHI,@,MIA,L 99-108,240,34,86,.395,19,49,.388,15,37,.405,16,21,.762,99
2977,2018-03-08,BOS,@,MIN,W 117-109,240,43,87,.494,32,55,.582,11,32,.344,20,27,.741,117
2978,2018-03-08,MIN,,BOS,L 109-117,240,44,94,.468,32,63,.508,12,31,.387,9,13,.692,109
2979,2018-03-08,OKC,,PHO,W 115-87,240,42,80,.525,29,47,.617,13,33,.394,18,27,.667,115
2980,2018-03-08,PHO,@,OKC,L 87-115,240,31,92,.337,22,55,.400,9,37,.243,16,18,.889,87
2981,2018-03-07,CHI,,MEM,W 119-110,240,42,79,.532,31,50,.620,11,29,.379,24,32,.750,119
2982,2018-03-07,MEM,@,CHI,L 110-119,240,40,82,.488,30,53,.566,10,29,.345,20,25,.800,110
2983,2018-03-07,CLE,@,DEN,W 113-108,240,44,87,.506,31,58,.534,13,29,.448,12,18,.667,113
2984,2018-03-07,DEN,,CLE,L 108-113,240,42,86,.488,32,59,.542,10,27,.370,14,18,.778,108
2985,2018-03-07,DET,,TOR,L 119-121 (OT),265,44,90,.489,31,64,.484,13,26,.500,18,23,.783,119
2986,2018-03-07,TOR,@,DET,W 121-119 (OT),265,45,101,.446,33,61,.541,12,40,.300,19,21,.905,121
2987,2018-03-07,IND,,UTA,L 84-104,240,34,88,.386,31,65,.477,3,23,.130,13,17,.765,84
2988,2018-03-07,UTA,@,IND,W 104-84,240,41,80,.513,30,49,.612,11,31,.355,11,16,.688,104
2989,2018-03-07,LAL,,ORL,W 108-107,240,43,88,.489,32,55,.582,11,33,.333,11,12,.917,108
2990,2018-03-07,ORL,@,LAL,L 107-108,240,42,84,.500,30,56,.536,12,28,.429,11,19,.579,107
2991,2018-03-07,HOU,@,MIL,W 110-99,240,39,82,.476,25,42,.595,14,40,.350,18,27,.667,110
2992,2018-03-07,MIL,,HOU,L 99-110,240,38,83,.458,29,55,.527,9,28,.321,14,19,.737,99
2993,2018-03-07,NOP,@,SAC,W 114-101,240,47,83,.566,36,57,.632,11,26,.423,9,9,1.000,114
2994,2018-03-07,SAC,,NOP,L 101-114,240,39,93,.419,30,65,.462,9,28,.321,14,17,.824,101
2995,2018-03-06,CHA,,PHI,L 114-128,240,40,80,.500,29,51,.569,11,29,.379,23,31,.742,114
2996,2018-03-06,PHI,@,CHO,W 128-114,240,50,87,.575,34,54,.630,16,33,.485,12,15,.800,128
2997,2018-03-06,DAL,,DEN,W 118-107,240,43,90,.478,28,63,.444,15,27,.556,17,23,.739,118
2998,2018-03-06,DEN,@,DAL,L 107-118,240,38,92,.413,27,56,.482,11,36,.306,20,26,.769,107
2999,2018-03-06,BRK,@,GSW,L 101-114,240,36,85,.424,27,51,.529,9,34,.265,20,25,.800,101
3000,2018-03-06,GSW,,BRK,W 114-101,240,47,83,.566,36,60,.600,11,23,.478,9,11,.818,114
3001,2018-03-06,LAC,,NOP,L 116-121,240,46,99,.465,39,72,.542,7,27,.259,17,26,.654,116
3002,2018-03-06,NOP,@,LAC,W 121-116,240,46,103,.447,33,73,.452,13,30,.433,16,18,.889,121
3003,2018-03-06,HOU,@,OKC,W 122-112,240,38,72,.528,21,39,.538,17,33,.515,29,34,.853,122
3004,2018-03-06,OKC,,HOU,L 112-122,240,46,93,.495,34,59,.576,12,34,.353,8,11,.727,112
3005,2018-03-06,NYK,@,POR,L 87-111,240,35,83,.422,28,64,.438,7,19,.368,10,15,.667,87
3006,2018-03-06,POR,,NYK,W 111-87,240,35,81,.432,15,48,.313,20,33,.606,21,24,.875,111
3007,2018-03-06,ATL,@,TOR,L 90-106,240,34,80,.425,28,59,.475,6,21,.286,16,21,.762,90
3008,2018-03-06,TOR,,ATL,W 106-90,240,34,88,.386,24,52,.462,10,36,.278,28,33,.848,106
3009,2018-03-06,MIA,@,WAS,L 113-117 (OT),265,42,94,.447,33,61,.541,9,33,.273,20,27,.741,113
3010,2018-03-06,WAS,,MIA,W 117-113 (OT),265,40,80,.500,26,56,.464,14,24,.583,23,27,.852,117
3011,2018-03-05,BOS,@,CHI,W 105-89,240,41,84,.488,29,48,.604,12,36,.333,11,12,.917,105
3012,2018-03-05,CHI,,BOS,L 89-105,240,32,81,.395,20,48,.417,12,33,.364,13,20,.650,89
3013,2018-03-05,CLE,,DET,W 112-90,240,43,88,.489,31,55,.564,12,33,.364,14,17,.824,112
3014,2018-03-05,DET,@,CLE,L 90-112,240,34,87,.391,22,53,.415,12,34,.353,10,15,.667,90
3015,2018-03-05,IND,,MIL,W 92-89,240,33,77,.429,23,60,.383,10,17,.588,16,21,.762,92
3016,2018-03-05,MIL,@,IND,L 89-92,240,34,76,.447,27,53,.509,7,23,.304,14,16,.875,89
3017,2018-03-05,LAL,,POR,L 103-108,240,34,87,.391,23,50,.460,11,37,.297,24,31,.774,103
3018,2018-03-05,POR,@,LAL,W 108-103,240,35,83,.422,25,60,.417,10,23,.435,28,38,.737,108
3019,2018-03-05,MIA,,PHO,W 125-103,240,47,92,.511,35,56,.625,12,36,.333,19,23,.826,125
3020,2018-03-05,PHO,@,MIA,L 103-125,240,42,87,.483,32,63,.508,10,24,.417,9,18,.500,103
3021,2018-03-05,MEM,@,SAS,L 98-100,240,42,80,.525,34,58,.586,8,22,.364,6,9,.667,98
3022,2018-03-05,SAS,,MEM,W 100-98,240,35,76,.461,29,54,.537,6,22,.273,24,31,.774,100
3023,2018-03-05,ORL,@,UTA,L 80-94,240,29,85,.341,18,51,.353,11,34,.324,11,14,.786,80
3024,2018-03-05,UTA,,ORL,W 94-80,240,36,73,.493,26,42,.619,10,31,.323,12,18,.667,94
3025,2018-03-04,ATL,,PHO,W 113-112,240,43,94,.457,26,61,.426,17,33,.515,10,12,.833,113
3026,2018-03-04,PHO,@,ATL,L 112-113,240,46,92,.500,35,66,.530,11,26,.423,9,15,.600,112
3027,2018-03-04,DAL,,NOP,L 109-126,240,40,90,.444,30,67,.448,10,23,.435,19,25,.760,109
3028,2018-03-04,NOP,@,DAL,W 126-109,240,49,91,.538,37,65,.569,12,26,.462,16,21,.762,126
3029,2018-03-04,BRK,@,LAC,L 120-123,240,40,92,.435,21,47,.447,19,45,.422,21,23,.913,120
3030,2018-03-04,LAC,,BRK,W 123-120,240,44,84,.524,34,57,.596,10,27,.370,25,30,.833,123
3031,2018-03-04,MIL,,PHI,W 118-110,240,47,95,.495,37,72,.514,10,23,.435,14,22,.636,118
3032,2018-03-04,PHI,@,MIL,L 110-118,240,39,70,.557,25,42,.595,14,28,.500,18,22,.818,110
3033,2018-03-04,NYK,@,SAC,L 99-102,240,40,88,.455,34,67,.507,6,21,.286,13,18,.722,99
3034,2018-03-04,SAC,,NYK,W 102-99,240,39,86,.453,26,56,.464,13,30,.433,11,11,1.000,102
3035,2018-03-04,CHA,@,TOR,L 98-103,240,32,85,.376,27,64,.422,5,21,.238,29,35,.829,98
3036,2018-03-04,TOR,,CHO,W 103-98,240,35,83,.422,23,42,.548,12,41,.293,21,27,.778,103
3037,2018-03-04,IND,@,WAS,W 98-95,240,34,77,.442,26,52,.500,8,25,.320,22,24,.917,98
3038,2018-03-04,WAS,,IND,L 95-98,240,35,83,.422,25,56,.446,10,27,.370,15,19,.789,95
3039,2018-03-03,CLE,,DEN,L 117-126,240,46,88,.523,37,64,.578,9,24,.375,16,21,.762,117
3040,2018-03-03,DEN,@,CLE,W 126-117,240,47,86,.547,28,51,.549,19,35,.543,13,15,.867,126
3041,2018-03-03,BOS,@,HOU,L 120-123,240,44,91,.484,31,67,.463,13,24,.542,19,21,.905,120
3042,2018-03-03,HOU,,BOS,W 123-120,240,39,87,.448,20,38,.526,19,49,.388,26,30,.867,123
3043,2018-03-03,DET,@,MIA,L 96-105,240,37,89,.416,30,65,.462,7,24,.292,15,21,.714,96
3044,2018-03-03,MIA,,DET,W 105-96,240,37,82,.451,25,53,.472,12,29,.414,19,28,.679,105
3045,2018-03-03,MEM,@,ORL,L 100-107,240,38,93,.409,32,71,.451,6,22,.273,18,26,.692,100
3046,2018-03-03,ORL,,MEM,W 107-100,240,36,72,.500,28,47,.596,8,25,.320,27,33,.818,107
3047,2018-03-03,OKC,@,POR,L 100-108,240,40,91,.440,34,64,.531,6,27,.222,14,21,.667,100
3048,2018-03-03,POR,,OKC,W 108-100,240,39,88,.443,28,55,.509,11,33,.333,19,23,.826,108
3049,2018-03-03,SAC,,UTA,L 91-98,240,34,89,.382,25,59,.424,9,30,.300,14,17,.824,91
3050,2018-03-03,UTA,@,SAC,W 98-91,240,34,82,.415,23,50,.460,11,32,.344,19,29,.655,98
3051,2018-03-03,LAL,@,SAS,W 116-112,240,40,92,.435,25,58,.431,15,34,.441,21,27,.778,116
3052,2018-03-03,SAS,,LAL,L 112-116,240,44,98,.449,37,68,.544,7,30,.233,17,20,.850,112
3053,2018-03-02,ATL,,GSW,L 109-114,240,38,86,.442,23,51,.451,15,35,.429,18,20,.900,109
3054,2018-03-02,GSW,@,ATL,W 114-109,240,42,79,.532,31,48,.646,11,31,.355,19,22,.864,114
3055,2018-03-02,CHI,,DAL,W 108-100,240,42,89,.472,32,62,.516,10,27,.370,14,20,.700,108
3056,2018-03-02,DAL,@,CHI,L 100-108,240,35,84,.417,22,55,.400,13,29,.448,17,21,.810,100
3057,2018-03-02,LAC,,NYK,W 128-105,240,50,89,.562,41,64,.641,9,25,.360,19,24,.792,128
3058,2018-03-02,NYK,@,LAC,L 105-128,240,41,89,.461,30,64,.469,11,25,.440,12,16,.750,105
3059,2018-03-02,DEN,@,MEM,W 108-102,240,40,73,.548,34,51,.667,6,22,.273,22,26,.846,108
3060,2018-03-02,MEM,,DEN,L 102-108,240,40,91,.440,30,64,.469,10,27,.370,12,15,.800,102
3061,2018-03-02,IND,@,MIL,W 103-96,240,37,83,.446,31,67,.463,6,16,.375,23,30,.767,103
3062,2018-03-02,MIL,,IND,L 96-103,240,31,81,.383,22,56,.393,9,25,.360,25,32,.781,96
3063,2018-03-02,DET,@,ORL,L 106-115 (OT),265,40,92,.435,28,63,.444,12,29,.414,14,24,.583,106
3064,2018-03-02,ORL,,DET,W 115-106 (OT),265,44,86,.512,31,50,.620,13,36,.361,14,19,.737,115
3065,2018-03-02,CHA,@,PHI,L 99-110,240,34,81,.420,23,57,.404,11,24,.458,20,32,.625,99
3066,2018-03-02,PHI,,CHO,W 110-99,240,41,81,.506,32,57,.561,9,24,.375,19,25,.760,110
3067,2018-03-02,OKC,@,PHO,W 124-116,240,46,96,.479,35,62,.565,11,34,.324,21,29,.724,124
3068,2018-03-02,PHO,,OKC,L 116-124,240,46,96,.479,35,71,.493,11,25,.440,13,18,.722,116
3069,2018-03-02,MIN,@,UTA,L 108-116,240,38,74,.514,29,57,.509,9,17,.529,23,31,.742,108
3070,2018-03-02,UTA,,MIN,W 116-108,240,40,78,.513,31,49,.633,9,29,.310,27,35,.771,116
3071,2018-03-02,TOR,@,WAS,W 102-95,240,36,78,.462,26,45,.578,10,33,.303,20,32,.625,102
3072,2018-03-02,WAS,,TOR,L 95-102,240,36,79,.456,27,55,.491,9,24,.375,14,21,.667,95
3073,2018-03-01,CLE,,PHI,L 97-108,240,36,87,.414,27,55,.491,9,32,.281,16,23,.696,97
3074,2018-03-01,PHI,@,CLE,W 108-97,240,40,90,.444,30,60,.500,10,30,.333,18,27,.667,108
3075,2018-03-01,LAL,@,MIA,W 131-113,240,47,79,.595,31,50,.620,16,29,.552,21,26,.808,131
3076,2018-03-01,MIA,,LAL,L 113-131,240,46,95,.484,37,64,.578,9,31,.290,12,16,.750,113
3077,2018-03-01,MIN,@,POR,L 99-108,240,38,85,.447,34,65,.523,4,20,.200,19,21,.905,99
3078,2018-03-01,POR,,MIN,W 108-99,240,36,92,.391,27,62,.435,9,30,.300,27,35,.771,108
3079,2018-03-01,BRK,@,SAC,L 111-116 (OT),265,40,96,.417,23,50,.460,17,46,.370,14,17,.824,111
3080,2018-03-01,SAC,,BRK,W 116-111 (OT),265,50,97,.515,44,83,.530,6,14,.429,10,12,.833,116
3081,2018-02-28,ATL,,IND,W 107-102,240,38,87,.437,29,58,.500,9,29,.310,22,27,.815,107
3082,2018-02-28,IND,@,ATL,L 102-107,240,38,90,.422,27,58,.466,11,32,.344,15,20,.750,102
3083,2018-02-28,BOS,,CHO,W 134-106,240,54,87,.621,42,67,.627,12,20,.600,14,15,.933,134
3084,2018-02-28,CHA,@,BOS,L 106-134,240,42,91,.462,33,64,.516,9,27,.333,13,22,.591,106
3085,2018-02-28,DAL,,OKC,L 110-111 (OT),265,44,91,.484,31,55,.564,13,36,.361,9,15,.600,110
3086,2018-02-28,OKC,@,DAL,W 111-110 (OT),265,42,93,.452,32,57,.561,10,36,.278,17,19,.895,111
3087,2018-02-28,DET,,MIL,W 110-87,240,42,95,.442,33,66,.500,9,29,.310,17,22,.773,110
3088,2018-02-28,MIL,@,DET,L 87-110,240,28,73,.384,20,49,.408,8,24,.333,23,28,.821,87
3089,2018-02-28,HOU,@,LAC,W 105-92,240,36,85,.424,23,42,.548,13,43,.302,20,24,.833,105
3090,2018-02-28,LAC,,HOU,L 92-105,240,36,79,.456,29,56,.518,7,23,.304,13,19,.684,92
3091,2018-02-28,MEM,,PHO,L 102-110,240,33,87,.379,20,56,.357,13,31,.419,23,28,.821,102
3092,2018-02-28,PHO,@,MEM,W 110-102,240,38,83,.458,32,62,.516,6,21,.286,28,38,.737,110
3093,2018-02-28,ORL,,TOR,L 104-117,240,39,82,.476,26,52,.500,13,30,.433,13,23,.565,104
3094,2018-02-28,TOR,@,ORL,W 117-104,240,45,83,.542,33,53,.623,12,30,.400,15,24,.625,117
3095,2018-02-28,NOP,@,SAS,W 121-116,240,50,99,.505,41,73,.562,9,26,.346,12,15,.800,121
3096,2018-02-28,SAS,,NOP,L 116-121,240,48,99,.485,39,73,.534,9,26,.346,11,14,.786,116
3097,2018-02-28,GSW,@,WAS,W 109-101,240,37,72,.514,27,48,.563,10,24,.417,25,30,.833,109
3098,2018-02-28,WAS,,GSW,L 101-109,240,36,90,.400,25,58,.431,11,32,.344,18,21,.857,101
3099,2018-02-27,CHI,@,CHO,L 103-118,240,39,81,.481,30,57,.526,9,24,.375,16,21,.762,103
3100,2018-02-27,CHA,,CHI,W 118-103,240,44,82,.537,29,47,.617,15,35,.429,15,21,.714,118
3101,2018-02-27,BRK,@,CLE,L 123-129,240,44,82,.537,32,50,.640,12,32,.375,23,30,.767,123
3102,2018-02-27,CLE,,BRK,W 129-123,240,50,97,.515,38,73,.521,12,24,.500,17,27,.630,129
3103,2018-02-27,DEN,,LAC,L 120-122,240,43,87,.494,33,56,.589,10,31,.323,24,30,.800,120
3104,2018-02-27,LAC,@,DEN,W 122-120,240,46,89,.517,39,63,.619,7,26,.269,23,31,.742,122
3105,2018-02-27,MIA,,PHI,W 102-101,240,36,82,.439,27,55,.491,9,27,.333,21,28,.750,102
3106,2018-02-27,PHI,@,MIA,L 101-102,240,35,84,.417,23,53,.434,12,31,.387,19,23,.826,101
3107,2018-02-27,MIL,,WAS,L 104-107,240,35,77,.455,25,51,.490,10,26,.385,24,28,.857,104
3108,2018-02-27,WAS,@,MIL,W 107-104,240,42,88,.477,35,68,.515,7,20,.350,16,22,.727,107
3109,2018-02-27,POR,,SAC,W 116-99,240,44,84,.524,29,50,.580,15,34,.441,13,17,.765,116
3110,2018-02-27,SAC,@,POR,L 99-116,240,39,88,.443,32,66,.485,7,22,.318,14,15,.933,99
3111,2018-02-26,ATL,,LAL,L 104-123,240,36,96,.375,28,60,.467,8,36,.222,24,34,.706,104
3112,2018-02-26,LAL,@,ATL,W 123-104,240,47,90,.522,32,57,.561,15,33,.455,14,19,.737,123
3113,2018-02-26,BOS,,MEM,W 109-98,240,39,86,.453,27,49,.551,12,37,.324,19,27,.704,109
3114,2018-02-26,MEM,@,BOS,L 98-109,240,34,78,.436,29,55,.527,5,23,.217,25,32,.781,98
3115,2018-02-26,BRK,,CHI,W 104-87,240,40,90,.444,24,48,.500,16,42,.381,8,8,1.000,104
3116,2018-02-26,CHI,@,BRK,L 87-104,240,33,93,.355,27,70,.386,6,23,.261,15,23,.652,87
3117,2018-02-26,DAL,,IND,W 109-103,240,40,88,.455,26,51,.510,14,37,.378,15,18,.833,109
3118,2018-02-26,IND,@,DAL,L 103-109,240,41,87,.471,36,67,.537,5,20,.250,16,23,.696,103
3119,2018-02-26,NOP,,PHO,W 125-116,240,43,91,.473,35,63,.556,8,28,.286,31,40,.775,125
3120,2018-02-26,PHO,@,NOP,L 116-125,240,42,97,.433,35,73,.479,7,24,.292,25,32,.781,116
3121,2018-02-26,GSW,@,NYK,W 125-111,240,44,85,.518,29,54,.537,15,31,.484,22,26,.846,125
3122,2018-02-26,NYK,,GSW,L 111-125,240,47,96,.490,37,71,.521,10,25,.400,7,9,.778,111
3123,2018-02-26,OKC,,ORL,W 112-105,240,42,88,.477,31,63,.492,11,25,.440,17,20,.850,112
3124,2018-02-26,ORL,@,OKC,L 105-112,240,39,84,.464,27,55,.491,12,29,.414,15,21,.714,105
3125,2018-02-26,MIN,@,SAC,W 118-100,240,39,76,.513,32,60,.533,7,16,.438,33,36,.917,118
3126,2018-02-26,SAC,,MIN,L 100-118,240,40,84,.476,32,62,.516,8,22,.364,12,13,.923,100
3127,2018-02-26,DET,@,TOR,L 94-123,240,36,94,.383,29,72,.403,7,22,.318,15,20,.750,94
3128,2018-02-26,TOR,,DET,W 123-94,240,42,80,.525,25,42,.595,17,38,.447,22,23,.957,123
3129,2018-02-26,HOU,@,UTA,W 96-85,240,34,79,.430,25,46,.543,9,33,.273,19,25,.760,96
3130,2018-02-26,UTA,,HOU,L 85-96,240,31,71,.437,24,42,.571,7,29,.241,16,22,.727,85
3131,2018-02-25,CHA,,DET,W 114-98,240,42,88,.477,26,53,.491,16,35,.457,14,23,.609,114
3132,2018-02-25,DET,@,CHO,L 98-114,240,42,85,.494,38,67,.567,4,18,.222,10,14,.714,98
3133,2018-02-25,CLE,,SAS,L 94-110,240,38,91,.418,30,57,.526,8,34,.235,10,14,.714,94
3134,2018-02-25,SAS,@,CLE,W 110-94,240,38,86,.442,29,67,.433,9,19,.474,25,32,.781,110
3135,2018-02-25,DEN,,HOU,L 114-119,240,44,91,.484,34,62,.548,10,29,.345,16,24,.667,114
3136,2018-02-25,HOU,@,DEN,W 119-114,240,39,77,.506,24,42,.571,15,35,.429,26,32,.813,119
3137,2018-02-25,MIL,,NOP,L 121-123 (OT),265,44,96,.458,37,71,.521,7,25,.280,26,29,.897,121
3138,2018-02-25,NOP,@,MIL,W 123-121 (OT),265,51,107,.477,41,77,.532,10,30,.333,11,14,.786,123
3139,2018-02-25,PHI,@,WAS,L 94-109,240,31,86,.360,22,53,.415,9,33,.273,23,31,.742,94
3140,2018-02-25,WAS,,PHI,W 109-94,240,43,79,.544,31,54,.574,12,25,.480,11,12,.917,109
3141,2018-02-24,GSW,,OKC,W 112-80,240,42,89,.472,25,51,.490,17,38,.447,11,13,.846,112
3142,2018-02-24,OKC,@,GSW,L 80-112,240,29,88,.330,20,54,.370,9,34,.265,13,21,.619,80
3143,2018-02-24,MEM,@,MIA,L 89-115,240,35,80,.438,30,69,.435,5,11,.455,14,17,.824,89
3144,2018-02-24,MIA,,MEM,W 115-89,240,41,89,.461,29,56,.518,12,33,.364,21,27,.778,115
3145,2018-02-24,CHI,@,MIN,L 104-122,240,42,90,.467,36,67,.537,6,23,.261,14,20,.700,104
3146,2018-02-24,MIN,,CHI,W 122-104,240,46,94,.489,35,59,.593,11,35,.314,19,26,.731,122
3147,2018-02-24,BOS,@,NYK,W 121-112,240,42,93,.452,29,60,.483,13,33,.394,24,28,.857,121
3148,2018-02-24,NYK,,BOS,L 112-121,240,45,96,.469,39,69,.565,6,27,.222,16,20,.800,112
3149,2018-02-24,ORL,@,PHI,L 105-116,240,38,85,.447,25,54,.463,13,31,.419,16,19,.842,105
3150,2018-02-24,PHI,,ORL,W 116-105,240,42,81,.519,33,54,.611,9,27,.333,23,27,.852,116
3151,2018-02-24,PHO,,POR,L 104-106,240,39,87,.448,28,61,.459,11,26,.423,15,21,.714,104
3152,2018-02-24,POR,@,PHO,W 106-104,240,39,99,.394,33,69,.478,6,30,.200,22,30,.733,106
3153,2018-02-24,LAL,@,SAC,W 113-108,240,41,91,.451,24,53,.453,17,38,.447,14,20,.700,113
3154,2018-02-24,SAC,,LAL,L 108-113,240,42,94,.447,29,69,.420,13,25,.520,11,17,.647,108
3155,2018-02-24,DAL,@,UTA,L 90-97,240,34,83,.410,24,48,.500,10,35,.286,12,14,.857,90
3156,2018-02-24,UTA,,DAL,W 97-90,240,34,85,.400,25,53,.472,9,32,.281,20,26,.769,97
3157,2018-02-23,DEN,,SAS,W 122-119,240,48,97,.495,36,65,.554,12,32,.375,14,19,.737,122
3158,2018-02-23,SAS,@,DEN,L 119-122,240,43,85,.506,38,69,.551,5,16,.313,28,39,.718,119
3159,2018-02-23,BOS,@,DET,W 110-98,240,41,85,.482,24,46,.522,17,39,.436,11,18,.611,110
3160,2018-02-23,DET,,BOS,L 98-110,240,37,85,.435,27,52,.519,10,33,.303,14,21,.667,98
3161,2018-02-23,HOU,,MIN,W 120-102,240,40,83,.482,26,45,.578,14,38,.368,26,30,.867,120
3162,2018-02-23,MIN,@,HOU,L 102-120,240,40,94,.426,30,68,.441,10,26,.385,12,16,.750,102
3163,2018-02-23,ATL,@,IND,L 93-116,240,37,82,.451,30,51,.588,7,31,.226,12,19,.632,93
3164,2018-02-23,IND,,ATL,W 116-93,240,48,101,.475,39,73,.534,9,28,.321,11,13,.846,116
3165,2018-02-23,DAL,@,LAL,L 102-124,240,37,91,.407,18,49,.367,19,42,.452,9,11,.818,102
3166,2018-02-23,LAL,,DAL,W 124-102,240,48,93,.516,35,60,.583,13,33,.394,15,20,.750,124
3167,2018-02-23,CLE,@,MEM,W 112-89,240,40,87,.460,29,58,.500,11,29,.379,21,22,.955,112
3168,2018-02-23,MEM,,CLE,L 89-112,240,33,84,.393,24,60,.400,9,24,.375,14,18,.778,89
3169,2018-02-23,MIA,@,NOP,L 123-124 (OT),265,50,108,.463,44,90,.489,6,18,.333,17,26,.654,123
3170,2018-02-23,NOP,,MIA,W 124-123 (OT),265,48,108,.444,40,77,.519,8,31,.258,20,24,.833,124
3171,2018-02-23,LAC,@,PHO,W 128-117,240,45,87,.517,31,55,.564,14,32,.438,24,32,.750,128
3172,2018-02-23,PHO,,LAC,L 117-128,240,45,103,.437,36,72,.500,9,31,.290,18,31,.581,117
3173,2018-02-23,MIL,@,TOR,W 122-119 (OT),265,43,90,.478,30,64,.469,13,26,.500,23,27,.852,122
3174,2018-02-23,TOR,,MIL,L 119-122 (OT),265,43,90,.478,34,56,.607,9,34,.265,24,26,.923,119
3175,2018-02-23,POR,@,UTA,W 100-81,240,39,87,.448,30,63,.476,9,24,.375,13,14,.929,100
3176,2018-02-23,UTA,,POR,L 81-100,240,33,78,.423,27,53,.509,6,25,.240,9,11,.818,81
3177,2018-02-23,CHA,@,WAS,W 122-105,240,44,90,.489,27,51,.529,17,39,.436,17,20,.850,122
3178,2018-02-23,WAS,,CHO,L 105-122,240,40,81,.494,31,56,.554,9,25,.360,16,17,.941,105
3179,2018-02-22,CHI,,PHI,L 115-116,240,44,97,.454,26,63,.413,18,34,.529,9,15,.600,115
3180,2018-02-22,PHI,@,CHI,W 116-115,240,42,82,.512,31,53,.585,11,29,.379,21,35,.600,116
3181,2018-02-22,BRK,@,CHO,L 96-111,240,36,93,.387,22,50,.440,14,43,.326,10,14,.714,96
3182,2018-02-22,CHA,,BRK,W 111-96,240,42,87,.483,31,66,.470,11,21,.524,16,20,.800,111
3183,2018-02-22,CLE,,WAS,L 103-110,240,42,84,.500,34,49,.694,8,35,.229,11,19,.579,103
3184,2018-02-22,WAS,@,CLE,W 110-103,240,44,92,.478,32,62,.516,12,30,.400,10,10,1.000,110
3185,2018-02-22,GSW,,LAC,W 134-127,240,47,77,.610,33,52,.635,14,25,.560,26,34,.765,134
3186,2018-02-22,LAC,@,GSW,L 127-134,240,44,88,.500,33,56,.589,11,32,.344,28,34,.824,127
3187,2018-02-22,NYK,@,ORL,W 120-113,240,48,99,.485,41,74,.554,7,25,.280,17,21,.810,120
3188,2018-02-22,ORL,,NYK,L 113-120,240,43,83,.518,32,59,.542,11,24,.458,16,23,.696,113
3189,2018-02-22,OKC,@,SAC,W 110-107,240,38,86,.442,24,51,.471,14,35,.400,20,24,.833,110
3190,2018-02-22,SAC,,OKC,L 107-110,240,42,91,.462,30,64,.469,12,27,.444,11,15,.733,107
3191,2018-02-15,DEN,@,MIL,W 134-123,240,47,85,.553,23,45,.511,24,40,.600,16,20,.800,134
3192,2018-02-15,MIL,,DEN,L 123-134,240,49,92,.533,40,66,.606,9,26,.346,16,22,.727,123
3193,2018-02-15,LAL,@,MIN,L 111-119,240,43,94,.457,36,63,.571,7,31,.226,18,26,.692,111
3194,2018-02-15,MIN,,LAL,W 119-111,240,42,90,.467,36,66,.545,6,24,.250,29,31,.935,119
3195,2018-02-14,BOS,,LAC,L 119-129,240,42,97,.433,27,66,.409,15,31,.484,20,21,.952,119
3196,2018-02-14,LAC,@,BOS,W 129-119,240,44,88,.500,33,59,.559,11,29,.379,30,33,.909,129
3197,2018-02-14,BRK,,IND,L 103-108,240,35,83,.422,22,48,.458,13,35,.371,20,27,.741,103
3198,2018-02-14,IND,@,BRK,W 108-103,240,39,90,.433,33,75,.440,6,15,.400,24,28,.857,108
3199,2018-02-14,CHI,,TOR,L 98-122,240,39,91,.429,35,67,.522,4,24,.167,16,20,.800,98
3200,2018-02-14,TOR,@,CHI,W 122-98,240,48,92,.522,34,54,.630,14,38,.368,12,15,.800,122
3201,2018-02-14,ATL,@,DET,L 98-104,240,38,89,.427,32,56,.571,6,33,.182,16,19,.842,98
3202,2018-02-14,DET,,ATL,W 104-98,240,35,83,.422,22,50,.440,13,33,.394,21,25,.840,104
3203,2018-02-14,HOU,,SAC,W 100-91,240,33,83,.398,19,34,.559,14,49,.286,20,22,.909,100
3204,2018-02-14,SAC,@,HOU,L 91-100,240,38,87,.437,28,55,.509,10,32,.313,5,8,.625,91
3205,2018-02-14,MEM,,OKC,L 114-121,240,44,86,.512,30,59,.508,14,27,.519,12,15,.800,114
3206,2018-02-14,OKC,@,MEM,W 121-114,240,40,81,.494,23,44,.523,17,37,.459,24,35,.686,121
3207,2018-02-14,LAL,@,NOP,L 117-139,240,46,90,.511,36,68,.529,10,22,.455,15,18,.833,117
3208,2018-02-14,NOP,,LAL,W 139-117,240,53,99,.535,39,67,.582,14,32,.438,19,21,.905,139
3209,2018-02-14,NYK,,WAS,L 113-118,240,45,97,.464,36,78,.462,9,19,.474,14,18,.778,113
3210,2018-02-14,WAS,@,NYK,W 118-113,240,48,88,.545,41,66,.621,7,22,.318,15,19,.789,118
3211,2018-02-14,CHA,@,ORL,W 104-102,240,38,88,.432,25,58,.431,13,30,.433,15,19,.789,104
3212,2018-02-14,ORL,,CHO,L 102-104,240,36,86,.419,21,49,.429,15,37,.405,15,17,.882,102
3213,2018-02-14,MIA,@,PHI,L 102-104,240,35,77,.455,24,50,.480,11,27,.407,21,29,.724,102
3214,2018-02-14,PHI,,MIA,W 104-102,240,39,92,.424,30,57,.526,9,35,.257,17,25,.680,104
3215,2018-02-14,GSW,@,POR,L 117-123,240,43,90,.478,30,53,.566,13,37,.351,18,19,.947,117
3216,2018-02-14,POR,,GSW,W 123-117,240,45,93,.484,33,60,.550,12,33,.364,21,24,.875,123
3217,2018-02-14,PHO,@,UTA,L 97-107,240,34,79,.430,22,50,.440,12,29,.414,17,24,.708,97
3218,2018-02-14,UTA,,PHO,W 107-97,240,39,92,.424,29,58,.500,10,34,.294,19,22,.864,107
3219,2018-02-13,DAL,,SAC,L 109-114,240,38,83,.458,23,43,.535,15,40,.375,18,23,.783,109
3220,2018-02-13,SAC,@,DAL,W 114-109,240,47,87,.540,35,58,.603,12,29,.414,8,12,.667,114
3221,2018-02-13,DEN,,SAS,W 117-109,240,46,93,.495,36,61,.590,10,32,.313,15,18,.833,117
3222,2018-02-13,SAS,@,DEN,L 109-117,240,44,82,.537,38,60,.633,6,22,.273,15,22,.682,109
3223,2018-02-13,ATL,@,MIL,L 92-97,240,33,86,.384,21,51,.412,12,35,.343,14,20,.700,92
3224,2018-02-13,MIL,,ATL,W 97-92,240,38,88,.432,30,63,.476,8,25,.320,13,17,.765,97
3225,2018-02-13,HOU,@,MIN,W 126-108,240,41,83,.494,19,36,.528,22,47,.468,22,29,.759,126
3226,2018-02-13,MIN,,HOU,L 108-126,240,40,84,.476,34,61,.557,6,23,.261,22,23,.957,108
3227,2018-02-13,CLE,@,OKC,W 120-112,240,45,88,.511,29,52,.558,16,36,.444,14,22,.636,120
3228,2018-02-13,OKC,,CLE,L 112-120,240,40,90,.444,29,55,.527,11,35,.314,21,30,.700,112
3229,2018-02-13,MIA,@,TOR,L 112-115,240,42,86,.488,30,57,.526,12,29,.414,16,19,.842,112
3230,2018-02-13,TOR,,MIA,W 115-112,240,42,90,.467,29,55,.527,13,35,.371,18,23,.783,115
3231,2018-02-12,BRK,,LAC,L 101-114,240,41,89,.461,29,49,.592,12,40,.300,7,10,.700,101
3232,2018-02-12,LAC,@,BRK,W 114-101,240,48,85,.565,42,69,.609,6,16,.375,12,14,.857,114
3233,2018-02-12,CHI,,ORL,W 105-101,240,40,88,.455,31,56,.554,9,32,.281,16,21,.762,105
3234,2018-02-12,ORL,@,CHI,L 101-105,240,37,84,.440,27,53,.509,10,31,.323,17,19,.895,101
3235,2018-02-12,DET,,NOP,L 103-118,240,35,95,.368,26,60,.433,9,35,.257,24,32,.750,103
3236,2018-02-12,NOP,@,DET,W 118-103,240,44,100,.440,30,66,.455,14,34,.412,16,16,1.000,118
3237,2018-02-12,GSW,,PHO,W 129-83,240,52,89,.584,41,63,.651,11,26,.423,14,21,.667,129
3238,2018-02-12,PHO,@,GSW,L 83-129,240,33,95,.347,30,72,.417,3,23,.130,14,22,.636,83
3239,2018-02-12,NYK,@,PHI,L 92-108,240,31,79,.392,25,55,.455,6,24,.250,24,28,.857,92
3240,2018-02-12,PHI,,NYK,W 108-92,240,41,75,.547,31,56,.554,10,19,.526,16,24,.667,108
3241,2018-02-12,SAS,@,UTA,L 99-101,240,38,85,.447,32,60,.533,6,25,.240,17,25,.680,99
3242,2018-02-12,UTA,,SAS,W 101-99,240,35,84,.417,24,60,.400,11,24,.458,20,30,.667,101
3243,2018-02-11,ATL,,DET,W 118-115,240,38,78,.487,28,49,.571,10,29,.345,32,37,.865,118
3244,2018-02-11,DET,@,ATL,L 115-118,240,38,83,.458,25,50,.500,13,33,.394,26,33,.788,115
3245,2018-02-11,BOS,,CLE,L 99-121,240,36,89,.404,26,51,.510,10,38,.263,17,22,.773,99
3246,2018-02-11,CLE,@,BOS,W 121-99,240,45,84,.536,29,54,.537,16,30,.533,15,20,.750,121
3247,2018-02-11,CHA,,TOR,L 103-123,240,38,89,.427,28,66,.424,10,23,.435,17,23,.739,103
3248,2018-02-11,TOR,@,CHO,W 123-103,240,49,87,.563,31,50,.620,18,37,.486,7,10,.700,123
3249,2018-02-11,DAL,@,HOU,L 97-104,240,38,93,.409,28,62,.452,10,31,.323,11,16,.688,97
3250,2018-02-11,HOU,,DAL,W 104-97,240,34,78,.436,21,33,.636,13,45,.289,23,33,.697,104
3251,2018-02-11,IND,,NYK,W 121-113,240,47,94,.500,35,66,.530,12,28,.429,15,22,.682,121
3252,2018-02-11,NYK,@,IND,L 113-121,240,41,93,.441,32,58,.552,9,35,.257,22,25,.880,113
3253,2018-02-11,MIN,,SAC,W 111-106,240,37,74,.500,28,50,.560,9,24,.375,28,32,.875,111
3254,2018-02-11,SAC,@,MIN,L 106-111,240,42,88,.477,32,63,.508,10,25,.400,12,17,.706,106
3255,2018-02-11,MEM,@,OKC,L 92-110,240,32,82,.390,26,54,.481,6,28,.214,22,24,.917,92
3256,2018-02-11,OKC,,MEM,W 110-92,240,34,77,.442,18,40,.450,16,37,.432,26,40,.650,110
3257,2018-02-11,POR,,UTA,L 96-115,240,33,81,.407,24,56,.429,9,25,.360,21,25,.840,96
3258,2018-02-11,UTA,@,POR,W 115-96,240,41,88,.466,28,62,.452,13,26,.500,20,22,.909,115
3259,2018-02-10,BRK,,NOP,L 128-138 (2OT),290,43,114,.377,22,55,.400,21,59,.356,21,22,.955,128
3260,2018-02-10,NOP,@,BRK,W 138-128 (2OT),290,52,106,.491,43,82,.524,9,24,.375,25,39,.641,138
3261,2018-02-10,CHI,,WAS,L 90-101,240,34,80,.425,25,48,.521,9,32,.281,13,16,.813,90
3262,2018-02-10,WAS,@,CHI,W 101-90,240,38,82,.463,25,44,.568,13,38,.342,12,14,.857,101
3263,2018-02-10,DAL,,LAL,W 130-123,240,48,89,.539,36,62,.581,12,27,.444,22,27,.815,130
3264,2018-02-10,LAL,@,DAL,L 123-130,240,46,84,.548,30,50,.600,16,34,.471,15,22,.682,123
3265,2018-02-10,GSW,,SAS,W 122-105,240,48,85,.565,36,58,.621,12,27,.444,14,15,.933,122
3266,2018-02-10,SAS,@,GSW,L 105-122,240,43,94,.457,38,67,.567,5,27,.185,14,19,.737,105
3267,2018-02-10,MIL,@,ORL,W 111-104,240,43,82,.524,34,57,.596,9,25,.360,16,20,.800,111
3268,2018-02-10,ORL,,MIL,L 104-111,240,37,83,.446,29,53,.547,8,30,.267,22,26,.846,104
3269,2018-02-10,LAC,@,PHI,L 98-112,240,38,88,.432,30,56,.536,8,32,.250,14,23,.609,98
3270,2018-02-10,PHI,,LAC,W 112-98,240,43,90,.478,30,57,.526,13,33,.394,13,17,.765,112
3271,2018-02-10,DEN,@,PHO,W 123-113,240,45,88,.511,32,59,.542,13,29,.448,20,22,.909,123
3272,2018-02-10,PHO,,DEN,L 113-123,240,46,84,.548,39,65,.600,7,19,.368,14,25,.560,113
3273,2018-02-09,ATL,,CLE,L 107-123,240,37,83,.446,21,39,.538,16,44,.364,17,19,.895,107
3274,2018-02-09,CLE,@,ATL,W 123-107,240,46,86,.535,31,51,.608,15,35,.429,16,24,.667,123
3275,2018-02-09,BOS,,IND,L 91-97,240,34,89,.382,27,62,.435,7,27,.259,16,20,.800,91
3276,2018-02-09,IND,@,BOS,W 97-91,240,37,83,.446,32,63,.508,5,20,.250,18,22,.818,97
3277,2018-02-09,CHI,,MIN,W 114-113,240,41,83,.494,32,57,.561,9,26,.346,23,30,.767,114
3278,2018-02-09,MIN,@,CHI,L 113-114,240,41,87,.471,33,65,.508,8,22,.364,23,28,.821,113
3279,2018-02-09,DET,,LAC,L 95-108,240,36,88,.409,26,57,.456,10,31,.323,13,17,.765,95
3280,2018-02-09,LAC,@,DET,W 108-95,240,42,91,.462,32,61,.525,10,30,.333,14,15,.933,108
3281,2018-02-09,DEN,@,HOU,L 104-130,240,42,88,.477,39,60,.650,3,28,.107,17,21,.810,104
3282,2018-02-09,HOU,,DEN,W 130-104,240,43,86,.500,24,45,.533,19,41,.463,25,34,.735,130
3283,2018-02-09,MIA,,MIL,W 91-85,240,32,88,.364,22,62,.355,10,26,.385,17,18,.944,91
3284,2018-02-09,MIL,@,MIA,L 85-91,240,32,76,.421,26,56,.464,6,20,.300,15,17,.882,85
3285,2018-02-09,NOP,@,PHI,L 82-100,240,33,95,.347,25,64,.391,8,31,.258,8,16,.500,82
3286,2018-02-09,PHI,,NOP,W 100-82,240,39,93,.419,25,59,.424,14,34,.412,8,9,.889,100
3287,2018-02-09,POR,@,SAC,W 118-100,240,43,88,.489,28,53,.528,15,35,.429,17,18,.944,118
3288,2018-02-09,SAC,,POR,L 100-118,240,38,90,.422,29,67,.433,9,23,.391,15,21,.714,100
3289,2018-02-09,CHA,@,UTA,L 94-106,240,35,85,.412,26,61,.426,9,24,.375,15,19,.789,94
3290,2018-02-09,UTA,,CHO,W 106-94,240,41,84,.488,31,55,.564,10,29,.345,14,17,.824,106
3291,2018-02-08,DAL,@,GSW,L 103-121,240,40,92,.435,31,55,.564,9,37,.243,14,17,.824,103
3292,2018-02-08,GSW,,DAL,W 121-103,240,45,88,.511,31,59,.525,14,29,.483,17,20,.850,121
3293,2018-02-08,LAL,,OKC,W 106-81,240,42,96,.438,32,65,.492,10,31,.323,12,13,.923,106
3294,2018-02-08,OKC,@,LAL,L 81-106,240,32,90,.356,24,56,.429,8,34,.235,9,19,.474,81
3295,2018-02-08,ATL,@,ORL,L 98-100,240,37,87,.425,25,57,.439,12,30,.400,12,18,.667,98
3296,2018-02-08,ORL,,ATL,W 100-98,240,36,84,.429,27,55,.491,9,29,.310,19,22,.864,100
3297,2018-02-08,CHA,@,POR,L 103-109 (OT),265,38,98,.388,25,65,.385,13,33,.394,14,17,.824,103
3298,2018-02-08,POR,,CHO,W 109-103 (OT),265,41,90,.456,32,59,.542,9,31,.290,18,22,.818,109
3299,2018-02-08,NYK,@,TOR,L 88-113,240,33,83,.398,26,56,.464,7,27,.259,15,18,.833,88
3300,2018-02-08,TOR,,NYK,W 113-88,240,43,95,.453,27,52,.519,16,43,.372,11,14,.786,113
3301,2018-02-08,BOS,@,WAS,W 110-104 (OT),265,39,84,.464,30,58,.517,9,26,.346,23,34,.676,110
3302,2018-02-08,WAS,,BOS,L 104-110 (OT),265,38,95,.400,26,69,.377,12,26,.462,16,20,.800,104
3303,2018-02-07,CLE,,MIN,W 140-138 (OT),265,52,88,.591,31,47,.660,21,41,.512,15,23,.652,140
3304,2018-02-07,MIN,@,CLE,L 138-140 (OT),265,54,93,.581,35,60,.583,19,33,.576,11,12,.917,138
3305,2018-02-07,BRK,@,DET,L 106-115,240,39,90,.433,22,39,.564,17,51,.333,11,12,.917,106
3306,2018-02-07,DET,,BRK,W 115-106,240,44,92,.478,35,68,.515,9,24,.375,18,25,.720,115
3307,2018-02-07,MEM,,UTA,L 88-92,240,34,81,.420,26,58,.448,8,23,.348,12,16,.750,88
3308,2018-02-07,UTA,@,MEM,W 92-88,240,29,69,.420,23,47,.489,6,22,.273,28,33,.848,92
3309,2018-02-07,HOU,@,MIA,W 109-101,240,38,74,.514,26,43,.605,12,31,.387,21,26,.808,109
3310,2018-02-07,MIA,,HOU,L 101-109,240,39,88,.443,26,56,.464,13,32,.406,10,12,.833,101
3311,2018-02-07,PHO,,SAS,L 81-129,240,33,97,.340,30,65,.462,3,32,.094,12,18,.667,81
3312,2018-02-07,SAS,@,PHO,W 129-81,240,46,93,.495,30,61,.492,16,32,.500,21,27,.778,129
3313,2018-02-06,ATL,,MEM,W 108-82,240,42,83,.506,34,58,.586,8,25,.320,16,21,.762,108
3314,2018-02-06,MEM,@,ATL,L 82-108,240,34,79,.430,30,57,.526,4,22,.182,10,13,.769,82
3315,2018-02-06,BRK,,HOU,L 113-123,240,41,85,.482,25,50,.500,16,35,.457,15,17,.882,113
3316,2018-02-06,HOU,@,BRK,W 123-113,240,45,81,.556,29,48,.604,16,33,.485,17,21,.810,123
3317,2018-02-06,GSW,,OKC,L 105-125,240,37,76,.487,29,48,.604,8,28,.286,23,31,.742,105
3318,2018-02-06,OKC,@,GSW,W 125-105,240,44,93,.473,32,62,.516,12,31,.387,25,33,.758,125
3319,2018-02-06,LAL,,PHO,W 112-93,240,39,83,.470,28,57,.491,11,26,.423,23,26,.885,112
3320,2018-02-06,PHO,@,LAL,L 93-112,240,36,94,.383,28,65,.431,8,29,.276,13,23,.565,93
3321,2018-02-06,MIL,@,NYK,W 103-89,240,37,82,.451,29,56,.518,8,26,.308,21,27,.778,103
3322,2018-02-06,NYK,,MIL,L 89-103,240,37,89,.416,32,66,.485,5,23,.217,10,15,.667,89
3323,2018-02-06,CLE,@,ORL,L 98-116,240,36,84,.429,24,47,.511,12,37,.324,14,20,.700,98
3324,2018-02-06,ORL,,CLE,W 116-98,240,46,88,.523,40,66,.606,6,22,.273,18,27,.667,116
3325,2018-02-06,PHI,,WAS,W 115-102,240,45,82,.549,31,54,.574,14,28,.500,11,14,.786,115
3326,2018-02-06,WAS,@,PHI,L 102-115,240,41,93,.441,34,66,.515,7,27,.259,13,18,.722,102
3327,2018-02-06,BOS,@,TOR,L 91-111,240,33,83,.398,23,60,.383,10,23,.435,15,20,.750,91
3328,2018-02-06,TOR,,BOS,W 111-91,240,40,80,.500,23,44,.523,17,36,.472,14,17,.824,111
3329,2018-02-05,CHA,@,DEN,L 104-121,240,39,77,.506,28,51,.549,11,26,.423,15,24,.625,104
3330,2018-02-05,DEN,,CHO,W 121-104,240,46,81,.568,28,47,.596,18,34,.529,11,13,.846,121
3331,2018-02-05,DET,,POR,W 111-91,240,44,88,.500,29,58,.500,15,30,.500,8,12,.667,111
3332,2018-02-05,POR,@,DET,L 91-111,240,37,94,.394,27,61,.443,10,33,.303,7,8,.875,91
3333,2018-02-05,IND,,WAS,L 102-111,240,37,80,.463,25,51,.490,12,29,.414,16,25,.640,102
3334,2018-02-05,WAS,@,IND,W 111-102,240,45,82,.549,38,57,.667,7,25,.280,14,17,.824,111
3335,2018-02-05,DAL,@,LAC,L 101-104,240,33,80,.413,16,38,.421,17,42,.405,18,20,.900,101
3336,2018-02-05,LAC,,DAL,W 104-101,240,42,87,.483,32,60,.533,10,27,.370,10,12,.833,104
3337,2018-02-05,MIA,,ORL,L 109-111,240,40,93,.430,37,70,.529,3,23,.130,26,35,.743,109
3338,2018-02-05,ORL,@,MIA,W 111-109,240,41,84,.488,28,54,.519,13,30,.433,16,19,.842,111
3339,2018-02-05,NOP,,UTA,L 109-133,240,47,93,.505,39,71,.549,8,22,.364,7,13,.538,109
3340,2018-02-05,UTA,@,NOP,W 133-109,240,52,89,.584,38,68,.559,14,21,.667,15,17,.882,133
3341,2018-02-05,CHI,@,SAC,L 98-104,240,32,80,.400,18,44,.409,14,36,.389,20,24,.833,98
3342,2018-02-05,SAC,,CHI,W 104-98,240,37,84,.440,26,52,.500,11,32,.344,19,25,.760,104
3343,2018-02-04,BOS,,POR,W 97-96,240,35,85,.412,20,49,.408,15,36,.417,12,17,.706,97
3344,2018-02-04,POR,@,BOS,L 96-97,240,36,91,.396,23,60,.383,13,31,.419,11,14,.786,96
3345,2018-02-04,BRK,,MIL,L 94-109,240,37,90,.411,28,61,.459,9,29,.310,11,14,.786,94
3346,2018-02-04,MIL,@,BRK,W 109-94,240,42,81,.519,34,62,.548,8,19,.421,17,21,.810,109
3347,2018-02-04,ATL,@,NYK,W 99-96,240,35,87,.402,20,54,.370,15,33,.455,14,19,.737,99
3348,2018-02-04,NYK,,ATL,L 96-99,240,41,94,.436,36,71,.507,5,23,.217,9,15,.600,96
3349,2018-02-04,LAL,@,OKC,W 108-104,240,42,86,.488,29,56,.518,13,30,.433,11,18,.611,108
3350,2018-02-04,OKC,,LAL,L 104-108,240,40,89,.449,33,64,.516,7,25,.280,17,25,.680,104
3351,2018-02-04,CHA,@,PHO,W 115-110,240,40,96,.417,30,58,.517,10,38,.263,25,29,.862,115
3352,2018-02-04,PHO,,CHO,L 110-115,240,41,77,.532,26,48,.542,15,29,.517,13,13,1.000,110
3353,2018-02-04,MEM,@,TOR,L 86-101,240,29,81,.358,21,56,.375,8,25,.320,20,23,.870,86
3354,2018-02-04,TOR,,MEM,W 101-86,240,41,89,.461,35,54,.648,6,35,.171,13,15,.867,101
3355,2018-02-03,CLE,,HOU,L 88-120,240,34,87,.391,26,57,.456,8,30,.267,12,16,.750,88
3356,2018-02-03,HOU,@,CLE,W 120-88,240,44,93,.473,25,42,.595,19,51,.373,13,16,.813,120
3357,2018-02-03,DEN,,GSW,W 115-108,240,39,91,.429,27,62,.435,12,29,.414,25,29,.862,115
3358,2018-02-03,GSW,@,DEN,L 108-115,240,43,86,.500,35,55,.636,8,31,.258,14,23,.609,108
3359,2018-02-03,DET,,MIA,W 111-107,240,44,84,.524,35,58,.603,9,26,.346,14,17,.824,111
3360,2018-02-03,MIA,@,DET,L 107-111,240,44,91,.484,30,55,.545,14,36,.389,5,7,.714,107
3361,2018-02-03,IND,,PHI,W 100-92,240,35,79,.443,26,52,.500,9,27,.333,21,25,.840,100
3362,2018-02-03,PHI,@,IND,L 92-100,240,33,87,.379,23,55,.418,10,32,.313,16,24,.667,92
3363,2018-02-03,CHI,@,LAC,L 103-113,240,35,97,.361,23,60,.383,12,37,.324,21,21,1.000,103
3364,2018-02-03,LAC,,CHI,W 113-103,240,40,88,.455,31,63,.492,9,25,.360,24,28,.857,113
3365,2018-02-03,MIN,,NOP,W 118-107,240,48,95,.505,38,74,.514,10,21,.476,12,16,.750,118
3366,2018-02-03,NOP,@,MIN,L 107-118,240,42,101,.416,34,68,.500,8,33,.242,15,17,.882,107
3367,2018-02-03,ORL,,WAS,L 98-115,240,34,77,.442,24,45,.533,10,32,.313,20,22,.909,98
3368,2018-02-03,WAS,@,ORL,W 115-98,240,46,85,.541,39,59,.661,7,26,.269,16,18,.889,115
3369,2018-02-03,DAL,@,SAC,W 106-99,240,41,83,.494,28,42,.667,13,41,.317,11,14,.786,106
3370,2018-02-03,SAC,,DAL,L 99-106,240,43,82,.524,35,55,.636,8,27,.296,5,6,.833,99
3371,2018-02-03,SAS,,UTA,L 111-120,240,44,91,.484,34,65,.523,10,26,.385,13,18,.722,111
3372,2018-02-03,UTA,@,SAS,W 120-111,240,39,69,.565,27,46,.587,12,23,.522,30,36,.833,120
3373,2018-02-02,ATL,@,BOS,L 110-119,240,34,80,.425,23,49,.469,11,31,.355,31,34,.912,110
3374,2018-02-02,BOS,,ATL,W 119-110,240,45,89,.506,34,65,.523,11,24,.458,18,20,.900,119
3375,2018-02-02,BRK,,LAL,L 99-102,240,37,82,.451,28,53,.528,9,29,.310,16,23,.696,99
3376,2018-02-02,LAL,@,BRK,W 102-99,240,39,92,.424,29,66,.439,10,26,.385,14,20,.700,102
3377,2018-02-02,CHA,,IND,W 133-126,240,44,83,.530,29,50,.580,15,33,.455,30,34,.882,133
3378,2018-02-02,IND,@,CHO,L 126-133,240,44,87,.506,32,58,.552,12,29,.414,26,28,.929,126
3379,2018-02-02,MIL,,NYK,W 92-90,240,33,76,.434,26,52,.500,7,24,.292,19,26,.731,92
3380,2018-02-02,NYK,@,MIL,L 90-92,240,36,89,.404,31,64,.484,5,25,.200,13,17,.765,90
3381,2018-02-02,NOP,@,OKC,W 114-100,240,46,90,.511,33,66,.500,13,24,.542,9,13,.692,114
3382,2018-02-02,OKC,,NOP,L 100-114,240,37,97,.381,28,61,.459,9,36,.250,17,20,.850,100
3383,2018-02-02,MIA,@,PHI,L 97-103,240,34,87,.391,22,50,.440,12,37,.324,17,26,.654,97
3384,2018-02-02,PHI,,MIA,W 103-97,240,42,85,.494,34,61,.557,8,24,.333,11,15,.733,103
3385,2018-02-02,PHO,,UTA,L 97-129,240,36,87,.414,27,54,.500,9,33,.273,16,19,.842,97
3386,2018-02-02,UTA,@,PHO,W 129-97,240,51,90,.567,36,61,.590,15,29,.517,12,17,.706,129
3387,2018-02-02,GSW,@,SAC,W 119-104,240,44,80,.550,27,47,.574,17,33,.515,14,16,.875,119
3388,2018-02-02,SAC,,GSW,L 104-119,240,42,95,.442,32,70,.457,10,25,.400,10,15,.667,104
3389,2018-02-02,POR,@,TOR,L 105-130,240,37,73,.507,30,52,.577,7,21,.333,24,33,.727,105
3390,2018-02-02,TOR,,POR,W 130-105,240,46,99,.465,27,59,.458,19,40,.475,19,21,.905,130
3391,2018-02-01,DEN,,OKC,W 127-124,240,50,97,.515,35,59,.593,15,38,.395,12,17,.706,127
3392,2018-02-01,OKC,@,DEN,L 124-127,240,51,98,.520,42,70,.600,9,28,.321,13,17,.765,124
3393,2018-02-01,DET,,MEM,W 104-102,240,35,76,.461,28,51,.549,7,25,.280,27,37,.730,104
3394,2018-02-01,MEM,@,DET,L 102-104,240,40,96,.417,32,65,.492,8,31,.258,14,14,1.000,102
3395,2018-02-01,MIL,@,MIN,L 89-108,240,32,85,.376,26,56,.464,6,29,.207,19,25,.760,89
3396,2018-02-01,MIN,,MIL,W 108-89,240,42,78,.538,35,59,.593,7,19,.368,17,20,.850,108
3397,2018-02-01,HOU,@,SAS,W 102-91,240,37,83,.446,23,41,.561,14,42,.333,14,17,.824,102
3398,2018-02-01,SAS,,HOU,L 91-102,240,35,83,.422,29,59,.492,6,24,.250,15,17,.882,91
3399,2018-02-01,TOR,@,WAS,L 119-122,240,44,83,.530,32,54,.593,12,29,.414,19,24,.792,119
3400,2018-02-01,WAS,,TOR,W 122-119,240,44,85,.518,34,55,.618,10,30,.333,24,26,.923,122
3401,2018-01-31,ATL,,CHO,L 110-123,240,39,77,.506,27,45,.600,12,32,.375,20,22,.909,110
3402,2018-01-31,CHA,@,ATL,W 123-110,240,46,90,.511,29,58,.500,17,32,.531,14,18,.778,123
3403,2018-01-31,BOS,,NYK,W 103-73,240,40,83,.482,29,57,.509,11,26,.423,12,20,.600,103
3404,2018-01-31,NYK,@,BOS,L 73-103,240,28,87,.322,25,70,.357,3,17,.176,14,21,.667,73
3405,2018-01-31,BRK,,PHI,W 116-108,240,39,77,.506,26,45,.578,13,32,.406,25,28,.893,116
3406,2018-01-31,PHI,@,BRK,L 108-116,240,36,76,.474,29,58,.500,7,18,.389,29,34,.853,108
3407,2018-01-31,CLE,,MIA,W 91-89,240,28,80,.350,22,54,.407,6,26,.231,29,38,.763,91
3408,2018-01-31,MIA,@,CLE,L 89-91,240,36,83,.434,33,55,.600,3,28,.107,14,25,.560,89
3409,2018-01-31,IND,,MEM,W 105-101,240,37,70,.529,27,44,.614,10,26,.385,21,31,.677,105
3410,2018-01-31,MEM,@,IND,L 101-105,240,39,82,.476,27,56,.482,12,26,.462,11,15,.733,101
3411,2018-01-31,LAL,@,ORL,L 105-127,240,39,83,.470,35,63,.556,4,20,.200,23,30,.767,105
3412,2018-01-31,ORL,,LAL,W 127-105,240,44,81,.543,26,49,.531,18,32,.563,21,29,.724,127
3413,2018-01-31,DAL,@,PHO,L 88-102,240,32,88,.364,22,52,.423,10,36,.278,14,26,.538,88
3414,2018-01-31,PHO,,DAL,W 102-88,240,40,83,.482,29,53,.547,11,30,.367,11,15,.733,102
3415,2018-01-31,CHI,@,POR,L 108-124,240,41,99,.414,28,65,.431,13,34,.382,13,22,.591,108
3416,2018-01-31,POR,,CHI,W 124-108,240,46,82,.561,31,50,.620,15,32,.469,17,20,.850,124
3417,2018-01-30,CLE,@,DET,L 114-125,240,38,84,.452,25,49,.510,13,35,.371,25,32,.781,114
3418,2018-01-30,DET,,CLE,W 125-114,240,49,93,.527,40,70,.571,9,23,.391,18,28,.643,125
3419,2018-01-30,HOU,,ORL,W 114-107,240,39,77,.506,26,42,.619,13,35,.371,23,28,.821,114
3420,2018-01-30,ORL,@,HOU,L 107-114,240,42,83,.506,27,52,.519,15,31,.484,8,10,.800,107
3421,2018-01-30,LAC,,POR,L 96-104,240,35,85,.412,29,63,.460,6,22,.273,20,26,.769,96
3422,2018-01-30,POR,@,LAC,W 104-96,240,36,98,.367,23,68,.338,13,30,.433,19,22,.864,104
3423,2018-01-30,NOP,,SAC,L 103-114,240,39,77,.506,30,52,.577,9,25,.360,16,22,.727,103
3424,2018-01-30,SAC,@,NOP,W 114-103,240,46,97,.474,36,71,.507,10,26,.385,12,14,.857,114
3425,2018-01-30,BRK,@,NYK,L 95-111,240,36,87,.414,27,50,.540,9,37,.243,14,16,.875,95
3426,2018-01-30,NYK,,BRK,W 111-95,240,39,89,.438,26,63,.413,13,26,.500,20,25,.800,111
3427,2018-01-30,DEN,@,SAS,L 104-106,240,40,86,.465,30,63,.476,10,23,.435,14,14,1.000,104
3428,2018-01-30,SAS,,DEN,W 106-104,240,46,92,.500,37,68,.544,9,24,.375,5,5,1.000,106
3429,2018-01-30,MIN,@,TOR,L 104-109,240,42,85,.494,37,73,.507,5,12,.417,15,24,.625,104
3430,2018-01-30,TOR,,MIN,W 109-104,240,39,81,.481,30,52,.577,9,29,.310,22,26,.846,109
3431,2018-01-30,GSW,@,UTA,L 99-129,240,39,85,.459,34,60,.567,5,25,.200,16,21,.762,99
3432,2018-01-30,UTA,,GSW,W 129-99,240,53,91,.582,39,63,.619,14,28,.500,9,14,.643,129
3433,2018-01-30,OKC,@,WAS,L 96-102,240,30,80,.375,21,48,.438,9,32,.281,27,34,.794,96
3434,2018-01-30,WAS,,OKC,W 102-96,240,34,89,.382,27,64,.422,7,25,.280,27,29,.931,102
3435,2018-01-29,ATL,,MIN,W 105-100,240,39,79,.494,26,45,.578,13,34,.382,14,16,.875,105
3436,2018-01-29,MIN,@,ATL,L 100-105,240,39,83,.470,32,64,.500,7,19,.368,15,18,.833,100
3437,2018-01-29,DAL,,MIA,L 88-95,240,33,86,.384,25,57,.439,8,29,.276,14,16,.875,88
3438,2018-01-29,MIA,@,DAL,W 95-88,240,34,75,.453,22,44,.500,12,31,.387,15,19,.789,95
3439,2018-01-29,BOS,@,DEN,W 111-110,240,43,91,.473,26,55,.473,17,36,.472,8,10,.800,111
3440,2018-01-29,DEN,,BOS,L 110-111,240,42,93,.452,32,60,.533,10,33,.303,16,21,.762,110
3441,2018-01-29,CHA,@,IND,L 96-105,240,37,83,.446,28,52,.538,9,31,.290,13,20,.650,96
3442,2018-01-29,IND,,CHO,W 105-96,240,45,83,.542,39,62,.629,6,21,.286,9,11,.818,105
3443,2018-01-29,MEM,,PHO,W 120-109,240,47,83,.566,36,61,.590,11,22,.500,15,18,.833,120
3444,2018-01-29,PHO,@,MEM,L 109-120,240,38,82,.463,31,59,.525,7,23,.304,26,36,.722,109
3445,2018-01-29,MIL,,PHI,W 107-95,240,38,80,.475,27,52,.519,11,28,.393,20,22,.909,107
3446,2018-01-29,PHI,@,MIL,L 95-107,240,36,82,.439,34,56,.607,2,26,.077,21,23,.913,95
3447,2018-01-28,CHI,,MIL,L 96-110,240,36,87,.414,24,53,.453,12,34,.353,12,15,.800,96
3448,2018-01-28,MIL,@,CHI,W 110-96,240,41,77,.532,28,49,.571,13,28,.464,15,25,.600,110
3449,2018-01-28,CLE,,DET,W 121-104,240,42,83,.506,27,48,.563,15,35,.429,22,26,.846,121
3450,2018-01-28,DET,@,CLE,L 104-121,240,40,95,.421,26,59,.441,14,36,.389,10,13,.769,104
3451,2018-01-28,HOU,,PHO,W 113-102,240,32,72,.444,21,35,.600,11,37,.297,38,49,.776,113
3452,2018-01-28,PHO,@,HOU,L 102-113,240,36,85,.424,28,52,.538,8,33,.242,22,26,.846,102
3453,2018-01-28,LAC,@,NOP,W 112-103,240,45,96,.469,36,68,.529,9,28,.321,13,18,.722,112
3454,2018-01-28,NOP,,LAC,L 103-112,240,38,85,.447,29,50,.580,9,35,.257,18,25,.720,103
3455,2018-01-28,OKC,,PHI,W 122-112,240,45,92,.489,35,59,.593,10,33,.303,22,30,.733,122
3456,2018-01-28,PHI,@,OKC,L 112-122,240,38,76,.500,27,47,.574,11,29,.379,25,31,.806,112
3457,2018-01-28,SAC,@,SAS,L 98-113,240,35,82,.427,17,48,.354,18,34,.529,10,11,.909,98
3458,2018-01-28,SAS,,SAC,W 113-98,240,45,90,.500,34,65,.523,11,25,.440,12,17,.706,113
3459,2018-01-28,LAL,@,TOR,L 111-123,240,40,91,.440,32,66,.485,8,25,.320,23,33,.697,111
3460,2018-01-28,TOR,,LAL,W 123-111,240,46,92,.500,34,61,.557,12,31,.387,19,25,.760,123
3461,2018-01-27,ATL,,WAS,L 104-129,240,38,88,.432,26,45,.578,12,43,.279,16,21,.762,104
3462,2018-01-27,WAS,@,ATL,W 129-104,240,49,85,.576,31,53,.585,18,32,.563,13,14,.929,129
3463,2018-01-27,DAL,@,DEN,L 89-91,240,34,85,.400,23,54,.426,11,31,.355,10,19,.526,89
3464,2018-01-27,DEN,,DAL,W 91-89,240,34,81,.420,22,48,.458,12,33,.364,11,15,.733,91
3465,2018-01-27,DET,,OKC,L 108-121,240,39,84,.464,27,51,.529,12,33,.364,18,24,.750,108
3466,2018-01-27,OKC,@,DET,W 121-108,240,45,93,.484,31,60,.517,14,33,.424,17,23,.739,121
3467,2018-01-27,BOS,@,GSW,L 105-109,240,37,85,.435,23,57,.404,14,28,.500,17,24,.708,105
3468,2018-01-27,GSW,,BOS,W 109-105,240,38,84,.452,28,57,.491,10,27,.370,23,26,.885,109
3469,2018-01-27,IND,,ORL,W 114-112,240,47,87,.540,42,69,.609,5,18,.278,15,19,.789,114
3470,2018-01-27,ORL,@,IND,L 112-114,240,42,77,.545,34,52,.654,8,25,.320,20,32,.625,112
3471,2018-01-27,CHA,@,MIA,L 91-95,240,29,84,.345,24,60,.400,5,24,.208,28,35,.800,91
3472,2018-01-27,MIA,,CHO,W 95-91,240,38,85,.447,30,59,.508,8,26,.308,11,18,.611,95
3473,2018-01-27,BRK,@,MIN,L 97-111,240,38,82,.463,29,52,.558,9,30,.300,12,15,.800,97
3474,2018-01-27,MIN,,BRK,W 111-97,240,42,96,.438,38,75,.507,4,21,.190,23,26,.885,111
3475,2018-01-26,CHI,,LAL,L 103-108,240,35,93,.376,18,57,.316,17,36,.472,16,24,.667,103
3476,2018-01-26,LAL,@,CHI,W 108-103,240,41,91,.451,36,67,.537,5,24,.208,21,28,.750,108
3477,2018-01-26,ATL,@,CHO,L 110-121,240,37,79,.468,22,49,.449,15,30,.500,21,25,.840,110
3478,2018-01-26,CHA,,ATL,W 121-110,240,40,88,.455,27,54,.500,13,34,.382,28,32,.875,121
3479,2018-01-26,CLE,,IND,W 115-108,240,46,82,.561,33,45,.733,13,37,.351,10,13,.769,115
3480,2018-01-26,IND,@,CLE,L 108-115,240,43,91,.473,30,60,.500,13,31,.419,9,11,.818,108
3481,2018-01-26,DAL,,POR,L 93-107,240,35,89,.393,25,59,.424,10,30,.333,13,17,.765,93
3482,2018-01-26,POR,@,DAL,W 107-93,240,39,79,.494,29,49,.592,10,30,.333,19,23,.826,107
3483,2018-01-26,LAC,@,MEM,W 109-100,240,39,80,.488,29,53,.547,10,27,.370,21,29,.724,109
3484,2018-01-26,MEM,,LAC,L 100-109,240,39,81,.481,31,54,.574,8,27,.296,14,18,.778,100
3485,2018-01-26,BRK,@,MIL,L 91-116,240,33,89,.371,25,55,.455,8,34,.235,17,20,.850,91
3486,2018-01-26,MIL,,BRK,W 116-91,240,43,83,.518,31,60,.517,12,23,.522,18,20,.900,116
3487,2018-01-26,HOU,@,NOP,L 113-115,240,36,78,.462,24,42,.571,12,36,.333,29,35,.829,113
3488,2018-01-26,NOP,,HOU,W 115-113,240,44,82,.537,33,55,.600,11,27,.407,16,21,.762,115
3489,2018-01-26,NYK,@,PHO,W 107-85,240,41,85,.482,32,60,.533,9,25,.360,16,22,.727,107
3490,2018-01-26,PHO,,NYK,L 85-107,240,33,94,.351,22,61,.361,11,33,.333,8,13,.615,85
3491,2018-01-26,PHI,@,SAS,W 97-78,240,38,79,.481,29,58,.500,9,21,.429,12,18,.667,97
3492,2018-01-26,SAS,,PHI,L 78-97,240,30,75,.400,27,51,.529,3,24,.125,15,18,.833,78
3493,2018-01-26,TOR,,UTA,L 93-97,240,37,95,.389,30,68,.441,7,27,.259,12,17,.706,93
3494,2018-01-26,UTA,@,TOR,W 97-93,240,36,87,.414,26,66,.394,10,21,.476,15,21,.714,97
3495,2018-01-25,DEN,,NYK,W 130-118,240,48,80,.600,34,52,.654,14,28,.500,20,24,.833,130
3496,2018-01-25,NYK,@,DEN,L 118-130,240,45,82,.549,37,61,.607,8,21,.381,20,24,.833,118
3497,2018-01-25,GSW,,MIN,W 126-113,240,48,89,.539,27,52,.519,21,37,.568,9,15,.600,126
3498,2018-01-25,MIN,@,GSW,L 113-126,240,46,101,.455,40,81,.494,6,20,.300,15,18,.833,113
3499,2018-01-25,MIA,,SAC,L 88-89,240,31,82,.378,19,48,.396,12,34,.353,14,18,.778,88
3500,2018-01-25,SAC,@,MIA,W 89-88,240,38,81,.469,33,69,.478,5,12,.417,8,14,.571,89
3501,2018-01-25,OKC,,WAS,W 121-112,240,45,87,.517,36,60,.600,9,27,.333,22,29,.759,121
3502,2018-01-25,WAS,@,OKC,L 112-121,240,42,86,.488,26,51,.510,16,35,.457,12,16,.750,112
3503,2018-01-24,ATL,,TOR,L 93-108,240,37,94,.394,30,73,.411,7,21,.333,12,17,.706,93
3504,2018-01-24,TOR,@,ATL,W 108-93,240,39,89,.438,25,53,.472,14,36,.389,16,25,.640,108
3505,2018-01-24,CHA,,NOP,L 96-101,240,36,85,.424,30,64,.469,6,21,.286,18,31,.581,96
3506,2018-01-24,NOP,@,CHO,W 101-96,240,39,87,.448,30,61,.492,9,26,.346,14,18,.778,101
3507,2018-01-24,DAL,,HOU,L 97-104,240,35,82,.427,20,47,.426,15,35,.429,12,18,.667,97
3508,2018-01-24,HOU,@,DAL,W 104-97,240,36,82,.439,15,31,.484,21,51,.412,11,23,.478,104
3509,2018-01-24,DET,,UTA,L 95-98 (OT),265,38,97,.392,31,66,.470,7,31,.226,12,18,.667,95
3510,2018-01-24,UTA,@,DET,W 98-95 (OT),265,38,96,.396,28,65,.431,10,31,.323,12,16,.750,98
3511,2018-01-24,IND,,PHO,W 116-101,240,45,80,.563,36,56,.643,9,24,.375,17,25,.680,116
3512,2018-01-24,PHO,@,IND,L 101-116,240,35,84,.417,26,49,.531,9,35,.257,22,29,.759,101
3513,2018-01-24,BOS,@,LAC,W 113-102,240,39,93,.419,25,53,.472,14,40,.350,21,22,.955,113
3514,2018-01-24,LAC,,BOS,L 102-113,240,35,79,.443,30,58,.517,5,21,.238,27,39,.692,102
3515,2018-01-24,MEM,,SAS,L 85-108,240,36,83,.434,34,65,.523,2,18,.111,11,14,.786,85
3516,2018-01-24,SAS,@,MEM,W 108-85,240,38,82,.463,28,58,.483,10,24,.417,22,25,.880,108
3517,2018-01-24,CHI,@,PHI,L 101-115,240,36,94,.383,25,57,.439,11,37,.297,18,22,.818,101
3518,2018-01-24,PHI,,CHI,W 115-101,240,42,81,.519,26,49,.531,16,32,.500,15,20,.750,115
3519,2018-01-24,MIN,@,POR,L 114-123,240,45,84,.536,39,68,.574,6,16,.375,18,22,.818,114
3520,2018-01-24,POR,,MIN,W 123-114,240,45,82,.549,28,51,.549,17,31,.548,16,21,.762,123
3521,2018-01-23,GSW,,NYK,W 123-112,240,46,83,.554,33,53,.623,13,30,.433,18,20,.900,123
3522,2018-01-23,NYK,@,GSW,L 112-123,240,43,83,.518,34,61,.557,9,22,.409,17,19,.895,112
3523,2018-01-23,BOS,@,LAL,L 107-108,240,42,90,.467,27,46,.587,15,44,.341,8,10,.800,107
3524,2018-01-23,LAL,,BOS,W 108-107,240,40,91,.440,33,65,.508,7,26,.269,21,36,.583,108
3525,2018-01-23,BRK,@,OKC,L 108-109,240,37,79,.468,21,41,.512,16,38,.421,18,25,.720,108
3526,2018-01-23,OKC,,BRK,W 109-108,240,40,94,.426,33,69,.478,7,25,.280,22,32,.688,109
3527,2018-01-23,ORL,,SAC,L 99-105,240,36,83,.434,25,52,.481,11,31,.355,16,19,.842,99
3528,2018-01-23,SAC,@,ORL,W 105-99,240,43,87,.494,35,61,.574,8,26,.308,11,13,.846,105
3529,2018-01-23,CLE,@,SAS,L 102-114,240,35,72,.486,29,51,.569,6,21,.286,26,31,.839,102
3530,2018-01-23,SAS,,CLE,W 114-102,240,47,94,.500,39,66,.591,8,28,.286,12,16,.750,114
3531,2018-01-22,ATL,,UTA,W 104-90,240,40,83,.482,28,57,.491,12,26,.462,12,12,1.000,104
3532,2018-01-22,UTA,@,ATL,L 90-104,240,33,76,.434,29,61,.475,4,15,.267,20,28,.714,90
3533,2018-01-22,CHA,,SAC,W 112-107,240,38,86,.442,22,46,.478,16,40,.400,20,25,.800,112
3534,2018-01-22,SAC,@,CHO,L 107-112,240,43,97,.443,33,75,.440,10,22,.455,11,15,.733,107
3535,2018-01-22,DAL,,WAS,W 98-75,240,38,87,.437,28,56,.500,10,31,.323,12,17,.706,98
3536,2018-01-22,WAS,@,DAL,L 75-98,240,26,86,.302,19,54,.352,7,32,.219,16,27,.593,75
3537,2018-01-22,DEN,,POR,W 104-101,240,34,83,.410,24,53,.453,10,30,.333,26,33,.788,104
3538,2018-01-22,POR,@,DEN,L 101-104,240,36,85,.424,28,60,.467,8,25,.320,21,26,.808,101
3539,2018-01-22,HOU,,MIA,W 99-90,240,36,81,.444,21,44,.477,15,37,.405,12,18,.667,99
3540,2018-01-22,MIA,@,HOU,L 90-99,240,39,82,.476,32,52,.615,7,30,.233,5,9,.556,90
3541,2018-01-22,LAC,,MIN,L 118-126,240,47,84,.560,38,57,.667,9,27,.333,15,22,.682,118
3542,2018-01-22,MIN,@,LAC,W 126-118,240,43,91,.473,36,69,.522,7,22,.318,33,39,.846,126
3543,2018-01-22,MEM,,PHI,W 105-101,240,33,78,.423,23,52,.442,10,26,.385,29,35,.829,105
3544,2018-01-22,PHI,@,MEM,L 101-105,240,32,71,.451,18,40,.450,14,31,.452,23,31,.742,101
3545,2018-01-22,MIL,,PHO,W 109-105,240,38,71,.535,33,54,.611,5,17,.294,28,37,.757,109
3546,2018-01-22,PHO,@,MIL,L 105-109,240,39,79,.494,30,53,.566,9,26,.346,18,20,.900,105
3547,2018-01-22,CHI,@,NOP,L 128-132 (2OT),290,45,92,.489,37,61,.607,8,31,.258,30,34,.882,128
3548,2018-01-22,NOP,,CHI,W 132-128 (2OT),290,47,113,.416,31,69,.449,16,44,.364,22,26,.846,132
3549,2018-01-21,BOS,,ORL,L 95-103,240,37,85,.435,29,58,.500,8,27,.296,13,14,.929,95
3550,2018-01-21,ORL,@,BOS,W 103-95,240,43,92,.467,37,71,.521,6,21,.286,11,16,.688,103
3551,2018-01-21,BRK,@,DET,W 101-100,240,37,80,.463,24,49,.490,13,31,.419,14,20,.700,101
3552,2018-01-21,DET,,BRK,L 100-101,240,38,90,.422,29,61,.475,9,29,.310,15,17,.882,100
3553,2018-01-21,LAL,,NYK,W 127-107,240,51,91,.560,41,65,.631,10,26,.385,15,21,.714,127
3554,2018-01-21,NYK,@,LAL,L 107-127,240,44,81,.543,32,56,.571,12,25,.480,7,10,.700,107
3555,2018-01-21,IND,@,SAS,W 94-86,240,37,84,.440,33,65,.508,4,19,.211,16,17,.941,94
3556,2018-01-21,SAS,,IND,L 86-94,240,35,82,.427,26,48,.542,9,34,.265,7,12,.583,86
3557,2018-01-20,ATL,,CHI,L 97-113,240,35,92,.380,24,44,.545,11,48,.229,16,23,.696,97
3558,2018-01-20,CHI,@,ATL,W 113-97,240,40,80,.500,26,48,.542,14,32,.438,19,21,.905,113
3559,2018-01-20,CHA,,MIA,L 105-106,240,41,90,.456,34,63,.540,7,27,.259,16,21,.762,105
3560,2018-01-20,MIA,@,CHO,W 106-105,240,43,87,.494,30,59,.508,13,28,.464,7,12,.583,106
3561,2018-01-20,CLE,,OKC,L 124-148,240,46,89,.517,36,52,.692,10,37,.270,22,27,.815,124
3562,2018-01-20,OKC,@,CLE,W 148-124,240,58,100,.580,44,70,.629,14,30,.467,18,28,.643,148
3563,2018-01-20,GSW,@,HOU,L 108-116,240,40,82,.488,23,46,.500,17,36,.472,11,15,.733,108
3564,2018-01-20,HOU,,GSW,W 116-108,240,41,87,.471,27,50,.540,14,37,.378,20,29,.690,116
3565,2018-01-20,MIN,,TOR,W 115-109,240,38,81,.469,31,65,.477,7,16,.438,32,42,.762,115
3566,2018-01-20,TOR,@,MIN,L 109-115,240,39,83,.470,27,50,.540,12,33,.364,19,21,.905,109
3567,2018-01-20,MEM,@,NOP,L 104-111,240,37,82,.451,22,47,.468,15,35,.429,15,16,.938,104
3568,2018-01-20,NOP,,MEM,W 111-104,240,39,78,.500,32,51,.627,7,27,.259,26,32,.813,111
3569,2018-01-20,MIL,@,PHI,L 94-116,240,33,82,.402,23,50,.460,10,32,.313,18,22,.818,94
3570,2018-01-20,PHI,,MIL,W 116-94,240,45,85,.529,35,60,.583,10,25,.400,16,19,.842,116
3571,2018-01-20,DAL,@,POR,L 108-117,240,38,83,.458,28,58,.483,10,25,.400,22,28,.786,108
3572,2018-01-20,POR,,DAL,W 117-108,240,45,86,.523,27,50,.540,18,36,.500,9,10,.900,117
3573,2018-01-20,LAC,@,UTA,L 113-125,240,36,82,.439,25,46,.543,11,36,.306,30,38,.789,113
3574,2018-01-20,UTA,,LAC,W 125-113,240,45,82,.549,34,54,.630,11,28,.393,24,32,.750,125
3575,2018-01-19,BRK,,MIA,W 101-95,240,36,76,.474,27,44,.614,9,32,.281,20,26,.769,101
3576,2018-01-19,MIA,@,BRK,L 95-101,240,35,84,.417,28,62,.452,7,22,.318,18,25,.720,95
3577,2018-01-19,DEN,,PHO,L 100-108,240,35,78,.449,21,42,.500,14,36,.389,16,21,.762,100
3578,2018-01-19,PHO,@,DEN,W 108-100,240,40,81,.494,26,48,.542,14,33,.424,14,20,.700,108
3579,2018-01-19,DET,,WAS,L 112-122,240,40,80,.500,30,50,.600,10,30,.333,22,26,.846,112
3580,2018-01-19,WAS,@,DET,W 122-112,240,41,82,.500,25,47,.532,16,35,.457,24,27,.889,122
3581,2018-01-19,IND,@,LAL,L 86-99,240,37,97,.381,35,72,.486,2,25,.080,10,13,.769,86
3582,2018-01-19,LAL,,IND,W 99-86,240,44,80,.550,35,52,.673,9,28,.321,2,14,.143,99
3583,2018-01-19,MEM,,SAC,W 106-88,240,39,88,.443,29,54,.537,10,34,.294,18,23,.783,106
3584,2018-01-19,SAC,@,MEM,L 88-106,240,32,80,.400,21,53,.396,11,27,.407,13,18,.722,88
3585,2018-01-19,SAS,@,TOR,L 83-86,240,31,91,.341,26,71,.366,5,20,.250,16,20,.800,83
3586,2018-01-19,TOR,,SAS,W 86-83,240,34,85,.400,25,59,.424,9,26,.346,9,14,.643,86
3587,2018-01-19,NYK,@,UTA,W 117-115,240,44,89,.494,33,69,.478,11,20,.550,18,23,.783,117
3588,2018-01-19,UTA,,NYK,L 115-117,240,42,91,.462,31,60,.517,11,31,.355,20,30,.667,115
3589,2018-01-18,BOS,,PHI,L 80-89,240,30,74,.405,23,45,.511,7,29,.241,13,17,.765,80
3590,2018-01-18,PHI,@,BOS,W 89-80,240,34,73,.466,28,56,.500,6,17,.353,15,17,.882,89
3591,2018-01-18,CLE,,ORL,W 104-103,240,38,85,.447,28,51,.549,10,34,.294,18,27,.667,104
3592,2018-01-18,ORL,@,CLE,L 103-104,240,41,88,.466,36,66,.545,5,22,.227,16,21,.762,103
3593,2018-01-18,HOU,,MIN,W 116-98,240,42,88,.477,25,49,.510,17,39,.436,15,17,.882,116
3594,2018-01-18,MIN,@,HOU,L 98-116,240,38,81,.469,30,57,.526,8,24,.333,14,21,.667,98
3595,2018-01-18,IND,@,POR,L 86-100,240,36,91,.396,29,65,.446,7,26,.269,7,13,.538,86
3596,2018-01-18,POR,,IND,W 100-86,240,37,94,.394,27,62,.435,10,32,.313,16,16,1.000,100
3597,2018-01-17,ATL,,NOP,W 94-93,240,37,89,.416,27,49,.551,10,40,.250,10,13,.769,94
3598,2018-01-17,NOP,@,ATL,L 93-94,240,35,80,.438,25,53,.472,10,27,.370,13,19,.684,93
3599,2018-01-17,BRK,,SAS,L 95-100,240,35,83,.422,22,47,.468,13,36,.361,12,18,.667,95
3600,2018-01-17,SAS,@,BRK,W 100-95,240,34,82,.415,25,63,.397,9,19,.474,23,31,.742,100
3601,2018-01-17,CHI,,GSW,L 112-119,240,45,106,.425,35,67,.522,10,39,.256,12,13,.923,112
3602,2018-01-17,GSW,@,CHI,W 119-112,240,42,84,.500,29,51,.569,13,33,.394,22,25,.880,119
3603,2018-01-17,CHA,,WAS,W 133-109,240,48,98,.490,33,67,.493,15,31,.484,22,26,.846,133
3604,2018-01-17,WAS,@,CHO,L 109-133,240,40,82,.488,27,59,.458,13,23,.565,16,23,.696,109
3605,2018-01-17,DEN,@,LAC,L 104-109,240,42,97,.433,37,72,.514,5,25,.200,15,18,.833,104
3606,2018-01-17,LAC,,DEN,W 109-104,240,40,87,.460,30,57,.526,10,30,.333,19,31,.613,109
3607,2018-01-17,MEM,,NYK,W 105-99,240,41,91,.451,31,63,.492,10,28,.357,13,17,.765,105
3608,2018-01-17,NYK,@,MEM,L 99-105,240,35,82,.427,28,55,.509,7,27,.259,22,23,.957,99
3609,2018-01-17,MIA,@,MIL,W 106-101,240,38,82,.463,28,58,.483,10,24,.417,20,27,.741,106
3610,2018-01-17,MIL,,MIA,L 101-106,240,33,76,.434,22,48,.458,11,28,.393,24,32,.750,101
3611,2018-01-17,LAL,@,OKC,L 90-114,240,38,81,.469,28,55,.509,10,26,.385,4,4,1.000,90
3612,2018-01-17,OKC,,LAL,W 114-90,240,46,95,.484,34,60,.567,12,35,.343,10,12,.833,114
3613,2018-01-17,SAC,,UTA,L 105-120,240,38,72,.528,25,51,.490,13,21,.619,16,20,.800,105
3614,2018-01-17,UTA,@,SAC,W 120-105,240,46,81,.568,34,52,.654,12,29,.414,16,20,.800,120
3615,2018-01-17,DET,@,TOR,L 91-96,240,37,88,.420,27,60,.450,10,28,.357,7,15,.467,91
3616,2018-01-17,TOR,,DET,W 96-91,240,34,80,.425,23,49,.469,11,31,.355,17,23,.739,96
3617,2018-01-16,BOS,,NOP,L 113-116 (OT),265,40,101,.396,21,51,.412,19,50,.380,14,16,.875,113
3618,2018-01-16,NOP,@,BOS,W 116-113 (OT),265,45,100,.450,38,73,.521,7,27,.259,19,25,.760,116
3619,2018-01-16,DAL,@,DEN,L 102-105,240,38,78,.487,30,51,.588,8,27,.296,18,22,.818,102
3620,2018-01-16,DEN,,DAL,W 105-102,240,40,86,.465,32,60,.533,8,26,.308,17,26,.654,105
3621,2018-01-16,MIN,@,ORL,L 102-108,240,43,98,.439,36,82,.439,7,16,.438,9,10,.900,102
3622,2018-01-16,ORL,,MIN,W 108-102,240,40,90,.444,29,59,.492,11,31,.355,17,19,.895,108
3623,2018-01-16,PHO,@,POR,L 111-118,240,37,89,.416,21,48,.438,16,41,.390,21,22,.955,111
3624,2018-01-16,POR,,PHO,W 118-111,240,46,91,.505,29,56,.518,17,35,.486,9,10,.900,118
3625,2018-01-15,ATL,,SAS,W 102-99,240,40,86,.465,31,61,.508,9,25,.360,13,14,.929,102
3626,2018-01-15,SAS,@,ATL,L 99-102,240,37,87,.425,29,65,.446,8,22,.364,17,20,.850,99
3627,2018-01-15,BRK,,NYK,L 104-119,240,32,87,.368,21,55,.382,11,32,.344,29,36,.806,104
3628,2018-01-15,NYK,@,BRK,W 119-104,240,42,82,.512,33,66,.500,9,16,.563,26,37,.703,119
3629,2018-01-15,CHI,,MIA,W 119-111,240,42,88,.477,26,49,.531,16,39,.410,19,22,.864,119
3630,2018-01-15,MIA,@,CHI,L 111-119,240,40,84,.476,28,48,.583,12,36,.333,19,24,.792,111
3631,2018-01-15,CLE,,GSW,L 108-118,240,43,94,.457,36,66,.545,7,28,.250,15,22,.682,108
3632,2018-01-15,GSW,@,CLE,W 118-108,240,41,85,.482,29,53,.547,12,32,.375,24,30,.800,118
3633,2018-01-15,CHA,@,DET,W 118-107,240,43,84,.512,33,63,.524,10,21,.476,22,33,.667,118
3634,2018-01-15,DET,,CHO,L 107-118,240,42,86,.488,27,57,.474,15,29,.517,8,11,.727,107
3635,2018-01-15,HOU,@,LAC,L 102-113,240,38,94,.404,25,50,.500,13,44,.295,13,16,.813,102
3636,2018-01-15,LAC,,HOU,W 113-102,240,44,79,.557,34,54,.630,10,25,.400,15,20,.750,113
3637,2018-01-15,LAL,@,MEM,L 114-123,240,38,96,.396,26,61,.426,12,35,.343,26,31,.839,114
3638,2018-01-15,MEM,,LAL,W 123-114,240,42,82,.512,32,60,.533,10,22,.455,29,34,.853,123
3639,2018-01-15,OKC,,SAC,W 95-88,240,36,86,.419,27,56,.482,9,30,.300,14,29,.483,95
3640,2018-01-15,SAC,@,OKC,L 88-95,240,33,84,.393,26,54,.481,7,30,.233,15,25,.600,88
3641,2018-01-15,PHI,,TOR,W 117-111,240,40,81,.494,34,56,.607,6,25,.240,31,38,.816,117
3642,2018-01-15,TOR,@,PHI,L 111-117,240,38,95,.400,29,63,.460,9,32,.281,26,30,.867,111
3643,2018-01-15,IND,@,UTA,W 109-94,240,41,77,.532,27,51,.529,14,26,.538,13,15,.867,109
3644,2018-01-15,UTA,,IND,L 94-109,240,36,81,.444,27,48,.563,9,33,.273,13,17,.765,94
3645,2018-01-15,MIL,@,WAS,W 104-95,240,38,81,.469,30,65,.462,8,16,.500,20,29,.690,104
3646,2018-01-15,WAS,,MIL,L 95-104,240,32,76,.421,26,55,.473,6,21,.286,25,31,.806,95
3647,2018-01-14,MIA,,MIL,W 97-79,240,35,76,.461,24,47,.511,11,29,.379,16,20,.800,97
3648,2018-01-14,MIL,@,MIA,L 79-97,240,25,79,.316,21,51,.412,4,28,.143,25,27,.926,79
3649,2018-01-14,MIN,,POR,W 120-103,240,43,80,.538,36,61,.590,7,19,.368,27,33,.818,120
3650,2018-01-14,POR,@,MIN,L 103-120,240,39,79,.494,28,54,.519,11,25,.440,14,17,.824,103
3651,2018-01-14,NOP,@,NYK,W 123-118 (OT),265,45,95,.474,36,63,.571,9,32,.281,24,34,.706,123
3652,2018-01-14,NYK,,NOP,L 118-123 (OT),265,46,97,.474,34,63,.540,12,34,.353,14,18,.778,118
3653,2018-01-14,IND,@,PHO,W 120-97,240,48,88,.545,37,65,.569,11,23,.478,13,14,.929,120
3654,2018-01-14,PHO,,IND,L 97-120,240,35,85,.412,26,48,.542,9,37,.243,18,24,.750,97
3655,2018-01-13,CHI,,DET,W 107-105,240,42,87,.483,25,51,.490,17,36,.472,6,9,.667,107
3656,2018-01-13,DET,@,CHI,L 105-107,240,41,92,.446,29,63,.460,12,29,.414,11,14,.786,105
3657,2018-01-13,CHA,,OKC,L 91-101,240,33,83,.398,24,55,.436,9,28,.321,16,23,.696,91
3658,2018-01-13,OKC,@,CHO,W 101-91,240,39,97,.402,31,71,.437,8,26,.308,15,20,.750,101
3659,2018-01-13,DAL,,LAL,L 101-107 (OT),265,34,90,.378,23,47,.489,11,43,.256,22,28,.786,101
3660,2018-01-13,LAL,@,DAL,W 107-101 (OT),265,43,95,.453,35,69,.507,8,26,.308,13,18,.722,107
3661,2018-01-13,LAC,,SAC,W 126-105,240,46,82,.561,34,51,.667,12,31,.387,22,26,.846,126
3662,2018-01-13,SAC,@,LAC,L 105-126,240,43,85,.506,37,68,.544,6,17,.353,13,22,.591,105
3663,2018-01-13,DEN,@,SAS,L 80-112,240,29,83,.349,22,55,.400,7,28,.250,15,17,.882,80
3664,2018-01-13,SAS,,DEN,W 112-80,240,41,79,.519,27,52,.519,14,27,.519,16,18,.889,112
3665,2018-01-13,GSW,@,TOR,W 127-125,240,47,81,.580,38,57,.667,9,24,.375,24,28,.857,127
3666,2018-01-13,TOR,,GSW,L 125-127,240,45,93,.484,37,68,.544,8,25,.320,27,32,.844,125
3667,2018-01-13,BRK,@,WAS,L 113-119 (OT),265,42,99,.424,30,56,.536,12,43,.279,17,20,.850,113
3668,2018-01-13,WAS,,BRK,W 119-113 (OT),265,46,93,.495,36,70,.514,10,23,.435,17,23,.739,119
3669,2018-01-12,ATL,,BRK,L 105-110,240,37,80,.463,26,52,.500,11,28,.393,20,26,.769,105
3670,2018-01-12,BRK,@,ATL,W 110-105,240,40,87,.460,27,53,.509,13,34,.382,17,26,.654,110
3671,2018-01-12,CHA,,UTA,W 99-88,240,32,78,.410,23,51,.451,9,27,.333,26,34,.765,99
3672,2018-01-12,UTA,@,CHO,L 88-99,240,28,77,.364,16,42,.381,12,35,.343,20,23,.870,88
3673,2018-01-12,DEN,,MEM,W 87-78,240,27,70,.386,20,48,.417,7,22,.318,26,32,.813,87
3674,2018-01-12,MEM,@,DEN,L 78-87,240,30,77,.390,23,53,.434,7,24,.292,11,14,.786,78
3675,2018-01-12,CLE,@,IND,L 95-97,240,37,85,.435,30,51,.588,7,34,.206,14,19,.737,95
3676,2018-01-12,IND,,CLE,W 97-95,240,39,85,.459,29,64,.453,10,21,.476,9,12,.750,97
3677,2018-01-12,GSW,@,MIL,W 108-94,240,44,79,.557,39,64,.609,5,15,.333,15,18,.833,108
3678,2018-01-12,MIL,,GSW,L 94-108,240,36,85,.424,25,57,.439,11,28,.393,11,12,.917,94
3679,2018-01-12,MIN,,NYK,W 118-108,240,49,95,.516,39,68,.574,10,27,.370,10,16,.625,118
3680,2018-01-12,NYK,@,MIN,L 108-118,240,45,83,.542,33,59,.559,12,24,.500,6,9,.667,108
3681,2018-01-12,NOP,,POR,W 119-113,240,45,82,.549,38,63,.603,7,19,.368,22,23,.957,119
3682,2018-01-12,POR,@,NOP,L 113-119,240,45,101,.446,33,59,.559,12,42,.286,11,14,.786,113
3683,2018-01-12,HOU,@,PHO,W 112-95,240,39,94,.415,24,47,.511,15,47,.319,19,22,.864,112
3684,2018-01-12,PHO,,HOU,L 95-112,240,37,80,.463,23,47,.489,14,33,.424,7,9,.778,95
3685,2018-01-12,ORL,@,WAS,L 119-125,240,41,80,.513,29,51,.569,12,29,.414,25,31,.806,119
3686,2018-01-12,WAS,,ORL,W 125-119,240,54,95,.568,50,79,.633,4,16,.250,13,19,.684,125
3687,2018-01-11,LAL,,SAS,W 93-81,240,36,87,.414,23,49,.469,13,38,.342,8,14,.571,93
3688,2018-01-11,SAS,@,LAL,L 81-93,240,31,76,.408,23,56,.411,8,20,.400,11,15,.733,81
3689,2018-01-11,BOS,@,PHI,W 114-103,240,43,89,.483,30,54,.556,13,35,.371,15,19,.789,114
3690,2018-01-11,PHI,,BOS,L 103-114,240,38,82,.463,27,54,.500,11,28,.393,16,18,.889,103
3691,2018-01-11,LAC,@,SAC,W 121-115,240,43,84,.512,30,53,.566,13,31,.419,22,30,.733,121
3692,2018-01-11,SAC,,LAC,L 115-121,240,42,85,.494,34,59,.576,8,26,.308,23,28,.821,115
3693,2018-01-11,CLE,@,TOR,L 99-133,240,34,89,.382,28,63,.444,6,26,.231,25,30,.833,99
3694,2018-01-11,TOR,,CLE,W 133-99,240,53,106,.500,35,64,.547,18,42,.429,9,13,.692,133
3695,2018-01-10,BRK,,DET,L 80-114,240,27,74,.365,15,37,.405,12,37,.324,14,15,.933,80
3696,2018-01-10,DET,@,BRK,W 114-80,240,48,93,.516,38,72,.528,10,21,.476,8,12,.667,114
3697,2018-01-10,CHA,,DAL,L 111-115,240,43,84,.512,33,58,.569,10,26,.385,15,30,.500,111
3698,2018-01-10,DAL,@,CHO,W 115-111,240,39,83,.470,24,47,.511,15,36,.417,22,28,.786,115
3699,2018-01-10,ATL,@,DEN,W 110-97,240,40,80,.500,28,53,.528,12,27,.444,18,18,1.000,110
3700,2018-01-10,DEN,,ATL,L 97-110,240,38,95,.400,29,58,.500,9,37,.243,12,20,.600,97
3701,2018-01-10,GSW,,LAC,L 106-125,240,38,79,.481,30,56,.536,8,23,.348,22,26,.846,106
3702,2018-01-10,LAC,@,GSW,W 125-106,240,46,94,.489,35,70,.500,11,24,.458,22,28,.786,125
3703,2018-01-10,HOU,,POR,W 121-112,240,45,100,.450,33,62,.532,12,38,.316,19,25,.760,121
3704,2018-01-10,POR,@,HOU,L 112-121,240,40,83,.482,31,57,.544,9,26,.346,23,32,.719,112
3705,2018-01-10,IND,,MIA,L 106-114,240,43,87,.494,42,69,.609,1,18,.056,19,29,.655,106
3706,2018-01-10,MIA,@,IND,W 114-106,240,43,81,.531,30,51,.588,13,30,.433,15,21,.714,114
3707,2018-01-10,MEM,,NOP,W 105-102,240,37,88,.420,32,69,.464,5,19,.263,26,32,.813,105
3708,2018-01-10,NOP,@,MEM,L 102-105,240,34,77,.442,23,42,.548,11,35,.314,23,34,.676,102
3709,2018-01-10,MIL,,ORL,W 110-103,240,45,82,.549,41,63,.651,4,19,.211,16,25,.640,110
3710,2018-01-10,ORL,@,MIL,L 103-110,240,39,90,.433,31,61,.508,8,29,.276,17,18,.944,103
3711,2018-01-10,MIN,,OKC,W 104-88,240,39,80,.488,32,60,.533,7,20,.350,19,27,.704,104
3712,2018-01-10,OKC,@,MIN,L 88-104,240,32,80,.400,26,55,.473,6,25,.240,18,24,.750,88
3713,2018-01-10,CHI,@,NYK,W 122-119 (2OT),290,45,98,.459,30,65,.462,15,33,.455,17,20,.850,122
3714,2018-01-10,NYK,,CHI,L 119-122 (2OT),290,48,96,.500,38,74,.514,10,22,.455,13,21,.619,119
3715,2018-01-10,UTA,@,WAS,W 107-104,240,43,92,.467,32,59,.542,11,33,.333,10,13,.769,107
3716,2018-01-10,WAS,,UTA,L 104-107,240,41,78,.526,31,53,.585,10,25,.400,12,17,.706,104
3717,2018-01-09,DAL,,ORL,W 114-99,240,43,83,.518,34,57,.596,9,26,.346,19,22,.864,114
3718,2018-01-09,ORL,@,DAL,L 99-114,240,36,79,.456,25,50,.500,11,29,.379,16,22,.727,99
3719,2018-01-09,LAL,,SAC,W 99-86,240,37,77,.481,25,42,.595,12,35,.343,13,21,.619,99
3720,2018-01-09,SAC,@,LAL,L 86-99,240,30,87,.345,22,66,.333,8,21,.381,18,27,.667,86
3721,2018-01-09,OKC,,POR,L 106-117,240,37,84,.440,24,53,.453,13,31,.419,19,26,.731,106
3722,2018-01-09,POR,@,OKC,W 117-106,240,43,81,.531,33,58,.569,10,23,.435,21,26,.808,117
3723,2018-01-09,MIA,@,TOR,W 90-89,240,39,97,.402,35,75,.467,4,22,.182,8,10,.800,90
3724,2018-01-09,TOR,,MIA,L 89-90,240,35,90,.389,28,69,.406,7,21,.333,12,15,.800,89
3725,2018-01-08,BRK,,TOR,L 113-114 (OT),265,39,100,.390,27,67,.403,12,33,.364,23,28,.821,113
3726,2018-01-08,TOR,@,BRK,W 114-113 (OT),265,43,101,.426,33,67,.493,10,34,.294,18,23,.783,114
3727,2018-01-08,CHI,,HOU,L 107-116,240,40,86,.465,28,58,.483,12,28,.429,15,18,.833,107
3728,2018-01-08,HOU,@,CHI,W 116-107,240,39,86,.453,19,32,.594,20,54,.370,18,24,.750,116
3729,2018-01-08,DEN,@,GSW,L 114-124,240,47,95,.495,39,76,.513,8,19,.421,12,16,.750,114
3730,2018-01-08,GSW,,DEN,W 124-114,240,48,85,.565,35,55,.636,13,30,.433,15,21,.714,124
3731,2018-01-08,IND,,MIL,W 109-96,240,44,79,.557,37,57,.649,7,22,.318,14,20,.700,109
3732,2018-01-08,MIL,@,IND,L 96-109,240,34,74,.459,27,47,.574,7,27,.259,21,27,.778,96
3733,2018-01-08,ATL,@,LAC,L 107-108,240,38,96,.396,28,59,.475,10,37,.270,21,29,.724,107
3734,2018-01-08,LAC,,ATL,W 108-107,240,38,85,.447,29,67,.433,9,18,.500,23,34,.676,108
3735,2018-01-08,CLE,@,MIN,L 99-127,240,37,84,.440,24,46,.522,13,38,.342,12,16,.750,99
3736,2018-01-08,MIN,,CLE,W 127-99,240,52,100,.520,42,69,.609,10,31,.323,13,17,.765,127
3737,2018-01-08,DET,@,NOP,L 109-112,240,41,93,.441,33,66,.500,8,27,.296,19,22,.864,109
3738,2018-01-08,NOP,,DET,W 112-109,240,46,82,.561,40,60,.667,6,22,.273,14,21,.667,112
3739,2018-01-08,SAC,,SAS,L 100-107,240,40,82,.488,32,59,.542,8,23,.348,12,16,.750,100
3740,2018-01-08,SAS,@,SAC,W 107-100,240,44,90,.489,33,64,.516,11,26,.423,8,13,.615,107
3741,2018-01-07,DAL,,NYK,L 96-100,240,35,92,.380,29,68,.426,6,24,.250,20,24,.833,96
3742,2018-01-07,NYK,@,DAL,W 100-96,240,38,83,.458,32,67,.478,6,16,.375,18,20,.900,100
3743,2018-01-07,ATL,@,LAL,L 113-132,240,41,94,.436,29,60,.483,12,34,.353,19,23,.826,113
3744,2018-01-07,LAL,,ATL,W 132-113,240,48,86,.558,32,50,.640,16,36,.444,20,25,.800,132
3745,2018-01-07,MIA,,UTA,W 103-102,240,40,83,.482,31,54,.574,9,29,.310,14,20,.700,103
3746,2018-01-07,UTA,@,MIA,L 102-103,240,37,82,.451,27,50,.540,10,32,.313,18,20,.900,102
3747,2018-01-07,OKC,@,PHO,L 100-114,240,40,86,.465,32,59,.542,8,27,.296,12,21,.571,100
3748,2018-01-07,PHO,,OKC,W 114-100,240,39,88,.443,22,49,.449,17,39,.436,19,23,.826,114
3749,2018-01-07,POR,,SAS,W 111-110,240,48,92,.522,40,69,.580,8,23,.348,7,10,.700,111
3750,2018-01-07,SAS,@,POR,L 110-111,240,40,81,.494,29,58,.500,11,23,.478,19,26,.731,110
3751,2018-01-06,BOS,@,BRK,W 87-85,240,37,98,.378,32,80,.400,5,18,.278,8,15,.533,87
3752,2018-01-06,BRK,,BOS,L 85-87,240,30,91,.330,24,60,.400,6,31,.194,19,22,.864,85
3753,2018-01-06,DET,,HOU,W 108-101,240,38,75,.507,26,50,.520,12,25,.480,20,27,.741,108
3754,2018-01-06,HOU,@,DET,L 101-108,240,38,90,.422,23,43,.535,15,47,.319,10,11,.909,101
3755,2018-01-06,CHI,@,IND,L 86-125,240,30,80,.375,20,48,.417,10,32,.313,16,20,.800,86
3756,2018-01-06,IND,,CHI,W 125-86,240,48,86,.558,33,55,.600,15,31,.484,14,18,.778,125
3757,2018-01-06,GSW,@,LAC,W 121-105,240,39,94,.415,26,55,.473,13,39,.333,30,37,.811,121
3758,2018-01-06,LAC,,GSW,L 105-121,240,39,91,.429,36,80,.450,3,11,.273,24,30,.800,105
3759,2018-01-06,MIN,,NOP,W 116-98,240,44,90,.489,35,72,.486,9,18,.500,19,21,.905,116
3760,2018-01-06,NOP,@,MIN,L 98-116,240,33,78,.423,27,49,.551,6,29,.207,26,28,.929,98
3761,2018-01-06,CLE,@,ORL,W 131-127,240,47,94,.500,32,60,.533,15,34,.441,22,31,.710,131
3762,2018-01-06,ORL,,CLE,L 127-131,240,49,98,.500,35,61,.574,14,37,.378,15,22,.682,127
3763,2018-01-06,DEN,@,SAC,L 98-106,240,35,76,.461,22,42,.524,13,34,.382,15,21,.714,98
3764,2018-01-06,SAC,,DEN,W 106-98,240,42,94,.447,33,69,.478,9,25,.360,13,17,.765,106
3765,2018-01-06,MIL,@,WAS,W 110-103,240,39,80,.488,32,58,.552,7,22,.318,25,30,.833,110
3766,2018-01-06,WAS,,MIL,L 103-110,240,37,78,.474,29,57,.509,8,21,.381,21,29,.724,103
3767,2018-01-05,BOS,,MIN,W 91-84,240,38,94,.404,32,58,.552,6,36,.167,9,13,.692,91
3768,2018-01-05,MIN,@,BOS,L 84-91,240,28,76,.368,21,53,.396,7,23,.304,21,28,.750,84
3769,2018-01-05,CHI,@,DAL,W 127-124,240,44,78,.564,30,50,.600,14,28,.500,25,31,.806,127
3770,2018-01-05,DAL,,CHI,L 124-127,240,49,92,.533,35,60,.583,14,32,.438,12,17,.706,124
3771,2018-01-05,DEN,,UTA,W 99-91,240,38,86,.442,24,51,.471,14,35,.400,9,15,.600,99
3772,2018-01-05,UTA,@,DEN,L 91-99,240,38,84,.452,26,51,.510,12,33,.364,3,6,.500,91
3773,2018-01-05,CHA,@,LAL,W 108-94,240,42,99,.424,30,66,.455,12,33,.364,12,16,.750,108
3774,2018-01-05,LAL,,CHO,L 94-108,240,38,94,.404,29,58,.500,9,36,.250,9,12,.750,94
3775,2018-01-05,MEM,,WAS,L 100-102,240,35,86,.407,25,56,.446,10,30,.333,20,26,.769,100
3776,2018-01-05,WAS,@,MEM,W 102-100,240,33,84,.393,23,57,.404,10,27,.370,26,34,.765,102
3777,2018-01-05,MIA,,NYK,W 107-103 (OT),265,38,94,.404,26,52,.500,12,42,.286,19,20,.950,107
3778,2018-01-05,NYK,@,MIA,L 103-107 (OT),265,39,80,.488,34,67,.507,5,13,.385,20,23,.870,103
3779,2018-01-05,MIL,,TOR,L 110-129,240,41,77,.532,34,60,.567,7,17,.412,21,29,.724,110
3780,2018-01-05,TOR,@,MIL,W 129-110,240,48,86,.558,38,53,.717,10,33,.303,23,28,.821,129
3781,2018-01-05,DET,@,PHI,L 78-114,240,30,78,.385,23,56,.411,7,22,.318,11,19,.579,78
3782,2018-01-05,PHI,,DET,W 114-78,240,44,90,.489,30,60,.500,14,30,.467,12,13,.923,114
3783,2018-01-05,ATL,@,POR,L 89-110,240,30,83,.361,22,57,.386,8,26,.308,21,25,.840,89
3784,2018-01-05,POR,,ATL,W 110-89,240,43,80,.538,30,50,.600,13,30,.433,11,14,.786,110
3785,2018-01-05,PHO,@,SAS,L 89-103,240,35,83,.422,28,53,.528,7,30,.233,12,18,.667,89
3786,2018-01-05,SAS,,PHO,W 103-89,240,41,87,.471,30,57,.526,11,30,.367,10,18,.556,103
3787,2018-01-04,GSW,@,HOU,W 124-114,240,48,87,.552,35,57,.614,13,30,.433,15,20,.750,124
3788,2018-01-04,HOU,,GSW,L 114-124,240,42,89,.472,25,39,.641,17,50,.340,13,22,.591,114
3789,2018-01-04,LAC,,OKC,L 117-127,240,45,100,.450,36,70,.514,9,30,.300,18,23,.783,117
3790,2018-01-04,OKC,@,LAC,W 127-117,240,51,95,.537,36,61,.590,15,34,.441,10,14,.714,127
3791,2018-01-03,BOS,,CLE,W 102-88,240,41,92,.446,29,56,.518,12,36,.333,8,11,.727,102
3792,2018-01-03,CLE,@,BOS,L 88-102,240,31,89,.348,23,57,.404,8,32,.250,18,18,1.000,88
3793,2018-01-03,BRK,,MIN,W 98-97,240,37,72,.514,23,42,.548,14,30,.467,10,11,.909,98
3794,2018-01-03,MIN,@,BRK,L 97-98,240,36,80,.450,35,69,.507,1,11,.091,24,30,.800,97
3795,2018-01-03,CHI,,TOR,L 115-124,240,43,93,.462,30,60,.500,13,33,.394,16,19,.842,115
3796,2018-01-03,TOR,@,CHI,W 124-115,240,45,92,.489,30,54,.556,15,38,.395,19,19,1.000,124
3797,2018-01-03,DAL,,GSW,L 122-125,240,43,90,.478,24,47,.511,19,43,.442,17,22,.773,122
3798,2018-01-03,GSW,@,DAL,W 125-122,240,48,91,.527,35,59,.593,13,32,.406,16,19,.842,125
3799,2018-01-03,DEN,,PHO,W 134-111,240,51,82,.622,39,55,.709,12,27,.444,20,22,.909,134
3800,2018-01-03,PHO,@,DEN,L 111-134,240,39,92,.424,26,57,.456,13,35,.371,20,28,.714,111
3801,2018-01-03,LAL,,OKC,L 96-133,240,38,92,.413,27,59,.458,11,33,.333,9,15,.600,96
3802,2018-01-03,OKC,@,LAL,W 133-96,240,56,93,.602,42,63,.667,14,30,.467,7,9,.778,133
3803,2018-01-03,DET,@,MIA,L 104-111,240,41,86,.477,32,62,.516,9,24,.375,13,16,.813,104
3804,2018-01-03,MIA,,DET,W 111-104,240,43,84,.512,26,50,.520,17,34,.500,8,11,.727,111
3805,2018-01-03,IND,@,MIL,L 101-122,240,41,84,.488,38,69,.551,3,15,.200,16,19,.842,101
3806,2018-01-03,MIL,,IND,W 122-101,240,44,75,.587,35,58,.603,9,17,.529,25,28,.893,122
3807,2018-01-03,HOU,@,ORL,W 116-98,240,42,89,.472,27,55,.491,15,34,.441,17,21,.810,116
3808,2018-01-03,ORL,,HOU,L 98-116,240,35,91,.385,29,60,.483,6,31,.194,22,25,.880,98
3809,2018-01-03,PHI,,SAS,W 112-106,240,36,80,.450,29,58,.500,7,22,.318,33,43,.767,112
3810,2018-01-03,SAS,@,PHI,L 106-112,240,39,87,.448,31,62,.500,8,25,.320,20,23,.870,106
3811,2018-01-03,NOP,@,UTA,W 108-98,240,41,82,.500,27,52,.519,14,30,.467,12,12,1.000,108
3812,2018-01-03,UTA,,NOP,L 98-108,240,38,84,.452,31,52,.596,7,32,.219,15,17,.882,98
3813,2018-01-03,NYK,@,WAS,L 103-121,240,41,86,.477,34,67,.507,7,19,.368,14,18,.778,103
3814,2018-01-03,WAS,,NYK,W 121-103,240,48,81,.593,39,58,.672,9,23,.391,16,26,.615,121
3815,2018-01-02,CLE,,POR,W 127-110,240,43,83,.518,30,51,.588,13,32,.406,28,37,.757,127
3816,2018-01-02,POR,@,CLE,L 110-127,240,42,90,.467,29,58,.500,13,32,.406,13,19,.684,110
3817,2018-01-02,LAC,,MEM,W 113-105,240,39,71,.549,30,48,.625,9,23,.391,26,31,.839,113
3818,2018-01-02,MEM,@,LAC,L 105-113,240,38,79,.481,30,53,.566,8,26,.308,21,33,.636,105
3819,2018-01-02,NYK,,SAS,L 91-100,240,35,87,.402,28,65,.431,7,22,.318,14,18,.778,91
3820,2018-01-02,SAS,@,NYK,W 100-91,240,31,82,.378,21,55,.382,10,27,.370,28,34,.824,100
3821,2018-01-02,ATL,@,PHO,L 103-104,240,36,87,.414,26,56,.464,10,31,.323,21,25,.840,103
3822,2018-01-02,PHO,,ATL,W 104-103,240,39,77,.506,32,55,.582,7,22,.318,19,26,.731,104
3823,2018-01-02,CHA,@,SAC,W 131-111,240,51,89,.573,36,57,.632,15,32,.469,14,18,.778,131
3824,2018-01-02,SAC,,CHO,L 111-131,240,45,87,.517,38,70,.543,7,17,.412,14,18,.778,111
3825,2018-01-01,BRK,,ORL,W 98-95,240,36,82,.439,27,57,.474,9,25,.360,17,23,.739,98
3826,2018-01-01,ORL,@,BRK,L 95-98,240,35,96,.365,29,65,.446,6,31,.194,19,25,.760,95
3827,2018-01-01,CHI,,POR,L 120-124 (OT),265,45,104,.433,34,77,.442,11,27,.407,19,23,.826,120
3828,2018-01-01,POR,@,CHI,W 124-120 (OT),265,47,108,.435,33,75,.440,14,33,.424,16,18,.889,124
3829,2018-01-01,LAL,@,MIN,L 96-114,240,34,76,.447,26,50,.520,8,26,.308,20,29,.690,96
3830,2018-01-01,MIN,,LAL,W 114-96,240,40,81,.494,33,61,.541,7,20,.350,27,30,.900,114
3831,2018-01-01,MIL,@,TOR,L 127-131 (OT),265,44,93,.473,31,66,.470,13,27,.481,26,28,.929,127
3832,2018-01-01,TOR,,MIL,W 131-127 (OT),265,45,91,.495,31,58,.534,14,33,.424,27,33,.818,131
3833,2017-12-31,BOS,,BRK,W 108-105,240,39,79,.494,25,46,.543,14,33,.424,16,25,.640,108
3834,2017-12-31,BRK,@,BOS,L 105-108,240,39,95,.411,28,59,.475,11,36,.306,16,19,.842,105
3835,2017-12-31,HOU,,LAL,W 148-142 (2OT),290,49,106,.462,31,54,.574,18,52,.346,32,39,.821,148
3836,2017-12-31,LAL,@,HOU,L 142-148 (2OT),290,53,105,.505,43,80,.538,10,25,.400,26,37,.703,142
3837,2017-12-31,IND,,MIN,L 90-107,240,33,85,.388,23,60,.383,10,25,.400,14,18,.778,90
3838,2017-12-31,MIN,@,IND,W 107-90,240,41,86,.477,37,67,.552,4,19,.211,21,25,.840,107
3839,2017-12-31,CHA,@,LAC,L 98-106,240,36,93,.387,25,60,.417,11,33,.333,15,19,.789,98
3840,2017-12-31,LAC,,CHO,W 106-98,240,36,76,.474,26,48,.542,10,28,.357,24,27,.889,106
3841,2017-12-31,DAL,@,OKC,W 116-113,240,46,89,.517,31,55,.564,15,34,.441,9,14,.643,116
3842,2017-12-31,OKC,,DAL,L 113-116,240,43,89,.483,33,57,.579,10,32,.313,17,23,.739,113
3843,2017-12-31,PHI,@,PHO,W 123-110,240,43,77,.558,33,53,.623,10,24,.417,27,34,.794,123
3844,2017-12-31,PHO,,PHI,L 110-123,240,37,88,.420,27,61,.443,10,27,.370,26,34,.765,110
3845,2017-12-31,MEM,@,SAC,W 114-96,240,41,76,.539,27,46,.587,14,30,.467,18,24,.750,114
3846,2017-12-31,SAC,,MEM,L 96-114,240,37,86,.430,28,62,.452,9,24,.375,13,25,.520,96
3847,2017-12-31,CHI,@,WAS,L 110-114,240,42,92,.457,34,57,.596,8,35,.229,18,22,.818,110
3848,2017-12-31,WAS,,CHI,W 114-110,240,43,93,.462,27,57,.474,16,36,.444,12,17,.706,114
3849,2017-12-30,ATL,,POR,W 104-89,240,40,89,.449,26,59,.441,14,30,.467,10,15,.667,104
3850,2017-12-30,POR,@,ATL,L 89-104,240,36,85,.424,29,60,.483,7,25,.280,10,13,.769,89
3851,2017-12-30,DEN,,PHI,L 102-107,240,35,87,.402,28,55,.509,7,32,.219,25,34,.735,102
3852,2017-12-30,PHI,@,DEN,W 107-102,240,45,93,.484,37,69,.536,8,24,.333,9,10,.900,107
3853,2017-12-30,DET,,SAS,W 93-79,240,36,81,.444,28,57,.491,8,24,.333,13,16,.813,93
3854,2017-12-30,SAS,@,DET,L 79-93,240,31,84,.369,26,58,.448,5,26,.192,12,13,.923,79
3855,2017-12-30,GSW,,MEM,W 141-128,240,50,85,.588,32,52,.615,18,33,.545,23,25,.920,141
3856,2017-12-30,MEM,@,GSW,L 128-141,240,49,94,.521,34,73,.466,15,21,.714,15,22,.682,128
3857,2017-12-30,NOP,,NYK,L 103-105,240,38,84,.452,32,58,.552,6,26,.231,21,27,.778,103
3858,2017-12-30,NYK,@,NOP,W 105-103,240,41,94,.436,36,75,.480,5,19,.263,18,21,.857,105
3859,2017-12-30,MIA,@,ORL,W 117-111,240,45,88,.511,33,64,.516,12,24,.500,15,18,.833,117
3860,2017-12-30,ORL,,MIA,L 111-117,240,44,81,.543,32,54,.593,12,27,.444,11,15,.733,111
3861,2017-12-30,CLE,@,UTA,L 101-104,240,34,81,.420,22,41,.537,12,40,.300,21,26,.808,101
3862,2017-12-30,UTA,,CLE,W 104-101,240,38,82,.463,28,51,.549,10,31,.323,18,21,.857,104
3863,2017-12-29,CHI,,IND,W 119-107,240,43,85,.506,25,46,.543,18,39,.462,15,15,1.000,119
3864,2017-12-29,IND,@,CHI,L 107-119,240,43,93,.462,36,71,.507,7,22,.318,14,20,.700,107
3865,2017-12-29,CHA,@,GSW,W 111-100,240,41,89,.461,35,69,.507,6,20,.300,23,34,.676,111
3866,2017-12-29,GSW,,CHO,L 100-111,240,40,87,.460,32,65,.492,8,22,.364,12,13,.923,100
3867,2017-12-29,LAC,@,LAL,W 121-106,240,42,86,.488,33,54,.611,9,32,.281,28,34,.824,121
3868,2017-12-29,LAL,,LAC,L 106-121,240,46,94,.489,43,75,.573,3,19,.158,11,16,.688,106
3869,2017-12-29,BRK,@,MIA,W 111-87,240,39,79,.494,28,53,.528,11,26,.423,22,25,.880,111
3870,2017-12-29,MIA,,BRK,L 87-111,240,30,89,.337,27,63,.429,3,26,.115,24,31,.774,87
3871,2017-12-29,DAL,@,NOP,W 128-120,240,46,83,.554,24,44,.545,22,39,.564,14,18,.778,128
3872,2017-12-29,NOP,,DAL,L 120-128,240,42,85,.494,34,54,.630,8,31,.258,28,32,.875,120
3873,2017-12-29,MIL,@,OKC,W 97-95,240,40,85,.471,31,56,.554,9,29,.310,8,17,.471,97
3874,2017-12-29,OKC,,MIL,L 95-97,240,38,83,.458,31,58,.534,7,25,.280,12,20,.600,95
3875,2017-12-29,PHO,@,SAC,W 111-101,240,41,85,.482,28,55,.509,13,30,.433,16,24,.667,111
3876,2017-12-29,SAC,,PHO,L 101-111,240,37,80,.463,29,57,.509,8,23,.348,19,23,.826,101
3877,2017-12-29,ATL,@,TOR,L 98-111,240,38,88,.432,29,64,.453,9,24,.375,13,20,.650,98
3878,2017-12-29,TOR,,ATL,W 111-98,240,46,105,.438,33,68,.485,13,37,.351,6,8,.750,111
3879,2017-12-29,HOU,@,WAS,L 103-121,240,38,89,.427,24,41,.585,14,48,.292,13,16,.813,103
3880,2017-12-29,WAS,,HOU,W 121-103,240,47,88,.534,29,52,.558,18,36,.500,9,12,.750,121
3881,2017-12-28,BOS,,HOU,W 99-98,240,37,82,.451,29,53,.547,8,29,.276,17,24,.708,99
3882,2017-12-28,HOU,@,BOS,L 98-99,240,30,80,.375,16,37,.432,14,43,.326,24,31,.774,98
3883,2017-12-28,MIL,,MIN,W 102-96,240,41,75,.547,36,60,.600,5,15,.333,15,16,.938,102
3884,2017-12-28,MIN,@,MIL,L 96-102,240,34,71,.479,25,43,.581,9,28,.321,19,26,.731,96
3885,2017-12-28,DET,@,ORL,L 89-102,240,35,87,.402,26,64,.406,9,23,.391,10,14,.714,89
3886,2017-12-28,ORL,,DET,W 102-89,240,37,82,.451,26,56,.464,11,26,.423,17,17,1.000,102
3887,2017-12-28,PHI,@,POR,L 110-114,240,42,87,.483,26,55,.473,16,32,.500,10,14,.714,110
3888,2017-12-28,POR,,PHI,W 114-110,240,35,75,.467,27,51,.529,8,24,.333,36,47,.766,114
3889,2017-12-28,NYK,@,SAS,L 107-119,240,41,90,.456,36,76,.474,5,14,.357,20,22,.909,107
3890,2017-12-28,SAS,,NYK,W 119-107,240,41,80,.513,32,60,.533,9,20,.450,28,39,.718,119
3891,2017-12-27,ATL,,WAS,W 113-99,240,41,94,.436,30,57,.526,11,37,.297,20,29,.690,113
3892,2017-12-27,WAS,@,ATL,L 99-113,240,35,81,.432,26,57,.456,9,24,.375,20,26,.769,99
3893,2017-12-27,CHI,,NYK,W 92-87,240,35,86,.407,25,58,.431,10,28,.357,12,16,.750,92
3894,2017-12-27,NYK,@,CHI,L 87-92,240,37,91,.407,33,68,.485,4,23,.174,9,13,.692,87
3895,2017-12-27,BOS,@,CHO,W 102-91,240,37,78,.474,22,44,.500,15,34,.441,13,13,1.000,102
3896,2017-12-27,CHA,,BOS,L 91-102,240,32,87,.368,25,64,.391,7,23,.304,20,29,.690,91
3897,2017-12-27,GSW,,UTA,W 126-101,240,51,86,.593,40,63,.635,11,23,.478,13,17,.765,126
3898,2017-12-27,UTA,@,GSW,L 101-126,240,37,92,.402,31,69,.449,6,23,.261,21,27,.778,101
3899,2017-12-27,DAL,@,IND,W 98-94,240,40,78,.513,32,49,.653,8,29,.276,10,15,.667,98
3900,2017-12-27,IND,,DAL,L 94-98,240,38,79,.481,28,54,.519,10,25,.400,8,10,.800,94
3901,2017-12-27,LAL,,MEM,L 99-109,240,35,93,.376,27,65,.415,8,28,.286,21,33,.636,99
3902,2017-12-27,MEM,@,LAL,W 109-99,240,35,71,.493,30,50,.600,5,21,.238,34,39,.872,109
3903,2017-12-27,DEN,@,MIN,L 125-128 (OT),265,42,91,.462,27,52,.519,15,39,.385,26,31,.839,125
3904,2017-12-27,MIN,,DEN,W 128-125 (OT),265,47,90,.522,35,61,.574,12,29,.414,22,30,.733,128
3905,2017-12-27,BRK,@,NOP,L 113-128,240,41,90,.456,22,52,.423,19,38,.500,12,14,.857,113
3906,2017-12-27,NOP,,BRK,W 128-113,240,48,90,.533,31,57,.544,17,33,.515,15,19,.789,128
3907,2017-12-27,OKC,,TOR,W 124-107,240,46,87,.529,37,62,.597,9,25,.360,23,33,.697,124
3908,2017-12-27,TOR,@,OKC,L 107-124,240,36,85,.424,25,47,.532,11,38,.289,24,26,.923,107
3909,2017-12-27,CLE,@,SAC,L 95-109,240,32,74,.432,20,43,.465,12,31,.387,19,25,.760,95
3910,2017-12-27,SAC,,CLE,W 109-95,240,41,79,.519,29,49,.592,12,30,.400,15,18,.833,109
3911,2017-12-26,DAL,,TOR,W 98-93,240,40,94,.426,34,70,.486,6,24,.250,12,16,.750,98
3912,2017-12-26,TOR,@,DAL,L 93-98,240,30,89,.337,21,58,.362,9,31,.290,24,32,.750,93
3913,2017-12-26,DEN,,UTA,W 107-83,240,39,81,.481,28,51,.549,11,30,.367,18,22,.818,107
3914,2017-12-26,UTA,@,DEN,L 83-107,240,27,84,.321,17,49,.347,10,35,.286,19,23,.826,83
3915,2017-12-26,DET,,IND,W 107-83,240,41,82,.500,29,48,.604,12,34,.353,13,16,.813,107
3916,2017-12-26,IND,@,DET,L 83-107,240,34,77,.442,28,56,.500,6,21,.286,9,13,.692,83
3917,2017-12-26,LAC,,SAC,W 122-95,240,44,81,.543,31,50,.620,13,31,.419,21,27,.778,122
3918,2017-12-26,SAC,@,LAC,L 95-122,240,40,96,.417,33,74,.446,7,22,.318,8,12,.667,95
3919,2017-12-26,MIA,,ORL,W 107-89,240,41,91,.451,30,58,.517,11,33,.333,14,17,.824,107
3920,2017-12-26,ORL,@,MIA,L 89-107,240,33,81,.407,28,61,.459,5,20,.250,18,22,.818,89
3921,2017-12-26,CHI,@,MIL,W 115-106,240,45,103,.437,35,75,.467,10,28,.357,15,25,.600,115
3922,2017-12-26,MIL,,CHI,L 106-115,240,39,83,.470,29,52,.558,10,31,.323,18,24,.750,106
3923,2017-12-26,MEM,@,PHO,L 97-99,240,35,87,.402,32,67,.478,3,20,.150,24,29,.828,97
3924,2017-12-26,PHO,,MEM,W 99-97,240,32,72,.444,24,50,.480,8,22,.364,27,35,.771,99
3925,2017-12-26,BRK,@,SAS,L 97-109,240,39,93,.419,27,61,.443,12,32,.375,7,9,.778,97
3926,2017-12-26,SAS,,BRK,W 109-97,240,41,80,.513,34,64,.531,7,16,.438,20,24,.833,109
3927,2017-12-25,BOS,,WAS,L 103-111,240,39,81,.481,25,52,.481,14,29,.483,11,17,.647,103
3928,2017-12-25,WAS,@,BOS,W 111-103,240,43,93,.462,37,67,.552,6,26,.231,19,28,.679,111
3929,2017-12-25,CLE,@,GSW,L 92-99,240,28,88,.318,13,52,.250,15,36,.417,21,25,.840,92
3930,2017-12-25,GSW,,CLE,W 99-92,240,38,82,.463,28,45,.622,10,37,.270,13,17,.765,99
3931,2017-12-25,LAL,,MIN,L 104-121,240,40,92,.435,30,62,.484,10,30,.333,14,20,.700,104
3932,2017-12-25,MIN,@,LAL,W 121-104,240,49,84,.583,38,52,.731,11,32,.344,12,14,.857,121
3933,2017-12-25,NYK,,PHI,L 98-105,240,38,94,.404,34,79,.430,4,15,.267,18,28,.643,98
3934,2017-12-25,PHI,@,NYK,W 105-98,240,35,82,.427,25,54,.463,10,28,.357,25,30,.833,105
3935,2017-12-25,HOU,@,OKC,L 107-112,240,35,81,.432,23,44,.523,12,37,.324,25,31,.806,107
3936,2017-12-25,OKC,,HOU,W 112-107,240,43,79,.544,35,61,.574,8,18,.444,18,23,.783,112
3937,2017-12-23,ATL,,DAL,W 112-107,240,42,75,.560,32,51,.627,10,24,.417,18,22,.818,112
3938,2017-12-23,DAL,@,ATL,L 107-112,240,43,85,.506,34,52,.654,9,33,.273,12,15,.800,107
3939,2017-12-23,BOS,,CHI,W 117-92,240,44,92,.478,32,60,.533,12,32,.375,17,21,.810,117
3940,2017-12-23,CHI,@,BOS,L 92-117,240,34,86,.395,27,67,.403,7,19,.368,17,25,.680,92
3941,2017-12-23,CHA,,MIL,W 111-106,240,36,74,.486,27,53,.509,9,21,.429,30,40,.750,111
3942,2017-12-23,MIL,@,CHO,L 106-111,240,42,87,.483,34,61,.557,8,26,.308,14,17,.824,106
3943,2017-12-23,DEN,@,GSW,W 96-81,240,38,82,.463,31,54,.574,7,28,.250,13,15,.867,96
3944,2017-12-23,GSW,,DEN,L 81-96,240,32,84,.381,29,57,.509,3,27,.111,14,17,.824,81
3945,2017-12-23,BRK,@,IND,L 119-123 (OT),265,42,98,.429,26,62,.419,16,36,.444,19,25,.760,119
3946,2017-12-23,IND,,BRK,W 123-119 (OT),265,47,90,.522,37,67,.552,10,23,.435,19,24,.792,123
3947,2017-12-23,LAL,,POR,L 92-95,240,36,85,.424,28,60,.467,8,25,.320,12,20,.600,92
3948,2017-12-23,POR,@,LAL,W 95-92,240,39,95,.411,29,70,.414,10,25,.400,7,14,.500,95
3949,2017-12-23,LAC,@,MEM,L 112-115,240,39,79,.494,26,45,.578,13,34,.382,21,28,.750,112
3950,2017-12-23,MEM,,LAC,W 115-112,240,40,90,.444,27,59,.458,13,31,.419,22,25,.880,115
3951,2017-12-23,MIA,,NOP,L 94-109,240,36,85,.424,26,53,.491,10,32,.313,12,15,.800,94
3952,2017-12-23,NOP,@,MIA,W 109-94,240,39,73,.534,24,48,.500,15,25,.600,16,19,.842,109
3953,2017-12-23,MIN,@,PHO,W 115-106,240,42,84,.500,36,68,.529,6,16,.375,25,29,.862,115
3954,2017-12-23,PHO,,MIN,L 106-115,240,40,86,.465,29,54,.537,11,32,.344,15,24,.625,106
3955,2017-12-23,SAC,,SAS,L 99-108,240,40,86,.465,28,64,.438,12,22,.545,7,11,.636,99
3956,2017-12-23,SAS,@,SAC,W 108-99,240,44,88,.500,33,65,.508,11,23,.478,9,11,.818,108
3957,2017-12-23,PHI,@,TOR,L 86-102,240,33,80,.413,26,53,.491,7,27,.259,13,20,.650,86
3958,2017-12-23,TOR,,PHI,W 102-86,240,35,85,.412,26,58,.448,9,27,.333,23,26,.885,102
3959,2017-12-23,OKC,@,UTA,W 103-89,240,39,88,.443,27,59,.458,12,29,.414,13,16,.813,103
3960,2017-12-23,UTA,,OKC,L 89-103,240,33,72,.458,27,46,.587,6,26,.231,17,20,.850,89
3961,2017-12-23,ORL,@,WAS,L 103-130,240,42,87,.483,34,61,.557,8,26,.308,11,17,.647,103
3962,2017-12-23,WAS,,ORL,W 130-103,240,47,86,.547,31,56,.554,16,30,.533,20,23,.870,130
3963,2017-12-22,BRK,,WAS,W 119-84,240,44,88,.500,30,47,.638,14,41,.341,17,21,.810,119
3964,2017-12-22,WAS,@,BRK,L 84-119,240,34,93,.366,29,73,.397,5,20,.250,11,15,.733,84
3965,2017-12-22,DET,,NYK,W 104-101,240,38,88,.432,28,63,.444,10,25,.400,18,25,.720,104
3966,2017-12-22,NYK,@,DET,L 101-104,240,44,97,.454,36,73,.493,8,24,.333,5,6,.833,101
3967,2017-12-22,GSW,,LAL,W 113-106,240,42,85,.494,35,61,.574,7,24,.292,22,27,.815,113
3968,2017-12-22,LAL,@,GSW,L 106-113,240,40,94,.426,29,65,.446,11,29,.379,15,22,.682,106
3969,2017-12-22,HOU,,LAC,L 118-128,240,36,78,.462,19,38,.500,17,40,.425,29,35,.829,118
3970,2017-12-22,LAC,@,HOU,W 128-118,240,43,91,.473,25,49,.510,18,42,.429,24,31,.774,128
3971,2017-12-22,DAL,@,MIA,L 101-113,240,38,75,.507,21,40,.525,17,35,.486,8,11,.727,101
3972,2017-12-22,MIA,,DAL,W 113-101,240,46,72,.639,30,47,.638,16,25,.640,5,6,.833,113
3973,2017-12-22,CHA,@,MIL,L 104-109,240,39,88,.443,27,62,.435,12,26,.462,14,17,.824,104
3974,2017-12-22,MIL,,CHO,W 109-104,240,41,87,.471,33,58,.569,8,29,.276,19,23,.826,109
3975,2017-12-22,ATL,@,OKC,L 117-120,240,44,85,.518,29,53,.547,15,32,.469,14,17,.824,117
3976,2017-12-22,OKC,,ATL,W 120-117,240,44,82,.537,31,57,.544,13,25,.520,19,31,.613,120
3977,2017-12-22,NOP,@,ORL,W 111-97,240,43,86,.500,33,56,.589,10,30,.333,15,24,.625,111
3978,2017-12-22,ORL,,NOP,L 97-111,240,36,85,.424,32,65,.492,4,20,.200,21,29,.724,97
3979,2017-12-22,DEN,@,POR,W 102-85,240,42,85,.494,35,60,.583,7,25,.280,11,15,.733,102
3980,2017-12-22,POR,,DEN,L 85-102,240,35,83,.422,29,61,.475,6,22,.273,9,16,.563,85
3981,2017-12-21,CHI,@,CLE,L 112-115,240,47,85,.553,35,54,.648,12,31,.387,6,8,.750,112
3982,2017-12-21,CLE,,CHI,W 115-112,240,42,82,.512,30,53,.566,12,29,.414,19,22,.864,115
3983,2017-12-21,BOS,@,NYK,L 93-102,240,33,86,.384,20,48,.417,13,38,.342,14,19,.737,93
3984,2017-12-21,NYK,,BOS,W 102-93,240,36,79,.456,28,65,.431,8,14,.571,22,26,.846,102
3985,2017-12-21,PHI,,TOR,L 109-114,240,45,86,.523,36,57,.632,9,29,.310,10,14,.714,109
3986,2017-12-21,TOR,@,PHI,W 114-109,240,35,85,.412,23,50,.460,12,35,.343,32,35,.914,114
3987,2017-12-21,MEM,@,PHO,L 95-97,240,39,90,.433,34,64,.531,5,26,.192,12,16,.750,95
3988,2017-12-21,PHO,,MEM,W 97-95,240,33,81,.407,23,55,.418,10,26,.385,21,27,.778,97
3989,2017-12-21,SAS,@,UTA,L 89-100,240,34,78,.436,24,57,.421,10,21,.476,11,16,.688,89
3990,2017-12-21,UTA,,SAS,W 100-89,240,34,74,.459,22,48,.458,12,26,.462,20,24,.833,100
3991,2017-12-20,ATL,,IND,L 95-105,240,35,81,.432,27,52,.519,8,29,.276,17,20,.850,95
3992,2017-12-20,IND,@,ATL,W 105-95,240,40,82,.488,33,61,.541,7,21,.333,18,19,.947,105
3993,2017-12-20,BOS,,MIA,L 89-90,240,30,80,.375,17,48,.354,13,32,.406,16,21,.762,89
3994,2017-12-20,MIA,@,BOS,W 90-89,240,33,75,.440,23,47,.489,10,28,.357,14,25,.560,90
3995,2017-12-20,BRK,,SAC,L 99-104,240,32,82,.390,17,40,.425,15,42,.357,20,23,.870,99
3996,2017-12-20,SAC,@,BRK,W 104-99,240,40,82,.488,33,63,.524,7,19,.368,17,20,.850,104
3997,2017-12-20,CHI,,ORL,W 112-94,240,44,87,.506,33,55,.600,11,32,.344,13,14,.929,112
3998,2017-12-20,ORL,@,CHI,L 94-112,240,35,89,.393,30,62,.484,5,27,.185,19,23,.826,94
3999,2017-12-20,CHA,,TOR,L 111-129,240,39,85,.459,32,62,.516,7,23,.304,26,35,.743,111
4000,2017-12-20,TOR,@,CHO,W 129-111,240,49,91,.538,33,58,.569,16,33,.485,15,18,.833,129
4001,2017-12-20,DAL,,DET,W 110-93,240,40,75,.533,26,45,.578,14,30,.467,16,20,.800,110
4002,2017-12-20,DET,@,DAL,L 93-110,240,33,77,.429,26,53,.491,7,24,.292,20,22,.909,93
4003,2017-12-20,DEN,,MIN,L 104-112,240,36,72,.500,23,44,.523,13,28,.464,19,24,.792,104
4004,2017-12-20,MIN,@,DEN,W 112-104,240,43,87,.494,35,63,.556,8,24,.333,18,19,.947,112
4005,2017-12-20,GSW,,MEM,W 97-84,240,34,74,.459,27,53,.509,7,21,.333,22,25,.880,97
4006,2017-12-20,MEM,@,GSW,L 84-97,240,28,84,.333,16,53,.302,12,31,.387,16,19,.842,84
4007,2017-12-20,HOU,,LAL,L 116-122,240,37,90,.411,20,48,.417,17,42,.405,25,32,.781,116
4008,2017-12-20,LAL,@,HOU,W 122-116,240,40,85,.471,25,50,.500,15,35,.429,27,43,.628,122
4009,2017-12-20,LAC,,PHO,W 108-95,240,41,87,.471,31,57,.544,10,30,.333,16,24,.667,108
4010,2017-12-20,PHO,@,LAC,L 95-108,240,35,97,.361,27,62,.435,8,35,.229,17,19,.895,95
4011,2017-12-20,OKC,,UTA,W 107-79,240,40,77,.519,32,54,.593,8,23,.348,19,22,.864,107
4012,2017-12-20,UTA,@,OKC,L 79-107,240,26,73,.356,19,42,.452,7,31,.226,20,27,.741,79
4013,2017-12-20,POR,,SAS,L 91-93,240,38,96,.396,32,71,.451,6,25,.240,9,14,.643,91
4014,2017-12-20,SAS,@,POR,W 93-91,240,41,79,.519,35,62,.565,6,17,.353,5,6,.833,93
4015,2017-12-19,CLE,@,MIL,L 116-119,240,40,80,.500,24,39,.615,16,41,.390,20,24,.833,116
4016,2017-12-19,MIL,,CLE,W 119-116,240,43,82,.524,32,53,.604,11,29,.379,22,27,.815,119
4017,2017-12-19,PHI,,SAC,L 95-101,240,34,81,.420,24,46,.522,10,35,.286,17,24,.708,95
4018,2017-12-19,SAC,@,PHI,W 101-95,240,41,91,.451,34,64,.531,7,27,.259,12,23,.522,101
4019,2017-12-19,NOP,@,WAS,L 106-116,240,34,80,.425,29,60,.483,5,20,.250,33,40,.825,106
4020,2017-12-19,WAS,,NOP,W 116-106,240,46,92,.500,32,57,.561,14,35,.400,10,14,.714,116
4021,2017-12-18,ATL,,MIA,W 110-104,240,38,83,.458,30,61,.492,8,22,.364,26,31,.839,110
4022,2017-12-18,MIA,@,ATL,L 104-110,240,36,79,.456,29,54,.537,7,25,.280,25,30,.833,104
4023,2017-12-18,CHI,,PHI,W 117-115,240,44,92,.478,31,64,.484,13,28,.464,16,19,.842,117
4024,2017-12-18,PHI,@,CHI,L 115-117,240,44,91,.484,30,58,.517,14,33,.424,13,18,.722,115
4025,2017-12-18,CHA,,NYK,W 109-91,240,43,88,.489,34,68,.500,9,20,.450,14,16,.875,109
4026,2017-12-18,NYK,@,CHO,L 91-109,240,36,86,.419,33,68,.485,3,18,.167,16,20,.800,91
4027,2017-12-18,DAL,,PHO,L 91-97,240,32,88,.364,21,51,.412,11,37,.297,16,17,.941,91
4028,2017-12-18,PHO,@,DAL,W 97-91,240,35,79,.443,25,54,.463,10,25,.400,17,22,.773,97
4029,2017-12-18,HOU,,UTA,W 120-99,240,40,77,.519,23,34,.676,17,43,.395,23,27,.852,120
4030,2017-12-18,UTA,@,HOU,L 99-120,240,42,91,.462,34,64,.531,8,27,.296,7,8,.875,99
4031,2017-12-18,BOS,@,IND,W 112-111,240,44,79,.557,28,53,.528,16,26,.615,8,14,.571,112
4032,2017-12-18,IND,,BOS,L 111-112,240,37,79,.468,30,58,.517,7,21,.333,30,38,.789,111
4033,2017-12-18,GSW,@,LAL,W 116-114 (OT),265,43,107,.402,32,73,.438,11,34,.324,19,21,.905,116
4034,2017-12-18,LAL,,GSW,L 114-116 (OT),265,41,92,.446,31,67,.463,10,25,.400,22,35,.629,114
4035,2017-12-18,MIN,,POR,W 108-107,240,42,91,.462,35,72,.486,7,19,.368,17,21,.810,108
4036,2017-12-18,POR,@,MIN,L 107-108,240,46,84,.548,36,60,.600,10,24,.417,5,5,1.000,107
4037,2017-12-18,DEN,@,OKC,L 94-95,240,37,86,.430,25,49,.510,12,37,.324,8,12,.667,94
4038,2017-12-18,OKC,,DEN,W 95-94,240,39,81,.481,32,57,.561,7,24,.292,10,15,.667,95
4039,2017-12-18,LAC,@,SAS,L 91-109,240,37,84,.440,28,55,.509,9,29,.310,8,16,.500,91
4040,2017-12-18,SAS,,LAC,W 109-91,240,40,82,.488,31,58,.534,9,24,.375,20,25,.800,109
4041,2017-12-17,BRK,,IND,L 97-109,240,34,81,.420,22,48,.458,12,33,.364,17,21,.810,97
4042,2017-12-17,IND,@,BRK,W 109-97,240,43,76,.566,35,58,.603,8,18,.444,15,19,.789,109
4043,2017-12-17,DET,,ORL,W 114-110,240,42,89,.472,25,55,.455,17,34,.500,13,16,.813,114
4044,2017-12-17,ORL,@,DET,L 110-114,240,41,85,.482,24,52,.462,17,33,.515,11,17,.647,110
4045,2017-12-17,SAC,@,TOR,L 93-108,240,38,81,.469,27,55,.491,11,26,.423,6,8,.750,93
4046,2017-12-17,TOR,,SAC,W 108-93,240,36,85,.424,23,55,.418,13,30,.433,23,28,.821,108
4047,2017-12-17,CLE,@,WAS,W 106-99,240,41,87,.471,27,53,.509,14,34,.412,10,12,.833,106
4048,2017-12-17,WAS,,CLE,L 99-106,240,39,91,.429,27,58,.466,12,33,.364,9,16,.563,99
4049,2017-12-16,CHA,,POR,L 91-93,240,33,96,.344,26,65,.400,7,31,.226,18,28,.643,91
4050,2017-12-16,POR,@,CHO,W 93-91,240,37,79,.468,27,55,.491,10,24,.417,9,18,.500,93
4051,2017-12-16,CLE,,UTA,W 109-100,240,42,79,.532,32,57,.561,10,22,.455,15,17,.882,109
4052,2017-12-16,UTA,@,CLE,L 100-109,240,37,81,.457,20,47,.426,17,34,.500,9,14,.643,100
4053,2017-12-16,HOU,,MIL,W 115-111,240,35,76,.461,24,41,.585,11,35,.314,34,42,.810,115
4054,2017-12-16,MIL,@,HOU,L 111-115,240,38,82,.463,30,55,.545,8,27,.296,27,33,.818,111
4055,2017-12-16,BOS,@,MEM,W 102-93,240,39,80,.488,25,50,.500,14,30,.467,10,14,.714,102
4056,2017-12-16,MEM,,BOS,L 93-102,240,32,79,.405,18,45,.400,14,34,.412,15,17,.882,93
4057,2017-12-16,LAC,@,MIA,L 85-90,240,35,80,.438,27,52,.519,8,28,.286,7,14,.500,85
4058,2017-12-16,MIA,,LAC,W 90-85,240,31,82,.378,19,47,.404,12,35,.343,16,21,.762,90
4059,2017-12-16,MIN,,PHO,L 106-108,240,40,95,.421,31,68,.456,9,27,.333,17,24,.708,106
4060,2017-12-16,PHO,@,MIN,W 108-106,240,33,72,.458,22,48,.458,11,24,.458,31,35,.886,108
4061,2017-12-16,NYK,,OKC,W 111-96,240,38,69,.551,24,46,.522,14,23,.609,21,26,.808,111
4062,2017-12-16,OKC,@,NYK,L 96-111,240,36,85,.424,24,58,.414,12,27,.444,12,20,.600,96
4063,2017-12-16,DAL,@,SAS,L 96-98,240,39,80,.488,29,52,.558,10,28,.357,8,9,.889,96
4064,2017-12-16,SAS,,DAL,W 98-96,240,39,86,.453,34,61,.557,5,25,.200,15,18,.833,98
4065,2017-12-15,BOS,,UTA,L 95-107,240,35,86,.407,26,55,.473,9,31,.290,16,19,.842,95
4066,2017-12-15,UTA,@,BOS,W 107-95,240,40,83,.482,27,58,.466,13,25,.520,14,18,.778,107
4067,2017-12-15,CHA,,MIA,L 98-104,240,34,83,.410,24,56,.429,10,27,.370,20,27,.741,98
4068,2017-12-15,MIA,@,CHO,W 104-98,240,39,78,.500,28,47,.596,11,31,.355,15,17,.882,104
4069,2017-12-15,DEN,,NOP,W 117-111 (OT),265,46,100,.460,30,64,.469,16,36,.444,9,14,.643,117
4070,2017-12-15,NOP,@,DEN,L 111-117 (OT),265,43,91,.473,28,57,.491,15,34,.441,10,14,.714,111
4071,2017-12-15,HOU,,SAS,W 124-109,240,43,91,.473,25,41,.610,18,50,.360,20,25,.800,124
4072,2017-12-15,SAS,@,HOU,L 109-124,240,46,94,.489,36,68,.529,10,26,.385,7,13,.538,109
4073,2017-12-15,DET,@,IND,W 104-98,240,39,93,.419,26,61,.426,13,32,.406,13,17,.765,104
4074,2017-12-15,IND,,DET,L 98-104,240,35,87,.402,26,57,.456,9,30,.300,19,25,.760,98
4075,2017-12-15,ATL,@,MEM,L 94-96,240,34,77,.442,22,46,.478,12,31,.387,14,16,.875,94
4076,2017-12-15,MEM,,ATL,W 96-94,240,36,78,.462,24,53,.453,12,25,.480,12,17,.706,96
4077,2017-12-15,CHI,@,MIL,W 115-109,240,42,86,.488,34,64,.531,8,22,.364,23,35,.657,115
4078,2017-12-15,MIL,,CHI,L 109-115,240,40,83,.482,31,50,.620,9,33,.273,20,29,.690,109
4079,2017-12-15,ORL,,POR,L 88-95,240,32,84,.381,22,55,.400,10,29,.345,14,19,.737,88
4080,2017-12-15,POR,@,ORL,W 95-88,240,37,86,.430,29,68,.426,8,18,.444,13,15,.867,95
4081,2017-12-15,OKC,@,PHI,W 119-117 (3OT),315,47,113,.416,32,78,.410,15,35,.429,10,19,.526,119
4082,2017-12-15,PHI,,OKC,L 117-119 (3OT),315,44,100,.440,31,54,.574,13,46,.283,16,20,.800,117
4083,2017-12-15,BRK,@,TOR,L 87-120,240,32,76,.421,25,53,.472,7,23,.304,16,19,.842,87
4084,2017-12-15,TOR,,BRK,W 120-87,240,54,97,.557,47,69,.681,7,28,.250,5,9,.556,120
4085,2017-12-15,LAC,@,WAS,L 91-100,240,33,86,.384,26,62,.419,7,24,.292,18,29,.621,91
4086,2017-12-15,WAS,,LAC,W 100-91,240,39,88,.443,32,57,.561,7,31,.226,15,23,.652,100
4087,2017-12-14,ATL,,DET,L 91-105,240,32,70,.457,21,39,.538,11,31,.355,16,26,.615,91
4088,2017-12-14,DET,@,ATL,W 105-91,240,41,90,.456,28,60,.467,13,30,.433,10,12,.833,105
4089,2017-12-14,BRK,,NYK,L 104-111,240,37,83,.446,25,41,.610,12,42,.286,18,23,.783,104
4090,2017-12-14,NYK,@,BRK,W 111-104,240,41,89,.461,31,69,.449,10,20,.500,19,22,.864,111
4091,2017-12-14,CLE,,LAL,W 121-112,240,43,86,.500,28,50,.560,15,36,.417,20,25,.800,121
4092,2017-12-14,LAL,@,CLE,L 112-121,240,47,95,.495,38,64,.594,9,31,.290,9,14,.643,112
4093,2017-12-14,DAL,@,GSW,L 97-112,240,37,82,.451,27,53,.509,10,29,.345,13,17,.765,97
4094,2017-12-14,GSW,,DAL,W 112-97,240,47,78,.603,36,56,.643,11,22,.500,7,9,.778,112
4095,2017-12-14,MIN,,SAC,W 119-96,240,46,82,.561,36,61,.590,10,21,.476,17,20,.850,119
4096,2017-12-14,SAC,@,MIN,L 96-119,240,36,87,.414,22,54,.407,14,33,.424,10,12,.833,96
4097,2017-12-13,BOS,,DEN,W 124-118,240,47,79,.595,36,54,.667,11,25,.440,19,24,.792,124
4098,2017-12-13,DEN,@,BOS,L 118-124,240,45,91,.495,36,63,.571,9,28,.321,19,26,.731,118
4099,2017-12-13,CHI,,UTA,W 103-100,240,41,93,.441,34,76,.447,7,17,.412,14,21,.667,103
4100,2017-12-13,UTA,@,CHI,L 100-103,240,42,91,.462,33,61,.541,9,30,.300,7,7,1.000,100
4101,2017-12-13,CHA,@,HOU,L 96-108,240,36,87,.414,32,66,.485,4,21,.190,20,27,.741,96
4102,2017-12-13,HOU,,CHO,W 108-96,240,39,88,.443,22,43,.512,17,45,.378,13,19,.684,108
4103,2017-12-13,IND,,OKC,L 95-100,240,40,89,.449,29,58,.500,11,31,.355,4,6,.667,95
4104,2017-12-13,OKC,@,IND,W 100-95,240,36,88,.409,23,59,.390,13,29,.448,15,24,.625,100
4105,2017-12-13,MIA,,POR,L 95-102,240,34,72,.472,21,42,.500,13,30,.433,14,23,.609,95
4106,2017-12-13,POR,@,MIA,W 102-95,240,36,72,.500,26,44,.591,10,28,.357,20,23,.870,102
4107,2017-12-13,MIL,@,NOP,L 108-115,240,44,95,.463,36,68,.529,8,27,.296,12,19,.632,108
4108,2017-12-13,NOP,,MIL,W 115-108,240,45,80,.563,32,55,.582,13,25,.520,12,15,.800,115
4109,2017-12-13,LAC,@,ORL,W 106-95,240,39,88,.443,27,62,.435,12,26,.462,16,20,.800,106
4110,2017-12-13,ORL,,LAC,L 95-106,240,37,88,.420,28,61,.459,9,27,.333,12,21,.571,95
4111,2017-12-13,PHO,,TOR,L 109-115,240,37,83,.446,29,59,.492,8,24,.333,27,34,.794,109
4112,2017-12-13,TOR,@,PHO,W 115-109,240,40,92,.435,31,66,.470,9,26,.346,26,31,.839,115
4113,2017-12-13,MEM,@,WAS,L 87-93,240,31,81,.383,21,53,.396,10,28,.357,15,16,.938,87
4114,2017-12-13,WAS,,MEM,W 93-87,240,36,77,.468,27,55,.491,9,22,.409,12,24,.500,93
4115,2017-12-12,BRK,,WAS,W 103-98,240,34,84,.405,24,41,.585,10,43,.233,25,33,.758,103
4116,2017-12-12,WAS,@,BRK,L 98-103,240,38,95,.400,34,73,.466,4,22,.182,18,22,.818,98
4117,2017-12-12,ATL,@,CLE,L 114-123,240,43,92,.467,27,56,.482,16,36,.444,12,13,.923,114
4118,2017-12-12,CLE,,ATL,W 123-114,240,48,86,.558,28,48,.583,20,38,.526,7,10,.700,123
4119,2017-12-12,DAL,,SAS,W 95-89,240,38,89,.427,29,65,.446,9,24,.375,10,12,.833,95
4120,2017-12-12,SAS,@,DAL,L 89-95,240,35,87,.402,28,59,.475,7,28,.250,12,19,.632,89
4121,2017-12-12,DEN,@,DET,W 103-84,240,40,79,.506,30,49,.612,10,30,.333,13,14,.929,103
4122,2017-12-12,DET,,DEN,L 84-103,240,28,79,.354,19,54,.352,9,25,.360,19,22,.864,84
4123,2017-12-12,MIN,,PHI,L 112-118 (OT),265,44,108,.407,39,79,.494,5,29,.172,19,27,.704,112
4124,2017-12-12,PHI,@,MIN,W 118-112 (OT),265,40,80,.500,29,54,.537,11,26,.423,27,32,.844,118
4125,2017-12-12,LAL,@,NYK,L 109-113 (OT),265,42,102,.412,29,67,.433,13,35,.371,12,15,.800,109
4126,2017-12-12,NYK,,LAL,W 113-109 (OT),265,48,101,.475,39,79,.494,9,22,.409,8,11,.727,113
4127,2017-12-12,PHO,@,SAC,L 92-99,240,37,90,.411,30,58,.517,7,32,.219,11,14,.786,92
4128,2017-12-12,SAC,,PHO,W 99-92,240,38,89,.427,31,67,.463,7,22,.318,16,22,.727,99
4129,2017-12-11,BOS,@,CHI,L 85-108,240,33,83,.398,23,43,.535,10,40,.250,9,14,.643,85
4130,2017-12-11,CHI,,BOS,W 108-85,240,39,81,.481,27,52,.519,12,29,.414,18,25,.720,108
4131,2017-12-11,GSW,,POR,W 111-104,240,44,80,.550,34,60,.567,10,20,.500,13,17,.765,111
4132,2017-12-11,POR,@,GSW,L 104-111,240,37,88,.420,30,60,.500,7,28,.250,23,25,.920,104
4133,2017-12-11,HOU,,NOP,W 130-123,240,48,88,.545,31,43,.721,17,45,.378,17,25,.680,130
4134,2017-12-11,NOP,@,HOU,L 123-130,240,49,85,.576,31,52,.596,18,33,.545,7,13,.538,123
4135,2017-12-11,LAC,,TOR,W 96-91,240,34,92,.370,26,56,.464,8,36,.222,20,24,.833,96
4136,2017-12-11,TOR,@,LAC,L 91-96,240,32,80,.400,25,51,.490,7,29,.241,20,26,.769,91
4137,2017-12-11,MEM,,MIA,L 82-107,240,28,72,.389,20,45,.444,8,27,.296,18,27,.667,82
4138,2017-12-11,MIA,@,MEM,W 107-82,240,37,66,.561,23,39,.590,14,27,.519,19,24,.792,107
4139,2017-12-11,CHA,@,OKC,W 116-103,240,43,81,.531,30,56,.536,13,25,.520,17,24,.708,116
4140,2017-12-11,OKC,,CHO,L 103-116,240,35,85,.412,26,59,.441,9,26,.346,24,25,.960,103
4141,2017-12-10,BOS,@,DET,W 91-81,240,33,79,.418,22,49,.449,11,30,.367,14,18,.778,91
4142,2017-12-10,DET,,BOS,L 81-91,240,28,84,.333,18,51,.353,10,33,.303,15,19,.789,81
4143,2017-12-10,DEN,@,IND,L 116-126 (OT),265,43,95,.453,26,53,.491,17,42,.405,13,16,.813,116
4144,2017-12-10,IND,,DEN,W 126-116 (OT),265,49,93,.527,39,68,.574,10,25,.400,18,22,.818,126
4145,2017-12-10,DAL,@,MIN,L 92-97,240,37,81,.457,26,50,.520,11,31,.355,7,9,.778,92
4146,2017-12-10,MIN,,DAL,W 97-92,240,36,72,.500,29,53,.547,7,19,.368,18,23,.783,97
4147,2017-12-10,NOP,,PHI,W 131-124,240,46,80,.575,31,56,.554,15,24,.625,24,32,.750,131
4148,2017-12-10,PHI,@,NOP,L 124-131,240,44,96,.458,35,67,.522,9,29,.310,27,30,.900,124
4149,2017-12-10,ATL,@,NYK,L 107-111,240,37,77,.481,28,46,.609,9,31,.290,24,30,.800,107
4150,2017-12-10,NYK,,ATL,W 111-107,240,39,80,.488,34,63,.540,5,17,.294,28,34,.824,111
4151,2017-12-10,SAC,,TOR,L 87-102,240,35,73,.479,25,50,.500,10,23,.435,7,14,.500,87
4152,2017-12-10,TOR,@,SAC,W 102-87,240,39,87,.448,28,50,.560,11,37,.297,13,19,.684,102
4153,2017-12-09,ATL,,ORL,W 117-110,240,41,80,.513,24,47,.511,17,33,.515,18,25,.720,117
4154,2017-12-09,ORL,@,ATL,L 110-117,240,45,92,.489,32,58,.552,13,34,.382,7,8,.875,110
4155,2017-12-09,BRK,,MIA,L 89-101,240,33,81,.407,26,54,.481,7,27,.259,16,19,.842,89
4156,2017-12-09,MIA,@,BRK,W 101-89,240,42,90,.467,34,63,.540,8,27,.296,9,14,.643,101
4157,2017-12-09,CHI,,NYK,W 104-102,240,42,82,.512,35,57,.614,7,25,.280,13,23,.565,104
4158,2017-12-09,NYK,@,CHI,L 102-104,240,43,91,.473,36,67,.537,7,24,.292,9,9,1.000,102
4159,2017-12-09,CHA,,LAL,L 99-110,240,41,93,.441,33,68,.485,8,25,.320,9,14,.643,99
4160,2017-12-09,LAL,@,CHO,W 110-99,240,43,85,.506,34,58,.586,9,27,.333,15,21,.714,110
4161,2017-12-09,CLE,,PHI,W 105-98,240,36,75,.480,22,46,.478,14,29,.483,19,25,.760,105
4162,2017-12-09,PHI,@,CLE,L 98-105,240,37,78,.474,26,45,.578,11,33,.333,13,13,1.000,98
4163,2017-12-09,LAC,,WAS,W 113-112,240,39,80,.488,25,48,.521,14,32,.438,21,24,.875,113
4164,2017-12-09,WAS,@,LAC,L 112-113,240,42,82,.512,29,50,.580,13,32,.406,15,23,.652,112
4165,2017-12-09,MEM,,OKC,L 101-102 (OT),265,39,88,.443,26,55,.473,13,33,.394,10,17,.588,101
4166,2017-12-09,OKC,@,MEM,W 102-101 (OT),265,36,92,.391,24,58,.414,12,34,.353,18,31,.581,102
4167,2017-12-09,MIL,,UTA,W 117-100,240,44,81,.543,37,64,.578,7,17,.412,22,26,.846,117
4168,2017-12-09,UTA,@,MIL,L 100-117,240,33,76,.434,25,53,.472,8,23,.348,26,37,.703,100
4169,2017-12-09,PHO,,SAS,L 101-104,240,35,80,.438,28,55,.509,7,25,.280,24,30,.800,101
4170,2017-12-09,SAS,@,PHO,W 104-101,240,40,87,.460,34,68,.500,6,19,.316,18,25,.720,104
4171,2017-12-09,HOU,@,POR,W 124-117,240,40,75,.533,30,50,.600,10,25,.400,34,42,.810,124
4172,2017-12-09,POR,,HOU,L 117-124,240,45,88,.511,27,47,.574,18,41,.439,9,12,.750,117
4173,2017-12-08,CHI,@,CHO,W 119-111 (OT),265,48,99,.485,42,81,.519,6,18,.333,17,22,.773,119
4174,2017-12-08,CHA,,CHI,L 111-119 (OT),265,40,100,.400,30,71,.423,10,29,.345,21,29,.724,111
4175,2017-12-08,DET,,GSW,L 98-102,240,38,92,.413,26,65,.400,12,27,.444,10,19,.526,98
4176,2017-12-08,GSW,@,DET,W 102-98,240,39,81,.481,32,55,.582,7,26,.269,17,22,.773,102
4177,2017-12-08,CLE,@,IND,L 102-106,240,37,85,.435,26,49,.531,11,36,.306,17,22,.773,102
4178,2017-12-08,IND,,CLE,W 106-102,240,38,86,.442,23,47,.489,15,39,.385,15,24,.625,106
4179,2017-12-08,MEM,,TOR,L 107-116,240,41,82,.500,32,55,.582,9,27,.333,16,22,.727,107
4180,2017-12-08,TOR,@,MEM,W 116-107,240,37,78,.474,24,47,.511,13,31,.419,29,33,.879,116
4181,2017-12-08,DAL,@,MIL,L 102-109,240,35,75,.467,25,51,.490,10,24,.417,22,26,.846,102
4182,2017-12-08,MIL,,DAL,W 109-102,240,36,79,.456,28,55,.509,8,24,.333,29,34,.853,109
4183,2017-12-08,NOP,,SAC,L 109-116 (OT),265,41,89,.461,31,61,.508,10,28,.357,17,19,.895,109
4184,2017-12-08,SAC,@,NOP,W 116-109 (OT),265,47,97,.485,34,67,.507,13,30,.433,9,14,.643,116
4185,2017-12-08,DEN,@,ORL,W 103-89,240,42,85,.494,36,64,.563,6,21,.286,13,16,.813,103
4186,2017-12-08,ORL,,DEN,L 89-103,240,33,83,.398,28,62,.452,5,21,.238,18,23,.783,89
4187,2017-12-08,BOS,@,SAS,L 102-105,240,38,83,.458,27,45,.600,11,38,.289,15,17,.882,102
4188,2017-12-08,SAS,,BOS,W 105-102,240,38,81,.469,30,54,.556,8,27,.296,21,24,.875,105
4189,2017-12-07,BRK,,OKC,W 100-95,240,35,80,.438,24,43,.558,11,37,.297,19,30,.633,100
4190,2017-12-07,OKC,@,BRK,L 95-100,240,38,98,.388,31,74,.419,7,24,.292,12,23,.522,95
4191,2017-12-07,LAL,@,PHI,W 107-104,240,42,96,.438,31,68,.456,11,28,.393,12,24,.500,107
4192,2017-12-07,PHI,,LAL,L 104-107,240,39,81,.481,29,55,.527,10,26,.385,16,21,.762,104
4193,2017-12-07,PHO,,WAS,L 99-109,240,36,78,.462,29,55,.527,7,23,.304,20,28,.714,99
4194,2017-12-07,WAS,@,PHO,W 109-99,240,41,81,.506,33,60,.550,8,21,.381,19,25,.760,109
4195,2017-12-07,HOU,@,UTA,W 112-101,240,38,81,.469,20,39,.513,18,42,.429,18,24,.750,112
4196,2017-12-07,UTA,,HOU,L 101-112,240,34,77,.442,23,47,.489,11,30,.367,22,27,.815,101
4197,2017-12-06,BOS,,DAL,W 97-90,240,36,87,.414,24,53,.453,12,34,.353,13,17,.765,97
4198,2017-12-06,DAL,@,BOS,L 90-97,240,34,86,.395,25,58,.431,9,28,.321,13,17,.765,90
4199,2017-12-06,CHA,,GSW,L 87-101,240,34,97,.351,28,78,.359,6,19,.316,13,17,.765,87
4200,2017-12-06,GSW,@,CHO,W 101-87,240,40,84,.476,29,54,.537,11,30,.367,10,13,.769,101
4201,2017-12-06,CLE,,SAC,W 101-95,240,37,78,.474,23,39,.590,14,39,.359,13,21,.619,101
4202,2017-12-06,SAC,@,CLE,L 95-101,240,39,86,.453,29,54,.537,10,32,.313,7,13,.538,95
4203,2017-12-06,CHI,@,IND,L 96-98,240,39,83,.470,29,57,.509,10,26,.385,8,16,.500,96
4204,2017-12-06,IND,,CHI,W 98-96,240,39,87,.448,27,53,.509,12,34,.353,8,10,.800,98
4205,2017-12-06,LAC,,MIN,L 107-113,240,44,99,.444,34,67,.507,10,32,.313,9,15,.600,107
4206,2017-12-06,MIN,@,LAC,W 113-107,240,45,82,.549,38,63,.603,7,19,.368,16,21,.762,113
4207,2017-12-06,DET,@,MIL,L 100-104,240,36,87,.414,26,57,.456,10,30,.333,18,27,.667,100
4208,2017-12-06,MIL,,DET,W 104-100,240,39,79,.494,31,57,.544,8,22,.364,18,26,.692,104
4209,2017-12-06,DEN,@,NOP,L 114-123,240,41,94,.436,25,59,.424,16,35,.457,16,22,.727,114
4210,2017-12-06,NOP,,DEN,W 123-114,240,46,86,.535,34,55,.618,12,31,.387,19,29,.655,123
4211,2017-12-06,MEM,@,NYK,L 88-99,240,29,70,.414,17,42,.405,12,28,.429,18,22,.818,88
4212,2017-12-06,NYK,,MEM,W 99-88,240,35,67,.522,26,53,.491,9,14,.643,20,27,.741,99
4213,2017-12-06,ATL,@,ORL,L 106-110 (OT),265,40,93,.430,29,66,.439,11,27,.407,15,20,.750,106
4214,2017-12-06,ORL,,ATL,W 110-106 (OT),265,46,98,.469,40,70,.571,6,28,.214,12,18,.667,110
4215,2017-12-06,MIA,@,SAS,L 105-117,240,39,72,.542,21,38,.553,18,34,.529,9,12,.750,105
4216,2017-12-06,SAS,,MIA,W 117-105,240,46,87,.529,33,62,.532,13,25,.520,12,14,.857,117
4217,2017-12-05,OKC,,UTA,W 100-94,240,39,81,.481,35,63,.556,4,18,.222,18,26,.692,100
4218,2017-12-05,UTA,@,OKC,L 94-100,240,34,79,.430,23,46,.500,11,33,.333,15,21,.714,94
4219,2017-12-05,POR,,WAS,L 92-106,240,32,78,.410,20,51,.392,12,27,.444,16,21,.762,92
4220,2017-12-05,WAS,@,POR,W 106-92,240,42,89,.472,31,64,.484,11,25,.440,11,14,.786,106
4221,2017-12-05,PHO,@,TOR,L 113-126,240,37,75,.493,28,51,.549,9,24,.375,30,38,.789,113
4222,2017-12-05,TOR,,PHO,W 126-113,240,44,92,.478,29,56,.518,15,36,.417,23,26,.885,126
4223,2017-12-04,ATL,,BRK,L 90-110,240,30,82,.366,21,52,.404,9,30,.300,21,27,.778,90
4224,2017-12-04,BRK,@,ATL,W 110-90,240,41,85,.482,26,49,.531,15,36,.417,13,15,.867,110
4225,2017-12-04,BOS,,MIL,W 111-100,240,43,78,.551,33,56,.589,10,22,.455,15,19,.789,111
4226,2017-12-04,MIL,@,BOS,L 100-111,240,35,78,.449,26,57,.456,9,21,.429,21,24,.875,100
4227,2017-12-04,CHI,,CLE,L 91-113,240,34,82,.415,25,48,.521,9,34,.265,14,18,.778,91
4228,2017-12-04,CLE,@,CHI,W 113-91,240,42,81,.519,29,45,.644,13,36,.361,16,17,.941,113
4229,2017-12-04,CHA,,ORL,W 104-94,240,34,84,.405,31,67,.463,3,17,.176,33,40,.825,104
4230,2017-12-04,ORL,@,CHO,L 94-104,240,36,82,.439,26,50,.520,10,32,.313,12,14,.857,94
4231,2017-12-04,DAL,,DEN,W 122-105,240,49,86,.570,37,60,.617,12,26,.462,12,17,.706,122
4232,2017-12-04,DEN,@,DAL,L 105-122,240,38,91,.418,24,55,.436,14,36,.389,15,23,.652,105
4233,2017-12-04,IND,,NYK,W 115-97,240,46,86,.535,35,60,.583,11,26,.423,12,15,.800,115
4234,2017-12-04,NYK,@,IND,L 97-115,240,40,91,.440,34,68,.500,6,23,.261,11,16,.688,97
4235,2017-12-04,MEM,,MIN,W 95-92,240,34,72,.472,28,51,.549,6,21,.286,21,24,.875,95
4236,2017-12-04,MIN,@,MEM,L 92-95,240,35,79,.443,31,62,.500,4,17,.235,18,19,.947,92
4237,2017-12-04,GSW,@,NOP,W 125-115,240,45,87,.517,29,54,.537,16,33,.485,19,27,.704,125
4238,2017-12-04,NOP,,GSW,L 115-125,240,45,91,.495,29,52,.558,16,39,.410,9,15,.600,115
4239,2017-12-04,PHI,,PHO,L 101-115,240,39,91,.429,32,61,.525,7,30,.233,16,16,1.000,101
4240,2017-12-04,PHO,@,PHI,W 115-101,240,44,91,.484,34,69,.493,10,22,.455,17,22,.773,115
4241,2017-12-04,DET,@,SAS,L 93-96,240,35,85,.412,27,58,.466,8,27,.296,15,24,.625,93
4242,2017-12-04,SAS,,DET,W 96-93,240,35,82,.427,21,51,.412,14,31,.452,12,12,1.000,96
4243,2017-12-04,UTA,,WAS,W 116-69,240,43,76,.566,27,42,.643,16,34,.471,14,18,.778,116
4244,2017-12-04,WAS,@,UTA,L 69-116,240,23,80,.288,19,60,.317,4,20,.200,19,23,.826,69
4245,2017-12-03,HOU,@,LAL,W 118-95,240,45,90,.500,31,53,.585,14,37,.378,14,17,.824,118
4246,2017-12-03,LAL,,HOU,L 95-118,240,32,84,.381,23,56,.411,9,28,.321,22,30,.733,95
4247,2017-12-03,GSW,@,MIA,W 123-95,240,47,84,.560,36,54,.667,11,30,.367,18,24,.750,123
4248,2017-12-03,MIA,,GSW,L 95-123,240,33,81,.407,19,44,.432,14,37,.378,15,17,.882,95
4249,2017-12-03,LAC,@,MIN,L 106-112,240,37,73,.507,22,39,.564,15,34,.441,17,22,.773,106
4250,2017-12-03,MIN,,LAC,W 112-106,240,38,88,.432,30,62,.484,8,26,.308,28,31,.903,112
4251,2017-12-03,NYK,,ORL,L 100-105,240,43,93,.462,38,78,.487,5,15,.333,9,10,.900,100
4252,2017-12-03,ORL,@,NYK,W 105-100,240,37,82,.451,31,54,.574,6,28,.214,25,29,.862,105
4253,2017-12-03,OKC,,SAS,W 90-87,240,37,87,.425,31,65,.477,6,22,.273,10,21,.476,90
4254,2017-12-03,SAS,@,OKC,L 87-90,240,31,76,.408,23,48,.479,8,28,.286,17,23,.739,87
4255,2017-12-02,BOS,,PHO,W 116-111,240,42,80,.525,28,49,.571,14,31,.452,18,23,.783,116
4256,2017-12-02,PHO,@,BOS,L 111-116,240,48,101,.475,41,77,.532,7,24,.292,8,11,.727,111
4257,2017-12-02,ATL,@,BRK,W 114-102,240,47,99,.475,37,72,.514,10,27,.370,10,14,.714,114
4258,2017-12-02,BRK,,ATL,L 102-114,240,34,82,.415,17,40,.425,17,42,.405,17,21,.810,102
4259,2017-12-02,CLE,,MEM,W 116-111,240,42,75,.560,31,51,.608,11,24,.458,21,23,.913,116
4260,2017-12-02,MEM,@,CLE,L 111-116,240,43,84,.512,30,61,.492,13,23,.565,12,14,.857,111
4261,2017-12-02,DAL,,LAC,W 108-82,240,36,79,.456,20,44,.455,16,35,.457,20,26,.769,108
4262,2017-12-02,LAC,@,DAL,L 82-108,240,30,86,.349,24,64,.375,6,22,.273,16,23,.696,82
4263,2017-12-02,DEN,,LAL,W 115-100,240,40,87,.460,28,56,.500,12,31,.387,23,28,.821,115
4264,2017-12-02,LAL,@,DEN,L 100-115,240,38,86,.442,29,56,.518,9,30,.300,15,21,.714,100
4265,2017-12-02,MIL,,SAC,W 109-104,240,34,69,.493,28,50,.560,6,19,.316,35,42,.833,109
4266,2017-12-02,SAC,@,MIL,L 104-109,240,37,77,.481,26,53,.491,11,24,.458,19,21,.905,104
4267,2017-12-02,DET,@,PHI,L 103-108,240,34,78,.436,25,47,.532,9,31,.290,26,32,.813,103
4268,2017-12-02,PHI,,DET,W 108-103,240,35,86,.407,25,58,.431,10,28,.357,28,32,.875,108
4269,2017-12-02,NOP,@,POR,W 123-116,240,45,86,.523,30,55,.545,15,31,.484,18,25,.720,123
4270,2017-12-02,POR,,NOP,L 116-123,240,47,105,.448,36,70,.514,11,35,.314,11,11,1.000,116
4271,2017-12-01,CHI,,SAC,L 106-107,240,42,90,.467,29,54,.537,13,36,.361,9,13,.692,106
4272,2017-12-01,SAC,@,CHI,W 107-106,240,45,85,.529,39,67,.582,6,18,.333,11,14,.786,107
4273,2017-12-01,MEM,,SAS,L 79-95,240,30,74,.405,25,59,.424,5,15,.333,14,18,.778,79
4274,2017-12-01,SAS,@,MEM,W 95-79,240,31,70,.443,20,43,.465,11,27,.407,22,32,.688,95
4275,2017-12-01,CHA,@,MIA,L 100-105,240,38,79,.481,33,59,.559,5,20,.250,19,21,.905,100
4276,2017-12-01,MIA,,CHO,W 105-100,240,39,80,.488,25,45,.556,14,35,.400,13,21,.619,105
4277,2017-12-01,MIN,@,OKC,L 107-111,240,39,76,.513,27,52,.519,12,24,.500,17,21,.810,107
4278,2017-12-01,OKC,,MIN,W 111-107,240,41,79,.519,33,53,.623,8,26,.308,21,22,.955,111
4279,2017-12-01,GSW,@,ORL,W 133-112,240,55,88,.625,43,64,.672,12,24,.500,11,11,1.000,133
4280,2017-12-01,ORL,,GSW,L 112-133,240,44,96,.458,33,68,.485,11,28,.393,13,18,.722,112
4281,2017-12-01,IND,@,TOR,L 115-120,240,45,102,.441,37,76,.487,8,26,.308,17,22,.773,115
4282,2017-12-01,TOR,,IND,W 120-115,240,48,97,.495,38,65,.585,10,32,.313,14,21,.667,120
4283,2017-12-01,NOP,@,UTA,L 108-114,240,42,87,.483,27,57,.474,15,30,.500,9,15,.600,108
4284,2017-12-01,UTA,,NOP,W 114-108,240,42,85,.494,30,55,.545,12,30,.400,18,25,.720,114
4285,2017-12-01,DET,@,WAS,L 91-109,240,35,79,.443,26,49,.531,9,30,.300,12,19,.632,91
4286,2017-12-01,WAS,,DET,W 109-91,240,43,89,.483,36,68,.529,7,21,.333,16,19,.842,109
4287,2017-11-30,ATL,,CLE,L 114-121,240,41,79,.519,29,48,.604,12,31,.387,20,24,.833,114
4288,2017-11-30,CLE,@,ATL,W 121-114,240,41,79,.519,23,40,.575,18,39,.462,21,27,.778,121
4289,2017-11-30,BOS,,PHI,W 108-97,240,40,79,.506,28,50,.560,12,29,.414,16,20,.800,108
4290,2017-11-30,PHI,@,BOS,L 97-108,240,35,84,.417,19,52,.365,16,32,.500,11,18,.611,97
4291,2017-11-30,CHI,@,DEN,L 110-111,240,44,82,.537,35,58,.603,9,24,.375,13,21,.619,110
4292,2017-11-30,DEN,,CHI,W 111-110,240,38,83,.458,26,52,.500,12,31,.387,23,31,.742,111
4293,2017-11-30,LAC,,UTA,L 107-126,240,38,70,.543,28,41,.683,10,29,.345,21,30,.700,107
4294,2017-11-30,UTA,@,LAC,W 126-107,240,49,85,.576,32,50,.640,17,35,.486,11,14,.786,126
4295,2017-11-30,MIL,@,POR,W 103-91,240,42,87,.483,36,67,.537,6,20,.300,13,15,.867,103
4296,2017-11-30,POR,,MIL,L 91-103,240,35,83,.422,29,60,.483,6,23,.261,15,17,.882,91
4297,2017-11-29,BRK,@,DAL,W 109-104,240,42,90,.467,31,61,.508,11,29,.379,14,25,.560,109
4298,2017-11-29,DAL,,BRK,L 104-109,240,39,84,.464,30,57,.526,9,27,.333,17,21,.810,104
4299,2017-11-29,DET,,PHO,W 131-107,240,51,89,.573,38,61,.623,13,28,.464,16,21,.762,131
4300,2017-11-29,PHO,@,DET,L 107-131,240,39,84,.464,32,62,.516,7,22,.318,22,28,.786,107
4301,2017-11-29,HOU,,IND,W 118-97,240,42,86,.488,24,46,.522,18,40,.450,16,21,.762,118
4302,2017-11-29,IND,@,HOU,L 97-118,240,42,88,.477,35,60,.583,7,28,.250,6,6,1.000,97
4303,2017-11-29,GSW,@,LAL,W 127-123 (OT),265,47,94,.500,35,64,.547,12,30,.400,21,28,.750,127
4304,2017-11-29,LAL,,GSW,L 123-127 (OT),265,47,95,.495,38,71,.535,9,24,.375,20,25,.800,123
4305,2017-11-29,MIN,@,NOP,W 120-102,240,47,81,.580,38,58,.655,9,23,.391,17,19,.895,120
4306,2017-11-29,NOP,,MIN,L 102-120,240,39,84,.464,25,49,.510,14,35,.400,10,11,.909,102
4307,2017-11-29,MIA,@,NYK,L 86-115,240,32,84,.381,22,46,.478,10,38,.263,12,20,.600,86
4308,2017-11-29,NYK,,MIA,W 115-86,240,44,73,.603,39,60,.650,5,13,.385,22,26,.846,115
4309,2017-11-29,OKC,@,ORL,L 108-121,240,38,96,.396,26,64,.406,12,32,.375,20,30,.667,108
4310,2017-11-29,ORL,,OKC,W 121-108,240,45,76,.592,32,46,.696,13,30,.433,18,26,.692,121
4311,2017-11-29,PHI,,WAS,W 118-113,240,37,81,.457,34,63,.540,3,18,.167,41,64,.641,118
4312,2017-11-29,WAS,@,PHI,L 113-118,240,36,89,.404,27,67,.403,9,22,.409,32,37,.865,113
4313,2017-11-29,MEM,@,SAS,L 95-104,240,35,77,.455,24,55,.436,11,22,.500,14,16,.875,95
4314,2017-11-29,SAS,,MEM,W 104-95,240,38,75,.507,30,55,.545,8,20,.400,20,24,.833,104
4315,2017-11-29,CHA,@,TOR,L 113-126,240,37,79,.468,28,60,.467,9,19,.474,30,35,.857,113
4316,2017-11-29,TOR,,CHO,W 126-113,240,52,98,.531,38,66,.576,14,32,.438,8,11,.727,126
4317,2017-11-28,CHI,,PHO,L 99-104,240,38,94,.404,22,54,.407,16,40,.400,7,10,.700,99
4318,2017-11-28,PHO,@,CHI,W 104-99,240,38,87,.437,27,57,.474,11,30,.367,17,23,.739,104
4319,2017-11-28,CLE,,MIA,W 108-97,240,40,81,.494,29,48,.604,11,33,.333,17,23,.739,108
4320,2017-11-28,MIA,@,CLE,L 97-108,240,37,84,.440,27,53,.509,10,31,.323,13,20,.650,97
4321,2017-11-28,MIN,,WAS,L 89-92,240,35,85,.412,25,55,.455,10,30,.333,9,14,.643,89
4322,2017-11-28,WAS,@,MIN,W 92-89,240,36,83,.434,26,55,.473,10,28,.357,10,17,.588,92
4323,2017-11-28,MIL,@,SAC,W 112-87,240,42,71,.592,33,49,.673,9,22,.409,19,31,.613,112
4324,2017-11-28,SAC,,MIL,L 87-112,240,31,77,.403,26,60,.433,5,17,.294,20,29,.690,87
4325,2017-11-28,DEN,@,UTA,L 77-106,240,28,78,.359,21,44,.477,7,34,.206,14,16,.875,77
4326,2017-11-28,UTA,,DEN,W 106-77,240,42,87,.483,28,55,.509,14,32,.438,8,9,.889,106
4327,2017-11-27,BOS,,DET,L 108-118,240,40,77,.519,24,44,.545,16,33,.485,12,21,.571,108
4328,2017-11-27,DET,@,BOS,W 118-108,240,44,85,.518,33,60,.550,11,25,.440,19,23,.826,118
4329,2017-11-27,GSW,,SAC,L 106-110,240,40,80,.500,24,43,.558,16,37,.432,10,14,.714,106
4330,2017-11-27,SAC,@,GSW,W 110-106,240,42,79,.532,33,62,.532,9,17,.529,17,21,.810,110
4331,2017-11-27,BRK,@,HOU,L 103-117,240,40,86,.465,30,47,.638,10,39,.256,13,17,.765,103
4332,2017-11-27,HOU,,BRK,W 117-103,240,42,86,.488,22,36,.611,20,50,.400,13,20,.650,117
4333,2017-11-27,IND,,ORL,W 121-109,240,42,79,.532,27,53,.509,15,26,.577,22,26,.846,121
4334,2017-11-27,ORL,@,IND,L 109-121,240,40,92,.435,24,51,.471,16,41,.390,13,16,.813,109
4335,2017-11-27,LAC,,LAL,W 120-115,240,41,85,.482,31,57,.544,10,28,.357,28,30,.933,120
4336,2017-11-27,LAL,@,LAC,L 115-120,240,44,91,.484,33,61,.541,11,30,.367,16,24,.667,115
4337,2017-11-27,NYK,,POR,L 91-103,240,35,88,.398,30,73,.411,5,15,.333,16,22,.727,91
4338,2017-11-27,POR,@,NYK,W 103-91,240,37,83,.446,30,62,.484,7,21,.333,22,26,.846,103
4339,2017-11-27,CLE,@,PHI,W 113-91,240,41,86,.477,26,49,.531,15,37,.405,16,20,.800,113
4340,2017-11-27,PHI,,CLE,L 91-113,240,36,96,.375,33,68,.485,3,28,.107,16,20,.800,91
4341,2017-11-27,DAL,@,SAS,L 108-115,240,41,85,.482,27,53,.509,14,32,.438,12,17,.706,108
4342,2017-11-27,SAS,,DAL,W 115-108,240,43,82,.524,33,58,.569,10,24,.417,19,21,.905,115
4343,2017-11-26,CHI,,MIA,L 93-100,240,33,89,.371,19,56,.339,14,33,.424,13,16,.813,93
4344,2017-11-26,MIA,@,CHI,W 100-93,240,34,75,.453,21,43,.488,13,32,.406,19,23,.826,100
4345,2017-11-26,BRK,@,MEM,W 98-88,240,33,74,.446,20,45,.444,13,29,.448,19,23,.826,98
4346,2017-11-26,MEM,,BRK,L 88-98,240,32,80,.400,24,55,.436,8,25,.320,16,18,.889,88
4347,2017-11-26,MIN,,PHO,W 119-108,240,49,93,.527,40,72,.556,9,21,.429,12,17,.706,119
4348,2017-11-26,PHO,@,MIN,L 108-119,240,43,85,.506,30,59,.508,13,26,.500,9,12,.750,108
4349,2017-11-25,ATL,,TOR,L 78-112,240,26,75,.347,20,48,.417,6,27,.222,20,23,.870,78
4350,2017-11-25,TOR,@,ATL,W 112-78,240,46,84,.548,33,52,.635,13,32,.406,7,9,.778,112
4351,2017-11-25,CHA,,SAS,L 86-106,240,31,84,.369,27,59,.458,4,25,.160,20,26,.769,86
4352,2017-11-25,SAS,@,CHO,W 106-86,240,39,81,.481,33,56,.589,6,25,.240,22,25,.880,106
4353,2017-11-25,DAL,,OKC,W 97-81,240,37,75,.493,22,40,.550,15,35,.429,8,11,.727,97
4354,2017-11-25,OKC,@,DAL,L 81-97,240,29,80,.363,16,45,.356,13,35,.371,10,13,.769,81
4355,2017-11-25,GSW,,NOP,W 110-95,240,39,94,.415,29,61,.475,10,33,.303,22,27,.815,110
4356,2017-11-25,NOP,@,GSW,L 95-110,240,34,84,.405,23,53,.434,11,31,.355,16,23,.696,95
4357,2017-11-25,HOU,,NYK,W 117-102,240,41,94,.436,23,47,.489,18,47,.383,17,22,.773,117
4358,2017-11-25,NYK,@,HOU,L 102-117,240,42,85,.494,38,68,.559,4,17,.235,14,19,.737,102
4359,2017-11-25,BOS,@,IND,W 108-98,240,45,80,.563,35,55,.636,10,25,.400,8,9,.889,108
4360,2017-11-25,IND,,BOS,L 98-108,240,38,78,.487,31,55,.564,7,23,.304,15,15,1.000,98
4361,2017-11-25,ORL,@,PHI,L 111-130,240,39,86,.453,27,55,.491,12,31,.387,21,31,.677,111
4362,2017-11-25,PHI,,ORL,W 130-111,240,48,95,.505,32,61,.525,16,34,.471,18,20,.900,130
4363,2017-11-25,LAC,@,SAC,W 97-95,240,38,80,.475,29,52,.558,9,28,.321,12,13,.923,97
4364,2017-11-25,SAC,,LAC,L 95-97,240,38,83,.458,27,62,.435,11,21,.524,8,9,.889,95
4365,2017-11-25,MIL,@,UTA,L 108-121,240,41,77,.532,33,56,.589,8,21,.381,18,23,.783,108
4366,2017-11-25,UTA,,MIL,W 121-108,240,46,81,.568,28,49,.571,18,32,.563,11,19,.579,121
4367,2017-11-25,POR,@,WAS,W 108-105,240,41,80,.513,32,56,.571,9,24,.375,17,22,.773,108
4368,2017-11-25,WAS,,POR,L 105-108,240,41,89,.461,33,66,.500,8,23,.348,15,16,.938,105
4369,2017-11-24,ATL,,NYK,W 116-104,240,47,99,.475,34,68,.500,13,31,.419,9,12,.750,116
4370,2017-11-24,NYK,@,ATL,L 104-116,240,40,78,.513,28,48,.583,12,30,.400,12,14,.857,104
4371,2017-11-24,BOS,,ORL,W 118-103,240,42,91,.462,25,49,.510,17,42,.405,17,25,.680,118
4372,2017-11-24,ORL,@,BOS,L 103-118,240,41,95,.432,32,71,.451,9,24,.375,12,19,.632,103
4373,2017-11-24,BRK,,POR,L 125-127,240,50,100,.500,40,75,.533,10,25,.400,15,21,.714,125
4374,2017-11-24,POR,@,BRK,W 127-125,240,48,96,.500,42,81,.519,6,15,.400,25,35,.714,127
4375,2017-11-24,CHA,@,CLE,L 99-100,240,36,94,.383,25,65,.385,11,29,.379,16,27,.593,99
4376,2017-11-24,CLE,,CHO,W 100-99,240,38,83,.458,25,44,.568,13,39,.333,11,15,.733,100
4377,2017-11-24,DEN,,MEM,W 104-92,240,40,79,.506,31,47,.660,9,32,.281,15,26,.577,104
4378,2017-11-24,MEM,@,DEN,L 92-104,240,36,73,.493,27,49,.551,9,24,.375,11,16,.688,92
4379,2017-11-24,CHI,@,GSW,L 94-143,240,35,99,.354,22,63,.349,13,36,.361,11,15,.733,94
4380,2017-11-24,GSW,,CHI,W 143-94,240,53,91,.582,37,55,.673,16,36,.444,21,21,1.000,143
4381,2017-11-24,IND,,TOR,W 107-104,240,38,83,.458,27,57,.474,11,26,.423,20,27,.741,107
4382,2017-11-24,TOR,@,IND,L 104-107,240,40,81,.494,31,51,.608,9,30,.300,15,20,.750,104
4383,2017-11-24,MIA,@,MIN,W 109-97,240,38,80,.475,19,41,.463,19,39,.487,14,16,.875,109
4384,2017-11-24,MIN,,MIA,L 97-109,240,37,84,.440,30,67,.448,7,17,.412,16,26,.615,97
4385,2017-11-24,DET,@,OKC,W 99-98,240,39,84,.464,25,47,.532,14,37,.378,7,9,.778,99
4386,2017-11-24,OKC,,DET,L 98-99,240,42,98,.429,34,66,.515,8,32,.250,6,8,.750,98
4387,2017-11-24,NOP,@,PHO,W 115-91,240,45,91,.495,36,64,.563,9,27,.333,16,22,.727,115
4388,2017-11-24,PHO,,NOP,L 91-115,240,37,94,.394,35,74,.473,2,20,.100,15,18,.833,91
4389,2017-11-22,ATL,,LAC,L 103-116,240,40,83,.482,30,54,.556,10,29,.345,13,15,.867,103
4390,2017-11-22,LAC,@,ATL,W 116-103,240,44,76,.579,29,46,.630,15,30,.500,13,19,.684,116
4391,2017-11-22,CHA,,WAS,W 129-124 (OT),265,43,91,.473,33,63,.524,10,28,.357,33,40,.825,129
4392,2017-11-22,WAS,@,CHO,L 124-129 (OT),265,48,99,.485,37,66,.561,11,33,.333,17,22,.773,124
4393,2017-11-22,BRK,@,CLE,L 109-119,240,42,81,.519,28,44,.636,14,37,.378,11,16,.688,109
4394,2017-11-22,CLE,,BRK,W 119-109,240,43,82,.524,29,48,.604,14,34,.412,19,27,.704,119
4395,2017-11-22,DEN,@,HOU,L 95-125,240,35,87,.402,25,54,.463,10,33,.303,15,23,.652,95
4396,2017-11-22,HOU,,DEN,W 125-95,240,45,82,.549,27,41,.659,18,41,.439,17,23,.739,125
4397,2017-11-22,DAL,@,MEM,W 95-94,240,39,91,.429,30,63,.476,9,28,.321,8,16,.500,95
4398,2017-11-22,MEM,,DAL,L 94-95,240,37,81,.457,30,52,.577,7,29,.241,13,14,.929,94
4399,2017-11-22,BOS,@,MIA,L 98-104,240,35,84,.417,26,58,.448,9,26,.346,19,27,.704,98
4400,2017-11-22,MIA,,BOS,W 104-98,240,40,81,.494,30,53,.566,10,28,.357,14,16,.875,104
4401,2017-11-22,MIN,,ORL,W 124-118,240,40,87,.460,32,64,.500,8,23,.348,36,45,.800,124
4402,2017-11-22,ORL,@,MIN,L 118-124,240,46,91,.505,34,54,.630,12,37,.324,14,22,.636,118
4403,2017-11-22,NOP,,SAS,W 107-90,240,39,81,.481,32,57,.561,7,24,.292,22,24,.917,107
4404,2017-11-22,SAS,@,NOP,L 90-107,240,35,88,.398,29,64,.453,6,24,.250,14,15,.933,90
4405,2017-11-22,NYK,,TOR,W 108-100,240,43,93,.462,35,69,.507,8,24,.333,14,17,.824,108
4406,2017-11-22,TOR,@,NYK,L 100-108,240,37,87,.425,23,49,.469,14,38,.368,12,18,.667,100
4407,2017-11-22,GSW,@,OKC,L 91-108,240,33,80,.413,23,49,.469,10,31,.323,15,18,.833,91
4408,2017-11-22,OKC,,GSW,W 108-91,240,41,90,.456,33,65,.508,8,25,.320,18,26,.692,108
4409,2017-11-22,PHI,,POR,W 101-81,240,39,90,.433,28,58,.483,11,32,.344,12,17,.706,101
4410,2017-11-22,POR,@,PHI,L 81-101,240,30,89,.337,23,63,.365,7,26,.269,14,24,.583,81
4411,2017-11-22,MIL,@,PHO,W 113-107 (OT),265,42,97,.433,34,68,.500,8,29,.276,21,31,.677,113
4412,2017-11-22,PHO,,MIL,L 107-113 (OT),265,37,93,.398,30,71,.423,7,22,.318,26,33,.788,107
4413,2017-11-22,LAL,@,SAC,L 102-113,240,39,78,.500,24,49,.490,15,29,.517,9,15,.600,102
4414,2017-11-22,SAC,,LAL,W 113-102,240,47,85,.553,37,64,.578,10,21,.476,9,14,.643,113
4415,2017-11-22,CHI,@,UTA,L 80-110,240,29,78,.372,24,57,.421,5,21,.238,17,20,.850,80
4416,2017-11-22,UTA,,CHI,W 110-80,240,40,86,.465,26,51,.510,14,35,.400,16,19,.842,110
4417,2017-11-21,CHI,@,LAL,L 94-103,240,36,94,.383,25,58,.431,11,36,.306,11,16,.688,94
4418,2017-11-21,LAL,,CHI,W 103-94,240,36,90,.400,23,50,.460,13,40,.325,18,25,.720,103
4419,2017-11-20,CHA,,MIN,W 118-102,240,42,85,.494,31,59,.525,11,26,.423,23,29,.793,118
4420,2017-11-20,MIN,@,CHO,L 102-118,240,37,90,.411,31,63,.492,6,27,.222,22,26,.846,102
4421,2017-11-20,BOS,@,DAL,W 110-102 (OT),265,38,84,.452,25,48,.521,13,36,.361,21,26,.808,110
4422,2017-11-20,DAL,,BOS,L 102-110 (OT),265,39,96,.406,32,63,.508,7,33,.212,17,20,.850,102
4423,2017-11-20,CLE,@,DET,W 116-88,240,42,80,.525,26,47,.553,16,33,.485,16,17,.941,116
4424,2017-11-20,DET,,CLE,L 88-116,240,34,77,.442,21,47,.447,13,30,.433,7,13,.538,88
4425,2017-11-20,MEM,,POR,L 92-100,240,33,86,.384,25,56,.446,8,30,.267,18,23,.783,92
4426,2017-11-20,POR,@,MEM,W 100-92,240,33,83,.398,27,68,.397,6,15,.400,28,32,.875,100
4427,2017-11-20,MIL,,WAS,L 88-99,240,35,79,.443,31,57,.544,4,22,.182,14,19,.737,88
4428,2017-11-20,WAS,@,MIL,W 99-88,240,39,74,.527,30,50,.600,9,24,.375,12,17,.706,99
4429,2017-11-20,NOP,,OKC,W 114-107,240,41,80,.513,34,55,.618,7,25,.280,25,32,.781,114
4430,2017-11-20,OKC,@,NOP,L 107-114,240,38,89,.427,27,54,.500,11,35,.314,20,26,.769,107
4431,2017-11-20,LAC,@,NYK,L 85-107,240,30,80,.375,20,48,.417,10,32,.313,15,21,.714,85
4432,2017-11-20,NYK,,LAC,W 107-85,240,35,81,.432,22,47,.468,13,34,.382,24,25,.960,107
4433,2017-11-20,IND,@,ORL,W 105-97,240,37,89,.416,29,69,.420,8,20,.400,23,29,.793,105
4434,2017-11-20,ORL,,IND,L 97-105,240,35,84,.417,22,46,.478,13,38,.342,14,23,.609,97
4435,2017-11-20,PHI,,UTA,W 107-86,240,44,85,.518,40,70,.571,4,15,.267,15,22,.682,107
4436,2017-11-20,UTA,@,PHI,L 86-107,240,30,85,.353,21,57,.368,9,28,.321,17,19,.895,86
4437,2017-11-20,DEN,@,SAC,W 114-98,240,42,86,.488,27,54,.500,15,32,.469,15,20,.750,114
4438,2017-11-20,SAC,,DEN,L 98-114,240,41,86,.477,33,66,.500,8,20,.400,8,9,.889,98
4439,2017-11-20,ATL,@,SAS,L 85-96,240,37,85,.435,29,55,.527,8,30,.267,3,8,.375,85
4440,2017-11-20,SAS,,ATL,W 96-85,240,40,89,.449,30,58,.517,10,31,.323,6,6,1.000,96
4441,2017-11-19,BRK,,GSW,L 111-118,240,34,95,.358,18,47,.383,16,48,.333,27,39,.692,111
4442,2017-11-19,GSW,@,BRK,W 118-111,240,46,90,.511,36,66,.545,10,24,.417,16,23,.696,118
4443,2017-11-19,DEN,@,LAL,L 109-127,240,36,84,.429,23,53,.434,13,31,.419,24,35,.686,109
4444,2017-11-19,LAL,,DEN,W 127-109,240,53,100,.530,41,68,.603,12,32,.375,9,16,.563,127
4445,2017-11-19,IND,@,MIA,W 120-95,240,51,85,.600,40,62,.645,11,23,.478,7,8,.875,120
4446,2017-11-19,MIA,,IND,L 95-120,240,35,83,.422,22,46,.478,13,37,.351,12,14,.857,95
4447,2017-11-19,DET,@,MIN,W 100-97,240,39,83,.470,31,58,.534,8,25,.320,14,20,.700,100
4448,2017-11-19,MIN,,DET,L 97-100,240,40,78,.513,35,56,.625,5,22,.227,12,18,.667,97
4449,2017-11-19,CHI,@,PHO,L 105-113,240,42,101,.416,30,65,.462,12,36,.333,9,14,.643,105
4450,2017-11-19,PHO,,CHI,W 113-105,240,45,89,.506,38,62,.613,7,27,.259,16,22,.727,113
4451,2017-11-19,TOR,,WAS,W 100-91,240,40,90,.444,30,51,.588,10,39,.256,10,14,.714,100
4452,2017-11-19,WAS,@,TOR,L 91-100,240,34,81,.420,23,62,.371,11,19,.579,12,21,.571,91
4453,2017-11-18,ATL,,BOS,L 99-110,240,37,78,.474,28,54,.519,9,24,.375,16,20,.800,99
4454,2017-11-18,BOS,@,ATL,W 110-99,240,39,82,.476,23,48,.479,16,34,.471,16,20,.800,110
4455,2017-11-18,CHA,,LAC,W 102-87,240,34,87,.391,23,61,.377,11,26,.423,23,29,.793,102
4456,2017-11-18,LAC,@,CHO,L 87-102,240,33,83,.398,25,54,.463,8,29,.276,13,19,.684,87
4457,2017-11-18,DAL,,MIL,W 111-79,240,38,79,.481,19,41,.463,19,38,.500,16,19,.842,111
4458,2017-11-18,MIL,@,DAL,L 79-111,240,28,74,.378,22,49,.449,6,25,.240,17,31,.548,79
4459,2017-11-18,HOU,@,MEM,W 105-83,240,35,78,.449,17,35,.486,18,43,.419,17,21,.810,105
4460,2017-11-18,MEM,,HOU,L 83-105,240,31,86,.360,24,59,.407,7,27,.259,14,19,.737,83
4461,2017-11-18,ORL,,UTA,L 85-125,240,31,81,.383,23,52,.442,8,29,.276,15,23,.652,85
4462,2017-11-18,UTA,@,ORL,W 125-85,240,47,98,.480,33,64,.516,14,34,.412,17,18,.944,125
4463,2017-11-18,GSW,@,PHI,W 124-116,240,50,91,.549,43,68,.632,7,23,.304,17,20,.850,124
4464,2017-11-18,PHI,,GSW,L 116-124,240,47,97,.485,37,68,.544,10,29,.345,12,16,.750,116
4465,2017-11-18,POR,,SAC,W 102-90,240,38,70,.543,28,49,.571,10,21,.476,16,21,.762,102
4466,2017-11-18,SAC,@,POR,L 90-102,240,34,89,.382,26,72,.361,8,17,.471,14,18,.778,90
4467,2017-11-17,BRK,,UTA,W 118-107,240,43,84,.512,26,47,.553,17,37,.459,15,20,.750,118
4468,2017-11-17,UTA,@,BRK,L 107-118,240,39,79,.494,27,53,.509,12,26,.462,17,24,.708,107
4469,2017-11-17,CHI,,CHO,W 123-120,240,47,91,.516,30,57,.526,17,34,.500,12,13,.923,123
4470,2017-11-17,CHA,@,CHI,L 120-123,240,42,81,.519,32,60,.533,10,21,.476,26,34,.765,120
4471,2017-11-17,CLE,,LAC,W 118-113 (OT),265,42,90,.467,31,57,.544,11,33,.333,23,29,.793,118
4472,2017-11-17,LAC,@,CLE,L 113-118 (OT),265,46,103,.447,36,68,.529,10,35,.286,11,14,.786,113
4473,2017-11-17,DAL,,MIN,L 87-111,240,32,86,.372,24,48,.500,8,38,.211,15,17,.882,87
4474,2017-11-17,MIN,@,DAL,W 111-87,240,39,84,.464,26,54,.481,13,30,.433,20,23,.870,111
4475,2017-11-17,DEN,,NOP,W 146-114,240,56,89,.629,38,54,.704,18,35,.514,16,21,.762,146
4476,2017-11-17,NOP,@,DEN,L 114-146,240,48,91,.527,36,58,.621,12,33,.364,6,10,.600,114
4477,2017-11-17,DET,@,IND,L 100-107,240,39,93,.419,25,60,.417,14,33,.424,8,10,.800,100
4478,2017-11-17,IND,,DET,W 107-100,240,39,89,.438,24,61,.393,15,28,.536,14,21,.667,107
4479,2017-11-17,LAL,,PHO,L 113-122,240,45,91,.495,38,66,.576,7,25,.280,16,24,.667,113
4480,2017-11-17,PHO,@,LAL,W 122-113,240,48,103,.466,35,71,.493,13,32,.406,13,19,.684,122
4481,2017-11-17,POR,@,SAC,L 82-86,240,30,81,.370,23,56,.411,7,25,.280,15,16,.938,82
4482,2017-11-17,SAC,,POR,W 86-82,240,36,85,.424,32,71,.451,4,14,.286,10,15,.667,86
4483,2017-11-17,OKC,@,SAS,L 101-104,240,39,89,.438,30,66,.455,9,23,.391,14,21,.667,101
4484,2017-11-17,SAS,,OKC,W 104-101,240,34,77,.442,20,42,.476,14,35,.400,22,28,.786,104
4485,2017-11-17,NYK,@,TOR,L 84-107,240,30,91,.330,21,68,.309,9,23,.391,15,17,.882,84
4486,2017-11-17,TOR,,NYK,W 107-84,240,44,78,.564,35,52,.673,9,26,.346,10,11,.909,107
4487,2017-11-17,MIA,@,WAS,W 91-88,240,34,83,.410,24,48,.500,10,35,.286,13,18,.722,91
4488,2017-11-17,WAS,,MIA,L 88-91,240,32,84,.381,22,49,.449,10,35,.286,14,16,.875,88
4489,2017-11-16,BOS,,GSW,W 92-88,240,26,79,.329,19,47,.404,7,32,.219,33,38,.868,92
4490,2017-11-16,GSW,@,BOS,L 88-92,240,33,82,.402,23,50,.460,10,32,.313,12,19,.632,88
4491,2017-11-16,HOU,@,PHO,W 142-116,240,43,90,.478,22,46,.478,21,44,.477,35,38,.921,142
4492,2017-11-16,PHO,,HOU,L 116-142,240,47,104,.452,37,74,.500,10,30,.333,12,21,.571,116
4493,2017-11-15,ATL,,SAC,W 126-80,240,50,79,.633,34,47,.723,16,32,.500,10,16,.625,126
4494,2017-11-15,SAC,@,ATL,L 80-126,240,31,88,.352,25,60,.417,6,28,.214,12,20,.600,80
4495,2017-11-15,CHA,,CLE,L 107-115,240,41,86,.477,35,60,.583,6,26,.231,19,28,.679,107
4496,2017-11-15,CLE,@,CHO,W 115-107,240,42,95,.442,29,57,.509,13,38,.342,18,20,.900,115
4497,2017-11-15,LAL,,PHI,L 109-115,240,42,109,.385,39,82,.476,3,27,.111,22,27,.815,109
4498,2017-11-15,PHI,@,LAL,W 115-109,240,42,86,.488,35,54,.648,7,32,.219,24,30,.800,115
4499,2017-11-15,IND,@,MEM,W 116-113,240,43,85,.506,31,61,.508,12,24,.500,18,20,.900,116
4500,2017-11-15,MEM,,IND,L 113-116,240,44,86,.512,36,54,.667,8,32,.250,17,22,.773,113
4501,2017-11-15,MIA,,WAS,L 93-102,240,32,78,.410,19,48,.396,13,30,.433,16,19,.842,93
4502,2017-11-15,WAS,@,MIA,W 102-93,240,32,78,.410,23,59,.390,9,19,.474,29,31,.935,102
4503,2017-11-15,DET,@,MIL,L 95-99,240,30,85,.353,15,48,.313,15,37,.405,20,23,.870,95
4504,2017-11-15,MIL,,DET,W 99-95,240,38,78,.487,30,56,.536,8,22,.364,15,20,.750,99
4505,2017-11-15,MIN,,SAS,W 98-86,240,39,87,.448,30,69,.435,9,18,.500,11,16,.688,98
4506,2017-11-15,SAS,@,MIN,L 86-98,240,33,79,.418,26,55,.473,7,24,.292,13,15,.867,86
4507,2017-11-15,NOP,,TOR,L 116-125,240,46,91,.505,36,64,.563,10,27,.370,14,14,1.000,116
4508,2017-11-15,TOR,@,NOP,W 125-116,240,45,76,.592,29,42,.690,16,34,.471,19,20,.950,125
4509,2017-11-15,NYK,,UTA,W 106-101,240,38,81,.469,29,60,.483,9,21,.429,21,25,.840,106
4510,2017-11-15,UTA,@,NYK,L 101-106,240,34,79,.430,17,44,.386,17,35,.486,16,17,.941,101
4511,2017-11-15,CHI,@,OKC,L 79-92,240,26,75,.347,15,46,.326,11,29,.379,16,20,.800,79
4512,2017-11-15,OKC,,CHI,W 92-79,240,26,72,.361,18,42,.429,8,30,.267,32,37,.865,92
4513,2017-11-15,ORL,@,POR,L 94-99,240,37,79,.468,26,50,.520,11,29,.379,9,9,1.000,94
4514,2017-11-15,POR,,ORL,W 99-94,240,38,87,.437,24,60,.400,14,27,.519,9,13,.692,99
4515,2017-11-14,BOS,@,BRK,W 109-102,240,39,86,.453,30,59,.508,9,27,.333,22,27,.815,109
4516,2017-11-14,BRK,,BOS,L 102-109,240,39,88,.443,25,53,.472,14,35,.400,10,16,.625,102
4517,2017-11-14,DAL,,SAS,L 91-97,240,33,81,.407,23,47,.489,10,34,.294,15,18,.833,91
4518,2017-11-14,SAS,@,DAL,W 97-91,240,35,79,.443,29,53,.547,6,26,.231,21,27,.778,97
4519,2017-11-14,HOU,,TOR,L 113-129,240,33,79,.418,21,40,.525,12,39,.308,35,41,.854,113
4520,2017-11-14,TOR,@,HOU,W 129-113,240,41,78,.526,27,48,.563,14,30,.467,33,42,.786,129
4521,2017-11-13,GSW,,ORL,W 110-100,240,44,88,.500,36,65,.554,8,23,.348,14,16,.875,110
4522,2017-11-13,ORL,@,GSW,L 100-110,240,37,88,.420,27,56,.482,10,32,.313,16,18,.889,100
4523,2017-11-13,LAC,,PHI,L 105-109,240,36,82,.439,24,50,.480,12,32,.375,21,32,.656,105
4524,2017-11-13,PHI,@,LAC,W 109-105,240,38,77,.494,31,45,.689,7,32,.219,26,35,.743,109
4525,2017-11-13,MEM,@,MIL,L 103-110,240,37,76,.487,26,50,.520,11,26,.423,18,21,.857,103
4526,2017-11-13,MIL,,MEM,W 110-103,240,40,82,.488,28,60,.467,12,22,.545,18,25,.720,110
4527,2017-11-13,ATL,@,NOP,L 105-106,240,40,87,.460,23,51,.451,17,36,.472,8,9,.889,105
4528,2017-11-13,NOP,,ATL,W 106-105,240,41,75,.547,28,42,.667,13,33,.394,11,17,.647,106
4529,2017-11-13,CLE,@,NYK,W 104-101,240,35,88,.398,19,43,.442,16,45,.356,18,22,.818,104
4530,2017-11-13,NYK,,CLE,L 101-104,240,38,88,.432,30,63,.476,8,25,.320,17,22,.773,101
4531,2017-11-13,LAL,@,PHO,W 100-93,240,39,92,.424,25,59,.424,14,33,.424,8,13,.615,100
4532,2017-11-13,PHO,,LAL,L 93-100,240,37,95,.389,30,69,.435,7,26,.269,12,20,.600,93
4533,2017-11-13,DEN,@,POR,L 82-99,240,30,84,.357,21,52,.404,9,32,.281,13,15,.867,82
4534,2017-11-13,POR,,DEN,W 99-82,240,38,73,.521,31,52,.596,7,21,.333,16,18,.889,99
4535,2017-11-13,MIN,@,UTA,W 109-98,240,37,71,.521,27,51,.529,10,20,.500,25,29,.862,109
4536,2017-11-13,UTA,,MIN,L 98-109,240,37,84,.440,23,44,.523,14,40,.350,10,11,.909,98
4537,2017-11-13,SAC,@,WAS,L 92-110,240,34,84,.405,22,61,.361,12,23,.522,12,18,.667,92
4538,2017-11-13,WAS,,SAC,W 110-92,240,44,86,.512,33,52,.635,11,34,.324,11,12,.917,110
4539,2017-11-12,BOS,,TOR,W 95-94,240,35,87,.402,25,61,.410,10,26,.385,15,19,.789,95
4540,2017-11-12,TOR,@,BOS,L 94-95,240,32,69,.464,22,45,.489,10,24,.417,20,23,.870,94
4541,2017-11-12,DET,,MIA,W 112-103,240,42,87,.483,28,59,.475,14,28,.500,14,20,.700,112
4542,2017-11-12,MIA,@,DET,L 103-112,240,39,90,.433,26,53,.491,13,37,.351,12,16,.750,103
4543,2017-11-12,HOU,@,IND,W 118-95,240,43,90,.478,26,43,.605,17,47,.362,15,18,.833,118
4544,2017-11-12,IND,,HOU,L 95-118,240,37,83,.446,29,61,.475,8,22,.364,13,21,.619,95
4545,2017-11-12,DAL,@,OKC,L 99-112,240,37,87,.425,26,50,.520,11,37,.297,14,18,.778,99
4546,2017-11-12,OKC,,DAL,W 112-99,240,36,72,.500,21,40,.525,15,32,.469,25,33,.758,112
4547,2017-11-11,CLE,@,DAL,W 111-104,240,35,81,.432,23,50,.460,12,31,.387,29,35,.829,111
4548,2017-11-11,DAL,,CLE,L 104-111,240,39,92,.424,29,58,.500,10,34,.294,16,21,.762,104
4549,2017-11-11,DEN,,ORL,W 125-107,240,46,87,.529,34,58,.586,12,29,.414,21,27,.778,125
4550,2017-11-11,ORL,@,DEN,L 107-125,240,41,87,.471,30,56,.536,11,31,.355,14,20,.700,107
4551,2017-11-11,GSW,,PHI,W 135-114,240,48,82,.585,34,55,.618,14,27,.519,25,26,.962,135
4552,2017-11-11,PHI,@,GSW,L 114-135,240,44,94,.468,32,66,.485,12,28,.429,14,20,.700,114
4553,2017-11-11,HOU,,MEM,W 111-96,240,37,83,.446,21,38,.553,16,45,.356,21,28,.750,111
4554,2017-11-11,MEM,@,HOU,L 96-111,240,38,79,.481,32,59,.542,6,20,.300,14,18,.778,96
4555,2017-11-11,LAL,@,MIL,L 90-98,240,31,74,.419,25,52,.481,6,22,.273,22,37,.595,90
4556,2017-11-11,MIL,,LAL,W 98-90,240,35,85,.412,29,62,.468,6,23,.261,22,26,.846,98
4557,2017-11-11,LAC,@,NOP,L 103-111,240,35,86,.407,25,60,.417,10,26,.385,23,27,.852,103
4558,2017-11-11,NOP,,LAC,W 111-103,240,43,80,.538,37,64,.578,6,16,.375,19,24,.792,111
4559,2017-11-11,NYK,,SAC,W 118-91,240,47,90,.522,35,63,.556,12,27,.444,12,15,.800,118
4560,2017-11-11,SAC,@,NYK,L 91-118,240,30,80,.375,23,58,.397,7,22,.318,24,30,.800,91
4561,2017-11-11,MIN,@,PHO,L 110-118,240,39,96,.406,35,76,.461,4,20,.200,28,35,.800,110
4562,2017-11-11,PHO,,MIN,W 118-110,240,46,86,.535,36,60,.600,10,26,.385,16,24,.667,118
4563,2017-11-11,CHI,@,SAS,L 94-133,240,40,86,.465,34,63,.540,6,23,.261,8,13,.615,94
4564,2017-11-11,SAS,,CHI,W 133-94,240,51,85,.600,33,58,.569,18,27,.667,13,16,.813,133
4565,2017-11-11,BRK,@,UTA,L 106-114,240,35,76,.461,28,53,.528,7,23,.304,29,39,.744,106
4566,2017-11-11,UTA,,BRK,W 114-106,240,41,85,.482,30,56,.536,11,29,.379,21,25,.840,114
4567,2017-11-11,ATL,@,WAS,L 94-113,240,34,83,.410,20,50,.400,14,33,.424,12,17,.706,94
4568,2017-11-11,WAS,,ATL,W 113-94,240,42,78,.538,35,54,.648,7,24,.292,22,28,.786,113
4569,2017-11-10,BOS,,CHO,W 90-87,240,30,84,.357,21,53,.396,9,31,.290,21,25,.840,90
4570,2017-11-10,CHA,@,BOS,L 87-90,240,31,80,.388,25,58,.431,6,22,.273,19,33,.576,87
4571,2017-11-10,CHI,,IND,L 87-105,240,37,93,.398,30,66,.455,7,27,.259,6,9,.667,87
4572,2017-11-10,IND,@,CHI,W 105-87,240,43,84,.512,31,55,.564,12,29,.414,7,12,.583,105
4573,2017-11-10,ATL,@,DET,L 104-111,240,44,89,.494,36,65,.554,8,24,.333,8,11,.727,104
4574,2017-11-10,DET,,ATL,W 111-104,240,39,89,.438,27,59,.458,12,30,.400,21,27,.778,111
4575,2017-11-10,LAC,@,OKC,L 111-120,240,39,84,.464,27,54,.500,12,30,.400,21,30,.700,111
4576,2017-11-10,OKC,,LAC,W 120-111,240,40,78,.513,29,52,.558,11,26,.423,29,40,.725,120
4577,2017-11-10,ORL,@,PHO,W 128-112,240,43,82,.524,30,54,.556,13,28,.464,29,43,.674,128
4578,2017-11-10,PHO,,ORL,L 112-128,240,44,94,.468,39,70,.557,5,24,.208,19,25,.760,112
4579,2017-11-10,BRK,@,POR,W 101-97,240,39,91,.429,27,53,.509,12,38,.316,11,19,.579,101
4580,2017-11-10,POR,,BRK,L 97-101,240,40,95,.421,32,72,.444,8,23,.348,9,11,.818,97
4581,2017-11-10,MIL,@,SAS,W 94-87,240,41,89,.461,36,71,.507,5,18,.278,7,14,.500,94
4582,2017-11-10,SAS,,MIL,L 87-94,240,34,80,.425,25,51,.490,9,29,.310,10,11,.909,87
4583,2017-11-10,MIA,@,UTA,W 84-74,240,30,77,.390,20,52,.385,10,25,.400,14,18,.778,84
4584,2017-11-10,UTA,,MIA,L 74-84,240,25,74,.338,20,53,.377,5,21,.238,19,22,.864,74
4585,2017-11-09,DEN,,OKC,W 102-94,240,38,82,.463,29,55,.527,9,27,.333,17,22,.773,102
4586,2017-11-09,OKC,@,DEN,L 94-102,240,38,90,.422,27,60,.450,11,30,.367,7,14,.500,94
4587,2017-11-09,CLE,@,HOU,L 113-117,240,45,81,.556,33,54,.611,12,27,.444,11,14,.786,113
4588,2017-11-09,HOU,,CLE,W 117-113,240,36,77,.468,20,31,.645,16,46,.348,29,36,.806,117
4589,2017-11-09,PHI,@,SAC,L 108-109,240,37,87,.425,22,50,.440,15,37,.405,19,27,.704,108
4590,2017-11-09,SAC,,PHI,W 109-108,240,40,93,.430,28,66,.424,12,27,.444,17,28,.607,109
4591,2017-11-09,NOP,@,TOR,L 118-122,240,44,82,.537,31,51,.608,13,31,.419,17,25,.680,118
4592,2017-11-09,TOR,,NOP,W 122-118,240,45,98,.459,29,56,.518,16,42,.381,16,23,.696,122
4593,2017-11-09,LAL,@,WAS,L 95-111,240,31,86,.360,28,63,.444,3,23,.130,30,41,.732,95
4594,2017-11-09,WAS,,LAL,W 111-95,240,43,83,.518,36,62,.581,7,21,.333,18,20,.900,111
4595,2017-11-08,BOS,,LAL,W 107-96,240,38,98,.388,31,69,.449,7,29,.241,24,31,.774,107
4596,2017-11-08,LAL,@,BOS,L 96-107,240,37,85,.435,32,61,.525,5,24,.208,17,23,.739,96
4597,2017-11-08,DET,,IND,W 114-97,240,43,83,.518,31,56,.554,12,27,.444,16,25,.640,114
4598,2017-11-08,IND,@,DET,L 97-114,240,38,88,.432,31,64,.484,7,24,.292,14,18,.778,97
4599,2017-11-08,GSW,,MIN,W 125-101,240,48,85,.565,33,49,.673,15,36,.417,14,18,.778,125
4600,2017-11-08,MIN,@,GSW,L 101-125,240,38,92,.413,33,68,.485,5,24,.208,20,27,.741,101
4601,2017-11-08,NYK,@,ORL,L 99-112,240,42,80,.525,37,68,.544,5,12,.417,10,13,.769,99
4602,2017-11-08,ORL,,NYK,W 112-99,240,43,80,.538,30,52,.577,13,28,.464,13,22,.591,112
4603,2017-11-08,MIA,@,PHO,W 126-115,240,43,81,.531,31,51,.608,12,30,.400,28,35,.800,126
4604,2017-11-08,PHO,,MIA,L 115-126,240,40,88,.455,28,59,.475,12,29,.414,23,30,.767,115
4605,2017-11-07,CLE,,MIL,W 124-119,240,41,82,.500,32,64,.500,9,18,.500,33,38,.868,124
4606,2017-11-07,MIL,@,CLE,L 119-124,240,47,83,.566,34,53,.642,13,30,.433,12,16,.750,119
4607,2017-11-07,BRK,@,DEN,L 104-112,240,38,89,.427,27,54,.500,11,35,.314,17,22,.773,104
4608,2017-11-07,DEN,,BRK,W 112-104,240,44,93,.473,35,59,.593,9,34,.265,15,20,.750,112
4609,2017-11-07,IND,,NOP,L 112-117,240,44,93,.473,35,69,.507,9,24,.375,15,18,.833,112
4610,2017-11-07,NOP,@,IND,W 117-112,240,44,87,.506,30,52,.577,14,35,.400,15,22,.682,117
4611,2017-11-07,CHA,@,NYK,L 113-118,240,42,91,.462,27,54,.500,15,37,.405,14,17,.824,113
4612,2017-11-07,NYK,,CHO,W 118-113,240,45,75,.600,33,50,.660,12,25,.480,16,21,.762,118
4613,2017-11-07,MEM,@,POR,W 98-97,240,35,73,.479,28,54,.519,7,19,.368,21,25,.840,98
4614,2017-11-07,POR,,MEM,L 97-98,240,36,81,.444,30,62,.484,6,19,.316,19,20,.950,97
4615,2017-11-07,OKC,@,SAC,L 86-94,240,29,86,.337,19,49,.388,10,37,.270,18,23,.783,86
4616,2017-11-07,SAC,,OKC,W 94-86,240,37,79,.468,28,55,.509,9,24,.375,11,12,.917,94
4617,2017-11-07,LAC,@,SAS,L 107-120,240,42,82,.512,31,52,.596,11,30,.367,12,17,.706,107
4618,2017-11-07,SAS,,LAC,W 120-107,240,45,84,.536,30,56,.536,15,28,.536,15,19,.789,120
4619,2017-11-07,CHI,@,TOR,L 114-119,240,40,80,.500,29,51,.569,11,29,.379,23,28,.821,114
4620,2017-11-07,TOR,,CHI,W 119-114,240,44,81,.543,31,56,.554,13,25,.520,18,24,.750,119
4621,2017-11-07,PHI,@,UTA,W 104-97,240,34,81,.420,22,54,.407,12,27,.444,24,30,.800,104
4622,2017-11-07,UTA,,PHI,L 97-104,240,30,99,.303,21,60,.350,9,39,.231,28,35,.800,97
4623,2017-11-07,DAL,@,WAS,W 113-99,240,43,91,.473,32,61,.525,11,30,.367,16,20,.800,113
4624,2017-11-07,WAS,,DAL,L 99-113,240,32,75,.427,22,50,.440,10,25,.400,25,32,.781,99
4625,2017-11-06,ATL,,BOS,L 107-110,240,39,81,.481,26,55,.473,13,26,.500,16,20,.800,107
4626,2017-11-06,BOS,@,ATL,W 110-107,240,39,81,.481,25,45,.556,14,36,.389,18,22,.818,110
4627,2017-11-06,GSW,,MIA,W 97-80,240,32,87,.368,21,55,.382,11,32,.344,22,24,.917,97
4628,2017-11-06,MIA,@,GSW,L 80-97,240,30,83,.361,22,57,.386,8,26,.308,12,17,.706,80
4629,2017-11-06,BRK,@,PHO,W 98-92,240,35,87,.402,27,55,.491,8,32,.250,20,29,.690,98
4630,2017-11-06,PHO,,BRK,L 92-98,240,30,86,.349,24,61,.393,6,25,.240,26,35,.743,92
4631,2017-11-05,ATL,@,CLE,W 117-115,240,41,86,.477,30,61,.492,11,25,.440,24,34,.706,117
4632,2017-11-05,CLE,,ATL,L 115-117,240,42,96,.438,32,60,.533,10,36,.278,21,23,.913,115
4633,2017-11-05,HOU,,UTA,W 137-110,240,48,81,.593,25,42,.595,23,39,.590,18,21,.857,137
4634,2017-11-05,UTA,@,HOU,L 110-137,240,38,88,.432,25,54,.463,13,34,.382,21,24,.875,110
4635,2017-11-05,LAC,,MIA,L 101-104,240,34,87,.391,25,56,.446,9,31,.290,24,30,.800,101
4636,2017-11-05,MIA,@,LAC,W 104-101,240,37,84,.440,23,48,.479,14,36,.389,16,19,.842,104
4637,2017-11-05,LAL,,MEM,W 107-102,240,40,85,.471,31,58,.534,9,27,.333,18,23,.783,107
4638,2017-11-05,MEM,@,LAL,L 102-107,240,40,87,.460,29,50,.580,11,37,.297,11,14,.786,102
4639,2017-11-05,CHA,@,MIN,L 94-112,240,37,89,.416,28,61,.459,9,28,.321,11,21,.524,94
4640,2017-11-05,MIN,,CHO,W 112-94,240,38,83,.458,28,59,.475,10,24,.417,26,30,.867,112
4641,2017-11-05,IND,@,NYK,L 101-108,240,37,79,.468,25,54,.463,12,25,.480,15,17,.882,101
4642,2017-11-05,NYK,,IND,W 108-101,240,44,88,.500,38,65,.585,6,23,.261,14,19,.737,108
4643,2017-11-05,BOS,@,ORL,W 104-88,240,39,89,.438,28,56,.500,11,33,.333,15,20,.750,104
4644,2017-11-05,ORL,,BOS,L 88-104,240,33,91,.363,27,62,.435,6,29,.207,16,18,.889,88
4645,2017-11-05,OKC,@,POR,L 99-103,240,40,89,.449,29,56,.518,11,33,.333,8,15,.533,99
4646,2017-11-05,POR,,OKC,W 103-99,240,37,74,.500,30,54,.556,7,20,.350,22,28,.786,103
4647,2017-11-05,PHO,@,SAS,L 95-112,240,37,81,.457,29,58,.500,8,23,.348,13,22,.591,95
4648,2017-11-05,SAS,,PHO,W 112-95,240,44,88,.500,33,66,.500,11,22,.500,13,18,.722,112
4649,2017-11-05,TOR,,WAS,L 96-107,240,37,80,.463,32,56,.571,5,24,.208,17,27,.630,96
4650,2017-11-05,WAS,@,TOR,W 107-96,240,40,85,.471,29,62,.468,11,23,.478,16,23,.696,107
4651,2017-11-04,CHI,,NOP,L 90-96 (OT),265,35,99,.354,24,57,.421,11,42,.262,9,12,.750,90
4652,2017-11-04,NOP,@,CHI,W 96-90 (OT),265,35,87,.402,26,56,.464,9,31,.290,17,22,.773,96
4653,2017-11-04,DEN,,GSW,L 108-127,240,40,87,.460,34,63,.540,6,24,.250,22,27,.815,108
4654,2017-11-04,GSW,@,DEN,W 127-108,240,50,91,.549,32,51,.627,18,40,.450,9,17,.529,127
4655,2017-11-04,DET,,SAC,W 108-99,240,40,79,.506,27,55,.491,13,24,.542,15,22,.682,108
4656,2017-11-04,SAC,@,DET,L 99-108,240,40,76,.526,30,55,.545,10,21,.476,9,13,.692,99
4657,2017-11-04,LAC,,MEM,L 104-113,240,38,83,.458,34,57,.596,4,26,.154,24,31,.774,104
4658,2017-11-04,MEM,@,LAC,W 113-104,240,40,84,.476,27,53,.509,13,31,.419,20,24,.833,113
4659,2017-11-04,DAL,@,MIN,L 99-112,240,40,87,.460,30,60,.500,10,27,.370,9,12,.750,99
4660,2017-11-04,MIN,,DAL,W 112-99,240,43,79,.544,33,55,.600,10,24,.417,16,20,.800,112
4661,2017-11-03,ATL,,HOU,L 104-119,240,39,81,.481,28,48,.583,11,33,.333,15,18,.833,104
4662,2017-11-03,HOU,@,ATL,W 119-104,240,42,89,.472,26,42,.619,16,47,.340,19,23,.826,119
4663,2017-11-03,DAL,,NOP,L 94-99,240,34,88,.386,25,54,.463,9,34,.265,17,22,.773,94
4664,2017-11-03,NOP,@,DAL,W 99-94,240,36,89,.404,29,60,.483,7,29,.241,20,26,.769,99
4665,2017-11-03,DEN,,MIA,W 95-94,240,36,80,.450,27,57,.474,9,23,.391,14,25,.560,95
4666,2017-11-03,MIA,@,DEN,L 94-95,240,36,77,.468,21,40,.525,15,37,.405,7,11,.636,94
4667,2017-11-03,DET,,MIL,W 105-96,240,37,78,.474,29,52,.558,8,26,.308,23,28,.821,105
4668,2017-11-03,MIL,@,DET,L 96-105,240,39,83,.470,29,58,.500,10,25,.400,8,9,.889,96
4669,2017-11-03,BRK,@,LAL,L 112-124,240,37,91,.407,28,53,.528,9,38,.237,29,38,.763,112
4670,2017-11-03,LAL,,BRK,W 124-112,240,48,94,.511,39,73,.534,9,21,.429,19,27,.704,124
4671,2017-11-03,NYK,,PHO,W 120-107,240,45,87,.517,37,61,.607,8,26,.308,22,25,.880,120
4672,2017-11-03,PHO,@,NYK,L 107-120,240,34,97,.351,25,65,.385,9,32,.281,30,37,.811,107
4673,2017-11-03,BOS,@,OKC,W 101-94,240,36,84,.429,23,56,.411,13,28,.464,16,24,.667,101
4674,2017-11-03,OKC,,BOS,L 94-101,240,35,87,.402,22,52,.423,13,35,.371,11,14,.786,94
4675,2017-11-03,CHI,@,ORL,W 105-83,240,40,85,.471,26,56,.464,14,29,.483,11,12,.917,105
4676,2017-11-03,ORL,,CHI,L 83-105,240,35,86,.407,25,51,.490,10,35,.286,3,5,.600,83
4677,2017-11-03,IND,@,PHI,L 110-121,240,45,97,.464,37,69,.536,8,28,.286,12,19,.632,110
4678,2017-11-03,PHI,,IND,W 121-110,240,46,92,.500,28,56,.500,18,36,.500,11,14,.786,121
4679,2017-11-03,CHA,@,SAS,L 101-108,240,33,80,.413,25,56,.446,8,24,.333,27,42,.643,101
4680,2017-11-03,SAS,,CHO,W 108-101,240,39,83,.470,30,56,.536,9,27,.333,21,26,.808,108
4681,2017-11-03,TOR,@,UTA,W 109-100,240,38,71,.535,27,41,.659,11,30,.367,22,28,.786,109
4682,2017-11-03,UTA,,TOR,L 100-109,240,35,80,.438,27,57,.474,8,23,.348,22,24,.917,100
4683,2017-11-03,CLE,@,WAS,W 130-122,240,46,82,.561,34,55,.618,12,27,.444,26,28,.929,130
4684,2017-11-03,WAS,,CLE,L 122-130,240,45,84,.536,34,56,.607,11,28,.393,21,31,.677,122
4685,2017-11-02,LAL,@,POR,L 110-113,240,43,79,.544,39,61,.639,4,18,.222,20,27,.741,110
4686,2017-11-02,POR,,LAL,W 113-110,240,40,86,.465,31,64,.484,9,22,.409,24,27,.889,113
4687,2017-11-02,GSW,@,SAS,W 112-92,240,43,83,.518,29,55,.527,14,28,.500,12,16,.750,112
4688,2017-11-02,SAS,,GSW,L 92-112,240,34,87,.391,27,63,.429,7,24,.292,17,23,.739,92
4689,2017-11-01,BOS,,SAC,W 113-86,240,40,82,.488,23,41,.561,17,41,.415,16,19,.842,113
4690,2017-11-01,SAC,@,BOS,L 86-113,240,35,81,.432,29,61,.475,6,20,.300,10,12,.833,86
4691,2017-11-01,CHA,,MIL,W 126-121,240,45,84,.536,31,59,.525,14,25,.560,22,29,.759,126
4692,2017-11-01,MIL,@,CHO,L 121-126,240,45,91,.495,26,55,.473,19,36,.528,12,15,.800,121
4693,2017-11-01,CLE,,IND,L 107-124,240,43,86,.500,36,55,.655,7,31,.226,14,20,.700,107
4694,2017-11-01,IND,@,CLE,W 124-107,240,49,90,.544,33,64,.516,16,26,.615,10,13,.769,124
4695,2017-11-01,DEN,,TOR,W 129-111,240,47,88,.534,31,56,.554,16,32,.500,19,29,.655,129
4696,2017-11-01,TOR,@,DEN,L 111-129,240,42,85,.494,31,54,.574,11,31,.355,16,25,.640,111
4697,2017-11-01,DAL,@,LAC,L 98-119,240,35,89,.393,23,53,.434,12,36,.333,16,20,.800,98
4698,2017-11-01,LAC,,DAL,W 119-98,240,41,78,.526,28,50,.560,13,28,.464,24,29,.828,119
4699,2017-11-01,MEM,,ORL,L 99-101,240,39,82,.476,29,52,.558,10,30,.333,11,16,.688,99
4700,2017-11-01,ORL,@,MEM,W 101-99,240,38,75,.507,25,46,.543,13,29,.448,12,14,.857,101
4701,2017-11-01,CHI,@,MIA,L 91-97,240,36,89,.404,29,61,.475,7,28,.250,12,19,.632,91
4702,2017-11-01,MIA,,CHI,W 97-91,240,34,83,.410,22,52,.423,12,31,.387,17,19,.895,97
4703,2017-11-01,MIN,@,NOP,W 104-98,240,41,83,.494,35,61,.574,6,22,.273,16,24,.667,104
4704,2017-11-01,NOP,,MIN,L 98-104,240,36,84,.429,28,53,.528,8,31,.258,18,21,.857,98
4705,2017-11-01,HOU,@,NYK,W 119-97,240,42,88,.477,23,36,.639,19,52,.365,16,21,.762,119
4706,2017-11-01,NYK,,HOU,L 97-119,240,39,90,.433,31,64,.484,8,26,.308,11,13,.846,97
4707,2017-11-01,ATL,@,PHI,L 109-119,240,41,94,.436,33,71,.465,8,23,.348,19,27,.704,109
4708,2017-11-01,PHI,,ATL,W 119-109,240,46,99,.465,33,64,.516,13,35,.371,14,25,.560,119
4709,2017-11-01,POR,@,UTA,L 103-112 (OT),265,37,93,.398,28,59,.475,9,34,.265,20,27,.741,103
4710,2017-11-01,UTA,,POR,W 112-103 (OT),265,34,90,.378,21,61,.344,13,29,.448,31,36,.861,112
4711,2017-11-01,PHO,@,WAS,W 122-116,240,41,83,.494,32,59,.542,9,24,.375,31,38,.816,122
4712,2017-11-01,WAS,,PHO,L 116-122,240,41,92,.446,31,62,.500,10,30,.333,24,30,.800,116
4713,2017-10-31,BRK,,PHO,L 114-122,240,42,102,.412,33,71,.465,9,31,.290,21,30,.700,114
4714,2017-10-31,PHO,@,BRK,W 122-114,240,45,96,.469,35,74,.473,10,22,.455,22,24,.917,122
4715,2017-10-31,IND,,SAC,W 101-83,240,36,85,.424,24,56,.429,12,29,.414,17,22,.773,101
4716,2017-10-31,SAC,@,IND,L 83-101,240,37,88,.420,35,74,.473,2,14,.143,7,14,.500,83
4717,2017-10-31,DET,@,LAL,L 93-113,240,41,94,.436,31,61,.508,10,33,.303,1,3,.333,93
4718,2017-10-31,LAL,,DET,W 113-93,240,45,91,.495,33,65,.508,12,26,.462,11,14,.786,113
4719,2017-10-31,MIL,,OKC,L 91-110,240,32,77,.416,23,46,.500,9,31,.290,18,22,.818,91
4720,2017-10-31,OKC,@,MIL,W 110-91,240,40,81,.494,28,53,.528,12,28,.429,18,21,.857,110
4721,2017-10-30,BOS,,SAS,W 108-94,240,42,88,.477,31,57,.544,11,31,.355,13,16,.813,108
4722,2017-10-30,SAS,@,BOS,L 94-108,240,36,87,.414,24,61,.393,12,26,.462,10,20,.500,94
4723,2017-10-30,HOU,,PHI,L 107-115,240,33,83,.398,20,36,.556,13,47,.277,28,38,.737,107
4724,2017-10-30,PHI,@,HOU,W 115-107,240,44,80,.550,34,56,.607,10,24,.417,17,24,.708,115
4725,2017-10-30,GSW,@,LAC,W 141-113,240,52,89,.584,38,60,.633,14,29,.483,23,30,.767,141
4726,2017-10-30,LAC,,GSW,L 113-141,240,39,86,.453,29,61,.475,10,25,.400,25,30,.833,113
4727,2017-10-30,CHA,@,MEM,W 104-99,240,37,89,.416,30,72,.417,7,17,.412,23,29,.793,104
4728,2017-10-30,MEM,,CHO,L 99-104,240,32,93,.344,24,58,.414,8,35,.229,27,33,.818,99
4729,2017-10-30,MIA,,MIN,L 122-125 (OT),265,49,93,.527,42,66,.636,7,27,.259,17,25,.680,122
4730,2017-10-30,MIN,@,MIA,W 125-122 (OT),265,41,91,.451,30,68,.441,11,23,.478,32,35,.914,125
4731,2017-10-30,NOP,,ORL,L 99-115,240,39,85,.459,32,57,.561,7,28,.250,14,18,.778,99
4732,2017-10-30,ORL,@,NOP,W 115-99,240,43,85,.506,27,51,.529,16,34,.471,13,18,.722,115
4733,2017-10-30,DEN,@,NYK,L 110-116,240,35,85,.412,17,44,.386,18,41,.439,22,31,.710,110
4734,2017-10-30,NYK,,DEN,W 116-110,240,41,82,.500,28,50,.560,13,32,.406,21,23,.913,116
4735,2017-10-30,POR,,TOR,L 85-99,240,31,80,.388,23,54,.426,8,26,.308,15,19,.789,85
4736,2017-10-30,TOR,@,POR,W 99-85,240,39,87,.448,31,63,.492,8,24,.333,13,17,.765,99
4737,2017-10-30,DAL,@,UTA,L 89-104,240,34,76,.447,22,52,.423,12,24,.500,9,11,.818,89
4738,2017-10-30,UTA,,DAL,W 104-89,240,38,81,.469,22,46,.478,16,35,.457,12,15,.800,104
4739,2017-10-29,ATL,,MIL,L 106-117,240,36,77,.468,23,48,.479,13,29,.448,21,26,.808,106
4740,2017-10-29,MIL,@,ATL,W 117-106,240,44,81,.543,31,55,.564,13,26,.500,16,21,.762,117
4741,2017-10-29,BRK,,DEN,L 111-124,240,39,96,.406,27,65,.415,12,31,.387,21,31,.677,111
4742,2017-10-29,DEN,@,BRK,W 124-111,240,47,94,.500,36,74,.486,11,20,.550,19,22,.864,124
4743,2017-10-29,CHA,,ORL,W 120-113,240,53,97,.546,47,79,.595,6,18,.333,8,17,.471,120
4744,2017-10-29,ORL,@,CHO,L 113-120,240,41,97,.423,30,64,.469,11,33,.333,20,26,.769,113
4745,2017-10-29,CLE,,NYK,L 95-114,240,31,81,.383,21,48,.438,10,33,.303,23,27,.852,95
4746,2017-10-29,NYK,@,CLE,W 114-95,240,42,89,.472,29,61,.475,13,28,.464,17,21,.810,114
4747,2017-10-29,DET,@,GSW,W 115-107,240,43,93,.462,31,66,.470,12,27,.444,17,17,1.000,115
4748,2017-10-29,GSW,,DET,L 107-115,240,44,77,.571,34,50,.680,10,27,.370,9,12,.750,107
4749,2017-10-29,IND,,SAS,W 97-94,240,36,77,.468,26,55,.473,10,22,.455,15,20,.750,97
4750,2017-10-29,SAS,@,IND,L 94-97,240,36,90,.400,27,62,.435,9,28,.321,13,18,.722,94
4751,2017-10-29,SAC,,WAS,L 83-110,240,32,82,.390,26,60,.433,6,22,.273,13,16,.813,83
4752,2017-10-29,WAS,@,SAC,W 110-83,240,40,85,.471,23,51,.451,17,34,.500,13,20,.650,110
4753,2017-10-28,CHI,,OKC,L 69-101,240,22,78,.282,12,41,.293,10,37,.270,15,20,.750,69
4754,2017-10-28,OKC,@,CHI,W 101-69,240,39,88,.443,26,54,.481,13,34,.382,10,14,.714,101
4755,2017-10-28,DAL,,PHI,L 110-112,240,38,74,.514,19,34,.559,19,40,.475,15,19,.789,110
4756,2017-10-28,PHI,@,DAL,W 112-110,240,43,87,.494,27,52,.519,16,35,.457,10,14,.714,112
4757,2017-10-28,DET,@,LAC,W 95-87,240,36,88,.409,27,60,.450,9,28,.321,14,21,.667,95
4758,2017-10-28,LAC,,DET,L 87-95,240,28,84,.333,13,46,.283,15,38,.395,16,22,.727,87
4759,2017-10-28,HOU,@,MEM,L 89-103,240,29,77,.377,15,39,.385,14,38,.368,17,21,.810,89
4760,2017-10-28,MEM,,HOU,W 103-89,240,40,85,.471,26,52,.500,14,33,.424,9,12,.750,103
4761,2017-10-28,BOS,@,MIA,W 96-90,240,34,81,.420,28,58,.483,6,23,.261,22,26,.846,96
4762,2017-10-28,MIA,,BOS,L 90-96,240,34,79,.430,27,48,.563,7,31,.226,15,16,.938,90
4763,2017-10-28,CLE,@,NOP,L 101-123,240,36,78,.462,24,46,.522,12,32,.375,17,23,.739,101
4764,2017-10-28,NOP,,CLE,W 123-101,240,49,95,.516,36,62,.581,13,33,.394,12,16,.750,123
4765,2017-10-28,PHO,@,POR,L 107-114,240,37,87,.425,28,61,.459,9,26,.346,24,30,.800,107
4766,2017-10-28,POR,,PHO,W 114-107,240,40,91,.440,29,65,.446,11,26,.423,23,28,.821,114
4767,2017-10-28,LAL,@,UTA,L 81-96,240,31,81,.383,26,59,.441,5,22,.227,14,20,.700,81
4768,2017-10-28,UTA,,LAL,W 96-81,240,37,79,.468,24,48,.500,13,31,.419,9,13,.692,96
4769,2017-10-27,ATL,,DEN,L 100-105,240,37,89,.416,23,56,.411,14,33,.424,12,12,1.000,100
4770,2017-10-27,DEN,@,ATL,W 105-100,240,42,91,.462,38,71,.535,4,20,.200,17,23,.739,105
4771,2017-10-27,CHA,,HOU,L 93-109,240,33,88,.375,22,59,.373,11,29,.379,16,28,.571,93
4772,2017-10-27,HOU,@,CHO,W 109-93,240,38,85,.447,16,28,.571,22,57,.386,11,13,.846,109
4773,2017-10-27,GSW,,WAS,W 120-117,240,46,95,.484,36,57,.632,10,38,.263,18,20,.900,120
4774,2017-10-27,WAS,@,GSW,L 117-120,240,43,97,.443,28,64,.438,15,33,.455,16,22,.727,117
4775,2017-10-27,LAL,,TOR,L 92-101,240,36,79,.456,33,56,.589,3,23,.130,17,24,.708,92
4776,2017-10-27,TOR,@,LAL,W 101-92,240,40,93,.430,33,64,.516,7,29,.241,14,20,.700,101
4777,2017-10-27,MIN,,OKC,W 119-116,240,42,86,.488,34,64,.531,8,22,.364,27,35,.771,119
4778,2017-10-27,OKC,@,MIN,L 116-119,240,43,86,.500,35,58,.603,8,28,.286,22,25,.880,116
4779,2017-10-27,BRK,@,NYK,L 86-107,240,30,75,.400,19,45,.422,11,30,.367,15,21,.714,86
4780,2017-10-27,NYK,,BRK,W 107-86,240,44,98,.449,35,71,.493,9,27,.333,10,17,.588,107
4781,2017-10-27,ORL,,SAS,W 114-87,240,48,84,.571,37,61,.607,11,23,.478,7,14,.500,114
4782,2017-10-27,SAS,@,ORL,L 87-114,240,30,89,.337,26,65,.400,4,24,.167,23,27,.852,87
4783,2017-10-26,ATL,@,CHI,L 86-91,240,32,81,.395,21,53,.396,11,28,.393,11,13,.846,86
4784,2017-10-26,CHI,,ATL,W 91-86,240,31,86,.360,24,54,.444,7,32,.219,22,29,.759,91
4785,2017-10-26,DAL,@,MEM,L 91-96,240,32,94,.340,22,60,.367,10,34,.294,17,20,.850,91
4786,2017-10-26,MEM,,DAL,W 96-91,240,30,73,.411,20,39,.513,10,34,.294,26,30,.867,96
4787,2017-10-26,BOS,@,MIL,W 96-89,240,33,78,.423,22,48,.458,11,30,.367,19,22,.864,96
4788,2017-10-26,MIL,,BOS,L 89-96,240,35,77,.455,24,52,.462,11,25,.440,8,14,.571,89
4789,2017-10-26,LAC,@,POR,W 104-103,240,36,77,.468,27,49,.551,9,28,.321,23,36,.639,104
4790,2017-10-26,POR,,LAC,L 103-104,240,35,89,.393,21,58,.362,14,31,.452,19,22,.864,103
4791,2017-10-26,NOP,@,SAC,W 114-106,240,42,86,.488,29,54,.537,13,32,.406,17,23,.739,114
4792,2017-10-26,SAC,,NOP,L 106-114,240,38,81,.469,31,61,.508,7,20,.350,23,25,.920,106
4793,2017-10-25,BRK,,CLE,W 112-107,240,40,93,.430,23,47,.489,17,46,.370,15,21,.714,112
4794,2017-10-25,CLE,@,BRK,L 107-112,240,39,81,.481,27,46,.587,12,35,.343,17,26,.654,107
4795,2017-10-25,CHA,,DEN,W 110-93,240,38,81,.469,25,50,.500,13,31,.419,21,26,.808,110
4796,2017-10-25,DEN,@,CHO,L 93-110,240,38,100,.380,30,69,.435,8,31,.258,9,15,.600,93
4797,2017-10-25,DAL,,MEM,W 103-94,240,36,74,.486,25,48,.521,11,26,.423,20,29,.690,103
4798,2017-10-25,MEM,@,DAL,L 94-103,240,33,72,.458,21,41,.512,12,31,.387,16,24,.667,94
4799,2017-10-25,DET,,MIN,W 122-101,240,48,92,.522,33,58,.569,15,34,.441,11,17,.647,122
4800,2017-10-25,MIN,@,DET,L 101-122,240,37,85,.435,28,60,.467,9,25,.360,18,21,.857,101
4801,2017-10-25,GSW,,TOR,W 117-112,240,43,77,.558,31,51,.608,12,26,.462,19,22,.864,117
4802,2017-10-25,TOR,@,GSW,L 112-117,240,43,94,.457,35,60,.583,8,34,.235,18,19,.947,112
4803,2017-10-25,LAL,,WAS,W 102-99 (OT),265,41,92,.446,34,62,.548,7,30,.233,13,16,.813,102
4804,2017-10-25,WAS,@,LAL,L 99-102 (OT),265,39,95,.411,33,69,.478,6,26,.231,15,23,.652,99
4805,2017-10-25,MIA,,SAS,L 100-117,240,37,80,.463,28,54,.519,9,26,.346,17,18,.944,100
4806,2017-10-25,SAS,@,MIA,W 117-100,240,42,76,.553,32,59,.542,10,17,.588,23,30,.767,117
4807,2017-10-25,IND,@,OKC,L 96-114,240,28,83,.337,18,54,.333,10,29,.345,30,35,.857,96
4808,2017-10-25,OKC,,IND,W 114-96,240,43,89,.483,33,62,.532,10,27,.370,18,26,.692,114
4809,2017-10-25,HOU,@,PHI,W 105-104,240,36,75,.480,24,36,.667,12,39,.308,21,24,.875,105
4810,2017-10-25,PHI,,HOU,L 104-105,240,43,97,.443,31,61,.508,12,36,.333,6,10,.600,104
4811,2017-10-25,PHO,,UTA,W 97-88,240,42,96,.438,36,77,.468,6,19,.316,7,9,.778,97
4812,2017-10-25,UTA,@,PHO,L 88-97,240,32,77,.416,26,52,.500,6,25,.240,18,25,.720,88
4813,2017-10-24,BOS,,NYK,W 110-89,240,37,75,.493,23,46,.500,14,29,.483,22,27,.815,110
4814,2017-10-24,NYK,@,BOS,L 89-110,240,36,85,.424,35,73,.479,1,12,.083,16,25,.640,89
4815,2017-10-24,CHI,@,CLE,L 112-119,240,42,88,.477,25,55,.455,17,33,.515,11,13,.846,112
4816,2017-10-24,CLE,,CHI,W 119-112,240,43,83,.518,27,45,.600,16,38,.421,17,22,.773,119
4817,2017-10-24,LAC,,UTA,W 102-84,240,39,83,.470,29,54,.537,10,29,.345,14,21,.667,102
4818,2017-10-24,UTA,@,LAC,L 84-102,240,34,79,.430,27,51,.529,7,28,.250,9,11,.818,84
4819,2017-10-24,IND,@,MIN,W 130-107,240,56,84,.667,46,62,.742,10,22,.455,8,11,.727,130
4820,2017-10-24,MIN,,IND,L 107-130,240,42,86,.488,33,62,.532,9,24,.375,14,22,.636,107
4821,2017-10-24,BRK,@,ORL,L 121-125,240,40,96,.417,29,61,.475,11,35,.314,30,34,.882,121
4822,2017-10-24,ORL,,BRK,W 125-121,240,41,83,.494,33,60,.550,8,23,.348,35,40,.875,125
4823,2017-10-24,NOP,@,POR,L 93-103,240,30,76,.395,21,46,.457,9,30,.300,24,32,.750,93
4824,2017-10-24,POR,,NOP,W 103-93,240,33,88,.375,23,59,.390,10,29,.345,27,33,.818,103
4825,2017-10-23,DAL,,GSW,L 103-133,240,38,96,.396,29,67,.433,9,29,.310,18,30,.600,103
4826,2017-10-23,GSW,@,DAL,W 133-103,240,48,86,.558,33,47,.702,15,39,.385,22,26,.846,133
4827,2017-10-23,DEN,,WAS,L 104-109,240,39,80,.488,31,57,.544,8,23,.348,18,23,.783,104
4828,2017-10-23,WAS,@,DEN,W 109-104,240,37,84,.440,28,54,.519,9,30,.300,26,28,.929,109
4829,2017-10-23,DET,,PHI,L 86-97,240,33,85,.388,27,55,.491,6,30,.200,14,19,.737,86
4830,2017-10-23,PHI,@,DET,W 97-86,240,35,75,.467,26,51,.510,9,24,.375,18,24,.750,97
4831,2017-10-23,HOU,,MEM,L 90-98,240,32,77,.416,23,39,.590,9,38,.237,17,23,.739,90
4832,2017-10-23,MEM,@,HOU,W 98-90,240,29,68,.426,23,49,.469,6,19,.316,34,37,.919,98
4833,2017-10-23,ATL,@,MIA,L 93-104,240,36,76,.474,29,59,.492,7,17,.412,14,18,.778,93
4834,2017-10-23,MIA,,ATL,W 104-93,240,39,85,.459,25,48,.521,14,37,.378,12,18,.667,104
4835,2017-10-23,CHA,@,MIL,L 94-103,240,33,78,.423,26,52,.500,7,26,.269,21,36,.583,94
4836,2017-10-23,MIL,,CHO,W 103-94,240,40,85,.471,31,59,.525,9,26,.346,14,16,.875,103
4837,2017-10-23,PHO,,SAC,W 117-115,240,42,77,.545,32,47,.681,10,30,.333,23,27,.852,117
4838,2017-10-23,SAC,@,PHO,L 115-117,240,43,99,.434,34,77,.442,9,22,.409,20,29,.690,115
4839,2017-10-23,SAS,,TOR,W 101-97,240,40,90,.444,35,70,.500,5,20,.250,16,23,.696,101
4840,2017-10-23,TOR,@,SAS,L 97-101,240,34,80,.425,24,43,.558,10,37,.270,19,24,.792,97
4841,2017-10-22,ATL,@,BRK,L 104-116,240,32,94,.340,25,67,.373,7,27,.259,33,36,.917,104
4842,2017-10-22,BRK,,ATL,W 116-104,240,41,87,.471,30,60,.500,11,27,.407,23,34,.676,116
4843,2017-10-22,LAL,,NOP,L 112-119,240,44,90,.489,35,63,.556,9,27,.333,15,20,.750,112
4844,2017-10-22,NOP,@,LAL,W 119-112,240,47,83,.566,37,51,.725,10,32,.313,15,21,.714,119
4845,2017-10-22,MIN,@,OKC,W 115-113,240,43,86,.500,33,61,.541,10,25,.400,19,23,.826,115
4846,2017-10-22,OKC,,MIN,L 113-115,240,46,96,.479,35,65,.538,11,31,.355,10,16,.625,113
4847,2017-10-21,CHI,,SAS,L 77-87,240,31,82,.378,23,54,.426,8,28,.286,7,9,.778,77
4848,2017-10-21,SAS,@,CHI,W 87-77,240,38,93,.409,37,81,.457,1,12,.083,10,16,.625,87
4849,2017-10-21,CLE,,ORL,L 93-114,240,33,86,.384,26,61,.426,7,25,.280,20,27,.741,93
4850,2017-10-21,ORL,@,CLE,W 114-93,240,40,90,.444,23,55,.418,17,35,.486,17,20,.850,114
4851,2017-10-21,DEN,,SAC,W 96-79,240,37,85,.435,27,55,.491,10,30,.333,12,20,.600,96
4852,2017-10-21,SAC,@,DEN,L 79-96,240,31,85,.365,23,63,.365,8,22,.364,9,13,.692,79
4853,2017-10-21,DAL,@,HOU,L 91-107,240,31,84,.369,18,53,.340,13,31,.419,16,21,.762,91
4854,2017-10-21,HOU,,DAL,W 107-91,240,39,82,.476,28,35,.800,11,47,.234,18,22,.818,107
4855,2017-10-21,LAC,,PHO,W 130-88,240,48,88,.545,36,62,.581,12,26,.462,22,30,.733,130
4856,2017-10-21,PHO,@,LAC,L 88-130,240,27,71,.380,21,47,.447,6,24,.250,28,38,.737,88
4857,2017-10-21,GSW,@,MEM,L 101-111,240,33,84,.393,21,46,.457,12,38,.316,23,27,.852,101
4858,2017-10-21,MEM,,GSW,W 111-101,240,36,77,.468,26,50,.520,10,27,.370,29,37,.784,111
4859,2017-10-21,IND,@,MIA,L 108-112,240,43,96,.448,36,77,.468,7,19,.368,15,21,.714,108
4860,2017-10-21,MIA,,IND,W 112-108,240,45,87,.517,31,53,.585,14,34,.412,8,14,.571,112
4861,2017-10-21,MIL,,POR,W 113-110,240,42,80,.525,35,62,.565,7,18,.389,22,30,.733,113
4862,2017-10-21,POR,@,MIL,L 110-113,240,34,81,.420,23,53,.434,11,28,.393,31,35,.886,110
4863,2017-10-21,DET,@,NYK,W 111-107,240,44,91,.484,35,61,.574,9,30,.300,14,15,.933,111
4864,2017-10-21,NYK,,DET,L 107-111,240,37,81,.457,29,51,.569,8,30,.267,25,31,.806,107
4865,2017-10-21,PHI,@,TOR,L 94-128,240,32,82,.390,24,58,.414,8,24,.333,22,36,.611,94
4866,2017-10-21,TOR,,PHI,W 128-94,240,42,89,.472,29,45,.644,13,44,.295,31,37,.838,128
4867,2017-10-21,OKC,@,UTA,L 87-96,240,32,78,.410,21,45,.467,11,33,.333,12,19,.632,87
4868,2017-10-21,UTA,,OKC,W 96-87,240,38,77,.494,29,48,.604,9,29,.310,11,14,.786,96
4869,2017-10-20,BRK,,ORL,W 126-121,240,46,92,.500,37,65,.569,9,27,.333,25,35,.714,126
4870,2017-10-20,ORL,@,BRK,L 121-126,240,45,89,.506,27,56,.482,18,33,.545,13,15,.867,121
4871,2017-10-20,ATL,@,CHO,L 91-109,240,36,95,.379,29,65,.446,7,30,.233,12,14,.857,91
4872,2017-10-20,CHA,,ATL,W 109-91,240,37,86,.430,26,50,.520,11,36,.306,24,30,.800,109
4873,2017-10-20,DAL,,SAC,L 88-93,240,31,75,.413,20,42,.476,11,33,.333,15,21,.714,88
4874,2017-10-20,SAC,@,DAL,W 93-88,240,37,87,.425,27,64,.422,10,23,.435,9,13,.692,93
4875,2017-10-20,IND,,POR,L 96-114,240,35,78,.449,31,60,.517,4,18,.222,22,33,.667,96
4876,2017-10-20,POR,@,IND,W 114-96,240,46,95,.484,37,76,.487,9,19,.474,13,17,.765,114
4877,2017-10-20,CLE,@,MIL,W 116-97,240,44,81,.543,33,55,.600,11,26,.423,17,17,1.000,116
4878,2017-10-20,MIL,,CLE,L 97-116,240,38,82,.463,27,47,.574,11,35,.314,10,12,.833,97
4879,2017-10-20,MIN,,UTA,W 100-97,240,36,81,.444,29,59,.492,7,22,.318,21,26,.808,100
4880,2017-10-20,UTA,@,MIN,L 97-100,240,37,77,.481,28,55,.509,9,22,.409,14,17,.824,97
4881,2017-10-20,GSW,@,NOP,W 128-120,240,47,92,.511,29,51,.569,18,41,.439,16,20,.800,128
4882,2017-10-20,NOP,,GSW,L 120-128,240,45,98,.459,29,62,.468,16,36,.444,14,22,.636,120
4883,2017-10-20,BOS,@,PHI,W 102-92,240,35,84,.417,25,55,.455,10,29,.345,22,32,.688,102
4884,2017-10-20,PHI,,BOS,L 92-102,240,35,92,.380,25,60,.417,10,32,.313,12,16,.750,92
4885,2017-10-20,LAL,@,PHO,W 132-130,240,48,93,.516,36,67,.537,12,26,.462,24,33,.727,132
4886,2017-10-20,PHO,,LAL,L 130-132,240,45,92,.489,31,63,.492,14,29,.483,26,38,.684,130
4887,2017-10-20,DET,@,WAS,L 111-115,240,43,87,.494,33,64,.516,10,23,.435,15,20,.750,111
4888,2017-10-20,WAS,,DET,W 115-111,240,40,75,.533,34,58,.586,6,17,.353,29,35,.829,115
4889,2017-10-19,LAC,@,LAL,W 108-92,240,42,107,.393,30,74,.405,12,33,.364,12,13,.923,108
4890,2017-10-19,LAL,,LAC,L 92-108,240,37,91,.407,33,75,.440,4,16,.250,14,23,.609,92
4891,2017-10-19,NYK,@,OKC,L 84-105,240,32,79,.405,25,55,.455,7,24,.292,13,19,.684,84
4892,2017-10-19,OKC,,NYK,W 105-84,240,39,90,.433,28,52,.538,11,38,.289,16,22,.727,105
4893,2017-10-19,CHI,@,TOR,L 100-117,240,37,89,.416,27,57,.474,10,32,.313,16,18,.889,100
4894,2017-10-19,TOR,,CHI,W 117-100,240,39,83,.470,26,54,.481,13,29,.448,26,28,.929,117
4895,2017-10-18,BOS,,MIL,L 100-108,240,39,91,.429,28,63,.444,11,28,.393,11,21,.524,100
4896,2017-10-18,MIL,@,BOS,W 108-100,240,38,76,.500,31,55,.564,7,21,.333,25,30,.833,108
4897,2017-10-18,ATL,@,DAL,W 117-111,240,48,94,.511,39,76,.513,9,18,.500,12,15,.800,117
4898,2017-10-18,DAL,,ATL,L 111-117,240,38,86,.442,21,41,.512,17,45,.378,18,21,.857,111
4899,2017-10-18,CHA,@,DET,L 90-102,240,29,73,.397,20,43,.465,9,30,.300,23,29,.793,90
4900,2017-10-18,DET,,CHO,W 102-90,240,41,96,.427,32,70,.457,9,26,.346,11,12,.917,102
4901,2017-10-18,BRK,@,IND,L 131-140,240,45,94,.479,33,64,.516,12,30,.400,29,32,.906,131
4902,2017-10-18,IND,,BRK,W 140-131,240,53,102,.520,44,68,.647,9,34,.265,25,32,.781,140
4903,2017-10-18,MEM,,NOP,W 103-91,240,39,92,.424,30,63,.476,9,29,.310,16,28,.571,103
4904,2017-10-18,NOP,@,MEM,L 91-103,240,30,79,.380,23,54,.426,7,25,.280,24,29,.828,91
4905,2017-10-18,MIA,@,ORL,L 109-116,240,44,101,.436,36,71,.507,8,30,.267,13,17,.765,109
4906,2017-10-18,ORL,,MIA,W 116-109,240,43,90,.478,35,69,.507,8,21,.381,22,29,.759,116
4907,2017-10-18,PHO,,POR,L 76-124,240,28,89,.315,21,62,.339,7,27,.259,13,18,.722,76
4908,2017-10-18,POR,@,PHO,W 124-76,240,44,90,.489,30,66,.455,14,24,.583,22,28,.786,124
4909,2017-10-18,HOU,@,SAC,W 105-100,240,33,83,.398,21,38,.553,12,45,.267,27,29,.931,105
4910,2017-10-18,SAC,,HOU,L 100-105,240,42,88,.477,34,65,.523,8,23,.348,8,10,.800,100
4911,2017-10-18,MIN,@,SAS,L 99-107,240,37,85,.435,29,66,.439,8,19,.421,17,23,.739,99
4912,2017-10-18,SAS,,MIN,W 107-99,240,41,89,.461,33,68,.485,8,21,.381,17,19,.895,107
4913,2017-10-18,DEN,@,UTA,L 96-106,240,36,77,.468,23,50,.460,13,27,.481,11,12,.917,96
4914,2017-10-18,UTA,,DEN,W 106-96,240,41,81,.506,32,57,.561,9,24,.375,15,16,.938,106
4915,2017-10-18,PHI,@,WAS,L 115-120,240,43,93,.462,28,58,.483,15,35,.429,14,19,.737,115
4916,2017-10-18,WAS,,PHI,W 120-115,240,42,97,.433,36,75,.480,6,22,.273,30,38,.789,120
4917,2017-10-17,BOS,@,CLE,L 99-102,240,36,88,.409,28,56,.500,8,32,.250,19,25,.760,99
4918,2017-10-17,CLE,,BOS,W 102-99,240,38,83,.458,33,61,.541,5,22,.227,21,25,.840,102
4919,2017-10-17,GSW,,HOU,L 121-122,240,43,80,.538,27,50,.540,16,30,.533,19,21,.905,121
4920,2017-10-17,HOU,@,GSW,W 122-121,240,47,97,.485,32,56,.571,15,41,.366,13,19,.684,122
4921,2017-04-12,BOS,,MIL,W 112-94,240,41,91,.451,29,54,.537,12,37,.324,18,26,.692,112
4922,2017-04-12,MIL,@,BOS,L 94-112,240,37,84,.440,31,61,.508,6,23,.261,14,17,.824,94
4923,2017-04-12,BRK,@,CHI,L 73-112,240,28,86,.326,25,53,.472,3,33,.091,14,18,.778,73
4924,2017-04-12,CHI,,BRK,W 112-73,240,41,95,.432,27,65,.415,14,30,.467,16,21,.762,112
4925,2017-04-12,CLE,,TOR,L 83-98,240,28,76,.368,18,39,.462,10,37,.270,17,24,.708,83
4926,2017-04-12,TOR,@,CLE,W 98-83,240,40,86,.465,32,60,.533,8,26,.308,10,16,.625,98
4927,2017-04-12,GSW,,LAL,W 109-94,240,41,90,.456,29,54,.537,12,36,.333,15,22,.682,109
4928,2017-04-12,LAL,@,GSW,L 94-109,240,41,93,.441,37,76,.487,4,17,.235,8,14,.571,94
4929,2017-04-12,HOU,,MIN,W 123-118,240,45,97,.464,26,41,.634,19,56,.339,14,22,.636,123
4930,2017-04-12,MIN,@,HOU,L 118-123,240,48,91,.527,37,68,.544,11,23,.478,11,15,.733,118
4931,2017-04-12,ATL,@,IND,L 86-104,240,30,72,.417,19,43,.442,11,29,.379,15,19,.789,86
4932,2017-04-12,IND,,ATL,W 104-86,240,39,82,.476,29,58,.500,10,24,.417,16,19,.842,104
4933,2017-04-12,LAC,,SAC,W 115-95,240,43,83,.518,33,55,.600,10,28,.357,19,25,.760,115
4934,2017-04-12,SAC,@,LAC,L 95-115,240,40,81,.494,35,70,.500,5,11,.455,10,14,.714,95
4935,2017-04-12,DAL,@,MEM,W 100-93,240,33,75,.440,24,41,.585,9,34,.265,25,31,.806,100
4936,2017-04-12,MEM,,DAL,L 93-100,240,33,84,.393,25,59,.424,8,25,.320,19,22,.864,93
4937,2017-04-12,MIA,,WAS,W 110-102,240,46,88,.523,38,64,.594,8,24,.333,10,12,.833,110
4938,2017-04-12,WAS,@,MIA,L 102-110,240,42,87,.483,35,61,.574,7,26,.269,11,14,.786,102
4939,2017-04-12,NYK,,PHI,W 114-113,240,41,83,.494,32,61,.525,9,22,.409,23,32,.719,114
4940,2017-04-12,PHI,@,NYK,L 113-114,240,46,93,.495,39,70,.557,7,23,.304,14,20,.700,113
4941,2017-04-12,DEN,@,OKC,W 111-105,240,39,85,.459,32,60,.533,7,25,.280,26,32,.813,111
4942,2017-04-12,OKC,,DEN,L 105-111,240,43,101,.426,35,76,.461,8,25,.320,11,17,.647,105
4943,2017-04-12,DET,@,ORL,L 109-113,240,41,106,.387,30,70,.429,11,36,.306,16,28,.571,109
4944,2017-04-12,ORL,,DET,W 113-109,240,42,87,.483,29,62,.468,13,25,.520,16,17,.941,113
4945,2017-04-12,NOP,@,POR,W 103-100,240,40,90,.444,32,66,.485,8,24,.333,15,21,.714,103
4946,2017-04-12,POR,,NOP,L 100-103,240,41,85,.482,28,55,.509,13,30,.433,5,13,.385,100
4947,2017-04-12,SAS,@,UTA,L 97-101,240,39,86,.453,31,65,.477,8,21,.381,11,13,.846,97
4948,2017-04-12,UTA,,SAS,W 101-97,240,39,77,.506,29,51,.569,10,26,.385,13,20,.650,101
4949,2017-04-11,ATL,,CHO,W 103-76,240,41,79,.519,34,52,.654,7,27,.259,14,18,.778,103
4950,2017-04-11,CHA,@,ATL,L 76-103,240,29,88,.330,26,65,.400,3,23,.130,15,19,.789,76
4951,2017-04-11,DAL,,DEN,L 91-109,240,35,88,.398,23,48,.479,12,40,.300,9,11,.818,91
4952,2017-04-11,DEN,@,DAL,W 109-91,240,41,84,.488,23,42,.548,18,42,.429,9,14,.643,109
4953,2017-04-11,LAL,,NOP,W 108-96,240,42,88,.477,34,66,.515,8,22,.364,16,23,.696,108
4954,2017-04-11,NOP,@,LAL,L 96-108,240,37,79,.468,30,57,.526,7,22,.318,15,20,.750,96
4955,2017-04-11,MIN,,OKC,L 98-100,240,38,86,.442,33,66,.500,5,20,.250,17,25,.680,98
4956,2017-04-11,OKC,@,MIN,W 100-98,240,37,86,.430,30,64,.469,7,22,.318,19,25,.760,100
4957,2017-04-11,PHO,@,SAC,L 104-129,240,41,109,.376,33,79,.418,8,30,.267,14,24,.583,104
4958,2017-04-11,SAC,,PHO,W 129-104,240,43,83,.518,34,64,.531,9,19,.474,34,43,.791,129
4959,2017-04-10,BOS,,BRK,W 114-105,240,41,91,.451,27,53,.509,14,38,.368,18,21,.857,114
4960,2017-04-10,BRK,@,BOS,L 105-114,240,31,86,.360,23,55,.418,8,31,.258,35,39,.897,105
4961,2017-04-10,CHI,,ORL,W 122-75,240,48,89,.539,36,63,.571,12,26,.462,14,16,.875,122
4962,2017-04-10,ORL,@,CHI,L 75-122,240,29,84,.345,24,57,.421,5,27,.185,12,16,.750,75
4963,2017-04-10,DET,,WAS,L 101-105,240,43,94,.457,33,68,.485,10,26,.385,5,5,1.000,101
4964,2017-04-10,WAS,@,DET,W 105-101,240,42,83,.506,35,64,.547,7,19,.368,14,16,.875,105
4965,2017-04-10,GSW,,UTA,L 99-105,240,39,80,.488,30,55,.545,9,25,.360,12,17,.706,99
4966,2017-04-10,UTA,@,GSW,W 105-99,240,41,92,.446,28,57,.491,13,35,.371,10,15,.667,105
4967,2017-04-10,HOU,@,LAC,L 96-125,240,33,84,.393,24,44,.545,9,40,.225,21,27,.778,96
4968,2017-04-10,LAC,,HOU,W 125-96,240,46,91,.505,36,65,.554,10,26,.385,23,28,.821,125
4969,2017-04-10,CLE,@,MIA,L 121-124 (OT),265,44,89,.494,30,54,.556,14,35,.400,19,22,.864,121
4970,2017-04-10,MIA,,CLE,W 124-121 (OT),265,44,95,.463,32,62,.516,12,33,.364,24,34,.706,124
4971,2017-04-10,CHA,@,MIL,L 79-89,240,33,81,.407,28,63,.444,5,18,.278,8,13,.615,79
4972,2017-04-10,MIL,,CHO,W 89-79,240,35,78,.449,19,51,.373,16,27,.593,3,5,.600,89
4973,2017-04-10,IND,@,PHI,W 120-111,240,49,85,.576,44,69,.638,5,16,.313,17,21,.810,120
4974,2017-04-10,PHI,,IND,L 111-120,240,35,75,.467,22,42,.524,13,33,.394,28,31,.903,111
4975,2017-04-10,POR,,SAS,W 99-98,240,37,89,.416,25,62,.403,12,27,.444,13,15,.867,99
4976,2017-04-10,SAS,@,POR,L 98-99,240,38,83,.458,30,62,.484,8,21,.381,14,20,.700,98
4977,2017-04-09,ATL,,CLE,W 126-125 (OT),265,44,94,.468,35,63,.556,9,31,.290,29,37,.784,126
4978,2017-04-09,CLE,@,ATL,L 125-126 (OT),265,45,98,.459,26,52,.500,19,46,.413,16,20,.800,125
4979,2017-04-09,DEN,,OKC,L 105-106,240,40,84,.476,29,50,.580,11,34,.324,14,15,.933,105
4980,2017-04-09,OKC,@,DEN,W 106-105,240,40,96,.417,34,71,.479,6,25,.240,20,22,.909,106
4981,2017-04-09,LAL,,MIN,W 110-109,240,42,86,.488,32,59,.542,10,27,.370,16,20,.800,110
4982,2017-04-09,MIN,@,LAL,L 109-110,240,40,80,.500,37,65,.569,3,15,.200,26,31,.839,109
4983,2017-04-09,DET,@,MEM,W 103-90,240,39,82,.476,25,54,.463,14,28,.500,11,16,.688,103
4984,2017-04-09,MEM,,DET,L 90-103,240,36,75,.480,27,54,.500,9,21,.429,9,13,.692,90
4985,2017-04-09,NYK,,TOR,L 97-110,240,37,82,.451,28,54,.519,9,28,.321,14,15,.933,97
4986,2017-04-09,TOR,@,NYK,W 110-97,240,40,77,.519,30,46,.652,10,31,.323,20,23,.870,110
4987,2017-04-09,DAL,@,PHO,L 111-124,240,41,97,.423,25,52,.481,16,45,.356,13,19,.684,111
4988,2017-04-09,PHO,,DAL,W 124-111,240,44,80,.550,36,61,.590,8,19,.421,28,32,.875,124
4989,2017-04-09,HOU,@,SAC,W 135-128,240,45,80,.563,27,37,.730,18,43,.419,27,31,.871,135
4990,2017-04-09,SAC,,HOU,L 128-135,240,47,94,.500,38,63,.603,9,31,.290,25,30,.833,128
4991,2017-04-08,BRK,,CHI,W 107-106,240,39,92,.424,29,61,.475,10,31,.323,19,24,.792,107
4992,2017-04-08,CHI,@,BRK,L 106-107,240,40,90,.444,29,66,.439,11,24,.458,15,17,.882,106
4993,2017-04-08,BOS,@,CHO,W 121-114,240,45,87,.517,28,48,.583,17,39,.436,14,17,.824,121
4994,2017-04-08,CHA,,BOS,L 114-121,240,38,84,.452,29,56,.518,9,28,.321,29,32,.906,114
4995,2017-04-08,GSW,,NOP,W 123-101,240,49,96,.510,39,63,.619,10,33,.303,15,16,.938,123
4996,2017-04-08,NOP,@,GSW,L 101-123,240,42,86,.488,37,65,.569,5,21,.238,12,19,.632,101
4997,2017-04-08,IND,@,ORL,W 127-112,240,51,86,.593,40,64,.625,11,22,.500,14,19,.737,127
4998,2017-04-08,ORL,,IND,L 112-127,240,41,84,.488,27,54,.500,14,30,.467,16,22,.727,112
4999,2017-04-08,MIL,@,PHI,W 90-82,240,35,79,.443,29,52,.558,6,27,.222,14,20,.700,90
5000,2017-04-08,PHI,,MIL,L 82-90,240,27,77,.351,19,46,.413,8,31,.258,20,23,.870,82
5001,2017-04-08,POR,,UTA,W 101-86,240,37,91,.407,24,61,.393,13,30,.433,14,16,.875,101
5002,2017-04-08,UTA,@,POR,L 86-101,240,31,78,.397,25,59,.424,6,19,.316,18,24,.750,86
5003,2017-04-08,LAC,@,SAS,W 98-87,240,42,84,.500,36,62,.581,6,22,.273,8,14,.571,98
5004,2017-04-08,SAS,,LAC,L 87-98,240,34,80,.425,26,58,.448,8,22,.364,11,14,.786,87
5005,2017-04-08,MIA,@,WAS,W 106-103,240,37,80,.463,30,62,.484,7,18,.389,25,36,.694,106
5006,2017-04-08,WAS,,MIA,L 103-106,240,39,81,.481,31,59,.525,8,22,.364,17,22,.773,103
5007,2017-04-07,ATL,@,CLE,W 114-100,240,45,89,.506,29,52,.558,16,37,.432,8,8,1.000,114
5008,2017-04-07,CLE,,ATL,L 100-114,240,39,81,.481,30,45,.667,9,36,.250,13,17,.765,100
5009,2017-04-07,DAL,,SAS,L 89-102,240,38,88,.432,30,62,.484,8,26,.308,5,8,.625,89
5010,2017-04-07,SAS,@,DAL,W 102-89,240,40,96,.417,31,68,.456,9,28,.321,13,22,.591,102
5011,2017-04-07,DEN,,NOP,W 122-106,240,43,78,.551,30,46,.652,13,32,.406,23,32,.719,122
5012,2017-04-07,NOP,@,DEN,L 106-122,240,47,99,.475,44,76,.579,3,23,.130,9,13,.692,106
5013,2017-04-07,DET,@,HOU,W 114-109,240,46,108,.426,37,82,.451,9,26,.346,13,16,.813,114
5014,2017-04-07,HOU,,DET,L 109-114,240,36,87,.414,20,36,.556,16,51,.314,21,28,.750,109
5015,2017-04-07,LAL,,SAC,W 98-94,240,38,86,.442,34,62,.548,4,24,.167,18,25,.720,98
5016,2017-04-07,SAC,@,LAL,L 94-98,240,38,75,.507,30,55,.545,8,20,.400,10,13,.769,94
5017,2017-04-07,MEM,,NYK,W 101-88,240,38,75,.507,23,48,.479,15,27,.556,10,12,.833,101
5018,2017-04-07,NYK,@,MEM,L 88-101,240,38,88,.432,32,60,.533,6,28,.214,6,13,.462,88
5019,2017-04-07,OKC,@,PHO,L 99-120,240,34,92,.370,27,62,.435,7,30,.233,24,33,.727,99
5020,2017-04-07,PHO,,OKC,W 120-99,240,43,83,.518,35,65,.538,8,18,.444,26,31,.839,120
5021,2017-04-07,MIA,@,TOR,L 94-96,240,33,83,.398,25,60,.417,8,23,.348,20,29,.690,94
5022,2017-04-07,TOR,,MIA,W 96-94,240,35,85,.412,26,65,.400,9,20,.450,17,24,.708,96
5023,2017-04-07,MIN,@,UTA,L 113-120,240,39,79,.494,32,63,.508,7,16,.438,28,28,1.000,113
5024,2017-04-07,UTA,,MIN,W 120-113,240,45,75,.600,31,50,.620,14,25,.560,16,22,.727,120
5025,2017-04-06,ATL,,BOS,W 123-116,240,44,89,.494,33,66,.500,11,23,.478,24,34,.706,123
5026,2017-04-06,BOS,@,ATL,L 116-123,240,37,90,.411,22,47,.468,15,43,.349,27,34,.794,116
5027,2017-04-06,IND,,MIL,W 104-89,240,38,80,.475,30,55,.545,8,25,.320,20,26,.769,104
5028,2017-04-06,MIL,@,IND,L 89-104,240,33,71,.465,22,47,.468,11,24,.458,12,14,.857,89
5029,2017-04-06,NYK,,WAS,L 103-106,240,40,95,.421,33,75,.440,7,20,.350,16,21,.762,103
5030,2017-04-06,WAS,@,NYK,W 106-103,240,36,74,.486,22,40,.550,14,34,.412,20,28,.714,106
5031,2017-04-06,BRK,@,ORL,L 107-115,240,40,87,.460,29,57,.509,11,30,.367,16,22,.727,107
5032,2017-04-06,ORL,,BRK,W 115-107,240,42,90,.467,33,65,.508,9,25,.360,22,26,.846,115
5033,2017-04-06,CHI,@,PHI,W 102-90,240,39,91,.429,31,66,.470,8,25,.320,16,17,.941,102
5034,2017-04-06,PHI,,CHI,L 90-102,240,33,91,.363,26,58,.448,7,33,.212,17,22,.773,90
5035,2017-04-06,MIN,@,POR,L 98-105,240,38,87,.437,34,69,.493,4,18,.222,18,20,.900,98
5036,2017-04-06,POR,,MIN,W 105-98,240,35,81,.432,21,48,.438,14,33,.424,21,26,.808,105
5037,2017-04-05,BOS,,CLE,L 91-114,240,33,81,.407,26,48,.542,7,33,.212,18,29,.621,91
5038,2017-04-05,CLE,@,BOS,W 114-91,240,43,92,.467,32,56,.571,11,36,.306,17,18,.944,114
5039,2017-04-05,CHA,,MIA,L 99-112,240,35,78,.449,27,53,.509,8,25,.320,21,24,.875,99
5040,2017-04-05,MIA,@,CHO,W 112-99,240,40,84,.476,19,44,.432,21,40,.525,11,12,.917,112
5041,2017-04-05,DET,,TOR,L 102-105,240,42,81,.519,35,60,.583,7,21,.333,11,18,.611,102
5042,2017-04-05,TOR,@,DET,W 105-102,240,41,87,.471,31,57,.544,10,30,.333,13,15,.867,105
5043,2017-04-05,DEN,@,HOU,L 104-110,240,41,104,.394,34,66,.515,7,38,.184,15,18,.833,104
5044,2017-04-05,HOU,,DEN,W 110-104,240,37,87,.425,27,53,.509,10,34,.294,26,38,.684,110
5045,2017-04-05,DAL,@,LAC,L 101-112,240,38,86,.442,27,55,.491,11,31,.355,14,18,.778,101
5046,2017-04-05,LAC,,DAL,W 112-101,240,38,75,.507,26,44,.591,12,31,.387,24,31,.774,112
5047,2017-04-05,MEM,,OKC,L 100-103,240,37,78,.474,28,52,.538,9,26,.346,17,21,.810,100
5048,2017-04-05,OKC,@,MEM,W 103-100,240,37,85,.435,23,54,.426,14,31,.452,15,24,.625,103
5049,2017-04-05,GSW,@,PHO,W 120-111,240,45,89,.506,32,59,.542,13,30,.433,17,24,.708,120
5050,2017-04-05,PHO,,GSW,L 111-120,240,43,103,.417,36,76,.474,7,27,.259,18,26,.692,111
5051,2017-04-05,LAL,@,SAS,W 102-95,240,42,86,.488,35,72,.486,7,14,.500,11,14,.786,102
5052,2017-04-05,SAS,,LAL,L 95-102,240,39,89,.438,26,54,.481,13,35,.371,4,6,.667,95
5053,2017-04-04,CLE,,ORL,W 122-102,240,44,82,.537,26,46,.565,18,36,.500,16,21,.762,122
5054,2017-04-04,ORL,@,CLE,L 102-122,240,33,86,.384,22,53,.415,11,33,.333,25,26,.962,102
5055,2017-04-04,GSW,,MIN,W 121-107,240,44,84,.524,30,52,.577,14,32,.438,19,24,.792,121
5056,2017-04-04,MIN,@,GSW,L 107-121,240,41,96,.427,37,77,.481,4,19,.211,21,26,.808,107
5057,2017-04-04,IND,,TOR,W 108-90,240,39,89,.438,27,64,.422,12,25,.480,18,18,1.000,108
5058,2017-04-04,TOR,@,IND,L 90-108,240,34,76,.447,29,53,.547,5,23,.217,17,19,.895,90
5059,2017-04-04,DEN,@,NOP,W 134-131,240,53,99,.535,40,69,.580,13,30,.433,15,21,.714,134
5060,2017-04-04,NOP,,DEN,L 131-134,240,51,100,.510,37,68,.544,14,32,.438,15,17,.882,131
5061,2017-04-04,CHI,@,NYK,L 91-100,240,32,85,.376,26,58,.448,6,27,.222,21,23,.913,91
5062,2017-04-04,NYK,,CHI,W 100-91,240,42,89,.472,36,66,.545,6,23,.261,10,16,.625,100
5063,2017-04-04,MIL,@,OKC,L 79-110,240,29,81,.358,26,63,.413,3,18,.167,18,26,.692,79
5064,2017-04-04,OKC,,MIL,W 110-79,240,40,84,.476,31,56,.554,9,28,.321,21,25,.840,110
5065,2017-04-04,BRK,@,PHI,W 141-118,240,48,75,.640,32,44,.727,16,31,.516,29,33,.879,141
5066,2017-04-04,PHI,,BRK,L 118-141,240,43,97,.443,31,59,.525,12,38,.316,20,27,.741,118
5067,2017-04-04,DAL,@,SAC,L 87-98,240,32,80,.400,20,37,.541,12,43,.279,11,14,.786,87
5068,2017-04-04,SAC,,DAL,W 98-87,240,36,81,.444,24,59,.407,12,22,.545,14,17,.824,98
5069,2017-04-04,MEM,@,SAS,L 89-95 (OT),265,35,89,.393,27,64,.422,8,25,.320,11,18,.611,89
5070,2017-04-04,SAS,,MEM,W 95-89 (OT),265,35,80,.438,24,59,.407,11,21,.524,14,18,.778,95
5071,2017-04-04,POR,@,UTA,L 87-106,240,33,83,.398,27,57,.474,6,26,.231,15,17,.882,87
5072,2017-04-04,UTA,,POR,W 106-87,240,39,74,.527,26,51,.510,13,23,.565,15,19,.789,106
5073,2017-04-04,CHA,@,WAS,L 111-118,240,40,79,.506,28,45,.622,12,34,.353,19,22,.864,111
5074,2017-04-04,WAS,,CHO,W 118-111,240,43,85,.506,26,51,.510,17,34,.500,15,18,.833,118
5075,2017-04-03,MIN,,POR,W 110-109,240,41,84,.488,37,75,.493,4,9,.444,24,28,.857,110
5076,2017-04-03,POR,@,MIN,L 109-110,240,38,86,.442,27,54,.500,11,32,.344,22,25,.880,109
5077,2017-04-02,ATL,@,BRK,L 82-91,240,30,80,.375,23,56,.411,7,24,.292,15,23,.652,82
5078,2017-04-02,BRK,,ATL,W 91-82,240,32,82,.390,22,49,.449,10,33,.303,17,20,.850,91
5079,2017-04-02,CLE,,IND,W 135-130 (2OT),290,47,95,.495,29,52,.558,18,43,.419,23,33,.697,135
5080,2017-04-02,IND,@,CLE,L 130-135 (2OT),290,48,105,.457,32,64,.500,16,41,.390,18,20,.900,130
5081,2017-04-02,GSW,,WAS,W 139-115,240,50,88,.568,34,52,.654,16,36,.444,23,26,.885,139
5082,2017-04-02,WAS,@,GSW,L 115-139,240,43,92,.467,33,65,.508,10,27,.370,19,25,.760,115
5083,2017-04-02,LAL,,MEM,W 108-103,240,40,85,.471,33,66,.500,7,19,.368,21,27,.778,108
5084,2017-04-02,MEM,@,LAL,L 103-108,240,40,80,.500,27,50,.540,13,30,.433,10,14,.714,103
5085,2017-04-02,DEN,@,MIA,W 116-113,240,44,87,.506,39,67,.582,5,20,.250,23,27,.852,116
5086,2017-04-02,MIA,,DEN,L 113-116,240,42,87,.483,29,60,.483,13,27,.481,16,21,.762,113
5087,2017-04-02,DAL,@,MIL,W 109-105,240,38,73,.521,24,37,.649,14,36,.389,19,20,.950,109
5088,2017-04-02,MIL,,DAL,L 105-109,240,39,77,.506,27,43,.628,12,34,.353,15,18,.833,105
5089,2017-04-02,CHI,@,NOP,W 117-110,240,45,92,.489,32,66,.485,13,26,.500,14,18,.778,117
5090,2017-04-02,NOP,,CHI,L 110-117,240,33,81,.407,23,51,.451,10,30,.333,34,35,.971,110
5091,2017-04-02,BOS,@,NYK,W 110-94,240,40,72,.556,28,35,.800,12,37,.324,18,26,.692,110
5092,2017-04-02,NYK,,BOS,L 94-110,240,33,85,.388,26,60,.433,7,25,.280,21,25,.840,94
5093,2017-04-02,CHA,@,OKC,W 113-101,240,37,77,.481,26,47,.553,11,30,.367,28,32,.875,113
5094,2017-04-02,OKC,,CHO,L 101-113,240,39,84,.464,27,53,.509,12,31,.387,11,12,.917,101
5095,2017-04-02,HOU,@,PHO,W 123-116,240,47,100,.470,33,62,.532,14,38,.368,15,23,.652,123
5096,2017-04-02,PHO,,HOU,L 116-123,240,42,100,.420,34,66,.515,8,34,.235,24,29,.828,116
5097,2017-04-02,SAS,,UTA,W 109-103,240,40,77,.519,30,58,.517,10,19,.526,19,22,.864,109
5098,2017-04-02,UTA,@,SAS,L 103-109,240,43,89,.483,34,65,.523,9,24,.375,8,13,.615,103
5099,2017-04-02,PHI,@,TOR,L 105-113,240,36,80,.450,25,44,.568,11,36,.306,22,25,.880,105
5100,2017-04-02,TOR,,PHI,W 113-105,240,46,85,.541,40,66,.606,6,19,.316,15,19,.789,113
5101,2017-04-01,BRK,,ORL,W 121-111,240,50,94,.532,42,63,.667,8,31,.258,13,16,.813,121
5102,2017-04-01,ORL,@,BRK,L 111-121,240,45,91,.495,35,66,.530,10,25,.400,11,15,.733,111
5103,2017-04-01,ATL,@,CHI,L 104-106,240,40,90,.444,29,62,.468,11,28,.393,13,17,.765,104
5104,2017-04-01,CHI,,ATL,W 106-104,240,40,85,.471,28,55,.509,12,30,.400,14,14,1.000,106
5105,2017-04-01,LAC,,LAL,W 115-104,240,38,69,.551,27,44,.614,11,25,.440,28,34,.824,115
5106,2017-04-01,LAL,@,LAC,L 104-115,240,39,90,.433,33,67,.493,6,23,.261,20,30,.667,104
5107,2017-04-01,MIN,,SAC,L 117-123,240,39,87,.448,30,60,.500,9,27,.333,30,38,.789,117
5108,2017-04-01,SAC,@,MIN,W 123-117,240,44,78,.564,33,59,.559,11,19,.579,24,33,.727,123
5109,2017-04-01,PHO,@,POR,L 117-130,240,44,84,.524,41,74,.554,3,10,.300,26,32,.813,117
5110,2017-04-01,POR,,PHO,W 130-117,240,43,92,.467,28,55,.509,15,37,.405,29,31,.935,130
5111,2017-03-31,BOS,,ORL,W 117-116,240,38,84,.452,26,51,.510,12,33,.364,29,34,.853,117
5112,2017-03-31,ORL,@,BOS,L 116-117,240,40,98,.408,28,68,.412,12,30,.400,24,25,.960,116
5113,2017-03-31,CHA,,DEN,W 122-114,240,40,86,.465,23,50,.460,17,36,.472,25,30,.833,122
5114,2017-03-31,DEN,@,CHO,L 114-122,240,45,90,.500,29,57,.509,16,33,.485,8,11,.727,114
5115,2017-03-31,CLE,,PHI,W 122-105,240,50,95,.526,37,66,.561,13,29,.448,9,16,.563,122
5116,2017-03-31,PHI,@,CLE,L 105-122,240,40,82,.488,29,49,.592,11,33,.333,14,19,.737,105
5117,2017-03-31,GSW,,HOU,W 107-98,240,43,95,.453,32,63,.508,11,32,.344,10,14,.714,107
5118,2017-03-31,HOU,@,GSW,L 98-107,240,34,91,.374,22,54,.407,12,37,.324,18,23,.783,98
5119,2017-03-31,DAL,@,MEM,L 90-99,240,29,76,.382,17,42,.405,12,34,.353,20,25,.800,90
5120,2017-03-31,MEM,,DAL,W 99-90,240,35,75,.467,24,48,.500,11,27,.407,18,20,.900,99
5121,2017-03-31,MIA,,NYK,L 94-98,240,34,83,.410,26,50,.520,8,33,.242,18,25,.720,94
5122,2017-03-31,NYK,@,MIA,W 98-94,240,38,80,.475,32,64,.500,6,16,.375,16,17,.941,98
5123,2017-03-31,DET,@,MIL,L 105-108 (OT),265,44,97,.454,37,67,.552,7,30,.233,10,16,.625,105
5124,2017-03-31,MIL,,DET,W 108-105 (OT),265,35,84,.417,21,48,.438,14,36,.389,24,34,.706,108
5125,2017-03-31,NOP,,SAC,W 117-89,240,46,95,.484,36,62,.581,10,33,.303,15,19,.789,117
5126,2017-03-31,SAC,@,NOP,L 89-117,240,35,90,.389,29,70,.414,6,20,.300,13,17,.765,89
5127,2017-03-31,OKC,,SAS,L 95-100,240,33,81,.407,27,60,.450,6,21,.286,23,27,.852,95
5128,2017-03-31,SAS,@,OKC,W 100-95,240,37,85,.435,28,58,.483,9,27,.333,17,27,.630,100
5129,2017-03-31,IND,@,TOR,L 100-111,240,36,87,.414,25,61,.410,11,26,.423,17,21,.810,100
5130,2017-03-31,TOR,,IND,W 111-100,240,37,82,.451,23,55,.418,14,27,.519,23,35,.657,111
5131,2017-03-31,UTA,,WAS,W 95-88,240,33,72,.458,23,47,.489,10,25,.400,19,31,.613,95
5132,2017-03-31,WAS,@,UTA,L 88-95,240,35,87,.402,30,70,.429,5,17,.294,13,16,.813,88
5133,2017-03-30,CHI,,CLE,W 99-93,240,38,90,.422,26,65,.400,12,25,.480,11,18,.611,99
5134,2017-03-30,CLE,@,CHI,L 93-99,240,37,83,.446,27,56,.482,10,27,.370,9,16,.563,93
5135,2017-03-30,BRK,@,DET,L 89-90,240,35,92,.380,25,61,.410,10,31,.323,9,12,.750,89
5136,2017-03-30,DET,,BRK,W 90-89,240,36,86,.419,29,68,.426,7,18,.389,11,17,.647,90
5137,2017-03-30,LAL,@,MIN,L 104-119,240,40,84,.476,31,57,.544,9,27,.333,15,16,.938,104
5138,2017-03-30,MIN,,LAL,W 119-104,240,43,89,.483,33,68,.485,10,21,.476,23,30,.767,119
5139,2017-03-30,LAC,@,PHO,W 124-118,240,44,80,.550,32,58,.552,12,22,.545,24,34,.706,124
5140,2017-03-30,PHO,,LAC,L 118-124,240,49,92,.533,42,69,.609,7,23,.304,13,24,.542,118
5141,2017-03-30,HOU,@,POR,L 107-117,240,40,91,.440,32,57,.561,8,34,.235,19,23,.826,107
5142,2017-03-30,POR,,HOU,W 117-107,240,43,90,.478,30,57,.526,13,33,.394,18,22,.818,117
5143,2017-03-29,BOS,,MIL,L 100-103,240,35,88,.398,23,51,.451,12,37,.324,18,23,.783,100
5144,2017-03-29,MIL,@,BOS,W 103-100,240,41,78,.526,33,56,.589,8,22,.364,13,17,.765,103
5145,2017-03-29,LAC,,WAS,W 133-124,240,47,83,.566,35,53,.660,12,30,.400,27,37,.730,133
5146,2017-03-29,WAS,@,LAC,L 124-133,240,46,93,.495,33,59,.559,13,34,.382,19,29,.655,124
5147,2017-03-29,IND,@,MEM,L 97-110,240,37,85,.435,27,60,.450,10,25,.400,13,15,.867,97
5148,2017-03-29,MEM,,IND,W 110-97,240,41,88,.466,29,56,.518,12,32,.375,16,18,.889,110
5149,2017-03-29,DAL,@,NOP,L 118-121,240,44,91,.484,30,64,.469,14,27,.519,16,17,.941,118
5150,2017-03-29,NOP,,DAL,W 121-118,240,42,84,.500,30,54,.556,12,30,.400,25,33,.758,121
5151,2017-03-29,MIA,@,NYK,W 105-88,240,40,84,.476,28,59,.475,12,25,.480,13,17,.765,105
5152,2017-03-29,NYK,,MIA,L 88-105,240,33,89,.371,28,64,.438,5,25,.200,17,21,.810,88
5153,2017-03-29,OKC,@,ORL,W 114-106 (OT),265,43,102,.422,33,69,.478,10,33,.303,18,28,.643,114
5154,2017-03-29,ORL,,OKC,L 106-114 (OT),265,39,97,.402,30,67,.448,9,30,.300,19,27,.704,106
5155,2017-03-29,ATL,@,PHI,W 99-92,240,34,80,.425,25,62,.403,9,18,.500,22,26,.846,99
5156,2017-03-29,PHI,,ATL,L 92-99,240,36,87,.414,25,48,.521,11,39,.282,9,11,.818,92
5157,2017-03-29,SAC,,UTA,L 82-112,240,34,75,.453,32,60,.533,2,15,.133,12,18,.667,82
5158,2017-03-29,UTA,@,SAC,W 112-82,240,42,79,.532,29,48,.604,13,31,.419,15,19,.789,112
5159,2017-03-29,GSW,@,SAS,W 110-98,240,43,85,.506,30,59,.508,13,26,.500,11,11,1.000,110
5160,2017-03-29,SAS,,GSW,L 98-110,240,34,83,.410,25,59,.424,9,24,.375,21,26,.808,98
5161,2017-03-29,CHA,@,TOR,W 110-106,240,39,86,.453,23,54,.426,16,32,.500,16,21,.762,110
5162,2017-03-29,TOR,,CHO,L 106-110,240,38,83,.458,27,52,.519,11,31,.355,19,24,.792,106
5163,2017-03-28,ATL,,PHO,W 95-91,240,34,85,.400,28,58,.483,6,27,.222,21,29,.724,95
5164,2017-03-28,PHO,@,ATL,L 91-95,240,35,96,.365,28,65,.431,7,31,.226,14,24,.583,91
5165,2017-03-28,BRK,,PHI,L 101-106,240,38,94,.404,29,62,.468,9,32,.281,16,24,.667,101
5166,2017-03-28,PHI,@,BRK,W 106-101,240,39,91,.429,29,58,.500,10,33,.303,18,21,.857,106
5167,2017-03-28,CHA,,MIL,L 108-118,240,39,80,.488,32,52,.615,7,28,.250,23,29,.793,108
5168,2017-03-28,MIL,@,CHO,W 118-108,240,46,74,.622,32,44,.727,14,30,.467,12,17,.706,118
5169,2017-03-28,DET,,MIA,L 96-97,240,36,85,.424,28,58,.483,8,27,.296,16,21,.762,96
5170,2017-03-28,MIA,@,DET,W 97-96,240,36,79,.456,31,58,.534,5,21,.238,20,28,.714,97
5171,2017-03-28,GSW,@,HOU,W 113-106,240,45,88,.511,34,47,.723,11,41,.268,12,16,.750,113
5172,2017-03-28,HOU,,GSW,L 106-113,240,33,85,.388,28,54,.519,5,31,.161,35,39,.897,106
5173,2017-03-28,IND,,MIN,L 114-115,240,40,81,.494,35,63,.556,5,18,.278,29,35,.829,114
5174,2017-03-28,MIN,@,IND,W 115-114,240,37,78,.474,28,58,.483,9,20,.450,32,37,.865,115
5175,2017-03-28,LAL,,WAS,L 108-119,240,43,85,.506,35,63,.556,8,22,.364,14,16,.875,108
5176,2017-03-28,WAS,@,LAL,W 119-108,240,48,94,.511,42,71,.592,6,23,.261,17,25,.680,119
5177,2017-03-28,DEN,@,POR,L 113-122,240,44,94,.468,35,64,.547,9,30,.300,16,20,.800,113
5178,2017-03-28,POR,,DEN,W 122-113,240,45,91,.495,37,64,.578,8,27,.296,24,33,.727,122
5179,2017-03-27,DAL,,OKC,L 91-92,240,33,80,.413,23,51,.451,10,29,.345,15,19,.789,91
5180,2017-03-27,OKC,@,DAL,W 92-91,240,37,85,.435,31,62,.500,6,23,.261,12,14,.857,92
5181,2017-03-27,DET,@,NYK,L 95-109,240,36,84,.429,27,61,.443,9,23,.391,14,21,.667,95
5182,2017-03-27,NYK,,DET,W 109-95,240,45,84,.536,38,63,.603,7,21,.333,12,13,.923,109
5183,2017-03-27,MEM,@,SAC,L 90-91,240,31,90,.344,26,64,.406,5,26,.192,23,29,.793,90
5184,2017-03-27,SAC,,MEM,W 91-90,240,31,67,.463,25,42,.595,6,25,.240,23,30,.767,91
5185,2017-03-27,CLE,@,SAS,L 74-103,240,31,83,.373,27,57,.474,4,26,.154,8,13,.615,74
5186,2017-03-27,SAS,,CLE,W 103-74,240,41,86,.477,34,60,.567,7,26,.269,14,17,.824,103
5187,2017-03-27,ORL,@,TOR,L 112-131,240,43,88,.489,39,68,.574,4,20,.200,22,28,.786,112
5188,2017-03-27,TOR,,ORL,W 131-112,240,49,83,.590,39,68,.574,10,15,.667,23,35,.657,131
5189,2017-03-27,NOP,@,UTA,L 100-108,240,37,80,.463,27,55,.491,10,25,.400,16,24,.667,100
5190,2017-03-27,UTA,,NOP,W 108-100,240,41,85,.482,26,58,.448,15,27,.556,11,18,.611,108
5191,2017-03-26,ATL,,BRK,L 92-107,240,34,98,.347,29,71,.408,5,27,.185,19,32,.594,92
5192,2017-03-26,BRK,@,ATL,W 107-92,240,38,86,.442,32,64,.500,6,22,.273,25,30,.833,107
5193,2017-03-26,BOS,,MIA,W 112-108,240,41,77,.532,33,53,.623,8,24,.333,22,25,.880,112
5194,2017-03-26,MIA,@,BOS,L 108-112,240,41,91,.451,34,62,.548,7,29,.241,19,24,.792,108
5195,2017-03-26,CHA,,PHO,W 120-106,240,42,87,.483,28,57,.491,14,30,.467,22,24,.917,120
5196,2017-03-26,PHO,@,CHO,L 106-120,240,41,81,.506,35,65,.538,6,16,.375,18,22,.818,106
5197,2017-03-26,DEN,,NOP,L 90-115,240,36,95,.379,30,70,.429,6,25,.240,12,14,.857,90
5198,2017-03-26,NOP,@,DEN,W 115-90,240,48,97,.495,39,70,.557,9,27,.333,10,12,.833,115
5199,2017-03-26,GSW,,MEM,W 106-94,240,39,71,.549,22,40,.550,17,31,.548,11,15,.733,106
5200,2017-03-26,MEM,@,GSW,L 94-106,240,38,85,.447,30,56,.536,8,29,.276,10,15,.667,94
5201,2017-03-26,HOU,,OKC,W 137-125,240,50,79,.633,30,40,.750,20,39,.513,17,21,.810,137
5202,2017-03-26,OKC,@,HOU,L 125-137,240,47,94,.500,36,64,.563,11,30,.367,20,28,.714,125
5203,2017-03-26,IND,,PHI,W 107-94,240,38,89,.427,31,72,.431,7,17,.412,24,29,.828,107
5204,2017-03-26,PHI,@,IND,L 94-107,240,35,88,.398,21,47,.447,14,41,.341,10,14,.714,94
5205,2017-03-26,LAC,,SAC,L 97-98,240,32,78,.410,22,49,.449,10,29,.345,23,28,.821,97
5206,2017-03-26,SAC,@,LAC,W 98-97,240,38,84,.452,25,56,.446,13,28,.464,9,13,.692,98
5207,2017-03-26,LAL,,POR,L 81-97,240,33,84,.393,28,63,.444,5,21,.238,10,17,.588,81
5208,2017-03-26,POR,@,LAL,W 97-81,240,36,89,.404,24,61,.393,12,28,.429,13,18,.722,97
5209,2017-03-26,CHI,@,MIL,W 109-94,240,46,85,.541,36,64,.563,10,21,.476,7,10,.700,109
5210,2017-03-26,MIL,,CHI,L 94-109,240,37,84,.440,30,61,.492,7,23,.304,13,17,.765,94
5211,2017-03-25,CLE,,WAS,L 115-127,240,41,83,.494,29,50,.580,12,33,.364,21,27,.778,115
5212,2017-03-25,WAS,@,CLE,W 127-115,240,49,82,.598,41,64,.641,8,18,.444,21,26,.808,127
5213,2017-03-25,DAL,,TOR,L 86-94,240,31,82,.378,24,54,.444,7,28,.250,17,20,.850,86
5214,2017-03-25,TOR,@,DAL,W 94-86,240,39,81,.481,30,60,.500,9,21,.429,7,9,.778,94
5215,2017-03-25,LAC,,UTA,W 108-95,240,38,84,.452,31,57,.544,7,27,.259,25,28,.893,108
5216,2017-03-25,UTA,@,LAC,L 95-108,240,37,86,.430,29,60,.483,8,26,.308,13,18,.722,95
5217,2017-03-25,MIN,@,POR,L 100-112,240,37,76,.487,35,66,.530,2,10,.200,24,32,.750,100
5218,2017-03-25,POR,,MIN,W 112-100,240,45,71,.634,34,49,.694,11,22,.500,11,17,.647,112
5219,2017-03-25,NYK,@,SAS,L 98-106,240,41,87,.471,38,77,.494,3,10,.300,13,15,.867,98
5220,2017-03-25,SAS,,NYK,W 106-98,240,45,99,.455,35,74,.473,10,25,.400,6,8,.750,106
5221,2017-03-24,BOS,,PHO,W 130-120,240,44,94,.468,30,53,.566,14,41,.341,28,35,.800,130
5222,2017-03-24,PHO,@,BOS,L 120-130,240,39,86,.453,33,67,.493,6,19,.316,36,49,.735,120
5223,2017-03-24,CHI,,PHI,L 107-117,240,37,91,.407,27,67,.403,10,24,.417,23,31,.742,107
5224,2017-03-24,PHI,@,CHI,W 117-107,240,46,83,.554,38,58,.655,8,25,.320,17,23,.739,117
5225,2017-03-24,CHA,,CLE,L 105-112,240,38,90,.422,28,52,.538,10,38,.263,19,24,.792,105
5226,2017-03-24,CLE,@,CHO,W 112-105,240,41,74,.554,32,49,.653,9,25,.360,21,24,.875,112
5227,2017-03-24,GSW,,SAC,W 114-100,240,44,89,.494,34,58,.586,10,31,.323,16,18,.889,114
5228,2017-03-24,SAC,@,GSW,L 100-114,240,40,83,.482,30,62,.484,10,21,.476,10,13,.769,100
5229,2017-03-24,HOU,,NOP,W 117-107,240,44,93,.473,30,54,.556,14,39,.359,15,20,.750,117
5230,2017-03-24,NOP,@,HOU,L 107-117,240,41,91,.451,27,53,.509,14,38,.368,11,14,.786,107
5231,2017-03-24,DEN,@,IND,W 125-117,240,39,82,.476,32,55,.582,7,27,.259,40,43,.930,125
5232,2017-03-24,IND,,DEN,L 117-125,240,48,95,.505,35,71,.493,13,24,.542,8,11,.727,117
5233,2017-03-24,LAL,,MIN,W 130-119 (OT),265,46,88,.523,32,65,.492,14,23,.609,24,28,.857,130
5234,2017-03-24,MIN,@,LAL,L 119-130 (OT),265,46,95,.484,39,74,.527,7,21,.333,20,22,.909,119
5235,2017-03-24,ATL,@,MIL,L 97-100,240,34,83,.410,26,61,.426,8,22,.364,21,24,.875,97
5236,2017-03-24,MIL,,ATL,W 100-97,240,39,88,.443,31,61,.508,8,27,.296,14,16,.875,100
5237,2017-03-24,DET,@,ORL,L 87-115,240,34,96,.354,32,74,.432,2,22,.091,17,20,.850,87
5238,2017-03-24,ORL,,DET,W 115-87,240,47,91,.516,35,65,.538,12,26,.462,9,13,.692,115
5239,2017-03-24,BRK,@,WAS,L 108-129,240,43,82,.524,40,67,.597,3,15,.200,19,26,.731,108
5240,2017-03-24,WAS,,BRK,W 129-108,240,49,97,.505,39,71,.549,10,26,.385,21,22,.955,129
5241,2017-03-23,BRK,,PHO,W 126-98,240,43,95,.453,35,66,.530,8,29,.276,32,42,.762,126
5242,2017-03-23,PHO,@,BRK,L 98-126,240,34,93,.366,27,68,.397,7,25,.280,23,34,.676,98
5243,2017-03-23,DAL,,LAC,W 97-95,240,38,82,.463,29,56,.518,9,26,.346,12,18,.667,97
5244,2017-03-23,LAC,@,DAL,L 95-97,240,36,80,.450,27,53,.509,9,27,.333,14,21,.667,95
5245,2017-03-23,MIA,,TOR,L 84-101,240,32,82,.390,26,59,.441,6,23,.261,14,23,.609,84
5246,2017-03-23,TOR,@,MIA,W 101-84,240,35,79,.443,29,56,.518,6,23,.261,25,32,.781,101
5247,2017-03-23,NYK,@,POR,L 95-110,240,36,88,.409,31,66,.470,5,22,.227,18,20,.900,95
5248,2017-03-23,POR,,NYK,W 110-95,240,39,80,.488,28,59,.475,11,21,.524,21,29,.724,110
5249,2017-03-23,MEM,@,SAS,L 90-97,240,34,78,.436,24,49,.490,10,29,.345,12,15,.800,90
5250,2017-03-23,SAS,,MEM,W 97-90,240,37,77,.481,29,51,.569,8,26,.308,15,23,.652,97
5251,2017-03-22,BOS,,IND,W 109-100,240,43,84,.512,32,57,.561,11,27,.407,12,14,.857,109
5252,2017-03-22,IND,@,BOS,L 100-109,240,38,87,.437,27,59,.458,11,28,.393,13,19,.684,100
5253,2017-03-22,CHI,,DET,W 117-95,240,47,80,.588,36,57,.632,11,23,.478,12,19,.632,117
5254,2017-03-22,DET,@,CHI,L 95-117,240,39,88,.443,32,68,.471,7,20,.350,10,17,.588,95
5255,2017-03-22,CLE,@,DEN,L 113-126,240,43,85,.506,28,48,.583,15,37,.405,12,14,.857,113
5256,2017-03-22,DEN,,CLE,W 126-113,240,51,96,.531,40,70,.571,11,26,.423,13,13,1.000,126
5257,2017-03-22,OKC,,PHI,W 122-97,240,48,88,.545,44,72,.611,4,16,.250,22,30,.733,122
5258,2017-03-22,PHI,@,OKC,L 97-122,240,37,87,.425,29,62,.468,8,25,.320,15,17,.882,97
5259,2017-03-22,CHA,@,ORL,W 109-102,240,42,90,.467,33,63,.524,9,27,.333,16,18,.889,109
5260,2017-03-22,ORL,,CHO,L 102-109,240,40,88,.455,26,48,.542,14,40,.350,8,10,.800,102
5261,2017-03-22,MIL,@,SAC,W 116-98,240,43,81,.531,27,46,.587,16,35,.457,14,19,.737,116
5262,2017-03-22,SAC,,MIL,L 98-116,240,41,84,.488,31,58,.534,10,26,.385,6,10,.600,98
5263,2017-03-22,NYK,@,UTA,L 101-108,240,38,80,.475,29,59,.492,9,21,.429,16,18,.889,101
5264,2017-03-22,UTA,,NYK,W 108-101,240,41,90,.456,34,62,.548,7,28,.250,19,29,.655,108
5265,2017-03-22,ATL,@,WAS,L 100-104,240,34,86,.395,26,61,.426,8,25,.320,24,29,.828,100
5266,2017-03-22,WAS,,ATL,W 104-100,240,38,95,.400,27,61,.443,11,34,.324,17,23,.739,104
5267,2017-03-21,BRK,,DET,W 98-96,240,38,88,.432,28,59,.475,10,29,.345,12,19,.632,98
5268,2017-03-21,DET,@,BRK,L 96-98,240,40,92,.435,35,69,.507,5,23,.217,11,16,.688,96
5269,2017-03-21,DAL,,GSW,L 87-112,240,33,92,.359,22,58,.379,11,34,.324,10,12,.833,87
5270,2017-03-21,GSW,@,DAL,W 112-87,240,43,78,.551,30,48,.625,13,30,.433,13,16,.813,112
5271,2017-03-21,LAC,@,LAL,W 133-109,240,45,84,.536,30,51,.588,15,33,.455,28,32,.875,133
5272,2017-03-21,LAL,,LAC,L 109-133,240,43,92,.467,37,72,.514,6,20,.300,17,27,.630,109
5273,2017-03-21,MIA,,PHO,W 112-97,240,42,96,.438,31,69,.449,11,27,.407,17,23,.739,112
5274,2017-03-21,PHO,@,MIA,L 97-112,240,36,82,.439,32,66,.485,4,16,.250,21,29,.724,97
5275,2017-03-21,MIN,,SAS,L 93-100,240,32,72,.444,25,57,.439,7,15,.467,22,25,.880,93
5276,2017-03-21,SAS,@,MIN,W 100-93,240,37,77,.481,29,53,.547,8,24,.333,18,22,.818,100
5277,2017-03-21,MEM,@,NOP,L 82-95,240,32,79,.405,23,44,.523,9,35,.257,9,13,.692,82
5278,2017-03-21,NOP,,MEM,W 95-82,240,35,88,.398,26,59,.441,9,29,.310,16,19,.842,95
5279,2017-03-21,MIL,@,POR,W 93-90,240,38,90,.422,31,74,.419,7,16,.438,10,12,.833,93
5280,2017-03-21,POR,,MIL,L 90-93,240,35,83,.422,31,62,.500,4,21,.190,16,26,.615,90
5281,2017-03-21,CHI,@,TOR,L 120-122 (OT),265,42,90,.467,28,53,.528,14,37,.378,22,27,.815,120
5282,2017-03-21,TOR,,CHI,W 122-120 (OT),265,47,95,.495,39,72,.542,8,23,.348,20,27,.741,122
5283,2017-03-20,BOS,,WAS,W 110-102,240,40,93,.430,30,60,.500,10,33,.303,20,28,.714,110
5284,2017-03-20,WAS,@,BOS,L 102-110,240,37,86,.430,29,51,.569,8,35,.229,20,26,.769,102
5285,2017-03-20,ATL,@,CHO,L 90-105,240,37,84,.440,25,47,.532,12,37,.324,4,10,.400,90
5286,2017-03-20,CHA,,ATL,W 105-90,240,40,80,.500,28,50,.560,12,30,.400,13,20,.650,105
5287,2017-03-20,DEN,@,HOU,L 124-125,240,44,86,.512,32,57,.561,12,29,.414,24,26,.923,124
5288,2017-03-20,HOU,,DEN,W 125-124,240,45,89,.506,28,51,.549,17,38,.447,18,23,.783,125
5289,2017-03-20,IND,,UTA,W 107-100,240,38,87,.437,28,67,.418,10,20,.500,21,23,.913,107
5290,2017-03-20,UTA,@,IND,L 100-107,240,40,88,.455,34,63,.540,6,25,.240,14,20,.700,100
5291,2017-03-20,LAC,,NYK,W 114-105,240,43,87,.494,33,56,.589,10,31,.323,18,24,.750,114
5292,2017-03-20,NYK,@,LAC,L 105-114,240,40,89,.449,34,65,.523,6,24,.250,19,24,.792,105
5293,2017-03-20,GSW,@,OKC,W 111-95,240,40,83,.482,25,50,.500,15,33,.455,16,21,.762,111
5294,2017-03-20,OKC,,GSW,L 95-111,240,37,87,.425,33,66,.500,4,21,.190,17,31,.548,95
5295,2017-03-20,ORL,,PHI,W 112-109 (OT),265,35,94,.372,31,71,.437,4,23,.174,38,46,.826,112
5296,2017-03-20,PHI,@,ORL,L 109-112 (OT),265,39,102,.382,30,68,.441,9,34,.265,22,24,.917,109
5297,2017-03-19,BRK,,DAL,L 104-111,240,31,72,.431,18,41,.439,13,31,.419,29,38,.763,104
5298,2017-03-19,DAL,@,BRK,W 111-104,240,41,76,.539,31,51,.608,10,25,.400,19,25,.760,111
5299,2017-03-19,DET,,PHO,W 112-95,240,40,92,.435,28,67,.418,12,25,.480,20,30,.667,112
5300,2017-03-19,PHO,@,DET,L 95-112,240,35,99,.354,29,77,.377,6,22,.273,19,30,.633,95
5301,2017-03-19,CLE,@,LAL,W 125-120,240,45,85,.529,32,49,.653,13,36,.361,22,27,.815,125
5302,2017-03-19,LAL,,CLE,L 120-125,240,47,91,.516,36,64,.563,11,27,.407,15,19,.789,120
5303,2017-03-19,MIA,,POR,L 104-115,240,41,88,.466,32,58,.552,9,30,.300,13,20,.650,104
5304,2017-03-19,POR,@,MIA,W 115-104,240,42,83,.506,29,57,.509,13,26,.500,18,24,.750,115
5305,2017-03-19,MIN,@,NOP,L 109-123,240,44,86,.512,35,61,.574,9,25,.360,12,17,.706,109
5306,2017-03-19,NOP,,MIN,W 123-109,240,49,90,.544,35,60,.583,14,30,.467,11,15,.733,123
5307,2017-03-19,BOS,@,PHI,L 99-105,240,34,84,.405,28,55,.509,6,29,.207,25,29,.862,99
5308,2017-03-19,PHI,,BOS,W 105-99,240,41,88,.466,29,55,.527,12,33,.364,11,15,.733,105
5309,2017-03-19,SAC,@,SAS,L 102-118,240,41,83,.494,34,73,.466,7,10,.700,13,17,.765,102
5310,2017-03-19,SAS,,SAC,W 118-102,240,43,87,.494,32,59,.542,11,28,.393,21,27,.778,118
5311,2017-03-19,IND,@,TOR,L 91-116,240,33,80,.413,27,57,.474,6,23,.261,19,26,.731,91
5312,2017-03-19,TOR,,IND,W 116-91,240,45,91,.495,33,64,.516,12,27,.444,14,16,.875,116
5313,2017-03-18,ATL,,POR,L 97-113,240,32,88,.364,25,62,.403,7,26,.269,26,32,.813,97
5314,2017-03-18,POR,@,ATL,W 113-97,240,44,87,.506,36,69,.522,8,18,.444,17,19,.895,113
5315,2017-03-18,CHI,,UTA,W 95-86,240,38,80,.475,31,61,.508,7,19,.368,12,14,.857,95
5316,2017-03-18,UTA,@,CHI,L 86-95,240,31,81,.383,24,56,.429,7,25,.280,17,25,.680,86
5317,2017-03-18,CHA,,WAS,W 98-93,240,35,82,.427,26,58,.448,9,24,.375,19,27,.704,98
5318,2017-03-18,WAS,@,CHO,L 93-98,240,29,79,.367,18,46,.391,11,33,.333,24,31,.774,93
5319,2017-03-18,DEN,,HOU,L 105-109,240,38,89,.427,28,58,.483,10,31,.323,19,30,.633,105
5320,2017-03-18,HOU,@,DEN,W 109-105,240,38,83,.458,33,59,.559,5,24,.208,28,35,.800,109
5321,2017-03-18,GSW,,MIL,W 117-92,240,45,75,.600,33,52,.635,12,23,.522,15,19,.789,117
5322,2017-03-18,MIL,@,GSW,L 92-117,240,36,89,.404,27,62,.435,9,27,.333,11,14,.786,92
5323,2017-03-18,CLE,@,LAC,L 78-108,240,32,83,.386,27,56,.482,5,27,.185,9,13,.692,78
5324,2017-03-18,LAC,,CLE,W 108-78,240,40,78,.513,32,52,.615,8,26,.308,20,29,.690,108
5325,2017-03-18,MEM,,SAS,W 104-96,240,32,76,.421,19,46,.413,13,30,.433,27,31,.871,104
5326,2017-03-18,SAS,@,MEM,L 96-104,240,33,75,.440,24,47,.511,9,28,.321,21,22,.955,96
5327,2017-03-18,OKC,,SAC,W 110-94,240,41,82,.500,31,56,.554,10,26,.385,18,25,.720,110
5328,2017-03-18,SAC,@,OKC,L 94-110,240,35,85,.412,30,64,.469,5,21,.238,19,23,.826,94
5329,2017-03-17,BOS,@,BRK,W 98-95,240,34,85,.400,27,56,.482,7,29,.241,23,29,.793,98
5330,2017-03-17,BRK,,BOS,L 95-98,240,30,83,.361,19,48,.396,11,35,.314,24,30,.800,95
5331,2017-03-17,DET,,TOR,L 75-87,240,29,83,.349,26,63,.413,3,20,.150,14,21,.667,75
5332,2017-03-17,TOR,@,DET,W 87-75,240,30,78,.385,21,51,.412,9,27,.333,18,20,.900,87
5333,2017-03-17,LAL,,MIL,L 103-107,240,38,84,.452,27,55,.491,11,29,.379,16,26,.615,103
5334,2017-03-17,MIL,@,LAL,W 107-103,240,40,82,.488,36,58,.621,4,24,.167,23,30,.767,107
5335,2017-03-17,MIA,,MIN,W 123-105,240,50,85,.588,42,59,.712,8,26,.308,15,19,.789,123
5336,2017-03-17,MIN,@,MIA,L 105-123,240,41,82,.500,39,70,.557,2,12,.167,21,22,.955,105
5337,2017-03-17,HOU,@,NOP,L 112-128,240,37,91,.407,24,51,.471,13,40,.325,25,32,.781,112
5338,2017-03-17,NOP,,HOU,W 128-112,240,49,92,.533,37,58,.638,12,34,.353,18,24,.750,128
5339,2017-03-17,DAL,@,PHI,L 74-116,240,30,87,.345,25,64,.391,5,23,.217,9,17,.529,74
5340,2017-03-17,PHI,,DAL,W 116-74,240,42,80,.525,30,51,.588,12,29,.414,20,23,.870,116
5341,2017-03-17,ORL,@,PHO,W 109-103,240,42,96,.438,35,73,.479,7,23,.304,18,21,.857,109
5342,2017-03-17,PHO,,ORL,L 103-109,240,38,87,.437,36,73,.493,2,14,.143,25,30,.833,103
5343,2017-03-17,CHI,@,WAS,L 107-112,240,44,88,.500,37,61,.607,7,27,.259,12,18,.667,107
5344,2017-03-17,WAS,,CHI,W 112-107,240,46,101,.455,36,75,.480,10,26,.385,10,12,.833,112
5345,2017-03-16,ATL,,MEM,L 91-103,240,29,71,.408,21,44,.477,8,27,.296,25,34,.735,91
5346,2017-03-16,MEM,@,ATL,W 103-91,240,39,92,.424,29,64,.453,10,28,.357,15,18,.833,103
5347,2017-03-16,CLE,,UTA,W 91-83,240,36,86,.419,27,53,.509,9,33,.273,10,19,.526,91
5348,2017-03-16,UTA,@,CLE,L 83-91,240,34,82,.415,29,61,.475,5,21,.238,10,14,.714,83
5349,2017-03-16,DEN,,LAC,W 129-114,240,46,86,.535,31,58,.534,15,28,.536,22,26,.846,129
5350,2017-03-16,LAC,@,DEN,L 114-129,240,44,84,.524,28,52,.538,16,32,.500,10,15,.667,114
5351,2017-03-16,GSW,,ORL,W 122-92,240,50,87,.575,40,61,.656,10,26,.385,12,23,.522,122
5352,2017-03-16,ORL,@,GSW,L 92-122,240,35,94,.372,28,67,.418,7,27,.259,15,21,.714,92
5353,2017-03-16,BRK,@,NYK,W 121-110,240,41,86,.477,31,54,.574,10,32,.313,29,35,.829,121
5354,2017-03-16,NYK,,BRK,L 110-121,240,41,88,.466,38,70,.543,3,18,.167,25,26,.962,110
5355,2017-03-16,OKC,@,TOR,W 123-102,240,47,88,.534,33,63,.524,14,25,.560,15,19,.789,123
5356,2017-03-16,TOR,,OKC,L 102-123,240,37,81,.457,32,61,.525,5,20,.250,23,30,.767,102
5357,2017-03-15,BOS,,MIN,W 117-104,240,43,79,.544,30,46,.652,13,33,.394,18,21,.857,117
5358,2017-03-15,MIN,@,BOS,L 104-117,240,40,91,.440,32,64,.500,8,27,.296,16,20,.800,104
5359,2017-03-15,CHI,,MEM,L 91-98,240,34,91,.374,23,63,.365,11,28,.393,12,15,.800,91
5360,2017-03-15,MEM,@,CHI,W 98-91,240,36,85,.424,25,54,.463,11,31,.355,15,18,.833,98
5361,2017-03-15,DET,,UTA,L 83-97,240,36,86,.419,33,73,.452,3,13,.231,8,12,.667,83
5362,2017-03-15,UTA,@,DET,W 97-83,240,36,77,.468,23,49,.469,13,28,.464,12,16,.750,97
5363,2017-03-15,HOU,,LAL,W 139-100,240,50,91,.549,32,48,.667,18,43,.419,21,32,.656,139
5364,2017-03-15,LAL,@,HOU,L 100-139,240,42,91,.462,39,66,.591,3,25,.120,13,18,.722,100
5365,2017-03-15,CHA,@,IND,L 77-98,240,32,80,.400,29,57,.509,3,23,.130,10,13,.769,77
5366,2017-03-15,IND,,CHO,W 98-77,240,39,73,.534,27,45,.600,12,28,.429,8,9,.889,98
5367,2017-03-15,LAC,,MIL,L 96-97,240,35,75,.467,30,51,.588,5,24,.208,21,29,.724,96
5368,2017-03-15,MIL,@,LAC,W 97-96,240,34,76,.447,24,47,.511,10,29,.345,19,25,.760,97
5369,2017-03-15,MIA,,NOP,W 120-112,240,44,87,.506,28,52,.538,16,35,.457,16,19,.842,120
5370,2017-03-15,NOP,@,MIA,L 112-120,240,42,88,.477,33,66,.500,9,22,.409,19,28,.679,112
5371,2017-03-15,PHO,,SAC,L 101-107,240,43,107,.402,37,82,.451,6,25,.240,9,14,.643,101
5372,2017-03-15,SAC,@,PHO,W 107-101,240,38,79,.481,32,65,.492,6,14,.429,25,34,.735,107
5373,2017-03-15,POR,@,SAS,W 110-106,240,38,80,.475,29,58,.500,9,22,.409,25,28,.893,110
5374,2017-03-15,SAS,,POR,L 106-110,240,42,88,.477,31,62,.500,11,26,.423,11,15,.733,106
5375,2017-03-15,DAL,@,WAS,W 112-107,240,40,79,.506,26,47,.553,14,32,.438,18,25,.720,112
5376,2017-03-15,WAS,,DAL,L 107-112,240,40,82,.488,28,52,.538,12,30,.400,15,21,.714,107
5377,2017-03-14,BRK,,OKC,L 104-122,240,33,71,.465,21,47,.447,12,24,.500,26,30,.867,104
5378,2017-03-14,OKC,@,BRK,W 122-104,240,44,89,.494,34,67,.507,10,22,.455,24,34,.706,122
5379,2017-03-14,CLE,,DET,W 128-96,240,46,77,.597,27,47,.574,19,30,.633,17,23,.739,128
5380,2017-03-14,DET,@,CLE,L 96-128,240,37,99,.374,33,80,.413,4,19,.211,18,19,.947,96
5381,2017-03-14,GSW,,PHI,W 106-104,240,32,88,.364,18,56,.321,14,32,.438,28,35,.800,106
5382,2017-03-14,PHI,@,GSW,L 104-106,240,39,89,.438,31,62,.500,8,27,.296,18,27,.667,104
5383,2017-03-14,NOP,,POR,W 100-77,240,38,80,.475,32,59,.542,6,21,.286,18,30,.600,100
5384,2017-03-14,POR,@,NOP,L 77-100,240,23,76,.303,12,44,.273,11,32,.344,20,26,.769,77
5385,2017-03-14,IND,@,NYK,L 81-87,240,32,87,.368,24,58,.414,8,29,.276,9,15,.600,81
5386,2017-03-14,NYK,,IND,W 87-81,240,35,83,.422,26,55,.473,9,28,.321,8,13,.615,87
5387,2017-03-13,CHI,@,CHO,W 115-109,240,41,92,.446,27,52,.519,14,40,.350,19,22,.864,115
5388,2017-03-13,CHA,,CHI,L 109-115,240,43,93,.462,36,64,.563,7,29,.241,16,19,.842,109
5389,2017-03-13,DEN,,LAL,W 129-101,240,45,84,.536,28,46,.609,17,38,.447,22,25,.880,129
5390,2017-03-13,LAL,@,DEN,L 101-129,240,42,97,.433,36,77,.468,6,20,.300,11,19,.579,101
5391,2017-03-13,MEM,,MIL,W 113-93,240,41,79,.519,27,52,.519,14,27,.519,17,23,.739,113
5392,2017-03-13,MIL,@,MEM,L 93-113,240,31,67,.463,17,41,.415,14,26,.538,17,20,.850,93
5393,2017-03-13,MIN,,WAS,W 119-104,240,45,86,.523,35,65,.538,10,21,.476,19,22,.864,119
5394,2017-03-13,WAS,@,MIN,L 104-119,240,36,84,.429,29,58,.500,7,26,.269,25,31,.806,104
5395,2017-03-13,ORL,@,SAC,L 115-120,240,45,98,.459,32,64,.500,13,34,.382,12,12,1.000,115
5396,2017-03-13,SAC,,ORL,W 120-115,240,44,82,.537,28,52,.538,16,30,.533,16,21,.762,120
5397,2017-03-13,ATL,@,SAS,L 99-107,240,37,81,.457,31,59,.525,6,22,.273,19,30,.633,99
5398,2017-03-13,SAS,,ATL,W 107-99,240,39,81,.481,23,47,.489,16,34,.471,13,17,.765,107
5399,2017-03-13,DAL,@,TOR,L 78-100,240,31,85,.365,24,60,.400,7,25,.280,9,13,.692,78
5400,2017-03-13,TOR,,DAL,W 100-78,240,37,78,.474,28,53,.528,9,25,.360,17,18,.944,100
5401,2017-03-13,LAC,@,UTA,L 108-114,240,39,78,.500,27,48,.563,12,30,.400,18,23,.783,108
5402,2017-03-13,UTA,,LAC,W 114-108,240,41,78,.526,27,57,.474,14,21,.667,18,22,.818,114
5403,2017-03-12,BOS,,CHI,W 100-80,240,40,86,.465,24,49,.490,16,37,.432,4,4,1.000,100
5404,2017-03-12,CHI,@,BOS,L 80-100,240,33,87,.379,26,62,.419,7,25,.280,7,9,.778,80
5405,2017-03-12,BRK,,NYK,W 120-112,240,40,87,.460,21,49,.429,19,38,.500,21,29,.724,120
5406,2017-03-12,NYK,@,BRK,L 112-120,240,39,94,.415,31,71,.437,8,23,.348,26,32,.813,112
5407,2017-03-12,CLE,@,HOU,L 112-117,240,42,80,.525,25,37,.676,17,43,.395,11,13,.846,112
5408,2017-03-12,HOU,,CLE,W 117-112,240,41,96,.427,25,51,.490,16,45,.356,19,28,.679,117
5409,2017-03-12,IND,,MIA,W 102-98,240,35,82,.427,30,67,.448,5,15,.333,27,32,.844,102
5410,2017-03-12,MIA,@,IND,L 98-102,240,39,94,.415,30,62,.484,9,32,.281,11,16,.688,98
5411,2017-03-12,LAL,,PHI,L 116-118,240,44,88,.500,40,68,.588,4,20,.200,24,28,.857,116
5412,2017-03-12,PHI,@,LAL,W 118-116,240,41,79,.519,31,55,.564,10,24,.417,26,32,.813,118
5413,2017-03-12,PHO,,POR,L 101-110,240,41,93,.441,36,79,.456,5,14,.357,14,20,.700,101
5414,2017-03-12,POR,@,PHO,W 110-101,240,43,86,.500,36,64,.563,7,22,.318,17,25,.680,110
5415,2017-03-11,CHA,,NOP,L 122-125 (OT),265,46,102,.451,33,56,.589,13,46,.283,17,20,.850,122
5416,2017-03-11,NOP,@,CHO,W 125-122 (OT),265,50,99,.505,36,65,.554,14,34,.412,11,16,.688,125
5417,2017-03-11,DAL,,PHO,L 98-100,240,28,74,.378,19,48,.396,9,26,.346,33,36,.917,98
5418,2017-03-11,PHO,@,DAL,W 100-98,240,38,83,.458,32,62,.516,6,21,.286,18,20,.900,100
5419,2017-03-11,DET,,NYK,W 112-92,240,46,96,.479,37,69,.536,9,27,.333,11,19,.579,112
5420,2017-03-11,NYK,@,DET,L 92-112,240,36,82,.439,23,52,.442,13,30,.433,7,11,.636,92
5421,2017-03-11,LAC,,PHI,W 112-100,240,40,81,.494,32,56,.571,8,25,.320,24,29,.828,112
5422,2017-03-11,PHI,@,LAC,L 100-112,240,40,84,.476,30,54,.556,10,30,.333,10,14,.714,100
5423,2017-03-11,ATL,@,MEM,W 107-90,240,36,72,.500,21,42,.500,15,30,.500,20,26,.769,107
5424,2017-03-11,MEM,,ATL,L 90-107,240,34,90,.378,29,61,.475,5,29,.172,17,23,.739,90
5425,2017-03-11,MIA,,TOR,W 104-89,240,35,72,.486,24,44,.545,11,28,.393,23,33,.697,104
5426,2017-03-11,TOR,@,MIA,L 89-104,240,33,88,.375,31,73,.425,2,15,.133,21,25,.840,89
5427,2017-03-11,MIL,,MIN,W 102-95,240,37,80,.463,29,60,.483,8,20,.400,20,23,.870,102
5428,2017-03-11,MIN,@,MIL,L 95-102,240,37,81,.457,32,68,.471,5,13,.385,16,21,.762,95
5429,2017-03-11,OKC,,UTA,W 112-104,240,43,86,.500,35,63,.556,8,23,.348,18,24,.750,112
5430,2017-03-11,UTA,@,OKC,L 104-112,240,36,75,.480,27,55,.491,9,20,.450,23,28,.821,104
5431,2017-03-11,CLE,@,ORL,W 116-104,240,43,86,.500,28,47,.596,15,39,.385,15,25,.600,116
5432,2017-03-11,ORL,,CLE,L 104-116,240,38,96,.396,34,75,.453,4,21,.190,24,28,.857,104
5433,2017-03-11,POR,,WAS,L 124-125 (OT),265,48,94,.511,32,62,.516,16,32,.500,12,16,.750,124
5434,2017-03-11,WAS,@,POR,W 125-124 (OT),265,47,90,.522,35,65,.538,12,25,.480,19,28,.679,125
5435,2017-03-11,DEN,@,SAC,W 105-92,240,40,85,.471,31,51,.608,9,34,.265,16,18,.889,105
5436,2017-03-11,SAC,,DEN,L 92-105,240,36,82,.439,28,59,.475,8,23,.348,12,20,.600,92
5437,2017-03-11,GSW,@,SAS,L 85-107,240,33,92,.359,28,75,.373,5,17,.294,14,23,.609,85
5438,2017-03-11,SAS,,GSW,W 107-85,240,40,77,.519,28,50,.560,12,27,.444,15,18,.833,107
5439,2017-03-10,ATL,,TOR,W 105-99,240,39,75,.520,31,53,.585,8,22,.364,19,29,.655,105
5440,2017-03-10,TOR,@,ATL,L 99-105,240,37,92,.402,33,67,.493,4,25,.160,21,27,.778,99
5441,2017-03-10,CHI,,HOU,L 94-115,240,38,98,.388,29,59,.492,9,39,.231,9,12,.750,94
5442,2017-03-10,HOU,@,CHI,W 115-94,240,37,89,.416,22,42,.524,15,47,.319,26,32,.813,115
5443,2017-03-10,CHA,,ORL,W 121-81,240,47,79,.595,37,58,.638,10,21,.476,17,20,.850,121
5444,2017-03-10,ORL,@,CHO,L 81-121,240,31,76,.408,26,49,.531,5,27,.185,14,22,.636,81
5445,2017-03-10,BRK,@,DAL,L 96-105,240,34,78,.436,25,47,.532,9,31,.290,19,23,.826,96
5446,2017-03-10,DAL,,BRK,W 105-96,240,33,78,.423,19,45,.422,14,33,.424,25,28,.893,105
5447,2017-03-10,BOS,@,DEN,L 99-119,240,34,81,.420,22,48,.458,12,33,.364,19,23,.826,99
5448,2017-03-10,DEN,,BOS,W 119-99,240,45,85,.529,33,54,.611,12,31,.387,17,22,.773,119
5449,2017-03-10,IND,@,MIL,L 85-99,240,33,75,.440,31,57,.544,2,18,.111,17,22,.773,85
5450,2017-03-10,MIL,,IND,W 99-85,240,33,64,.516,26,47,.553,7,17,.412,26,30,.867,99
5451,2017-03-10,GSW,@,MIN,L 102-103,240,41,88,.466,34,64,.531,7,24,.292,13,17,.765,102
5452,2017-03-10,MIN,,GSW,W 103-102,240,39,88,.443,35,74,.473,4,14,.286,21,27,.778,103
5453,2017-03-10,SAC,,WAS,L 122-130 (OT),265,44,92,.478,32,69,.464,12,23,.522,22,28,.786,122
5454,2017-03-10,WAS,@,SAC,W 130-122 (OT),265,52,104,.500,43,78,.551,9,26,.346,17,19,.895,130
5455,2017-03-09,CLE,@,DET,L 101-106,240,39,84,.464,28,45,.622,11,39,.282,12,19,.632,101
5456,2017-03-09,DET,,CLE,W 106-101,240,41,88,.466,32,62,.516,9,26,.346,15,19,.789,106
5457,2017-03-09,LAC,@,MEM,W 114-98,240,40,78,.513,29,48,.604,11,30,.367,23,28,.821,114
5458,2017-03-09,MEM,,LAC,L 98-114,240,37,83,.446,30,63,.476,7,20,.350,17,22,.773,98
5459,2017-03-09,OKC,,SAS,W 102-92,240,41,89,.461,35,69,.507,6,20,.300,14,21,.667,102
5460,2017-03-09,SAS,@,OKC,L 92-102,240,35,84,.417,29,65,.446,6,19,.316,16,20,.800,92
5461,2017-03-09,LAL,@,PHO,W 122-110,240,47,98,.480,35,71,.493,12,27,.444,16,24,.667,122
5462,2017-03-09,PHO,,LAL,L 110-122,240,42,91,.462,36,72,.500,6,19,.316,20,25,.800,110
5463,2017-03-09,PHI,@,POR,L 108-114 (OT),265,41,94,.436,30,65,.462,11,29,.379,15,20,.750,108
5464,2017-03-09,POR,,PHI,W 114-108 (OT),265,40,88,.455,34,67,.507,6,21,.286,28,33,.848,114
5465,2017-03-08,ATL,,BRK,W 110-105,240,41,95,.432,37,75,.493,4,20,.200,24,32,.750,110
5466,2017-03-08,BRK,@,ATL,L 105-110,240,37,80,.463,26,47,.553,11,33,.333,20,25,.800,105
5467,2017-03-08,DEN,,WAS,L 113-123,240,46,87,.529,33,59,.559,13,28,.464,8,17,.471,113
5468,2017-03-08,WAS,@,DEN,W 123-113,240,50,88,.568,39,62,.629,11,26,.423,12,19,.632,123
5469,2017-03-08,BOS,@,GSW,W 99-86,240,37,84,.440,27,55,.491,10,29,.345,15,19,.789,99
5470,2017-03-08,GSW,,BOS,L 86-99,240,37,84,.440,31,54,.574,6,30,.200,6,9,.667,86
5471,2017-03-08,HOU,,UTA,L 108-115,240,35,79,.443,27,47,.574,8,32,.250,30,40,.750,108
5472,2017-03-08,UTA,@,HOU,W 115-108,240,41,76,.539,29,45,.644,12,31,.387,21,24,.875,115
5473,2017-03-08,DET,@,IND,L 98-115,240,39,89,.438,32,63,.508,7,26,.269,13,22,.591,98
5474,2017-03-08,IND,,DET,W 115-98,240,44,88,.500,33,65,.508,11,23,.478,16,19,.842,115
5475,2017-03-08,CHA,@,MIA,L 101-108,240,37,80,.463,30,59,.508,7,21,.333,20,21,.952,101
5476,2017-03-08,MIA,,CHO,W 108-101,240,37,85,.435,20,44,.455,17,41,.415,17,24,.708,108
5477,2017-03-08,MIL,,NYK,W 104-93,240,37,86,.430,29,60,.483,8,26,.308,22,28,.786,104
5478,2017-03-08,NYK,@,MIL,L 93-104,240,39,84,.464,32,63,.508,7,21,.333,8,12,.667,93
5479,2017-03-08,LAC,@,MIN,L 91-107,240,35,83,.422,26,59,.441,9,24,.375,12,18,.667,91
5480,2017-03-08,MIN,,LAC,W 107-91,240,42,86,.488,37,66,.561,5,20,.250,18,20,.900,107
5481,2017-03-08,NOP,,TOR,L 87-94,240,34,80,.425,25,51,.490,9,29,.310,10,13,.769,87
5482,2017-03-08,TOR,@,NOP,W 94-87,240,36,76,.474,28,55,.509,8,21,.381,14,23,.609,94
5483,2017-03-08,CHI,@,ORL,L 91-98,240,36,81,.444,24,53,.453,12,28,.429,7,11,.636,91
5484,2017-03-08,ORL,,CHI,W 98-91,240,37,89,.416,30,64,.469,7,25,.280,17,21,.810,98
5485,2017-03-08,SAC,@,SAS,L 104-114,240,42,86,.488,35,67,.522,7,19,.368,13,16,.813,104
5486,2017-03-08,SAS,,SAC,W 114-104,240,42,84,.500,28,55,.509,14,29,.483,16,21,.762,114
5487,2017-03-07,DAL,,LAL,W 122-111,240,45,83,.542,28,52,.538,17,31,.548,15,19,.789,122
5488,2017-03-07,LAL,@,DAL,L 111-122,240,42,90,.467,31,60,.517,11,30,.367,16,22,.727,111
5489,2017-03-07,OKC,,POR,L 121-126,240,44,85,.518,34,60,.567,10,25,.400,23,30,.767,121
5490,2017-03-07,POR,@,OKC,W 126-121,240,47,85,.553,36,62,.581,11,23,.478,21,27,.778,126
5491,2017-03-07,PHO,,WAS,L 127-131,240,44,88,.500,31,61,.508,13,27,.481,26,33,.788,127
5492,2017-03-07,WAS,@,PHO,W 131-127,240,41,90,.456,34,72,.472,7,18,.389,42,53,.792,131
5493,2017-03-06,ATL,,GSW,L 111-119,240,38,82,.463,25,54,.463,13,28,.464,22,31,.710,111
5494,2017-03-06,GSW,@,ATL,W 119-111,240,41,87,.471,21,43,.488,20,44,.455,17,22,.773,119
5495,2017-03-06,CHA,,IND,W 100-88,240,35,86,.407,24,55,.436,11,31,.355,19,21,.905,100
5496,2017-03-06,IND,@,CHO,L 88-100,240,37,81,.457,25,51,.490,12,30,.400,2,3,.667,88
5497,2017-03-06,CLE,,MIA,L 98-106,240,35,78,.449,26,51,.510,9,27,.333,19,29,.655,98
5498,2017-03-06,MIA,@,CLE,W 106-98,240,39,91,.429,23,56,.411,16,35,.457,12,14,.857,106
5499,2017-03-06,DEN,,SAC,W 108-96,240,37,74,.500,24,44,.545,13,30,.433,21,28,.750,108
5500,2017-03-06,SAC,@,DEN,L 96-108,240,36,83,.434,30,67,.448,6,16,.375,18,21,.857,96
5501,2017-03-06,CHI,@,DET,L 95-109,240,34,83,.410,26,55,.473,8,28,.286,19,21,.905,95
5502,2017-03-06,DET,,CHI,W 109-95,240,45,92,.489,39,71,.549,6,21,.286,13,20,.650,109
5503,2017-03-06,BOS,@,LAC,L 102-116,240,34,83,.410,24,48,.500,10,35,.286,24,29,.828,102
5504,2017-03-06,LAC,,BOS,W 116-102,240,39,73,.534,30,53,.566,9,20,.450,29,47,.617,116
5505,2017-03-06,BRK,@,MEM,W 122-109,240,39,73,.534,25,43,.581,14,30,.467,30,38,.789,122
5506,2017-03-06,MEM,,BRK,L 109-122,240,34,77,.442,24,52,.462,10,25,.400,31,39,.795,109
5507,2017-03-06,NYK,@,ORL,W 113-105,240,40,86,.465,34,72,.472,6,14,.429,27,28,.964,113
5508,2017-03-06,ORL,,NYK,L 105-113,240,40,85,.471,31,53,.585,9,32,.281,16,24,.667,105
5509,2017-03-06,MIL,@,PHI,W 112-98,240,41,83,.494,27,50,.540,14,33,.424,16,20,.800,112
5510,2017-03-06,PHI,,MIL,L 98-112,240,39,89,.438,31,59,.525,8,30,.267,12,19,.632,98
5511,2017-03-06,HOU,@,SAS,L 110-112,240,41,88,.466,27,49,.551,14,39,.359,14,17,.824,110
5512,2017-03-06,SAS,,HOU,W 112-110,240,40,88,.455,29,60,.483,11,28,.393,21,23,.913,112
5513,2017-03-06,NOP,@,UTA,L 83-88,240,30,84,.357,20,51,.392,10,33,.303,13,18,.722,83
5514,2017-03-06,UTA,,NOP,W 88-83,240,33,81,.407,23,54,.426,10,27,.370,12,15,.800,88
5515,2017-03-05,ATL,,IND,L 96-97,240,34,77,.442,25,50,.500,9,27,.333,19,31,.613,96
5516,2017-03-05,IND,@,ATL,W 97-96,240,35,78,.449,20,45,.444,15,33,.455,12,21,.571,97
5517,2017-03-05,DAL,,OKC,W 104-89,240,42,86,.488,35,61,.574,7,25,.280,13,16,.813,104
5518,2017-03-05,OKC,@,DAL,L 89-104,240,33,82,.402,31,60,.517,2,22,.091,21,30,.700,89
5519,2017-03-05,LAL,,NOP,L 97-105,240,38,83,.458,28,55,.509,10,28,.357,11,15,.733,97
5520,2017-03-05,NOP,@,LAL,W 105-97,240,36,89,.404,27,65,.415,9,24,.375,24,35,.686,105
5521,2017-03-05,GSW,@,NYK,W 112-105,240,40,88,.455,27,53,.509,13,35,.371,19,23,.826,112
5522,2017-03-05,NYK,,GSW,L 105-112,240,39,83,.470,32,61,.525,7,22,.318,20,25,.800,105
5523,2017-03-05,BOS,@,PHO,L 106-109,240,32,85,.376,19,48,.396,13,37,.351,29,40,.725,106
5524,2017-03-05,PHO,,BOS,W 109-106,240,42,94,.447,38,74,.514,4,20,.200,21,26,.808,109
5525,2017-03-05,SAC,,UTA,L 109-110 (OT),265,43,83,.518,35,66,.530,8,17,.471,15,20,.750,109
5526,2017-03-05,UTA,@,SAC,W 110-109 (OT),265,41,90,.456,31,57,.544,10,33,.303,18,27,.667,110
5527,2017-03-05,ORL,@,WAS,L 114-115,240,44,89,.494,30,54,.556,14,35,.400,12,19,.632,114
5528,2017-03-05,WAS,,ORL,W 115-114,240,39,81,.481,25,55,.455,14,26,.538,23,25,.920,115
5529,2017-03-04,CHI,,LAC,L 91-101,240,35,83,.422,29,66,.439,6,17,.353,15,20,.750,91
5530,2017-03-04,LAC,@,CHI,W 101-91,240,41,85,.482,35,60,.583,6,25,.240,13,16,.813,101
5531,2017-03-04,CHA,@,DEN,W 112-102,240,41,90,.456,25,63,.397,16,27,.593,14,17,.824,112
5532,2017-03-04,DEN,,CHO,L 102-112,240,36,80,.450,27,50,.540,9,30,.300,21,25,.840,102
5533,2017-03-04,HOU,,MEM,W 123-108,240,39,78,.500,21,36,.583,18,42,.429,27,36,.750,123
5534,2017-03-04,MEM,@,HOU,L 108-123,240,43,97,.443,35,69,.507,8,28,.286,14,21,.667,108
5535,2017-03-04,CLE,@,MIA,L 92-120,240,35,73,.479,24,46,.522,11,27,.407,11,18,.611,92
5536,2017-03-04,MIA,,CLE,W 120-92,240,46,88,.523,28,54,.519,18,34,.529,10,12,.833,120
5537,2017-03-04,MIL,,TOR,W 101-94,240,38,87,.437,32,60,.533,6,27,.222,19,23,.826,101
5538,2017-03-04,TOR,@,MIL,L 94-101,240,35,75,.467,28,54,.519,7,21,.333,17,20,.850,94
5539,2017-03-04,DET,@,PHI,W 136-106,240,54,95,.568,44,72,.611,10,23,.435,18,21,.857,136
5540,2017-03-04,PHI,,DET,L 106-136,240,43,88,.489,29,54,.537,14,34,.412,6,7,.857,106
5541,2017-03-04,BRK,@,POR,L 116-130,240,45,86,.523,31,56,.554,14,30,.467,12,17,.706,116
5542,2017-03-04,POR,,BRK,W 130-116,240,49,86,.570,33,61,.541,16,25,.640,16,22,.727,130
5543,2017-03-04,MIN,@,SAS,L 90-97 (OT),265,35,89,.393,31,73,.425,4,16,.250,16,22,.727,90
5544,2017-03-04,SAS,,MIN,W 97-90 (OT),265,38,94,.404,32,70,.457,6,24,.250,15,24,.625,97
5545,2017-03-03,ATL,,CLE,L 130-135,240,49,91,.538,39,65,.600,10,26,.385,22,30,.733,130
5546,2017-03-03,CLE,@,ATL,W 135-130,240,47,86,.547,22,40,.550,25,46,.543,16,20,.800,135
5547,2017-03-03,DAL,,MEM,W 104-100,240,39,82,.476,34,55,.618,5,27,.185,21,27,.778,104
5548,2017-03-03,MEM,@,DAL,L 100-104,240,38,82,.463,29,54,.537,9,28,.321,15,22,.682,100
5549,2017-03-03,BOS,@,LAL,W 115-95,240,43,84,.512,33,51,.647,10,33,.303,19,25,.760,115
5550,2017-03-03,LAL,,BOS,L 95-115,240,37,87,.425,31,63,.492,6,24,.250,15,20,.750,95
5551,2017-03-03,LAC,@,MIL,L 101-112,240,36,64,.563,28,45,.622,8,19,.421,21,36,.583,101
5552,2017-03-03,MIL,,LAC,W 112-101,240,44,80,.550,34,55,.618,10,25,.400,14,15,.933,112
5553,2017-03-03,NOP,,SAS,L 98-101 (OT),265,35,91,.385,27,66,.409,8,25,.320,20,24,.833,98
5554,2017-03-03,SAS,@,NOP,W 101-98 (OT),265,40,95,.421,34,68,.500,6,27,.222,15,25,.600,101
5555,2017-03-03,MIA,@,ORL,L 99-110,240,35,91,.385,27,63,.429,8,28,.286,21,25,.840,99
5556,2017-03-03,ORL,,MIA,W 110-99,240,45,90,.500,40,73,.548,5,17,.294,15,19,.789,110
5557,2017-03-03,NYK,@,PHI,L 102-105,240,33,84,.393,26,63,.413,7,21,.333,29,33,.879,102
5558,2017-03-03,PHI,,NYK,W 105-102,240,36,83,.434,27,55,.491,9,28,.321,24,31,.774,105
5559,2017-03-03,OKC,@,PHO,L 111-118,240,37,87,.425,28,52,.538,9,35,.257,28,35,.800,111
5560,2017-03-03,PHO,,OKC,W 118-111,240,44,89,.494,39,68,.574,5,21,.238,25,31,.806,118
5561,2017-03-03,BRK,@,UTA,L 97-112,240,36,89,.404,29,59,.492,7,30,.233,18,24,.750,97
5562,2017-03-03,UTA,,BRK,W 112-97,240,38,74,.514,26,48,.542,12,26,.462,24,34,.706,112
5563,2017-03-03,TOR,@,WAS,W 114-106,240,41,81,.506,30,56,.536,11,25,.440,21,27,.778,114
5564,2017-03-03,WAS,,TOR,L 106-114,240,34,92,.370,24,62,.387,10,30,.333,28,32,.875,106
5565,2017-03-02,CHI,,GSW,W 94-87,240,36,82,.439,31,63,.492,5,19,.263,17,21,.810,94
5566,2017-03-02,GSW,@,CHI,L 87-94,240,34,88,.386,28,58,.483,6,30,.200,13,14,.929,87
5567,2017-03-02,CHA,@,PHO,L 103-120,240,35,89,.393,25,55,.455,10,34,.294,23,28,.821,103
5568,2017-03-02,PHO,,CHO,W 120-103,240,46,77,.597,39,58,.672,7,19,.368,21,25,.840,120
5569,2017-03-02,OKC,@,POR,L 109-114,240,34,86,.395,23,57,.404,11,29,.379,30,32,.938,109
5570,2017-03-02,POR,,OKC,W 114-109,240,39,79,.494,29,54,.537,10,25,.400,26,35,.743,114
5571,2017-03-01,ATL,,DAL,W 100-95,240,36,64,.563,26,43,.605,10,21,.476,18,24,.750,100
5572,2017-03-01,DAL,@,ATL,L 95-100,240,35,77,.455,21,44,.477,14,33,.424,11,13,.846,95
5573,2017-03-01,BOS,,CLE,W 103-99,240,36,78,.462,23,47,.489,13,31,.419,18,23,.783,103
5574,2017-03-01,CLE,@,BOS,L 99-103,240,37,91,.407,27,58,.466,10,33,.303,15,22,.682,99
5575,2017-03-01,HOU,@,LAC,W 122-103,240,37,87,.425,17,35,.486,20,52,.385,28,33,.848,122
5576,2017-03-01,LAC,,HOU,L 103-122,240,42,94,.447,30,60,.500,12,34,.353,7,13,.538,103
5577,2017-03-01,MIA,,PHI,W 125-98,240,49,90,.544,36,60,.600,13,30,.433,14,21,.667,125
5578,2017-03-01,PHI,@,MIA,L 98-125,240,37,85,.435,31,68,.456,6,17,.353,18,22,.818,98
5579,2017-03-01,DEN,@,MIL,W 110-98,240,41,84,.488,31,51,.608,10,33,.303,18,20,.900,110
5580,2017-03-01,MIL,,DEN,L 98-110,240,38,83,.458,29,65,.446,9,18,.500,13,15,.867,98
5581,2017-03-01,DET,@,NOP,L 86-109,240,40,103,.388,37,80,.463,3,23,.130,3,17,.176,86
5582,2017-03-01,NOP,,DET,W 109-86,240,39,78,.500,30,53,.566,9,25,.360,22,23,.957,109
5583,2017-03-01,NYK,@,ORL,W 101-90,240,34,81,.420,26,52,.500,8,29,.276,25,31,.806,101
5584,2017-03-01,ORL,,NYK,L 90-101,240,34,83,.410,29,58,.500,5,25,.200,17,22,.773,90
5585,2017-03-01,BRK,@,SAC,W 109-100,240,34,74,.459,23,46,.500,11,28,.393,30,36,.833,109
5586,2017-03-01,SAC,,BRK,L 100-109,240,35,81,.432,24,59,.407,11,22,.500,19,22,.864,100
5587,2017-03-01,IND,@,SAS,L 99-100,240,37,81,.457,30,58,.517,7,23,.304,18,25,.720,99
5588,2017-03-01,SAS,,IND,W 100-99,240,35,74,.473,26,45,.578,9,29,.310,21,24,.875,100
5589,2017-03-01,TOR,,WAS,L 96-105,240,33,90,.367,26,70,.371,7,20,.350,23,26,.885,96
5590,2017-03-01,WAS,@,TOR,W 105-96,240,40,84,.476,31,59,.525,9,25,.360,16,19,.842,105
5591,2017-03-01,MIN,@,UTA,W 107-80,240,39,78,.500,31,62,.500,8,16,.500,21,26,.808,107
5592,2017-03-01,UTA,,MIN,L 80-107,240,35,90,.389,31,71,.437,4,19,.211,6,11,.545,80
5593,2017-02-28,CHI,,DEN,L 107-125,240,44,96,.458,34,70,.486,10,26,.385,9,10,.900,107
5594,2017-02-28,DEN,@,CHI,W 125-107,240,45,80,.563,32,50,.640,13,30,.433,22,24,.917,125
5595,2017-02-28,DET,,POR,W 120-113 (OT),265,45,104,.433,38,79,.481,7,25,.280,23,31,.742,120
5596,2017-02-28,POR,@,DET,L 113-120 (OT),265,44,84,.524,34,59,.576,10,25,.400,15,22,.682,113
5597,2017-02-28,CHA,@,LAL,W 109-104,240,38,85,.447,22,46,.478,16,39,.410,17,24,.708,109
5598,2017-02-28,LAL,,CHO,L 104-109,240,41,84,.488,29,52,.558,12,32,.375,10,13,.769,104
5599,2017-02-28,MEM,,PHO,W 130-112,240,48,86,.558,36,61,.590,12,25,.480,22,29,.759,130
5600,2017-02-28,PHO,@,MEM,L 112-130,240,43,83,.518,36,62,.581,7,21,.333,19,24,.792,112
5601,2017-02-28,OKC,,UTA,W 109-106,240,39,76,.513,24,54,.444,15,22,.682,16,23,.696,109
5602,2017-02-28,UTA,@,OKC,L 106-109,240,43,93,.462,34,71,.479,9,22,.409,11,13,.846,106
5603,2017-02-28,GSW,@,WAS,L 108-112,240,39,84,.464,31,55,.564,8,29,.276,22,27,.815,108
5604,2017-02-28,WAS,,GSW,W 112-108,240,41,91,.451,29,63,.460,12,28,.429,18,20,.900,112
5605,2017-02-27,ATL,@,BOS,W 114-98,240,46,95,.484,40,70,.571,6,25,.240,16,20,.800,114
5606,2017-02-27,BOS,,ATL,L 98-114,240,34,87,.391,24,53,.453,10,34,.294,20,25,.800,98
5607,2017-02-27,CLE,,MIL,W 102-95,240,35,70,.500,25,42,.595,10,28,.357,22,26,.846,102
5608,2017-02-27,MIL,@,CLE,L 95-102,240,37,83,.446,26,53,.491,11,30,.367,10,16,.625,95
5609,2017-02-27,DAL,,MIA,W 96-89,240,33,76,.434,24,58,.414,9,18,.500,21,23,.913,96
5610,2017-02-27,MIA,@,DAL,L 89-96,240,37,83,.446,28,57,.491,9,26,.346,6,13,.462,89
5611,2017-02-27,HOU,,IND,L 108-117,240,32,88,.364,22,43,.512,10,45,.222,34,42,.810,108
5612,2017-02-27,IND,@,HOU,W 117-108,240,41,91,.451,28,61,.459,13,30,.433,22,25,.880,117
5613,2017-02-27,NYK,,TOR,L 91-92,240,33,73,.452,24,49,.490,9,24,.375,16,19,.842,91
5614,2017-02-27,TOR,@,NYK,W 92-91,240,33,78,.423,26,52,.500,7,26,.269,19,23,.826,92
5615,2017-02-27,GSW,@,PHI,W 119-108,240,40,89,.449,34,60,.567,6,29,.207,33,39,.846,119
5616,2017-02-27,PHI,,GSW,L 108-119,240,37,82,.451,27,48,.563,10,34,.294,24,27,.889,108
5617,2017-02-27,MIN,@,SAC,W 102-88,240,40,95,.421,32,72,.444,8,23,.348,14,20,.700,102
5618,2017-02-27,SAC,,MIN,L 88-102,240,36,82,.439,30,65,.462,6,17,.353,10,15,.667,88
5619,2017-02-26,DEN,,MEM,L 98-105,240,37,84,.440,26,50,.520,11,34,.324,13,17,.765,98
5620,2017-02-26,MEM,@,DEN,W 105-98,240,36,80,.450,25,47,.532,11,33,.333,22,25,.880,105
5621,2017-02-26,BOS,@,DET,W 104-98,240,34,85,.400,22,50,.440,12,35,.343,24,30,.800,104
5622,2017-02-26,DET,,BOS,L 98-104,240,35,81,.432,23,48,.479,12,33,.364,16,35,.457,98
5623,2017-02-26,CHA,@,LAC,L 121-124 (OT),265,38,80,.475,20,40,.500,18,40,.450,27,30,.900,121
5624,2017-02-26,LAC,,CHO,W 124-121 (OT),265,45,97,.464,35,65,.538,10,32,.313,24,34,.706,124
5625,2017-02-26,LAL,,SAS,L 98-119,240,40,87,.460,33,65,.508,7,22,.318,11,18,.611,98
5626,2017-02-26,SAS,@,LAL,W 119-98,240,49,94,.521,39,73,.534,10,21,.476,11,13,.846,119
5627,2017-02-26,MIL,,PHO,W 100-96,240,39,76,.513,33,56,.589,6,20,.300,16,18,.889,100
5628,2017-02-26,PHO,@,MIL,L 96-100,240,40,83,.482,35,69,.507,5,14,.357,11,16,.688,96
5629,2017-02-26,NOP,@,OKC,L 110-118,240,36,80,.450,28,59,.475,8,21,.381,30,37,.811,110
5630,2017-02-26,OKC,,NOP,W 118-110,240,42,88,.477,36,67,.537,6,21,.286,28,37,.757,118
5631,2017-02-26,POR,@,TOR,L 106-112,240,35,79,.443,26,58,.448,9,21,.429,27,35,.771,106
5632,2017-02-26,TOR,,POR,W 112-106,240,42,78,.538,35,58,.603,7,20,.350,21,27,.778,112
5633,2017-02-26,UTA,@,WAS,W 102-92,240,34,72,.472,23,48,.479,11,24,.458,23,32,.719,102
5634,2017-02-26,WAS,,UTA,L 92-102,240,37,87,.425,29,65,.446,8,22,.364,10,13,.769,92
5635,2017-02-25,CHI,@,CLE,W 117-99,240,46,93,.495,31,63,.492,15,30,.500,10,16,.625,117
5636,2017-02-25,CLE,,CHI,L 99-117,240,37,80,.463,23,43,.535,14,37,.378,11,15,.733,99
5637,2017-02-25,DAL,,NOP,W 96-83,240,36,78,.462,24,52,.462,12,26,.462,12,16,.750,96
5638,2017-02-25,NOP,@,DAL,L 83-96,240,31,78,.397,26,54,.481,5,24,.208,16,25,.640,83
5639,2017-02-25,BRK,@,GSW,L 95-112,240,38,94,.404,30,66,.455,8,28,.286,11,17,.647,95
5640,2017-02-25,GSW,,BRK,W 112-95,240,42,100,.420,31,69,.449,11,31,.355,17,22,.773,112
5641,2017-02-25,HOU,,MIN,W 142-130,240,44,94,.468,22,36,.611,22,58,.379,32,42,.762,142
5642,2017-02-25,MIN,@,HOU,L 130-142,240,49,94,.521,40,68,.588,9,26,.346,23,28,.821,130
5643,2017-02-25,IND,@,MIA,L 95-113,240,34,85,.400,30,73,.411,4,12,.333,23,26,.885,95
5644,2017-02-25,MIA,,IND,W 113-95,240,38,78,.487,25,47,.532,13,31,.419,24,31,.774,113
5645,2017-02-25,NYK,,PHI,W 110-109,240,43,91,.473,37,70,.529,6,21,.286,18,23,.783,110
5646,2017-02-25,PHI,@,NYK,L 109-110,240,40,95,.421,33,64,.516,7,31,.226,22,27,.815,109
5647,2017-02-25,ATL,@,ORL,L 86-105,240,32,85,.376,24,60,.400,8,25,.320,14,26,.538,86
5648,2017-02-25,ORL,,ATL,W 105-86,240,37,81,.457,29,54,.537,8,27,.296,23,24,.958,105
5649,2017-02-25,CHA,@,SAC,W 99-85,240,34,85,.400,20,47,.426,14,38,.368,17,18,.944,99
5650,2017-02-25,SAC,,CHO,L 85-99,240,31,79,.392,20,51,.392,11,28,.393,12,15,.800,85
5651,2017-02-24,ATL,,MIA,L 90-108,240,30,79,.380,24,59,.407,6,20,.300,24,36,.667,90
5652,2017-02-24,MIA,@,ATL,W 108-90,240,40,99,.404,23,62,.371,17,37,.459,11,13,.846,108
5653,2017-02-24,CHI,,PHO,W 128-121 (OT),265,46,98,.469,34,72,.472,12,26,.462,24,31,.774,128
5654,2017-02-24,PHO,@,CHI,L 121-128 (OT),265,49,93,.527,41,69,.594,8,24,.333,15,25,.600,121
5655,2017-02-24,BRK,@,DEN,L 109-129,240,41,83,.494,31,53,.585,10,30,.333,17,31,.548,109
5656,2017-02-24,DEN,,BRK,W 129-109,240,49,97,.505,35,66,.530,14,31,.452,17,24,.708,129
5657,2017-02-24,IND,,MEM,W 102-92,240,40,78,.513,29,52,.558,11,26,.423,11,11,1.000,102
5658,2017-02-24,MEM,@,IND,L 92-102,240,35,84,.417,26,57,.456,9,27,.333,13,23,.565,92
5659,2017-02-24,LAC,,SAS,L 97-105,240,35,79,.443,28,56,.500,7,23,.304,20,24,.833,97
5660,2017-02-24,SAS,@,LAC,W 105-97,240,35,82,.427,26,56,.464,9,26,.346,26,30,.867,105
5661,2017-02-24,MIL,,UTA,L 95-109,240,32,74,.432,25,56,.446,7,18,.389,24,29,.828,95
5662,2017-02-24,UTA,@,MIL,W 109-95,240,37,74,.500,29,51,.569,8,23,.348,27,30,.900,109
5663,2017-02-24,DAL,@,MIN,L 84-97,240,35,83,.422,27,50,.540,8,33,.242,6,9,.667,84
5664,2017-02-24,MIN,,DAL,W 97-84,240,41,78,.526,36,65,.554,5,13,.385,10,14,.714,97
5665,2017-02-24,LAL,@,OKC,L 93-110,240,40,101,.396,33,66,.500,7,35,.200,6,14,.429,93
5666,2017-02-24,OKC,,LAL,W 110-93,240,44,97,.454,34,73,.466,10,24,.417,12,17,.706,110
5667,2017-02-24,PHI,,WAS,W 120-112,240,43,87,.494,33,58,.569,10,29,.345,24,30,.800,120
5668,2017-02-24,WAS,@,PHI,L 112-120,240,38,90,.422,33,66,.500,5,24,.208,31,40,.775,112
5669,2017-02-24,BOS,@,TOR,L 97-107,240,33,78,.423,21,40,.525,12,38,.316,19,22,.864,97
5670,2017-02-24,TOR,,BOS,W 107-97,240,40,81,.494,35,66,.530,5,15,.333,22,29,.759,107
5671,2017-02-23,CLE,,NYK,W 119-104,240,46,87,.529,31,49,.633,15,38,.395,12,15,.800,119
5672,2017-02-23,NYK,@,CLE,L 104-119,240,42,101,.416,34,75,.453,8,26,.308,12,17,.706,104
5673,2017-02-23,CHA,@,DET,L 108-114 (OT),265,38,92,.413,31,62,.500,7,30,.233,25,26,.962,108
5674,2017-02-23,DET,,CHO,W 114-108 (OT),265,44,107,.411,29,70,.414,15,37,.405,11,12,.917,114
5675,2017-02-23,GSW,,LAC,W 123-113,240,43,81,.531,30,56,.536,13,25,.520,24,26,.923,123
5676,2017-02-23,LAC,@,GSW,L 113-123,240,38,93,.409,27,65,.415,11,28,.393,26,37,.703,113
5677,2017-02-23,HOU,@,NOP,W 129-99,240,45,91,.495,25,40,.625,20,51,.392,19,24,.792,129
5678,2017-02-23,NOP,,HOU,L 99-129,240,36,86,.419,30,55,.545,6,31,.194,21,26,.808,99
5679,2017-02-23,ORL,,POR,L 103-112,240,34,86,.395,27,64,.422,7,22,.318,28,39,.718,103
5680,2017-02-23,POR,@,ORL,W 112-103,240,41,81,.506,32,63,.508,9,18,.500,21,27,.778,112
5681,2017-02-23,DEN,@,SAC,L 100-116,240,39,88,.443,27,53,.509,12,35,.343,10,14,.714,100
5682,2017-02-23,SAC,,DEN,W 116-100,240,46,88,.523,39,74,.527,7,14,.500,17,19,.895,116
5683,2017-02-16,BOS,@,CHI,L 103-104,240,36,77,.468,22,40,.550,14,37,.378,17,20,.850,103
5684,2017-02-16,CHI,,BOS,W 104-103,240,38,90,.422,32,65,.492,6,25,.240,22,22,1.000,104
5685,2017-02-16,IND,,WAS,L 98-111,240,40,80,.500,36,62,.581,4,18,.222,14,18,.778,98
5686,2017-02-16,WAS,@,IND,W 111-98,240,43,83,.518,28,54,.519,15,29,.517,10,15,.667,111
5687,2017-02-15,BOS,,PHI,W 116-108,240,38,80,.475,25,52,.481,13,28,.464,27,36,.750,116
5688,2017-02-15,PHI,@,BOS,L 108-116,240,44,93,.473,36,62,.581,8,31,.258,12,18,.667,108
5689,2017-02-15,BRK,,MIL,L 125-129,240,46,88,.523,32,52,.615,14,36,.389,19,23,.826,125
5690,2017-02-15,MIL,@,BRK,W 129-125,240,50,88,.568,43,73,.589,7,15,.467,22,32,.688,129
5691,2017-02-15,CLE,,IND,W 113-104,240,39,82,.476,21,43,.488,18,39,.462,17,19,.895,113
5692,2017-02-15,IND,@,CLE,L 104-113,240,40,86,.465,28,62,.452,12,24,.500,12,14,.857,104
5693,2017-02-15,DEN,,MIN,L 99-112,240,38,94,.404,27,60,.450,11,34,.324,12,18,.667,99
5694,2017-02-15,MIN,@,DEN,W 112-99,240,41,86,.477,35,68,.515,6,18,.333,24,28,.857,112
5695,2017-02-15,DAL,@,DET,L 91-98,240,35,92,.380,25,55,.455,10,37,.270,11,11,1.000,91
5696,2017-02-15,DET,,DAL,W 98-91,240,36,82,.439,30,63,.476,6,19,.316,20,22,.909,98
5697,2017-02-15,GSW,,SAC,W 109-86,240,41,84,.488,28,48,.583,13,36,.361,14,21,.667,109
5698,2017-02-15,SAC,@,GSW,L 86-109,240,33,89,.371,26,65,.400,7,24,.292,13,17,.765,86
5699,2017-02-15,HOU,,MIA,L 109-117,240,36,87,.414,23,47,.489,13,40,.325,24,31,.774,109
5700,2017-02-15,MIA,@,HOU,W 117-109,240,44,84,.524,31,49,.633,13,35,.371,16,24,.667,117
5701,2017-02-15,ATL,@,LAC,L 84-99,240,32,79,.405,25,53,.472,7,26,.269,13,19,.684,84
5702,2017-02-15,LAC,,ATL,W 99-84,240,37,79,.468,23,42,.548,14,37,.378,11,12,.917,99
5703,2017-02-15,MEM,,NOP,L 91-95,240,33,89,.371,27,56,.482,6,33,.182,19,25,.760,91
5704,2017-02-15,NOP,@,MEM,W 95-91,240,37,75,.493,29,57,.509,8,18,.444,13,22,.591,95
5705,2017-02-15,NYK,@,OKC,L 105-116,240,41,86,.477,30,65,.462,11,21,.524,12,14,.857,105
5706,2017-02-15,OKC,,NYK,W 116-105,240,41,88,.466,29,65,.446,12,23,.522,22,31,.710,116
5707,2017-02-15,ORL,,SAS,L 79-107,240,30,76,.395,26,58,.448,4,18,.222,15,19,.789,79
5708,2017-02-15,SAS,@,ORL,W 107-79,240,42,89,.472,34,58,.586,8,31,.258,15,19,.789,107
5709,2017-02-15,LAL,@,PHO,L 101-137,240,35,93,.376,26,67,.388,9,26,.346,22,28,.786,101
5710,2017-02-15,PHO,,LAL,W 137-101,240,49,88,.557,39,64,.609,10,24,.417,29,34,.853,137
5711,2017-02-15,CHA,@,TOR,L 85-90,240,32,76,.421,19,38,.500,13,38,.342,8,9,.889,85
5712,2017-02-15,TOR,,CHO,W 90-85,240,32,84,.381,20,52,.385,12,32,.375,14,19,.737,90
5713,2017-02-15,POR,@,UTA,L 88-111,240,32,79,.405,23,57,.404,9,22,.409,15,20,.750,88
5714,2017-02-15,UTA,,POR,W 111-88,240,42,81,.519,31,59,.525,11,22,.500,16,23,.696,111
5715,2017-02-14,CHI,,TOR,W 105-94,240,35,73,.479,28,56,.500,7,17,.412,28,35,.800,105
5716,2017-02-14,TOR,@,CHI,L 94-105,240,35,77,.455,30,57,.526,5,20,.250,19,24,.792,94
5717,2017-02-14,LAL,,SAC,L 96-97,240,38,83,.458,26,54,.481,12,29,.414,8,15,.533,96
5718,2017-02-14,SAC,@,LAL,W 97-96,240,36,73,.493,29,49,.592,7,24,.292,18,25,.720,97
5719,2017-02-14,CLE,@,MIN,W 116-108,240,44,86,.512,31,47,.660,13,39,.333,15,22,.682,116
5720,2017-02-14,MIN,,CLE,L 108-116,240,42,86,.488,33,63,.524,9,23,.391,15,19,.789,108
5721,2017-02-13,BRK,,MEM,L 103-112,240,38,82,.463,26,45,.578,12,37,.324,15,18,.833,103
5722,2017-02-13,MEM,@,BRK,W 112-103,240,39,77,.506,30,55,.545,9,22,.409,25,27,.926,112
5723,2017-02-13,CHA,,PHI,L 99-105,240,34,78,.436,23,47,.489,11,31,.355,20,26,.769,99
5724,2017-02-13,PHI,@,CHO,W 105-99,240,41,86,.477,29,53,.547,12,33,.364,11,17,.647,105
5725,2017-02-13,BOS,@,DAL,W 111-98,240,40,81,.494,24,47,.511,16,34,.471,15,18,.833,111
5726,2017-02-13,DAL,,BOS,L 98-111,240,35,77,.455,26,50,.520,9,27,.333,19,25,.760,98
5727,2017-02-13,DEN,,GSW,W 132-110,240,48,88,.545,24,47,.511,24,41,.585,12,16,.750,132
5728,2017-02-13,GSW,@,DEN,L 110-132,240,45,92,.489,37,60,.617,8,32,.250,12,13,.923,110
5729,2017-02-13,IND,,SAS,L 106-110,240,38,78,.487,29,58,.500,9,20,.450,21,30,.700,106
5730,2017-02-13,SAS,@,IND,W 110-106,240,40,87,.460,33,72,.458,7,15,.467,23,27,.852,110
5731,2017-02-13,MIA,,ORL,L 107-116,240,39,83,.470,33,61,.541,6,22,.273,23,27,.852,107
5732,2017-02-13,ORL,@,MIA,W 116-107,240,44,90,.489,36,76,.474,8,14,.571,20,29,.690,116
5733,2017-02-13,DET,@,MIL,L 89-102,240,34,78,.436,27,57,.474,7,21,.333,14,19,.737,89
5734,2017-02-13,MIL,,DET,W 102-89,240,40,79,.506,34,58,.586,6,21,.286,16,16,1.000,102
5735,2017-02-13,NOP,@,PHO,W 110-108,240,37,78,.474,29,50,.580,8,28,.286,28,35,.800,110
5736,2017-02-13,PHO,,NOP,L 108-110,240,40,93,.430,32,70,.457,8,23,.348,20,24,.833,108
5737,2017-02-13,ATL,@,POR,W 109-104 (OT),265,32,83,.386,24,55,.436,8,28,.286,37,48,.771,109
5738,2017-02-13,POR,,ATL,L 104-109 (OT),265,37,103,.359,21,61,.344,16,42,.381,14,25,.560,104
5739,2017-02-13,LAC,@,UTA,W 88-72,240,36,81,.444,27,56,.482,9,25,.360,7,11,.636,88
5740,2017-02-13,UTA,,LAC,L 72-88,240,28,87,.322,24,64,.375,4,23,.174,12,18,.667,72
5741,2017-02-13,OKC,@,WAS,L 98-120,240,34,96,.354,27,62,.435,7,34,.206,23,30,.767,98
5742,2017-02-13,WAS,,OKC,W 120-98,240,42,73,.575,29,53,.547,13,20,.650,23,28,.821,120
5743,2017-02-12,CHI,@,MIN,L 89-117,240,35,84,.417,25,59,.424,10,25,.400,9,13,.692,89
5744,2017-02-12,MIN,,CHI,W 117-89,240,44,81,.543,38,57,.667,6,24,.250,23,26,.885,117
5745,2017-02-12,NYK,,SAS,W 94-90,240,34,68,.500,25,54,.463,9,14,.643,17,21,.810,94
5746,2017-02-12,SAS,@,NYK,L 90-94,240,33,91,.363,27,62,.435,6,29,.207,18,22,.818,90
5747,2017-02-12,NOP,@,SAC,L 99-105,240,34,82,.415,21,51,.412,13,31,.419,18,21,.857,99
5748,2017-02-12,SAC,,NOP,W 105-99,240,35,78,.449,24,47,.511,11,31,.355,24,27,.889,105
5749,2017-02-12,DET,@,TOR,W 102-101,240,36,84,.429,28,53,.528,8,31,.258,22,29,.759,102
5750,2017-02-12,TOR,,DET,L 101-102,240,38,75,.507,30,59,.508,8,16,.500,17,25,.680,101
5751,2017-02-11,CHA,,LAC,L 102-107,240,37,85,.435,24,48,.500,13,37,.351,15,20,.750,102
5752,2017-02-11,LAC,@,CHO,W 107-102,240,40,85,.471,26,51,.510,14,34,.412,13,20,.650,107
5753,2017-02-11,CLE,,DEN,W 125-109,240,46,84,.548,31,54,.574,15,30,.500,18,22,.818,125
5754,2017-02-11,DEN,@,CLE,L 109-125,240,39,97,.402,27,60,.450,12,37,.324,19,22,.864,109
5755,2017-02-11,DAL,,ORL,W 112-80,240,45,91,.495,28,56,.500,17,35,.486,5,6,.833,112
5756,2017-02-11,ORL,@,DAL,L 80-112,240,32,82,.390,29,59,.492,3,23,.130,13,18,.722,80
5757,2017-02-11,HOU,,PHO,W 133-102,240,42,85,.494,24,49,.490,18,36,.500,31,39,.795,133
5758,2017-02-11,PHO,@,HOU,L 102-133,240,37,94,.394,29,72,.403,8,22,.364,20,26,.769,102
5759,2017-02-11,IND,,MIL,L 100-116,240,35,73,.479,25,51,.490,10,22,.455,20,24,.833,100
5760,2017-02-11,MIL,@,IND,W 116-100,240,35,73,.479,18,42,.429,17,31,.548,29,37,.784,116
5761,2017-02-11,GSW,@,OKC,W 130-114,240,46,87,.529,33,56,.589,13,31,.419,25,35,.714,130
5762,2017-02-11,OKC,,GSW,L 114-130,240,40,83,.482,34,59,.576,6,24,.250,28,36,.778,114
5763,2017-02-11,MIA,@,PHI,L 109-117,240,39,85,.459,32,61,.525,7,24,.292,24,28,.857,109
5764,2017-02-11,PHI,,MIA,W 117-109,240,39,86,.453,30,61,.492,9,25,.360,30,38,.789,117
5765,2017-02-11,BOS,@,UTA,W 112-104,240,42,71,.592,29,41,.707,13,30,.433,15,23,.652,112
5766,2017-02-11,UTA,,BOS,L 104-112,240,35,86,.407,27,55,.491,8,31,.258,26,30,.867,104
5767,2017-02-10,BRK,,MIA,L 99-108,240,35,81,.432,27,61,.443,8,20,.400,21,28,.750,99
5768,2017-02-10,MIA,@,BRK,W 108-99,240,41,92,.446,34,69,.493,7,23,.304,19,21,.905,108
5769,2017-02-10,DET,,SAS,L 92-103,240,39,92,.424,34,75,.453,5,17,.294,9,13,.692,92
5770,2017-02-10,SAS,@,DET,W 103-92,240,41,82,.500,32,63,.508,9,19,.474,12,15,.800,103
5771,2017-02-10,GSW,@,MEM,W 122-107,240,39,77,.506,24,44,.545,15,33,.455,29,38,.763,122
5772,2017-02-10,MEM,,GSW,L 107-122,240,34,87,.391,25,61,.410,9,26,.346,30,37,.811,107
5773,2017-02-10,LAL,@,MIL,W 122-114,240,39,75,.520,24,44,.545,15,31,.484,29,35,.829,122
5774,2017-02-10,MIL,,LAL,L 114-122,240,40,76,.526,32,48,.667,8,28,.286,26,31,.839,114
5775,2017-02-10,MIN,,NOP,L 106-122,240,38,82,.463,32,55,.582,6,27,.222,24,32,.750,106
5776,2017-02-10,NOP,@,MIN,W 122-106,240,45,75,.600,33,50,.660,12,25,.480,20,27,.741,122
5777,2017-02-10,DEN,@,NYK,W 131-123,240,54,95,.568,38,63,.603,16,32,.500,7,10,.700,131
5778,2017-02-10,NYK,,DEN,L 123-131,240,52,93,.559,36,55,.655,16,38,.421,3,5,.600,123
5779,2017-02-10,CHI,@,PHO,L 97-115,240,37,86,.430,32,67,.478,5,19,.263,18,22,.818,97
5780,2017-02-10,PHO,,CHI,W 115-97,240,48,95,.505,40,76,.526,8,19,.421,11,13,.846,115
5781,2017-02-10,ATL,@,SAC,L 107-108,240,36,71,.507,25,41,.610,11,30,.367,24,31,.774,107
5782,2017-02-10,SAC,,ATL,W 108-107,240,38,80,.475,20,44,.455,18,36,.500,14,21,.667,108
5783,2017-02-10,IND,@,WAS,L 107-112,240,45,92,.489,41,71,.577,4,21,.190,13,15,.867,107
5784,2017-02-10,WAS,,IND,W 112-107,240,41,88,.466,31,59,.525,10,29,.345,20,30,.667,112
5785,2017-02-09,CHA,,HOU,L 95-107,240,37,85,.435,29,59,.492,8,26,.308,13,14,.929,95
5786,2017-02-09,HOU,@,CHO,W 107-95,240,39,87,.448,26,47,.553,13,40,.325,16,20,.800,107
5787,2017-02-09,DAL,,UTA,W 112-105 (OT),265,44,87,.506,39,67,.582,5,20,.250,19,25,.760,112
5788,2017-02-09,UTA,@,DAL,L 105-112 (OT),265,39,85,.459,26,56,.464,13,29,.448,14,17,.824,105
5789,2017-02-09,CLE,@,OKC,L 109-118,240,38,79,.481,28,58,.483,10,21,.476,23,30,.767,109
5790,2017-02-09,OKC,,CLE,W 118-109,240,50,106,.472,42,79,.532,8,27,.296,10,13,.769,118
5791,2017-02-09,ORL,,PHI,L 111-112,240,41,84,.488,31,63,.492,10,21,.476,19,24,.792,111
5792,2017-02-09,PHI,@,ORL,W 112-111,240,40,95,.421,29,67,.433,11,28,.393,21,27,.778,112
5793,2017-02-09,BOS,@,POR,W 120-111,240,44,91,.484,34,61,.557,10,30,.333,22,27,.815,120
5794,2017-02-09,POR,,BOS,L 111-120,240,39,77,.506,30,51,.588,9,26,.346,24,31,.774,111
5795,2017-02-08,ATL,,DEN,W 117-106,240,47,93,.505,39,66,.591,8,27,.296,15,18,.833,117
5796,2017-02-08,DEN,@,ATL,L 106-117,240,40,100,.400,27,56,.482,13,44,.295,13,21,.619,106
5797,2017-02-08,BRK,,WAS,L 110-114 (OT),265,38,91,.418,29,58,.500,9,33,.273,25,36,.694,110
5798,2017-02-08,WAS,@,BRK,W 114-110 (OT),265,40,97,.412,31,72,.431,9,25,.360,25,33,.758,114
5799,2017-02-08,DET,,LAL,W 121-102,240,51,97,.526,47,81,.580,4,16,.250,15,24,.625,121
5800,2017-02-08,LAL,@,DET,L 102-121,240,37,86,.430,31,63,.492,6,23,.261,22,26,.846,102
5801,2017-02-08,CHI,@,GSW,L 92-123,240,37,92,.402,33,68,.485,4,24,.167,14,19,.737,92
5802,2017-02-08,GSW,,CHI,W 123-92,240,48,85,.565,33,57,.579,15,28,.536,12,13,.923,123
5803,2017-02-08,CLE,@,IND,W 132-117,240,46,84,.548,30,48,.625,16,36,.444,24,26,.923,132
5804,2017-02-08,IND,,CLE,L 117-132,240,41,82,.500,28,57,.491,13,25,.520,22,26,.846,117
5805,2017-02-08,MEM,,PHO,W 110-91,240,35,72,.486,21,48,.438,14,24,.583,26,34,.765,110
5806,2017-02-08,PHO,@,MEM,L 91-110,240,29,87,.333,24,64,.375,5,23,.217,28,34,.824,91
5807,2017-02-08,MIA,@,MIL,W 106-88,240,41,86,.477,30,53,.566,11,33,.333,13,18,.722,106
5808,2017-02-08,MIL,,MIA,L 88-106,240,33,71,.465,27,56,.482,6,15,.400,16,28,.571,88
5809,2017-02-08,MIN,,TOR,W 112-109,240,39,80,.488,32,61,.525,7,19,.368,27,30,.900,112
5810,2017-02-08,TOR,@,MIN,L 109-112,240,42,79,.532,31,51,.608,11,28,.393,14,20,.700,109
5811,2017-02-08,NOP,,UTA,L 94-127,240,35,77,.455,30,53,.566,5,24,.208,19,25,.760,94
5812,2017-02-08,UTA,@,NOP,W 127-94,240,48,88,.545,34,56,.607,14,32,.438,17,21,.810,127
5813,2017-02-08,LAC,@,NYK,W 119-115,240,45,92,.489,35,67,.522,10,25,.400,19,28,.679,119
5814,2017-02-08,NYK,,LAC,L 115-119,240,46,92,.500,38,65,.585,8,27,.296,15,18,.833,115
5815,2017-02-08,PHI,,SAS,L 103-111,240,34,84,.405,21,50,.420,13,34,.382,22,29,.759,103
5816,2017-02-08,SAS,@,PHI,W 111-103,240,39,74,.527,28,52,.538,11,22,.500,22,25,.880,111
5817,2017-02-08,BOS,@,SAC,L 92-108,240,29,73,.397,19,41,.463,10,32,.313,24,27,.889,92
5818,2017-02-08,SAC,,BOS,W 108-92,240,42,84,.500,32,59,.542,10,25,.400,14,15,.933,108
5819,2017-02-07,BRK,@,CHO,L 107-111,240,39,86,.453,27,50,.540,12,36,.333,17,21,.810,107
5820,2017-02-07,CHA,,BRK,W 111-107,240,40,102,.392,33,76,.434,7,26,.269,24,29,.828,111
5821,2017-02-07,DAL,,POR,L 113-114,240,37,75,.493,25,47,.532,12,28,.429,27,32,.844,113
5822,2017-02-07,POR,@,DAL,W 114-113,240,42,86,.488,31,58,.534,11,28,.393,19,24,.792,114
5823,2017-02-07,HOU,,ORL,W 128-104,240,44,89,.494,28,51,.549,16,38,.421,24,36,.667,128
5824,2017-02-07,ORL,@,HOU,L 104-128,240,42,88,.477,36,63,.571,6,25,.240,14,20,.700,104
5825,2017-02-06,ATL,,UTA,L 95-120,240,33,74,.446,27,57,.474,6,17,.353,23,32,.719,95
5826,2017-02-06,UTA,@,ATL,W 120-95,240,49,80,.613,39,54,.722,10,26,.385,12,18,.667,120
5827,2017-02-06,DAL,@,DEN,L 87-110,240,34,79,.430,26,53,.491,8,26,.308,11,17,.647,87
5828,2017-02-06,DEN,,DAL,W 110-87,240,42,84,.500,31,56,.554,11,28,.393,15,16,.938,110
5829,2017-02-06,DET,,PHI,W 113-96,240,46,99,.465,41,77,.532,5,22,.227,16,17,.941,113
5830,2017-02-06,PHI,@,DET,L 96-113,240,36,85,.424,31,57,.544,5,28,.179,19,28,.679,96
5831,2017-02-06,IND,,OKC,W 93-90,240,33,87,.379,25,61,.410,8,26,.308,19,29,.655,93
5832,2017-02-06,OKC,@,IND,L 90-93,240,34,88,.386,27,60,.450,7,28,.250,15,21,.714,90
5833,2017-02-06,MEM,,SAS,W 89-74,240,32,81,.395,28,62,.452,4,19,.211,21,25,.840,89
5834,2017-02-06,SAS,@,MEM,L 74-89,240,30,82,.366,26,63,.413,4,19,.211,10,18,.556,74
5835,2017-02-06,MIA,@,MIN,W 115-113,240,45,86,.523,30,58,.517,15,28,.536,10,14,.714,115
5836,2017-02-06,MIN,,MIA,L 113-115,240,43,80,.538,38,69,.551,5,11,.455,22,28,.786,113
5837,2017-02-06,NOP,,PHO,W 111-106,240,42,92,.457,33,66,.500,9,26,.346,18,22,.818,111
5838,2017-02-06,PHO,@,NOP,L 106-111,240,40,93,.430,35,66,.530,5,27,.185,21,25,.840,106
5839,2017-02-06,LAL,@,NYK,W 121-107,240,44,102,.431,36,74,.486,8,28,.286,25,31,.806,121
5840,2017-02-06,NYK,,LAL,L 107-121,240,37,82,.451,30,61,.492,7,21,.333,26,33,.788,107
5841,2017-02-06,CHI,@,SAC,W 112-107,240,43,81,.531,37,62,.597,6,19,.316,20,31,.645,112
5842,2017-02-06,SAC,,CHI,L 107-112,240,41,79,.519,30,51,.588,11,28,.393,14,16,.875,107
5843,2017-02-06,LAC,@,TOR,L 109-118,240,42,90,.467,29,55,.527,13,35,.371,12,18,.667,109
5844,2017-02-06,TOR,,LAC,W 118-109,240,41,84,.488,31,60,.517,10,24,.417,26,29,.897,118
5845,2017-02-06,CLE,@,WAS,W 140-135 (OT),265,49,92,.533,30,54,.556,19,38,.500,23,28,.821,140
5846,2017-02-06,WAS,,CLE,L 135-140 (OT),265,50,99,.505,38,70,.543,12,29,.414,23,26,.885,135
5847,2017-02-05,BOS,,LAC,W 107-102,240,37,88,.420,21,36,.583,16,52,.308,17,20,.850,107
5848,2017-02-05,LAC,@,BOS,L 102-107,240,35,84,.417,25,55,.455,10,29,.345,22,28,.786,102
5849,2017-02-05,BRK,,TOR,L 95-103,240,32,76,.421,19,42,.452,13,34,.382,18,21,.857,95
5850,2017-02-05,TOR,@,BRK,W 103-95,240,40,87,.460,35,68,.515,5,19,.263,18,20,.900,103
5851,2017-02-05,OKC,,POR,W 105-99,240,40,98,.408,36,80,.450,4,18,.222,21,28,.750,105
5852,2017-02-05,POR,@,OKC,L 99-105,240,35,87,.402,25,59,.424,10,28,.357,19,21,.905,99
5853,2017-02-04,ATL,,ORL,W 113-86,240,41,78,.526,31,50,.620,10,28,.357,21,27,.778,113
5854,2017-02-04,ORL,@,ATL,L 86-113,240,27,78,.346,20,51,.392,7,27,.259,25,28,.893,86
5855,2017-02-04,DET,@,IND,L 84-105,240,31,75,.413,25,58,.431,6,17,.353,16,20,.800,84
5856,2017-02-04,IND,,DET,W 105-84,240,44,91,.484,37,67,.552,7,24,.292,10,15,.667,105
5857,2017-02-04,MIA,,PHI,W 125-102,240,48,82,.585,36,60,.600,12,22,.545,17,23,.739,125
5858,2017-02-04,PHI,@,MIA,L 102-125,240,35,84,.417,29,61,.475,6,23,.261,26,31,.839,102
5859,2017-02-04,MEM,@,MIN,W 107-99,240,32,77,.416,22,49,.449,10,28,.357,33,39,.846,107
5860,2017-02-04,MIN,,MEM,L 99-107,240,35,84,.417,25,58,.431,10,26,.385,19,24,.792,99
5861,2017-02-04,CLE,@,NYK,W 111-104,240,41,84,.488,25,44,.568,16,40,.400,13,18,.722,111
5862,2017-02-04,NYK,,CLE,L 104-111,240,39,86,.453,27,55,.491,12,31,.387,14,28,.500,104
5863,2017-02-04,MIL,@,PHO,W 137-112,240,52,82,.634,45,65,.692,7,17,.412,26,35,.743,137
5864,2017-02-04,PHO,,MIL,L 112-137,240,38,91,.418,27,63,.429,11,28,.393,25,30,.833,112
5865,2017-02-04,GSW,@,SAC,L 106-109 (OT),265,36,87,.414,21,43,.488,15,44,.341,19,24,.792,106
5866,2017-02-04,SAC,,GSW,W 109-106 (OT),265,43,88,.489,36,65,.554,7,23,.304,16,19,.842,109
5867,2017-02-04,DEN,@,SAS,L 97-121,240,41,92,.446,31,66,.470,10,26,.385,5,10,.500,97
5868,2017-02-04,SAS,,DEN,W 121-97,240,45,79,.570,35,58,.603,10,21,.476,21,26,.808,121
5869,2017-02-04,CHA,@,UTA,L 98-105,240,35,82,.427,22,49,.449,13,33,.394,15,18,.833,98
5870,2017-02-04,UTA,,CHO,W 105-98,240,38,81,.469,25,48,.521,13,33,.394,16,24,.667,105
5871,2017-02-04,NOP,@,WAS,L 91-105,240,37,84,.440,32,67,.478,5,17,.294,12,22,.545,91
5872,2017-02-04,WAS,,NOP,W 105-91,240,38,83,.458,28,52,.538,10,31,.323,19,22,.864,105
5873,2017-02-03,BOS,,LAL,W 113-107,240,39,82,.476,26,47,.553,13,35,.371,22,28,.786,113
5874,2017-02-03,LAL,@,BOS,L 107-113,240,37,94,.394,23,56,.411,14,38,.368,19,26,.731,107
5875,2017-02-03,BRK,,IND,L 97-106,240,32,86,.372,21,58,.362,11,28,.393,22,23,.957,97
5876,2017-02-03,IND,@,BRK,W 106-97,240,37,86,.430,29,66,.439,8,20,.400,24,31,.774,106
5877,2017-02-03,DEN,,MIL,W 121-117,240,40,89,.449,31,61,.508,9,28,.321,32,44,.727,121
5878,2017-02-03,MIL,@,DEN,L 117-121,240,45,83,.542,36,59,.610,9,24,.375,18,23,.783,117
5879,2017-02-03,DET,,MIN,W 116-108,240,44,98,.449,33,72,.458,11,26,.423,17,22,.773,116
5880,2017-02-03,MIN,@,DET,L 108-116,240,44,89,.494,39,72,.542,5,17,.294,15,19,.789,108
5881,2017-02-03,CHI,@,HOU,L 117-121 (OT),265,48,100,.480,40,75,.533,8,25,.320,13,18,.722,117
5882,2017-02-03,HOU,,CHI,W 121-117 (OT),265,44,98,.449,28,55,.509,16,43,.372,17,25,.680,121
5883,2017-02-03,MEM,@,OKC,L 102-114,240,40,83,.482,37,64,.578,3,19,.158,19,22,.864,102
5884,2017-02-03,OKC,,MEM,W 114-102,240,38,80,.475,25,54,.463,13,26,.500,25,33,.758,114
5885,2017-02-03,ORL,,TOR,W 102-94,240,37,80,.463,32,66,.485,5,14,.357,23,32,.719,102
5886,2017-02-03,TOR,@,ORL,L 94-102,240,34,87,.391,24,59,.407,10,28,.357,16,21,.762,94
5887,2017-02-03,DAL,@,POR,W 108-104,240,36,76,.474,19,45,.422,17,31,.548,19,23,.826,108
5888,2017-02-03,POR,,DAL,L 104-108,240,40,88,.455,31,58,.534,9,30,.300,15,20,.750,104
5889,2017-02-03,PHO,@,SAC,W 105-103,240,32,77,.416,20,48,.417,12,29,.414,29,35,.829,105
5890,2017-02-03,SAC,,PHO,L 103-105,240,38,85,.447,28,58,.483,10,27,.370,17,22,.773,103
5891,2017-02-02,ATL,@,HOU,W 113-108,240,44,85,.518,36,55,.655,8,30,.267,17,23,.739,113
5892,2017-02-02,HOU,,ATL,L 108-113,240,35,93,.376,22,42,.524,13,51,.255,25,33,.758,108
5893,2017-02-02,GSW,@,LAC,W 133-120,240,52,99,.525,38,65,.585,14,34,.412,15,18,.833,133
5894,2017-02-02,LAC,,GSW,L 120-133,240,40,80,.500,30,55,.545,10,25,.400,30,39,.769,120
5895,2017-02-02,PHI,@,SAS,L 86-102,240,30,88,.341,21,63,.333,9,25,.360,17,23,.739,86
5896,2017-02-02,SAS,,PHI,W 102-86,240,38,89,.427,32,68,.471,6,21,.286,20,27,.741,102
5897,2017-02-02,LAL,@,WAS,L 108-116,240,40,87,.460,28,48,.583,12,39,.308,16,22,.727,108
5898,2017-02-02,WAS,,LAL,W 116-108,240,44,96,.458,32,63,.508,12,33,.364,16,21,.762,116
5899,2017-02-01,BOS,,TOR,W 109-104,240,36,87,.414,24,51,.471,12,36,.333,25,30,.833,109
5900,2017-02-01,TOR,@,BOS,L 104-109,240,41,78,.526,33,47,.702,8,31,.258,14,25,.560,104
5901,2017-02-01,BRK,,NYK,L 90-95,240,37,88,.420,32,63,.508,5,25,.200,11,16,.688,90
5902,2017-02-01,NYK,@,BRK,W 95-90,240,35,99,.354,29,72,.403,6,27,.222,19,31,.613,95
5903,2017-02-01,CLE,,MIN,W 125-97,240,48,89,.539,33,52,.635,15,37,.405,14,22,.636,125
5904,2017-02-01,MIN,@,CLE,L 97-125,240,41,94,.436,34,73,.466,7,21,.333,8,10,.800,97
5905,2017-02-01,DAL,,PHI,W 113-95,240,40,86,.465,30,60,.500,10,26,.385,23,28,.821,113
5906,2017-02-01,PHI,@,DAL,L 95-113,240,35,77,.455,29,55,.527,6,22,.273,19,26,.731,95
5907,2017-02-01,DEN,,MEM,L 99-119,240,32,80,.400,23,55,.418,9,25,.360,26,35,.743,99
5908,2017-02-01,MEM,@,DEN,W 119-99,240,45,92,.489,31,62,.500,14,30,.467,15,20,.750,119
5909,2017-02-01,DET,,NOP,W 118-98,240,48,88,.545,38,62,.613,10,26,.385,12,17,.706,118
5910,2017-02-01,NOP,@,DET,L 98-118,240,41,82,.500,36,61,.590,5,21,.238,11,14,.786,98
5911,2017-02-01,CHA,@,GSW,L 111-126,240,39,88,.443,30,57,.526,9,31,.290,24,26,.923,111
5912,2017-02-01,GSW,,CHO,W 126-111,240,47,96,.490,26,48,.542,21,48,.438,11,14,.786,126
5913,2017-02-01,ATL,@,MIA,L 93-116,240,34,86,.395,27,60,.450,7,26,.269,18,21,.857,93
5914,2017-02-01,MIA,,ATL,W 116-93,240,45,93,.484,33,61,.541,12,32,.375,14,19,.737,116
5915,2017-02-01,CHI,@,OKC,W 128-100,240,49,81,.605,43,66,.652,6,15,.400,24,30,.800,128
5916,2017-02-01,OKC,,CHI,L 100-128,240,38,100,.380,28,63,.444,10,37,.270,14,17,.824,100
5917,2017-02-01,IND,@,ORL,W 98-88,240,33,69,.478,24,49,.490,9,20,.450,23,26,.885,98
5918,2017-02-01,ORL,,IND,L 88-98,240,31,77,.403,25,53,.472,6,24,.250,20,28,.714,88
5919,2017-02-01,LAC,@,PHO,W 124-114,240,44,85,.518,39,66,.591,5,19,.263,31,38,.816,124
5920,2017-02-01,PHO,,LAC,L 114-124,240,39,96,.406,32,76,.421,7,20,.350,29,35,.829,114
5921,2017-02-01,MIL,@,UTA,L 88-104,240,32,73,.438,23,50,.460,9,23,.391,15,25,.600,88
5922,2017-02-01,UTA,,MIL,W 104-88,240,36,78,.462,25,49,.510,11,29,.379,21,27,.778,104
5923,2017-01-31,HOU,,SAC,W 105-83,240,38,85,.447,24,40,.600,14,45,.311,15,22,.682,105
5924,2017-01-31,SAC,@,HOU,L 83-105,240,30,86,.349,22,57,.386,8,29,.276,15,26,.577,83
5925,2017-01-31,DEN,@,LAL,L 116-120,240,41,99,.414,26,72,.361,15,27,.556,19,23,.826,116
5926,2017-01-31,LAL,,DEN,W 120-116,240,47,89,.528,35,63,.556,12,26,.462,14,18,.778,120
5927,2017-01-31,CHA,@,POR,L 98-115,240,33,83,.398,22,52,.423,11,31,.355,21,25,.840,98
5928,2017-01-31,POR,,CHO,W 115-98,240,42,93,.452,31,62,.500,11,31,.355,20,23,.870,115
5929,2017-01-31,OKC,@,SAS,L 94-108,240,30,85,.353,23,57,.404,7,28,.250,27,32,.844,94
5930,2017-01-31,SAS,,OKC,W 108-94,240,37,86,.430,30,65,.462,7,21,.333,27,38,.711,108
5931,2017-01-31,NOP,@,TOR,L 106-108 (OT),265,40,94,.426,28,64,.438,12,30,.400,14,19,.737,106
5932,2017-01-31,TOR,,NOP,W 108-106 (OT),265,43,94,.457,33,63,.524,10,31,.323,12,15,.800,108
5933,2017-01-31,NYK,@,WAS,L 101-117,240,34,93,.366,29,69,.420,5,24,.208,28,35,.800,101
5934,2017-01-31,WAS,,NYK,W 117-101,240,49,88,.557,42,66,.636,7,22,.318,12,15,.800,117
5935,2017-01-30,BOS,,DET,W 113-109,240,36,82,.439,23,50,.460,13,32,.406,28,33,.848,113
5936,2017-01-30,DET,@,BOS,L 109-113,240,43,97,.443,40,70,.571,3,27,.111,20,29,.690,109
5937,2017-01-30,CLE,@,DAL,L 97-104,240,35,75,.467,23,43,.535,12,32,.375,15,21,.714,97
5938,2017-01-30,DAL,,CLE,W 104-97,240,39,86,.453,30,54,.556,9,32,.281,17,18,.944,104
5939,2017-01-30,BRK,@,MIA,L 96-104,240,37,87,.425,33,61,.541,4,26,.154,18,22,.818,96
5940,2017-01-30,MIA,,BRK,W 104-96,240,39,82,.476,28,56,.500,11,26,.423,15,23,.652,104
5941,2017-01-30,MIN,,ORL,W 111-105 (OT),265,40,91,.440,28,62,.452,12,29,.414,19,26,.731,111
5942,2017-01-30,ORL,@,MIN,L 105-111 (OT),265,41,96,.427,31,61,.508,10,35,.286,13,19,.684,105
5943,2017-01-30,PHI,,SAC,W 122-119,240,45,83,.542,34,52,.654,11,31,.355,21,26,.808,122
5944,2017-01-30,SAC,@,PHI,L 119-122,240,41,74,.554,28,45,.622,13,29,.448,24,29,.828,119
5945,2017-01-30,MEM,@,PHO,W 115-96,240,39,80,.488,23,52,.442,16,28,.571,21,24,.875,115
5946,2017-01-30,PHO,,MEM,L 96-115,240,31,74,.419,26,55,.473,5,19,.263,29,39,.744,96
5947,2017-01-29,ATL,,NYK,W 142-139 (4OT),340,52,119,.437,42,88,.477,10,31,.323,28,40,.700,142
5948,2017-01-29,NYK,@,ATL,L 139-142 (4OT),340,51,128,.398,33,77,.429,18,51,.353,19,23,.826,139
5949,2017-01-29,CHI,,PHI,W 121-108,240,45,89,.506,37,75,.493,8,14,.571,23,28,.821,121
5950,2017-01-29,PHI,@,CHI,L 108-121,240,44,99,.444,34,71,.479,10,28,.357,10,14,.714,108
5951,2017-01-29,CLE,,OKC,W 107-91,240,41,92,.446,33,63,.524,8,29,.276,17,22,.773,107
5952,2017-01-29,OKC,@,CLE,L 91-107,240,37,100,.370,31,74,.419,6,26,.231,11,16,.688,91
5953,2017-01-29,HOU,@,IND,L 101-120,240,34,83,.410,23,44,.523,11,39,.282,22,25,.880,101
5954,2017-01-29,IND,,HOU,W 120-101,240,47,87,.540,42,66,.636,5,21,.238,21,26,.808,120
5955,2017-01-29,NOP,,WAS,L 94-107,240,38,84,.452,28,52,.538,10,32,.313,8,15,.533,94
5956,2017-01-29,WAS,@,NOP,W 107-94,240,45,89,.506,35,68,.515,10,21,.476,7,10,.700,107
5957,2017-01-29,GSW,@,POR,W 113-111,240,36,79,.456,28,53,.528,8,26,.308,33,39,.846,113
5958,2017-01-29,POR,,GSW,L 111-113,240,46,93,.495,36,66,.545,10,27,.370,9,12,.750,111
5959,2017-01-29,DAL,@,SAS,W 105-101,240,39,87,.448,27,53,.509,12,34,.353,15,16,.938,105
5960,2017-01-29,SAS,,DAL,L 101-105,240,39,83,.470,31,61,.508,8,22,.364,15,23,.652,101
5961,2017-01-29,ORL,@,TOR,W 114-113,240,42,79,.532,32,56,.571,10,23,.435,20,26,.769,114
5962,2017-01-29,TOR,,ORL,L 113-114,240,36,79,.456,24,51,.471,12,28,.429,29,36,.806,113
5963,2017-01-28,CHA,,SAC,L 106-109,240,36,75,.480,24,38,.632,12,37,.324,22,24,.917,106
5964,2017-01-28,SAC,@,CHO,W 109-106,240,41,79,.519,30,52,.577,11,27,.407,16,26,.615,109
5965,2017-01-28,GSW,,LAC,W 144-98,240,57,92,.620,40,58,.690,17,34,.500,13,16,.813,144
5966,2017-01-28,LAC,@,GSW,L 98-144,240,36,82,.439,24,54,.444,12,28,.429,14,22,.636,98
5967,2017-01-28,DET,@,MIA,L 103-116,240,46,89,.517,42,77,.545,4,12,.333,7,12,.583,103
5968,2017-01-28,MIA,,DET,W 116-103,240,42,80,.525,28,52,.538,14,28,.500,18,23,.783,116
5969,2017-01-28,BOS,@,MIL,W 112-108 (OT),265,37,89,.416,23,48,.479,14,41,.341,24,30,.800,112
5970,2017-01-28,MIL,,BOS,L 108-112 (OT),265,37,87,.425,28,66,.424,9,21,.429,25,32,.781,108
5971,2017-01-28,BRK,@,MIN,L 109-129,240,41,85,.482,34,64,.531,7,21,.333,20,25,.800,109
5972,2017-01-28,MIN,,BRK,W 129-109,240,47,93,.505,38,73,.521,9,20,.450,26,32,.813,129
5973,2017-01-28,DEN,@,PHO,W 123-112,240,39,80,.488,31,55,.564,8,25,.320,37,42,.881,123
5974,2017-01-28,PHO,,DEN,L 112-123,240,41,91,.451,35,70,.500,6,21,.286,24,32,.750,112
5975,2017-01-28,MEM,@,UTA,W 102-95,240,41,80,.513,30,54,.556,11,26,.423,9,10,.900,102
5976,2017-01-28,UTA,,MEM,L 95-102,240,29,62,.468,19,37,.514,10,25,.400,27,29,.931,95
5977,2017-01-27,ATL,,WAS,L 86-112,240,30,83,.361,21,52,.404,9,31,.290,17,25,.680,86
5978,2017-01-27,WAS,@,ATL,W 112-86,240,43,89,.483,30,58,.517,13,31,.419,13,19,.684,112
5979,2017-01-27,BOS,,ORL,W 128-98,240,50,89,.562,34,55,.618,16,34,.471,12,15,.800,128
5980,2017-01-27,ORL,@,BOS,L 98-128,240,38,87,.437,29,62,.468,9,25,.360,13,18,.722,98
5981,2017-01-27,CHI,,MIA,L 88-100,240,33,78,.423,30,65,.462,3,13,.231,19,25,.760,88
5982,2017-01-27,MIA,@,CHI,W 100-88,240,41,89,.461,32,65,.492,9,24,.375,9,11,.818,100
5983,2017-01-27,BRK,@,CLE,L 116-124,240,43,87,.494,27,54,.500,16,33,.485,14,16,.875,116
5984,2017-01-27,CLE,,BRK,W 124-116,240,49,92,.533,36,56,.643,13,36,.361,13,20,.650,124
5985,2017-01-27,IND,,SAC,W 115-111 (OT),265,38,78,.487,28,50,.560,10,28,.357,29,33,.879,115
5986,2017-01-27,SAC,@,IND,L 111-115 (OT),265,35,70,.500,22,45,.489,13,25,.520,28,36,.778,111
5987,2017-01-27,NOP,,SAS,W 119-103,240,48,93,.516,35,63,.556,13,30,.433,10,14,.714,119
5988,2017-01-27,SAS,@,NOP,L 103-119,240,33,85,.388,21,57,.368,12,28,.429,25,29,.862,103
5989,2017-01-27,CHA,@,NYK,L 107-110,240,40,90,.444,27,53,.509,13,37,.351,14,15,.933,107
5990,2017-01-27,NYK,,CHO,W 110-107,240,46,96,.479,37,69,.536,9,27,.333,9,13,.692,110
5991,2017-01-27,HOU,@,PHI,W 123-118,240,42,81,.519,30,50,.600,12,31,.387,27,28,.964,123
5992,2017-01-27,PHI,,HOU,L 118-123,240,42,78,.538,32,53,.604,10,25,.400,24,32,.750,118
5993,2017-01-27,MEM,@,POR,L 109-112,240,37,77,.481,28,51,.549,9,26,.346,26,33,.788,109
5994,2017-01-27,POR,,MEM,W 112-109,240,38,81,.469,22,46,.478,16,35,.457,20,21,.952,112
5995,2017-01-27,MIL,@,TOR,L 86-102,240,31,80,.388,24,57,.421,7,23,.304,17,24,.708,86
5996,2017-01-27,TOR,,MIL,W 102-86,240,37,84,.440,27,59,.458,10,25,.400,18,23,.783,102
5997,2017-01-26,DEN,,PHO,W 127-120,240,44,86,.512,35,63,.556,9,23,.391,30,35,.857,127
5998,2017-01-26,PHO,@,DEN,L 120-127,240,48,89,.539,38,65,.585,10,24,.417,14,17,.824,120
5999,2017-01-26,IND,@,MIN,W 109-103,240,42,81,.519,32,63,.508,10,18,.556,15,17,.882,109
6000,2017-01-26,MIN,,IND,L 103-109,240,36,81,.444,26,54,.481,10,27,.370,21,27,.778,103
6001,2017-01-26,DAL,@,OKC,L 98-109,240,38,84,.452,27,58,.466,11,26,.423,11,13,.846,98
6002,2017-01-26,OKC,,DAL,W 109-98,240,37,72,.514,28,50,.560,9,22,.409,26,36,.722,109
6003,2017-01-26,LAL,@,UTA,L 88-96,240,36,84,.429,32,70,.457,4,14,.286,12,13,.923,88
6004,2017-01-26,UTA,,LAL,W 96-88,240,33,81,.407,27,55,.491,6,26,.231,24,28,.857,96
6005,2017-01-25,BOS,,HOU,W 120-109,240,47,91,.516,36,59,.610,11,32,.344,15,16,.938,120
6006,2017-01-25,HOU,@,BOS,L 109-120,240,36,77,.468,26,46,.565,10,31,.323,27,38,.711,109
6007,2017-01-25,BRK,,MIA,L 106-109,240,35,80,.438,22,45,.489,13,35,.371,23,26,.885,106
6008,2017-01-25,MIA,@,BRK,W 109-106,240,40,83,.482,29,60,.483,11,23,.478,18,25,.720,109
6009,2017-01-25,ATL,@,CHI,W 119-114,240,43,83,.518,26,53,.491,17,30,.567,16,19,.842,119
6010,2017-01-25,CHI,,ATL,L 114-119,240,43,94,.457,35,67,.522,8,27,.296,20,26,.769,114
6011,2017-01-25,CHA,,GSW,L 103-113,240,38,92,.413,31,69,.449,7,23,.304,20,21,.952,103
6012,2017-01-25,GSW,@,CHO,W 113-103,240,39,82,.476,28,54,.519,11,28,.393,24,27,.889,113
6013,2017-01-25,CLE,,SAC,L 112-116 (OT),265,40,82,.488,25,44,.568,15,38,.395,17,34,.500,112
6014,2017-01-25,SAC,@,CLE,W 116-112 (OT),265,43,95,.453,32,64,.500,11,31,.355,19,22,.864,116
6015,2017-01-25,DAL,,NYK,W 103-95,240,39,83,.470,33,57,.579,6,26,.231,19,24,.792,103
6016,2017-01-25,NYK,@,DAL,L 95-103,240,39,92,.424,32,69,.464,7,23,.304,10,12,.833,95
6017,2017-01-25,MEM,,TOR,W 101-99,240,36,78,.462,26,56,.464,10,22,.455,19,25,.760,101
6018,2017-01-25,TOR,@,MEM,L 99-101,240,39,92,.424,29,58,.500,10,34,.294,11,19,.579,99
6019,2017-01-25,MIL,,PHI,L 109-114,240,42,91,.462,35,63,.556,7,28,.250,18,23,.783,109
6020,2017-01-25,PHI,@,MIL,W 114-109,240,40,75,.533,28,49,.571,12,26,.462,22,25,.880,114
6021,2017-01-25,NOP,,OKC,L 105-114,240,41,96,.427,30,69,.435,11,27,.407,12,19,.632,105
6022,2017-01-25,OKC,@,NOP,W 114-105,240,42,91,.462,32,64,.500,10,27,.370,20,28,.714,114
6023,2017-01-25,LAL,@,POR,L 98-105,240,37,94,.394,26,64,.406,11,30,.367,13,14,.929,98
6024,2017-01-25,POR,,LAL,W 105-98,240,43,90,.478,39,75,.520,4,15,.267,15,20,.750,105
6025,2017-01-24,DEN,,UTA,W 103-93,240,35,76,.461,25,50,.500,10,26,.385,23,31,.742,103
6026,2017-01-24,UTA,@,DEN,L 93-103,240,35,85,.412,28,63,.444,7,22,.318,16,21,.762,93
6027,2017-01-24,CHI,@,ORL,W 100-92,240,35,77,.455,28,55,.509,7,22,.318,23,30,.767,100
6028,2017-01-24,ORL,,CHI,L 92-100,240,35,85,.412,28,63,.444,7,22,.318,15,20,.750,92
6029,2017-01-24,LAC,@,PHI,L 110-121,240,33,71,.465,15,37,.405,18,34,.529,26,41,.634,110
6030,2017-01-24,PHI,,LAC,W 121-110,240,45,90,.500,35,61,.574,10,29,.345,21,22,.955,121
6031,2017-01-24,MIN,@,PHO,W 112-111,240,44,84,.524,38,67,.567,6,17,.353,18,24,.750,112
6032,2017-01-24,PHO,,MIN,L 111-112,240,38,86,.442,31,67,.463,7,19,.368,28,32,.875,111
6033,2017-01-24,SAS,@,TOR,W 108-106,240,38,85,.447,31,61,.508,7,24,.292,25,33,.758,108
6034,2017-01-24,TOR,,SAS,L 106-108,240,38,84,.452,32,59,.542,6,25,.240,24,28,.857,106
6035,2017-01-24,BOS,@,WAS,L 108-123,240,38,84,.452,28,51,.549,10,33,.303,22,24,.917,108
6036,2017-01-24,WAS,,BOS,W 123-108,240,48,84,.571,39,64,.609,9,20,.450,18,21,.857,123
6037,2017-01-23,ATL,,LAC,L 105-115,240,37,88,.420,28,59,.475,9,29,.310,22,26,.846,105
6038,2017-01-23,LAC,@,ATL,W 115-105,240,42,84,.500,28,60,.467,14,24,.583,17,22,.773,115
6039,2017-01-23,BRK,,SAS,L 86-112,240,32,81,.395,27,56,.482,5,25,.200,17,18,.944,86
6040,2017-01-23,SAS,@,BRK,W 112-86,240,45,95,.474,36,73,.493,9,22,.409,13,16,.813,112
6041,2017-01-23,CHA,,WAS,L 99-109,240,35,90,.389,27,58,.466,8,32,.250,21,25,.840,99
6042,2017-01-23,WAS,@,CHO,W 109-99,240,43,80,.538,33,55,.600,10,25,.400,13,17,.765,109
6043,2017-01-23,DET,,SAC,L 104-109,240,41,82,.500,31,54,.574,10,28,.357,12,17,.706,104
6044,2017-01-23,SAC,@,DET,W 109-104,240,40,82,.488,31,61,.508,9,21,.429,20,26,.769,109
6045,2017-01-23,IND,,NYK,L 103-109,240,38,86,.442,31,60,.517,7,26,.269,20,25,.800,103
6046,2017-01-23,NYK,@,IND,W 109-103,240,35,76,.461,27,54,.500,8,22,.364,31,35,.886,109
6047,2017-01-23,GSW,@,MIA,L 102-105,240,41,88,.466,33,58,.569,8,30,.267,12,20,.600,102
6048,2017-01-23,MIA,,GSW,W 105-102,240,38,86,.442,25,56,.446,13,30,.433,16,27,.593,105
6049,2017-01-23,HOU,@,MIL,L 114-127,240,39,77,.506,25,42,.595,14,35,.400,22,28,.786,114
6050,2017-01-23,MIL,,HOU,W 127-114,240,47,80,.588,36,57,.632,11,23,.478,22,27,.815,127
6051,2017-01-23,CLE,@,NOP,L 122-124,240,43,93,.462,28,56,.500,15,37,.405,21,25,.840,122
6052,2017-01-23,NOP,,CLE,W 124-122,240,43,87,.494,27,48,.563,16,39,.410,22,30,.733,124
6053,2017-01-23,OKC,@,UTA,W 97-95,240,36,83,.434,30,63,.476,6,20,.300,19,25,.760,97
6054,2017-01-23,UTA,,OKC,L 95-97,240,36,84,.429,31,63,.492,5,21,.238,18,26,.692,95
6055,2017-01-22,DAL,,LAL,W 122-73,240,43,87,.494,26,48,.542,17,39,.436,19,19,1.000,122
6056,2017-01-22,LAL,@,DAL,L 73-122,240,28,73,.384,25,52,.481,3,21,.143,14,17,.824,73
6057,2017-01-22,DEN,@,MIN,L 108-111,240,42,82,.512,35,58,.603,7,24,.292,17,21,.810,108
6058,2017-01-22,MIN,,DEN,W 111-108,240,45,85,.529,39,70,.557,6,15,.400,15,21,.714,111
6059,2017-01-22,GSW,@,ORL,W 118-98,240,42,89,.472,23,47,.489,19,42,.452,15,19,.789,118
6060,2017-01-22,ORL,,GSW,L 98-118,240,42,96,.438,35,68,.515,7,28,.250,7,16,.438,98
6061,2017-01-22,PHO,@,TOR,W 115-103,240,40,79,.506,31,57,.544,9,22,.409,26,28,.929,115
6062,2017-01-22,TOR,,PHO,L 103-115,240,33,83,.398,26,56,.464,7,27,.259,30,35,.857,103
6063,2017-01-21,ATL,,PHI,W 110-93,240,45,91,.495,38,71,.535,7,20,.350,13,23,.565,110
6064,2017-01-21,PHI,@,ATL,L 93-110,240,33,78,.423,21,49,.429,12,29,.414,15,18,.833,93
6065,2017-01-21,BOS,,POR,L 123-127 (OT),265,42,92,.457,29,57,.509,13,35,.371,26,31,.839,123
6066,2017-01-21,POR,@,BOS,W 127-123 (OT),265,43,92,.467,33,67,.493,10,25,.400,31,36,.861,127
6067,2017-01-21,CHI,,SAC,W 102-99,240,34,83,.410,28,66,.424,6,17,.353,28,33,.848,102
6068,2017-01-21,SAC,@,CHI,L 99-102,240,37,84,.440,28,58,.483,9,26,.346,16,21,.762,99
6069,2017-01-21,BRK,@,CHO,L 105-112,240,38,88,.432,21,47,.447,17,41,.415,12,15,.800,105
6070,2017-01-21,CHA,,BRK,W 112-105,240,39,82,.476,25,52,.481,14,30,.467,20,22,.909,112
6071,2017-01-21,CLE,,SAS,L 115-118 (OT),265,45,91,.495,32,57,.561,13,34,.382,12,22,.545,115
6072,2017-01-21,SAS,@,CLE,W 118-115 (OT),265,48,96,.500,38,70,.543,10,26,.385,12,14,.857,118
6073,2017-01-21,DEN,,LAC,W 123-98,240,46,87,.529,36,63,.571,10,24,.417,21,26,.808,123
6074,2017-01-21,LAC,@,DEN,L 98-123,240,40,96,.417,30,64,.469,10,32,.313,8,8,1.000,98
6075,2017-01-21,DET,,WAS,W 113-112,240,43,87,.494,32,59,.542,11,28,.393,16,22,.727,113
6076,2017-01-21,WAS,@,DET,L 112-113,240,39,91,.429,31,65,.477,8,26,.308,26,33,.788,112
6077,2017-01-21,HOU,@,MEM,W 119-95,240,41,80,.513,25,38,.658,16,42,.381,21,25,.840,119
6078,2017-01-21,MEM,,HOU,L 95-119,240,33,89,.371,24,55,.436,9,34,.265,20,28,.714,95
6079,2017-01-21,MIA,,MIL,W 109-97,240,41,77,.532,28,47,.596,13,30,.433,14,22,.636,109
6080,2017-01-21,MIL,@,MIA,L 97-109,240,33,79,.418,27,61,.443,6,18,.333,25,32,.781,97
6081,2017-01-21,NYK,,PHO,L 105-107,240,40,89,.449,29,68,.426,11,21,.524,14,16,.875,105
6082,2017-01-21,PHO,@,NYK,W 107-105,240,37,85,.435,28,61,.459,9,24,.375,24,27,.889,107
6083,2017-01-21,IND,@,UTA,L 100-109,240,39,77,.506,29,57,.509,10,20,.500,12,17,.706,100
6084,2017-01-21,UTA,,IND,W 109-100,240,39,84,.464,33,60,.550,6,24,.250,25,32,.781,109
6085,2017-01-20,ATL,,CHI,W 102-93,240,39,82,.476,30,60,.500,9,22,.409,15,19,.789,102
6086,2017-01-20,CHI,@,ATL,L 93-102,240,34,81,.420,27,53,.509,7,28,.250,18,19,.947,93
6087,2017-01-20,CHA,,TOR,W 113-78,240,40,80,.500,28,55,.509,12,25,.480,21,25,.840,113
6088,2017-01-20,TOR,@,CHO,L 78-113,240,29,86,.337,22,56,.393,7,30,.233,13,14,.929,78
6089,2017-01-20,DAL,,UTA,L 107-112 (OT),265,39,87,.448,31,64,.484,8,23,.348,21,28,.750,107
6090,2017-01-20,UTA,@,DAL,W 112-107 (OT),265,38,83,.458,30,60,.500,8,23,.348,28,39,.718,112
6091,2017-01-20,GSW,@,HOU,W 125-108,240,47,89,.528,32,51,.627,15,38,.395,16,21,.762,125
6092,2017-01-20,HOU,,GSW,L 108-125,240,43,96,.448,36,61,.590,7,35,.200,15,18,.833,108
6093,2017-01-20,IND,@,LAL,L 95-108,240,34,80,.425,25,57,.439,9,23,.391,18,25,.720,95
6094,2017-01-20,LAL,,IND,W 108-95,240,41,87,.471,27,54,.500,14,33,.424,12,15,.800,108
6095,2017-01-20,MEM,,SAC,W 107-91,240,38,83,.458,27,55,.491,11,28,.393,20,25,.800,107
6096,2017-01-20,SAC,@,MEM,L 91-107,240,31,76,.408,25,47,.532,6,29,.207,23,32,.719,91
6097,2017-01-20,BRK,@,NOP,W 143-114,240,48,83,.578,33,53,.623,15,30,.500,32,35,.914,143
6098,2017-01-20,NOP,,BRK,L 114-143,240,43,105,.410,32,71,.451,11,34,.324,17,23,.739,114
6099,2017-01-20,MIL,@,ORL,L 96-112,240,34,83,.410,24,58,.414,10,25,.400,18,26,.692,96
6100,2017-01-20,ORL,,MIL,W 112-96,240,40,87,.460,32,59,.542,8,28,.286,24,31,.774,112
6101,2017-01-20,PHI,,POR,W 93-92,240,36,92,.391,24,63,.381,12,29,.414,9,16,.563,93
6102,2017-01-20,POR,@,PHI,L 92-93,240,33,89,.371,27,70,.386,6,19,.316,20,28,.714,92
6103,2017-01-19,CLE,,PHO,W 118-103,240,43,85,.506,24,43,.558,19,42,.452,13,19,.684,118
6104,2017-01-19,PHO,@,CLE,L 103-118,240,37,85,.435,33,66,.500,4,19,.211,25,31,.806,103
6105,2017-01-19,LAC,,MIN,L 101-104,240,42,87,.483,38,65,.585,4,22,.182,13,24,.542,101
6106,2017-01-19,MIN,@,LAC,W 104-101,240,40,84,.476,35,68,.515,5,16,.313,19,25,.760,104
6107,2017-01-19,DAL,@,MIA,L 95-99,240,37,82,.451,23,46,.500,14,36,.389,7,11,.636,95
6108,2017-01-19,MIA,,DAL,W 99-95,240,35,73,.479,26,53,.491,9,20,.450,20,29,.690,99
6109,2017-01-19,NYK,,WAS,L 110-113,240,42,90,.467,35,66,.530,7,24,.292,19,22,.864,110
6110,2017-01-19,WAS,@,NYK,W 113-110,240,44,88,.500,31,56,.554,13,32,.406,12,14,.857,113
6111,2017-01-19,DEN,@,SAS,L 104-118,240,37,91,.407,27,60,.450,10,31,.323,20,26,.769,104
6112,2017-01-19,SAS,,DEN,W 118-104,240,44,86,.512,35,64,.547,9,22,.409,21,25,.840,118
6113,2017-01-18,BOS,,NYK,L 106-117,240,35,91,.385,26,58,.448,9,33,.273,27,29,.931,106
6114,2017-01-18,NYK,@,BOS,W 117-106,240,46,91,.505,36,66,.545,10,25,.400,15,18,.833,117
6115,2017-01-18,CHA,,POR,W 107-85,240,41,87,.471,30,61,.492,11,26,.423,14,17,.824,107
6116,2017-01-18,POR,@,CHO,L 85-107,240,33,94,.351,25,63,.397,8,31,.258,11,11,1.000,85
6117,2017-01-18,ATL,@,DET,L 95-118,240,30,78,.385,24,53,.453,6,25,.240,29,37,.784,95
6118,2017-01-18,DET,,ATL,W 118-95,240,45,91,.495,35,66,.530,10,25,.400,18,28,.643,118
6119,2017-01-18,GSW,,OKC,W 121-100,240,46,85,.541,36,64,.563,10,21,.476,19,27,.704,121
6120,2017-01-18,OKC,@,GSW,L 100-121,240,38,90,.422,30,62,.484,8,28,.286,16,19,.842,100
6121,2017-01-18,HOU,,MIL,W 111-92,240,43,95,.453,29,51,.569,14,44,.318,11,15,.733,111
6122,2017-01-18,MIL,@,HOU,L 92-111,240,37,93,.398,30,65,.462,7,28,.250,11,14,.786,92
6123,2017-01-18,NOP,,ORL,W 118-98,240,46,93,.495,31,57,.544,15,36,.417,11,15,.733,118
6124,2017-01-18,ORL,@,NOP,L 98-118,240,39,88,.443,28,56,.500,11,32,.344,9,11,.818,98
6125,2017-01-18,PHI,,TOR,W 94-89,240,31,69,.449,23,45,.511,8,24,.333,24,32,.750,94
6126,2017-01-18,TOR,@,PHI,L 89-94,240,34,86,.395,28,62,.452,6,24,.250,15,23,.652,89
6127,2017-01-18,IND,@,SAC,W 106-100,240,39,75,.520,32,54,.593,7,21,.333,21,25,.840,106
6128,2017-01-18,SAC,,IND,L 100-106,240,35,72,.486,26,51,.510,9,21,.429,21,27,.778,100
6129,2017-01-18,MEM,@,WAS,L 101-104,240,33,83,.398,25,58,.431,8,25,.320,27,34,.794,101
6130,2017-01-18,WAS,,MEM,W 104-101,240,36,80,.450,28,51,.549,8,29,.276,24,26,.923,104
6131,2017-01-17,BRK,,TOR,L 109-119,240,40,89,.449,33,63,.524,7,26,.269,22,24,.917,109
6132,2017-01-17,TOR,@,BRK,W 119-109,240,48,92,.522,38,73,.521,10,19,.526,13,16,.813,119
6133,2017-01-17,CHI,,DAL,L 98-99,240,37,82,.451,31,68,.456,6,14,.429,18,22,.818,98
6134,2017-01-17,DAL,@,CHI,W 99-98,240,37,78,.474,26,50,.520,11,28,.393,14,18,.778,99
6135,2017-01-17,DEN,@,LAL,W 127-121,240,50,88,.568,39,62,.629,11,26,.423,16,26,.615,127
6136,2017-01-17,LAL,,DEN,L 121-127,240,47,108,.435,36,78,.462,11,30,.367,16,18,.889,121
6137,2017-01-17,HOU,@,MIA,L 103-109,240,36,90,.400,27,51,.529,9,39,.231,22,28,.786,103
6138,2017-01-17,MIA,,HOU,W 109-103,240,42,90,.467,33,61,.541,9,29,.310,16,24,.667,109
6139,2017-01-17,MIN,@,SAS,L 114-122,240,36,73,.493,30,60,.500,6,13,.462,36,41,.878,114
6140,2017-01-17,SAS,,MIN,W 122-114,240,43,84,.512,35,66,.530,8,18,.444,28,35,.800,122
6141,2017-01-16,BOS,,CHO,W 108-98,240,42,84,.500,27,45,.600,15,39,.385,9,10,.900,108
6142,2017-01-16,CHA,@,BOS,L 98-108,240,38,86,.442,30,61,.492,8,25,.320,14,17,.824,98
6143,2017-01-16,DEN,,ORL,W 125-112,240,52,89,.584,43,62,.694,9,27,.333,12,15,.800,125
6144,2017-01-16,ORL,@,DEN,L 112-125,240,45,88,.511,37,63,.587,8,25,.320,14,18,.778,112
6145,2017-01-16,CLE,@,GSW,L 91-126,240,31,88,.352,22,54,.407,9,34,.265,20,27,.741,91
6146,2017-01-16,GSW,,CLE,W 126-91,240,46,91,.505,31,57,.544,15,34,.441,19,24,.792,126
6147,2017-01-16,IND,,NOP,W 98-95,240,41,81,.506,36,62,.581,5,19,.263,11,16,.688,98
6148,2017-01-16,NOP,@,IND,L 95-98,240,36,83,.434,26,58,.448,10,25,.400,13,18,.722,95
6149,2017-01-16,LAC,,OKC,W 120-98,240,45,82,.549,33,54,.611,12,28,.429,18,22,.818,120
6150,2017-01-16,OKC,@,LAC,L 98-120,240,36,85,.424,26,55,.473,10,30,.333,16,19,.842,98
6151,2017-01-16,MIL,,PHI,L 104-113,240,42,89,.472,37,75,.493,5,14,.357,15,22,.682,104
6152,2017-01-16,PHI,@,MIL,W 113-104,240,35,78,.449,21,41,.512,14,37,.378,29,36,.806,113
6153,2017-01-16,ATL,@,NYK,W 108-107,240,40,87,.460,28,55,.509,12,32,.375,16,23,.696,108
6154,2017-01-16,NYK,,ATL,L 107-108,240,42,85,.494,34,59,.576,8,26,.308,15,23,.652,107
6155,2017-01-16,PHO,,UTA,L 101-106,240,40,81,.494,35,59,.593,5,22,.227,16,17,.941,101
6156,2017-01-16,UTA,@,PHO,W 106-101,240,41,89,.461,33,66,.500,8,23,.348,16,24,.667,106
6157,2017-01-16,POR,@,WAS,L 101-120,240,37,88,.420,29,62,.468,8,26,.308,19,25,.760,101
6158,2017-01-16,WAS,,POR,W 120-101,240,42,86,.488,29,63,.460,13,23,.565,23,25,.920,120
6159,2017-01-15,ATL,,MIL,W 111-98,240,42,80,.525,29,54,.537,13,26,.500,14,18,.778,111
6160,2017-01-15,MIL,@,ATL,L 98-111,240,39,79,.494,33,60,.550,6,19,.316,14,18,.778,98
6161,2017-01-15,BRK,,HOU,L 112-137,240,41,93,.441,26,49,.531,15,44,.341,15,19,.789,112
6162,2017-01-15,HOU,@,BRK,W 137-112,240,46,92,.500,25,48,.521,21,44,.477,24,32,.750,137
6163,2017-01-15,DAL,,MIN,W 98-87,240,36,77,.468,24,48,.500,12,29,.414,14,19,.737,98
6164,2017-01-15,MIN,@,DAL,L 87-98,240,35,80,.438,30,59,.508,5,21,.238,12,18,.667,87
6165,2017-01-15,DET,@,LAL,W 102-97,240,41,95,.432,32,70,.457,9,25,.360,11,16,.688,102
6166,2017-01-15,LAL,,DET,L 97-102,240,36,83,.434,30,57,.526,6,26,.231,19,24,.792,97
6167,2017-01-15,CHI,@,MEM,W 108-104,240,40,78,.513,36,61,.590,4,17,.235,24,35,.686,108
6168,2017-01-15,MEM,,CHI,L 104-108,240,40,95,.421,29,63,.460,11,32,.344,13,13,1.000,104
6169,2017-01-15,OKC,@,SAC,W 122-118,240,40,90,.444,31,62,.500,9,28,.321,33,41,.805,122
6170,2017-01-15,SAC,,OKC,L 118-122,240,37,81,.457,28,56,.500,9,25,.360,35,40,.875,118
6171,2017-01-15,NYK,@,TOR,L 101-116,240,35,84,.417,23,55,.418,12,29,.414,19,27,.704,101
6172,2017-01-15,TOR,,NYK,W 116-101,240,44,89,.494,36,67,.537,8,22,.364,20,23,.870,116
6173,2017-01-14,CHI,,NOP,W 107-99,240,43,101,.426,35,81,.432,8,20,.400,13,23,.565,107
6174,2017-01-14,NOP,@,CHI,L 99-107,240,39,84,.464,32,61,.525,7,23,.304,14,21,.667,99
6175,2017-01-14,LAC,,LAL,W 113-97,240,48,92,.522,38,64,.594,10,28,.357,7,8,.875,113
6176,2017-01-14,LAL,@,LAC,L 97-113,240,36,80,.450,26,59,.441,10,21,.476,15,27,.556,97
6177,2017-01-14,PHO,,SAS,W 108-105,240,39,85,.459,31,64,.484,8,21,.381,22,24,.917,108
6178,2017-01-14,SAS,@,PHO,L 105-108,240,36,71,.507,27,51,.529,9,20,.450,24,34,.706,105
6179,2017-01-14,ORL,@,UTA,L 107-114,240,38,82,.463,26,48,.542,12,34,.353,19,27,.704,107
6180,2017-01-14,UTA,,ORL,W 114-107,240,41,83,.494,34,57,.596,7,26,.269,25,36,.694,114
6181,2017-01-14,PHI,@,WAS,L 93-109,240,36,87,.414,26,56,.464,10,31,.323,11,21,.524,93
6182,2017-01-14,WAS,,PHI,W 109-93,240,44,91,.484,36,74,.486,8,17,.471,13,18,.722,109
6183,2017-01-13,ATL,,BOS,L 101-103,240,36,84,.429,25,54,.463,11,30,.367,18,21,.857,101
6184,2017-01-13,BOS,@,ATL,W 103-101,240,36,83,.434,19,39,.487,17,44,.386,14,19,.737,103
6185,2017-01-13,HOU,,MEM,L 105-110,240,33,82,.402,23,41,.561,10,41,.244,29,36,.806,105
6186,2017-01-13,MEM,@,HOU,W 110-105,240,41,76,.539,31,49,.633,10,27,.370,18,27,.667,110
6187,2017-01-13,MIA,@,MIL,L 108-116,240,41,83,.494,29,51,.569,12,32,.375,14,18,.778,108
6188,2017-01-13,MIL,,MIA,W 116-108,240,40,80,.500,31,65,.477,9,15,.600,27,31,.871,116
6189,2017-01-13,MIN,,OKC,W 96-86,240,39,86,.453,34,68,.500,5,18,.278,13,14,.929,96
6190,2017-01-13,OKC,@,MIN,L 86-96,240,33,85,.388,30,65,.462,3,20,.150,17,21,.810,86
6191,2017-01-13,CHA,@,PHI,L 93-102,240,28,85,.329,22,62,.355,6,23,.261,31,32,.969,93
6192,2017-01-13,PHI,,CHO,W 102-93,240,36,76,.474,22,38,.579,14,38,.368,16,20,.800,102
6193,2017-01-13,ORL,@,POR,W 115-109,240,41,83,.494,31,65,.477,10,18,.556,23,26,.885,115
6194,2017-01-13,POR,,ORL,L 109-115,240,39,97,.402,29,63,.460,10,34,.294,21,25,.840,109
6195,2017-01-13,CLE,@,SAC,W 120-108,240,44,87,.506,29,50,.580,15,37,.405,17,22,.773,120
6196,2017-01-13,SAC,,CLE,L 108-120,240,42,80,.525,33,55,.600,9,25,.360,15,19,.789,108
6197,2017-01-13,BRK,@,TOR,L 113-132,240,40,86,.465,23,50,.460,17,36,.472,16,20,.800,113
6198,2017-01-13,TOR,,BRK,W 132-113,240,52,97,.536,41,69,.594,11,28,.393,17,21,.810,132
6199,2017-01-13,DET,@,UTA,L 77-110,240,30,76,.395,24,59,.407,6,17,.353,11,16,.688,77
6200,2017-01-13,UTA,,DET,W 110-77,240,43,80,.538,27,49,.551,16,31,.516,8,13,.615,110
6201,2017-01-12,BRK,,NOP,L 95-104,240,40,97,.412,31,55,.564,9,42,.214,6,11,.545,95
6202,2017-01-12,NOP,@,BRK,W 104-95,240,38,90,.422,27,58,.466,11,32,.344,17,25,.680,104
6203,2017-01-12,DEN,,IND,W 140-112,240,52,90,.578,37,58,.638,15,32,.469,21,23,.913,140
6204,2017-01-12,IND,@,DEN,L 112-140,240,44,94,.468,32,65,.492,12,29,.414,12,13,.923,112
6205,2017-01-12,DET,@,GSW,L 107-127,240,43,88,.489,37,60,.617,6,28,.214,15,20,.750,107
6206,2017-01-12,GSW,,DET,W 127-107,240,50,89,.562,35,60,.583,15,29,.517,12,18,.667,127
6207,2017-01-12,CHI,@,NYK,L 89-104,240,35,89,.393,32,71,.451,3,18,.167,16,21,.762,89
6208,2017-01-12,NYK,,CHI,W 104-89,240,44,92,.478,37,69,.536,7,23,.304,9,11,.818,104
6209,2017-01-12,DAL,@,PHO,W 113-108,240,43,89,.483,28,55,.509,15,34,.441,12,17,.706,113
6210,2017-01-12,PHO,,DAL,L 108-113,240,38,78,.487,28,60,.467,10,18,.556,22,27,.815,108
6211,2017-01-12,LAL,@,SAS,L 94-134,240,35,85,.412,29,65,.446,6,20,.300,18,25,.720,94
6212,2017-01-12,SAS,,LAL,W 134-94,240,49,81,.605,39,60,.650,10,21,.476,26,29,.897,134
6213,2017-01-11,BOS,,WAS,W 117-108,240,43,85,.506,26,44,.591,17,41,.415,14,18,.778,117
6214,2017-01-11,WAS,@,BOS,L 108-117,240,45,105,.429,35,79,.443,10,26,.385,8,12,.667,108
6215,2017-01-11,LAC,,ORL,W 105-96,240,39,76,.513,30,50,.600,9,26,.346,18,26,.692,105
6216,2017-01-11,ORL,@,LAC,L 96-105,240,39,92,.424,33,65,.508,6,27,.222,12,18,.667,96
6217,2017-01-11,HOU,@,MIN,L 105-119,240,36,87,.414,21,45,.467,15,42,.357,18,22,.818,105
6218,2017-01-11,MIN,,HOU,W 119-105,240,44,81,.543,36,58,.621,8,23,.348,23,25,.920,119
6219,2017-01-11,MEM,@,OKC,L 95-103,240,38,92,.413,31,68,.456,7,24,.292,12,21,.571,95
6220,2017-01-11,OKC,,MEM,W 103-95,240,36,81,.444,28,55,.509,8,26,.308,23,29,.793,103
6221,2017-01-11,NYK,@,PHI,L 97-98,240,42,86,.488,38,64,.594,4,22,.182,9,10,.900,97
6222,2017-01-11,PHI,,NYK,W 98-97,240,37,95,.389,30,67,.448,7,28,.250,17,21,.810,98
6223,2017-01-11,CLE,@,POR,L 86-102,240,28,82,.341,19,52,.365,9,30,.300,21,28,.750,86
6224,2017-01-11,POR,,CLE,W 102-86,240,40,93,.430,30,63,.476,10,30,.333,12,16,.750,102
6225,2017-01-10,ATL,@,BRK,W 117-97,240,44,92,.478,37,69,.536,7,23,.304,22,38,.579,117
6226,2017-01-10,BRK,,ATL,L 97-117,240,35,87,.402,25,58,.431,10,29,.345,17,23,.739,97
6227,2017-01-10,GSW,,MIA,W 107-95,240,39,86,.453,28,59,.475,11,27,.407,18,22,.818,107
6228,2017-01-10,MIA,@,GSW,L 95-107,240,38,90,.422,32,60,.533,6,30,.200,13,17,.765,95
6229,2017-01-10,CHA,@,HOU,L 114-121,240,44,92,.478,25,49,.510,19,43,.442,7,9,.778,114
6230,2017-01-10,HOU,,CHO,W 121-114,240,40,82,.488,23,43,.535,17,39,.436,24,33,.727,121
6231,2017-01-10,LAL,,POR,L 87-108,240,32,83,.386,23,59,.390,9,24,.375,14,26,.538,87
6232,2017-01-10,POR,@,LAL,W 108-87,240,43,85,.506,36,64,.563,7,21,.333,15,20,.750,108
6233,2017-01-10,DET,@,SAC,L 94-100,240,36,82,.439,24,55,.436,12,27,.444,10,16,.625,94
6234,2017-01-10,SAC,,DET,W 100-94,240,32,73,.438,19,50,.380,13,23,.565,23,29,.793,100
6235,2017-01-10,MIL,@,SAS,W 109-107,240,44,84,.524,34,65,.523,10,19,.526,11,13,.846,109
6236,2017-01-10,SAS,,MIL,L 107-109,240,42,88,.477,30,58,.517,12,30,.400,11,14,.786,107
6237,2017-01-10,BOS,@,TOR,L 106-114,240,40,85,.471,31,58,.534,9,27,.333,17,20,.850,106
6238,2017-01-10,TOR,,BOS,W 114-106,240,41,87,.471,31,65,.477,10,22,.455,22,27,.815,114
6239,2017-01-10,CLE,@,UTA,L 92-100,240,31,85,.365,22,54,.407,9,31,.290,21,25,.840,92
6240,2017-01-10,UTA,,CLE,W 100-92,240,38,79,.481,25,45,.556,13,34,.382,11,19,.579,100
6241,2017-01-10,CHI,@,WAS,L 99-101,240,35,88,.398,25,61,.410,10,27,.370,19,21,.905,99
6242,2017-01-10,WAS,,CHI,W 101-99,240,42,83,.506,31,61,.508,11,22,.500,6,9,.667,101
6243,2017-01-09,CHI,,OKC,L 94-109,240,34,83,.410,27,64,.422,7,19,.368,19,22,.864,94
6244,2017-01-09,OKC,@,CHI,W 109-94,240,47,83,.566,40,59,.678,7,24,.292,8,11,.727,109
6245,2017-01-09,DAL,@,MIN,L 92-101,240,36,78,.462,23,50,.460,13,28,.464,7,9,.778,92
6246,2017-01-09,MIN,,DAL,W 101-92,240,40,71,.563,34,55,.618,6,16,.375,15,21,.714,101
6247,2017-01-09,NOP,@,NYK,W 110-96,240,41,84,.488,29,57,.509,12,27,.444,16,19,.842,110
6248,2017-01-09,NYK,,NOP,L 96-110,240,36,85,.424,25,56,.446,11,29,.379,13,16,.813,96
6249,2017-01-08,BRK,,PHI,L 95-105,240,36,78,.462,26,51,.510,10,27,.370,13,17,.765,95
6250,2017-01-08,PHI,@,BRK,W 105-95,240,37,94,.394,29,67,.433,8,27,.296,23,27,.852,105
6251,2017-01-08,LAC,,MIA,W 98-86,240,36,86,.419,27,56,.482,9,30,.300,17,25,.680,98
6252,2017-01-08,MIA,@,LAC,L 86-98,240,31,84,.369,24,57,.421,7,27,.259,17,21,.810,86
6253,2017-01-08,LAL,,ORL,W 111-95,240,42,87,.483,34,55,.618,8,32,.250,19,24,.792,111
6254,2017-01-08,ORL,@,LAL,L 95-111,240,34,90,.378,27,64,.422,7,26,.269,20,29,.690,95
6255,2017-01-08,MEM,,UTA,W 88-79,240,34,78,.436,25,54,.463,9,24,.375,11,14,.786,88
6256,2017-01-08,UTA,@,MEM,L 79-88,240,28,72,.389,19,49,.388,9,23,.391,14,23,.609,79
6257,2017-01-08,MIL,,WAS,L 101-107,240,37,80,.463,28,57,.491,9,23,.391,18,20,.900,101
6258,2017-01-08,WAS,@,MIL,W 107-101,240,41,84,.488,31,52,.596,10,32,.313,15,18,.833,107
6259,2017-01-08,CLE,@,PHO,W 120-116,240,44,82,.537,29,48,.604,15,34,.441,17,19,.895,120
6260,2017-01-08,PHO,,CLE,L 116-120,240,46,87,.529,37,60,.617,9,27,.333,15,19,.789,116
6261,2017-01-08,DET,@,POR,W 125-124 (2OT),290,54,105,.514,46,80,.575,8,25,.320,9,12,.750,125
6262,2017-01-08,POR,,DET,L 124-125 (2OT),290,51,98,.520,36,63,.571,15,35,.429,7,12,.583,124
6263,2017-01-08,GSW,@,SAC,W 117-106,240,45,89,.506,35,60,.583,10,29,.345,17,20,.850,117
6264,2017-01-08,SAC,,GSW,L 106-117,240,36,74,.486,25,46,.543,11,28,.393,23,29,.793,106
6265,2017-01-08,HOU,@,TOR,W 129-122,240,46,89,.517,35,51,.686,11,38,.289,26,31,.839,129
6266,2017-01-08,TOR,,HOU,L 122-129,240,42,78,.538,31,53,.585,11,25,.440,27,30,.900,122
6267,2017-01-07,BOS,,NOP,W 117-108,240,40,93,.430,22,57,.386,18,36,.500,19,21,.905,117
6268,2017-01-07,NOP,@,BOS,L 108-117,240,40,85,.471,30,54,.556,10,31,.323,18,23,.783,108
6269,2017-01-07,CHI,,TOR,W 123-118 (OT),265,38,97,.392,27,69,.391,11,28,.393,36,39,.923,123
6270,2017-01-07,TOR,@,CHI,L 118-123 (OT),265,37,85,.435,29,54,.537,8,31,.258,36,43,.837,118
6271,2017-01-07,ATL,@,DAL,W 97-82,240,30,74,.405,19,52,.365,11,22,.500,26,32,.813,97
6272,2017-01-07,DAL,,ATL,L 82-97,240,32,82,.390,23,46,.500,9,36,.250,9,10,.900,82
6273,2017-01-07,IND,,NYK,W 123-109,240,43,86,.500,32,62,.516,11,24,.458,26,28,.929,123
6274,2017-01-07,NYK,@,IND,L 109-123,240,40,87,.460,28,56,.500,12,31,.387,17,24,.708,109
6275,2017-01-07,MIN,,UTA,L 92-94,240,35,80,.438,28,60,.467,7,20,.350,15,21,.714,92
6276,2017-01-07,UTA,@,MIN,W 94-92,240,32,77,.416,24,54,.444,8,23,.348,22,28,.786,94
6277,2017-01-07,DEN,@,OKC,L 106-121,240,40,99,.404,31,75,.413,9,24,.375,17,24,.708,106
6278,2017-01-07,OKC,,DEN,W 121-106,240,43,89,.483,31,53,.585,12,36,.333,23,29,.793,121
6279,2017-01-07,CHA,@,SAS,L 85-102,240,30,75,.400,26,54,.481,4,21,.190,21,25,.840,85
6280,2017-01-07,SAS,,CHO,W 102-85,240,36,89,.404,23,55,.418,13,34,.382,17,20,.850,102
6281,2017-01-06,BOS,,PHI,W 110-106,240,35,87,.402,16,47,.340,19,40,.475,21,25,.840,110
6282,2017-01-06,PHI,@,BOS,L 106-110,240,37,79,.468,28,51,.549,9,28,.321,23,26,.885,106
6283,2017-01-06,BRK,,CLE,L 108-116,240,41,91,.451,32,61,.525,9,30,.300,17,19,.895,108
6284,2017-01-06,CLE,@,BRK,W 116-108,240,38,88,.432,29,55,.527,9,33,.273,31,43,.721,116
6285,2017-01-06,GSW,,MEM,L 119-128 (OT),265,41,83,.494,33,53,.623,8,30,.267,29,39,.744,119
6286,2017-01-06,MEM,@,GSW,W 128-119 (OT),265,50,103,.485,37,70,.529,13,33,.394,15,19,.789,128
6287,2017-01-06,LAL,,MIA,W 127-100,240,48,96,.500,38,68,.559,10,28,.357,21,29,.724,127
6288,2017-01-06,MIA,@,LAL,L 100-127,240,38,92,.413,30,60,.500,8,32,.250,16,27,.593,100
6289,2017-01-06,MIL,,NYK,L 111-116,240,39,78,.500,27,56,.482,12,22,.545,21,28,.750,111
6290,2017-01-06,NYK,@,MIL,W 116-111,240,41,83,.494,28,60,.467,13,23,.565,21,27,.778,116
6291,2017-01-06,HOU,@,ORL,W 100-93,240,39,86,.453,24,37,.649,15,49,.306,7,12,.583,100
6292,2017-01-06,ORL,,HOU,L 93-100,240,38,91,.418,30,68,.441,8,23,.348,9,13,.692,93
6293,2017-01-06,LAC,@,SAC,W 106-98,240,39,84,.464,26,53,.491,13,31,.419,15,21,.714,106
6294,2017-01-06,SAC,,LAC,L 98-106,240,36,87,.414,27,57,.474,9,30,.300,17,22,.773,98
6295,2017-01-06,MIN,@,WAS,L 105-112,240,42,88,.477,35,70,.500,7,18,.389,14,17,.824,105
6296,2017-01-06,WAS,,MIN,W 112-105,240,46,79,.582,34,57,.596,12,22,.545,8,9,.889,112
6297,2017-01-05,DAL,,PHO,L 95-102,240,36,79,.456,27,50,.540,9,29,.310,14,17,.824,95
6298,2017-01-05,PHO,@,DAL,W 102-95,240,38,85,.447,31,68,.456,7,17,.412,19,22,.864,102
6299,2017-01-05,DEN,,SAS,L 99-127,240,39,86,.453,32,61,.525,7,25,.280,14,17,.824,99
6300,2017-01-05,SAS,@,DEN,W 127-99,240,51,90,.567,39,66,.591,12,24,.500,13,17,.765,127
6301,2017-01-05,CHA,@,DET,L 114-115,240,37,91,.407,27,65,.415,10,26,.385,30,34,.882,114
6302,2017-01-05,DET,,CHO,W 115-114,240,39,97,.402,29,69,.420,10,28,.357,27,32,.844,115
6303,2017-01-05,HOU,,OKC,W 118-116,240,41,86,.477,26,47,.553,15,39,.385,21,30,.700,118
6304,2017-01-05,OKC,@,HOU,L 116-118,240,41,91,.451,29,61,.475,12,30,.400,22,27,.815,116
6305,2017-01-05,BRK,@,IND,L 109-121,240,41,90,.456,24,52,.462,17,38,.447,10,13,.769,109
6306,2017-01-05,IND,,BRK,W 121-109,240,48,93,.516,38,71,.535,10,22,.455,15,19,.789,121
6307,2017-01-05,ATL,@,NOP,W 99-94,240,38,90,.422,29,67,.433,9,23,.391,14,17,.824,99
6308,2017-01-05,NOP,,ATL,L 94-99,240,34,93,.366,19,58,.328,15,35,.429,11,14,.786,94
6309,2017-01-05,LAL,@,POR,L 109-118,240,36,86,.419,26,55,.473,10,31,.323,27,33,.818,109
6310,2017-01-05,POR,,LAL,W 118-109,240,43,81,.531,31,48,.646,12,33,.364,20,30,.667,118
6311,2017-01-05,TOR,,UTA,W 101-93,240,36,91,.396,28,70,.400,8,21,.381,21,28,.750,101
6312,2017-01-05,UTA,@,TOR,L 93-101,240,34,73,.466,27,53,.509,7,20,.350,18,21,.857,93
6313,2017-01-04,CHA,,OKC,W 123-112,240,37,80,.463,28,56,.500,9,24,.375,40,49,.816,123
6314,2017-01-04,OKC,@,CHO,L 112-123,240,42,96,.438,33,66,.500,9,30,.300,19,23,.826,112
6315,2017-01-04,CHI,@,CLE,W 106-94,240,41,85,.482,28,55,.509,13,30,.433,11,15,.733,106
6316,2017-01-04,CLE,,CHI,L 94-106,240,34,83,.410,26,58,.448,8,25,.320,18,24,.750,94
6317,2017-01-04,GSW,,POR,W 125-117,240,44,87,.506,31,51,.608,13,36,.361,24,29,.828,125
6318,2017-01-04,POR,@,GSW,L 117-125,240,40,89,.449,28,63,.444,12,26,.462,25,28,.893,117
6319,2017-01-04,LAC,,MEM,W 115-106,240,37,73,.507,28,50,.560,9,23,.391,32,45,.711,115
6320,2017-01-04,MEM,@,LAC,L 106-115,240,38,88,.432,27,60,.450,11,28,.393,19,25,.760,106
6321,2017-01-04,MIL,@,NYK,W 105-104,240,37,78,.474,28,50,.560,9,28,.321,22,31,.710,105
6322,2017-01-04,NYK,,MIL,L 104-105,240,42,94,.447,29,66,.439,13,28,.464,7,12,.583,104
6323,2017-01-04,ATL,@,ORL,W 111-92,240,44,81,.543,34,62,.548,10,19,.526,13,18,.722,111
6324,2017-01-04,ORL,,ATL,L 92-111,240,37,86,.430,28,58,.483,9,28,.321,9,10,.900,92
6325,2017-01-04,MIA,@,SAC,W 107-102,240,35,72,.486,23,44,.523,12,28,.429,25,29,.862,107
6326,2017-01-04,SAC,,MIA,L 102-107,240,40,78,.513,32,58,.552,8,20,.400,14,17,.824,102
6327,2017-01-03,BOS,,UTA,W 115-104,240,41,74,.554,24,43,.558,17,31,.548,16,17,.941,115
6328,2017-01-03,UTA,@,BOS,L 104-115,240,38,82,.463,27,56,.482,11,26,.423,17,21,.810,104
6329,2017-01-03,DAL,,WAS,W 113-105,240,37,78,.474,20,46,.435,17,32,.531,22,24,.917,113
6330,2017-01-03,WAS,@,DAL,L 105-113,240,41,92,.446,30,62,.484,11,30,.367,12,14,.857,105
6331,2017-01-03,DEN,,SAC,L 113-120,240,41,82,.500,23,44,.523,18,38,.474,13,13,1.000,113
6332,2017-01-03,SAC,@,DEN,W 120-113,240,46,88,.523,35,59,.593,11,29,.379,17,18,.944,120
6333,2017-01-03,DET,,IND,L 116-121,240,48,97,.495,38,68,.559,10,29,.345,10,12,.833,116
6334,2017-01-03,IND,@,DET,W 121-116,240,43,74,.581,34,58,.586,9,16,.563,26,30,.867,121
6335,2017-01-03,LAL,,MEM,W 116-102,240,42,82,.512,25,49,.510,17,33,.515,15,28,.536,116
6336,2017-01-03,MEM,@,LAL,L 102-116,240,30,77,.390,20,46,.435,10,31,.323,32,35,.914,102
6337,2017-01-03,MIN,@,PHI,L 91-93,240,33,82,.402,26,58,.448,7,24,.292,18,20,.900,91
6338,2017-01-03,PHI,,MIN,W 93-91,240,33,85,.388,26,53,.491,7,32,.219,20,25,.800,93
6339,2017-01-03,MIA,@,PHO,L 90-99,240,36,91,.396,30,68,.441,6,23,.261,12,16,.750,90
6340,2017-01-03,PHO,,MIA,W 99-90,240,36,77,.468,27,54,.500,9,23,.391,18,22,.818,99
6341,2017-01-03,SAS,,TOR,W 110-82,240,43,78,.551,30,54,.556,13,24,.542,11,15,.733,110
6342,2017-01-03,TOR,@,SAS,L 82-110,240,31,83,.373,27,65,.415,4,18,.222,16,22,.727,82
6343,2017-01-02,BRK,,UTA,L 89-101,240,33,78,.423,27,51,.529,6,27,.222,17,23,.739,89
6344,2017-01-02,UTA,@,BRK,W 101-89,240,39,93,.419,32,69,.464,7,24,.292,16,20,.800,101
6345,2017-01-02,CHI,,CHO,W 118-111,240,42,90,.467,35,67,.522,7,23,.304,27,29,.931,118
6346,2017-01-02,CHA,@,CHI,L 111-118,240,41,83,.494,32,64,.500,9,19,.474,20,22,.909,111
6347,2017-01-02,CLE,,NOP,W 90-82,240,34,90,.378,28,59,.475,6,31,.194,16,22,.727,90
6348,2017-01-02,NOP,@,CLE,L 82-90,240,32,88,.364,21,62,.339,11,26,.423,7,10,.700,82
6349,2017-01-02,DEN,@,GSW,L 119-127,240,48,101,.475,39,66,.591,9,35,.257,14,18,.778,119
6350,2017-01-02,GSW,,DEN,W 127-119,240,50,95,.526,39,70,.557,11,25,.440,16,21,.762,127
6351,2017-01-02,HOU,,WAS,W 101-91,240,37,86,.430,25,47,.532,12,39,.308,15,21,.714,101
6352,2017-01-02,WAS,@,HOU,L 91-101,240,38,87,.437,32,61,.525,6,26,.231,9,12,.750,91
6353,2017-01-02,LAC,,PHO,W 109-98,240,37,80,.463,30,64,.469,7,16,.438,28,38,.737,109
6354,2017-01-02,PHO,@,LAC,L 98-109,240,39,102,.382,37,87,.425,2,15,.133,18,22,.818,98
6355,2017-01-02,MIL,,OKC,W 98-94,240,38,79,.481,31,60,.517,7,19,.368,15,24,.625,98
6356,2017-01-02,OKC,@,MIL,L 94-98,240,36,78,.462,27,51,.529,9,27,.333,13,19,.684,94
6357,2017-01-02,NYK,,ORL,L 103-115,240,39,83,.470,31,62,.500,8,21,.381,17,24,.708,103
6358,2017-01-02,ORL,@,NYK,W 115-103,240,45,91,.495,30,60,.500,15,31,.484,10,14,.714,115
6359,2017-01-01,ATL,,SAS,W 114-112 (OT),265,42,92,.457,28,64,.438,14,28,.500,16,27,.593,114
6360,2017-01-01,SAS,@,ATL,L 112-114 (OT),265,42,90,.467,33,63,.524,9,27,.333,19,22,.864,112
6361,2017-01-01,IND,,ORL,W 117-104,240,43,86,.500,34,64,.531,9,22,.409,22,24,.917,117
6362,2017-01-01,ORL,@,IND,L 104-117,240,42,97,.433,32,59,.542,10,38,.263,10,11,.909,104
6363,2017-01-01,LAL,,TOR,L 114-123,240,37,92,.402,22,60,.367,15,32,.469,25,31,.806,114
6364,2017-01-01,TOR,@,LAL,W 123-114,240,42,75,.560,32,58,.552,10,17,.588,29,32,.906,123
6365,2017-01-01,DET,@,MIA,W 107-98,240,42,86,.488,33,64,.516,9,22,.409,14,22,.636,107
6366,2017-01-01,MIA,,DET,L 98-107,240,35,77,.455,21,51,.412,14,26,.538,14,18,.778,98
6367,2017-01-01,MIN,,POR,L 89-95,240,35,87,.402,28,64,.438,7,23,.304,12,18,.667,89
6368,2017-01-01,POR,@,MIN,W 95-89,240,36,73,.493,30,51,.588,6,22,.273,17,28,.607,95
6369,2016-12-31,CHI,,MIL,L 96-116,240,33,83,.398,23,56,.411,10,27,.370,20,28,.714,96
6370,2016-12-31,MIL,@,CHI,W 116-96,240,43,76,.566,34,61,.557,9,15,.600,21,27,.778,116
6371,2016-12-31,CHA,,CLE,L 109-121,240,40,78,.513,31,54,.574,9,24,.375,20,23,.870,109
6372,2016-12-31,CLE,@,CHO,W 121-109,240,43,85,.506,29,54,.537,14,31,.452,21,25,.840,121
6373,2016-12-31,HOU,,NYK,W 129-122,240,42,92,.457,21,37,.568,21,55,.382,24,29,.828,129
6374,2016-12-31,NYK,@,HOU,L 122-129,240,47,105,.448,37,73,.507,10,32,.313,18,25,.720,122
6375,2016-12-31,LAC,@,OKC,L 88-114,240,31,75,.413,23,45,.511,8,30,.267,18,21,.857,88
6376,2016-12-31,OKC,,LAC,W 114-88,240,37,78,.474,27,49,.551,10,29,.345,30,35,.857,114
6377,2016-12-31,MEM,@,SAC,W 112-98,240,44,87,.506,27,52,.519,17,35,.486,7,9,.778,112
6378,2016-12-31,SAC,,MEM,L 98-112,240,31,72,.431,20,44,.455,11,28,.393,25,28,.893,98
6379,2016-12-31,PHO,@,UTA,L 86-91,240,36,87,.414,29,70,.414,7,17,.412,7,10,.700,86
6380,2016-12-31,UTA,,PHO,W 91-86,240,35,73,.479,27,53,.509,8,20,.400,13,20,.650,91
6381,2016-12-30,ATL,,DET,W 105-98,240,39,88,.443,31,62,.500,8,26,.308,19,25,.760,105
6382,2016-12-30,DET,@,ATL,L 98-105,240,35,84,.417,26,53,.491,9,31,.290,19,21,.905,98
6383,2016-12-30,BOS,,MIA,W 117-114,240,38,74,.514,21,42,.500,17,32,.531,24,29,.828,117
6384,2016-12-30,MIA,@,BOS,L 114-117,240,48,90,.533,37,62,.597,11,28,.393,7,10,.700,114
6385,2016-12-30,DEN,,PHI,L 122-124,240,39,84,.464,28,57,.491,11,27,.407,33,41,.805,122
6386,2016-12-30,PHI,@,DEN,W 124-122,240,38,87,.437,22,54,.407,16,33,.485,32,40,.800,124
6387,2016-12-30,DAL,@,GSW,L 99-108,240,39,93,.419,31,61,.508,8,32,.250,13,15,.867,99
6388,2016-12-30,GSW,,DAL,W 108-99,240,42,84,.500,31,51,.608,11,33,.333,13,15,.867,108
6389,2016-12-30,HOU,,LAC,W 140-116,240,45,81,.556,31,41,.756,14,40,.350,36,43,.837,140
6390,2016-12-30,LAC,@,HOU,L 116-140,240,45,96,.469,32,63,.508,13,33,.394,13,16,.813,116
6391,2016-12-30,CHI,@,IND,L 101-111,240,35,84,.417,29,61,.475,6,23,.261,25,31,.806,101
6392,2016-12-30,IND,,CHI,W 111-101,240,39,81,.481,32,62,.516,7,19,.368,26,30,.867,111
6393,2016-12-30,MIL,@,MIN,L 99-116,240,40,74,.541,32,56,.571,8,18,.444,11,17,.647,99
6394,2016-12-30,MIN,,MIL,W 116-99,240,43,77,.558,30,52,.577,13,25,.520,17,21,.810,116
6395,2016-12-30,NOP,,NYK,W 104-92,240,38,85,.447,26,56,.464,12,29,.414,16,17,.941,104
6396,2016-12-30,NYK,@,NOP,L 92-104,240,35,93,.376,28,70,.400,7,23,.304,15,16,.938,92
6397,2016-12-30,POR,@,SAS,L 94-110,240,35,77,.455,29,57,.509,6,20,.300,18,21,.857,94
6398,2016-12-30,SAS,,POR,W 110-94,240,39,78,.500,28,56,.500,11,22,.500,21,25,.840,110
6399,2016-12-30,BRK,@,WAS,L 95-118,240,32,74,.432,22,49,.449,10,25,.400,21,25,.840,95
6400,2016-12-30,WAS,,BRK,W 118-95,240,47,83,.566,36,61,.590,11,22,.500,13,14,.929,118
6401,2016-12-29,CHA,,MIA,W 91-82,240,36,93,.387,31,67,.463,5,26,.192,14,18,.778,91
6402,2016-12-29,MIA,@,CHO,L 82-91,240,33,82,.402,23,54,.426,10,28,.357,6,13,.462,82
6403,2016-12-29,BOS,@,CLE,L 118-124,240,43,85,.506,31,48,.646,12,37,.324,20,21,.952,118
6404,2016-12-29,CLE,,BOS,W 124-118,240,43,83,.518,29,45,.644,14,38,.368,24,33,.727,124
6405,2016-12-29,DAL,@,LAL,W 101-89,240,38,77,.494,24,46,.522,14,31,.452,11,14,.786,101
6406,2016-12-29,LAL,,DAL,L 89-101,240,32,68,.471,25,49,.510,7,19,.368,18,25,.720,89
6407,2016-12-29,MEM,,OKC,W 114-80,240,43,82,.524,30,60,.500,13,22,.591,15,20,.750,114
6408,2016-12-29,OKC,@,MEM,L 80-114,240,25,74,.338,21,52,.404,4,22,.182,26,38,.684,80
6409,2016-12-29,PHO,,TOR,W 99-91,240,37,83,.446,28,62,.452,9,21,.429,16,23,.696,99
6410,2016-12-29,TOR,@,PHO,L 91-99,240,30,75,.400,23,48,.479,7,27,.259,24,29,.828,91
6411,2016-12-29,PHI,@,UTA,L 83-100,240,35,87,.402,29,63,.460,6,24,.250,7,8,.875,83
6412,2016-12-29,UTA,,PHI,W 100-83,240,35,73,.479,20,47,.426,15,26,.577,15,28,.536,100
6413,2016-12-28,ATL,,NYK,W 102-98 (OT),265,37,101,.366,30,74,.405,7,27,.259,21,27,.778,102
6414,2016-12-28,NYK,@,ATL,L 98-102 (OT),265,35,93,.376,28,66,.424,7,27,.259,21,26,.808,98
6415,2016-12-28,BRK,@,CHI,L 99-101,240,37,86,.430,24,54,.444,13,32,.406,12,16,.750,99
6416,2016-12-28,CHI,,BRK,W 101-99,240,35,88,.398,32,75,.427,3,13,.231,28,29,.966,101
6417,2016-12-28,DEN,,MIN,W 105-103,240,42,81,.519,32,53,.604,10,28,.357,11,14,.786,105
6418,2016-12-28,MIN,@,DEN,L 103-105,240,42,94,.447,35,69,.507,7,25,.280,12,17,.706,103
6419,2016-12-28,DET,,MIL,L 94-119,240,39,88,.443,33,64,.516,6,24,.250,10,16,.625,94
6420,2016-12-28,MIL,@,DET,W 119-94,240,48,84,.571,37,62,.597,11,22,.500,12,16,.750,119
6421,2016-12-28,GSW,,TOR,W 121-111,240,46,81,.568,32,58,.552,14,23,.609,15,18,.833,121
6422,2016-12-28,TOR,@,GSW,L 111-121,240,40,103,.388,27,68,.397,13,35,.371,18,22,.818,111
6423,2016-12-28,LAC,@,NOP,L 98-102,240,37,94,.394,26,57,.456,11,37,.297,13,18,.722,98
6424,2016-12-28,NOP,,LAC,W 102-98,240,40,87,.460,30,58,.517,10,29,.345,12,21,.571,102
6425,2016-12-28,CHA,@,ORL,W 120-101,240,46,84,.548,36,60,.600,10,24,.417,18,19,.947,120
6426,2016-12-28,ORL,,CHO,L 101-120,240,42,86,.488,33,52,.635,9,34,.265,8,10,.800,101
6427,2016-12-28,POR,,SAC,W 102-89,240,35,74,.473,23,49,.469,12,25,.480,20,22,.909,102
6428,2016-12-28,SAC,@,POR,L 89-102,240,31,79,.392,22,51,.431,9,28,.321,18,23,.783,89
6429,2016-12-28,PHO,@,SAS,L 98-119,240,36,74,.486,29,58,.500,7,16,.438,19,24,.792,98
6430,2016-12-28,SAS,,PHO,W 119-98,240,47,87,.540,42,70,.600,5,17,.294,20,25,.800,119
6431,2016-12-28,IND,@,WAS,L 105-111,240,35,79,.443,24,51,.471,11,28,.393,24,29,.828,105
6432,2016-12-28,WAS,,IND,W 111-105,240,38,78,.487,30,56,.536,8,22,.364,27,37,.730,111
6433,2016-12-27,BOS,,MEM,W 113-103,240,41,85,.482,29,54,.537,12,31,.387,19,21,.905,113
6434,2016-12-27,MEM,@,BOS,L 103-113,240,37,88,.420,28,58,.483,9,30,.300,20,29,.690,103
6435,2016-12-27,DAL,,HOU,L 107-123,240,36,87,.414,21,49,.429,15,38,.395,20,25,.800,107
6436,2016-12-27,HOU,@,DAL,W 123-107,240,41,78,.526,24,46,.522,17,32,.531,24,28,.857,123
6437,2016-12-27,LAL,,UTA,L 100-102,240,39,83,.470,35,67,.522,4,16,.250,18,22,.818,100
6438,2016-12-27,UTA,@,LAL,W 102-100,240,38,75,.507,29,49,.592,9,26,.346,17,24,.708,102
6439,2016-12-27,MIA,,OKC,L 94-106,240,36,82,.439,29,60,.483,7,22,.318,15,21,.714,94
6440,2016-12-27,OKC,@,MIA,W 106-94,240,42,82,.512,37,63,.587,5,19,.263,17,25,.680,106
6441,2016-12-26,BRK,,CHO,W 120-118,240,40,75,.533,25,44,.568,15,31,.484,25,31,.806,120
6442,2016-12-26,CHA,@,BRK,L 118-120,240,44,94,.468,36,68,.529,8,26,.308,22,25,.880,118
6443,2016-12-26,CHI,,IND,W 90-85,240,32,83,.386,26,58,.448,6,25,.240,20,28,.714,90
6444,2016-12-26,IND,@,CHI,L 85-90,240,34,81,.420,25,56,.446,9,25,.360,8,10,.800,85
6445,2016-12-26,CLE,@,DET,L 90-106,240,30,79,.380,19,51,.373,11,28,.393,19,23,.826,90
6446,2016-12-26,DET,,CLE,W 106-90,240,41,92,.446,25,64,.391,16,28,.571,8,15,.533,106
6447,2016-12-26,HOU,,PHO,W 131-115,240,46,92,.500,31,49,.633,15,43,.349,24,30,.800,131
6448,2016-12-26,PHO,@,HOU,L 115-131,240,43,101,.426,36,71,.507,7,30,.233,22,27,.815,115
6449,2016-12-26,DEN,@,LAC,W 106-102,240,36,82,.439,25,51,.490,11,31,.355,23,28,.821,106
6450,2016-12-26,LAC,,DEN,L 102-106,240,39,84,.464,30,59,.508,9,25,.360,15,20,.750,102
6451,2016-12-26,ATL,@,MIN,L 90-104,240,35,83,.422,27,51,.529,8,32,.250,12,17,.706,90
6452,2016-12-26,MIN,,ATL,W 104-90,240,37,82,.451,22,51,.431,15,31,.484,15,18,.833,104
6453,2016-12-26,DAL,@,NOP,L 104-111,240,37,75,.493,24,43,.558,13,32,.406,17,22,.773,104
6454,2016-12-26,NOP,,DAL,W 111-104,240,37,70,.529,25,45,.556,12,25,.480,25,30,.833,111
6455,2016-12-26,MEM,@,ORL,L 102-112,240,35,76,.461,25,51,.490,10,25,.400,22,28,.786,102
6456,2016-12-26,ORL,,MEM,W 112-102,240,44,86,.512,31,60,.517,13,26,.500,11,16,.688,112
6457,2016-12-26,POR,,TOR,L 91-95,240,35,83,.422,27,60,.450,8,23,.348,13,18,.722,91
6458,2016-12-26,TOR,@,POR,W 95-91,240,32,95,.337,20,61,.328,12,34,.353,19,24,.792,95
6459,2016-12-26,PHI,@,SAC,L 100-102,240,39,79,.494,30,54,.556,9,25,.360,13,18,.722,100
6460,2016-12-26,SAC,,PHI,W 102-100,240,39,87,.448,32,62,.516,7,25,.280,17,21,.810,102
6461,2016-12-26,MIL,@,WAS,L 102-107,240,40,87,.460,34,67,.507,6,20,.300,16,23,.696,102
6462,2016-12-26,WAS,,MIL,W 107-102,240,40,79,.506,28,50,.560,12,29,.414,15,20,.750,107
6463,2016-12-25,CLE,,GSW,W 109-108,240,37,95,.389,25,60,.417,12,35,.343,23,32,.719,109
6464,2016-12-25,GSW,@,CLE,L 108-109,240,37,77,.481,28,47,.596,9,30,.300,25,29,.862,108
6465,2016-12-25,LAC,@,LAL,L 102-111,240,37,85,.435,27,56,.482,10,29,.345,18,22,.818,102
6466,2016-12-25,LAL,,LAC,W 111-102,240,40,84,.476,32,59,.542,8,25,.320,23,30,.767,111
6467,2016-12-25,BOS,@,NYK,W 119-114,240,45,93,.484,31,57,.544,14,36,.389,15,20,.750,119
6468,2016-12-25,NYK,,BOS,L 114-119,240,41,87,.471,33,64,.516,8,23,.348,24,27,.889,114
6469,2016-12-25,MIN,@,OKC,L 100-112,240,39,83,.470,35,71,.493,4,12,.333,18,23,.783,100
6470,2016-12-25,OKC,,MIN,W 112-100,240,42,82,.512,34,58,.586,8,24,.333,20,24,.833,112
6471,2016-12-25,CHI,@,SAS,L 100-119,240,39,86,.453,32,68,.471,7,18,.389,15,20,.750,100
6472,2016-12-25,SAS,,CHI,W 119-100,240,48,85,.565,39,67,.582,9,18,.500,14,19,.737,119
6473,2016-12-23,BOS,,OKC,L 112-117,240,41,93,.441,32,65,.492,9,28,.321,21,26,.808,112
6474,2016-12-23,OKC,@,BOS,W 117-112,240,41,80,.513,30,54,.556,11,26,.423,24,36,.667,117
6475,2016-12-23,CHI,@,CHO,L 91-103,240,38,96,.396,31,74,.419,7,22,.318,8,10,.800,91
6476,2016-12-23,CHA,,CHI,W 103-91,240,37,84,.440,32,66,.485,5,18,.278,24,28,.857,103
6477,2016-12-23,BRK,@,CLE,L 99-119,240,38,85,.447,30,55,.545,8,30,.267,15,18,.833,99
6478,2016-12-23,CLE,,BRK,W 119-99,240,45,99,.455,37,64,.578,8,35,.229,21,24,.875,119
6479,2016-12-23,ATL,@,DEN,W 109-108,240,37,86,.430,29,61,.475,8,25,.320,27,33,.818,109
6480,2016-12-23,DEN,,ATL,L 108-109,240,37,78,.474,29,53,.547,8,25,.320,26,35,.743,108
6481,2016-12-23,DET,,GSW,L 113-119,240,43,85,.506,33,56,.589,10,29,.345,17,28,.607,113
6482,2016-12-23,GSW,@,DET,W 119-113,240,43,77,.558,32,50,.640,11,27,.407,22,24,.917,119
6483,2016-12-23,DAL,@,LAC,W 90-88,240,37,87,.425,30,58,.517,7,29,.241,9,15,.600,90
6484,2016-12-23,LAC,,DAL,L 88-90,240,34,74,.459,21,45,.467,13,29,.448,7,11,.636,88
6485,2016-12-23,HOU,@,MEM,L 109-115,240,38,89,.427,18,37,.486,20,52,.385,13,15,.867,109
6486,2016-12-23,MEM,,HOU,W 115-109,240,41,81,.506,28,56,.500,13,25,.520,20,25,.800,115
6487,2016-12-23,MIL,,WAS,W 123-96,240,45,80,.563,36,55,.655,9,25,.360,24,27,.889,123
6488,2016-12-23,WAS,@,MIL,L 96-123,240,37,79,.468,30,55,.545,7,24,.292,15,18,.833,96
6489,2016-12-23,MIN,,SAC,L 105-109,240,36,79,.456,24,47,.511,12,32,.375,21,26,.808,105
6490,2016-12-23,SAC,@,MIN,W 109-105,240,42,80,.525,27,51,.529,15,29,.517,10,14,.714,109
6491,2016-12-23,MIA,@,NOP,L 87-91,240,36,87,.414,28,67,.418,8,20,.400,7,13,.538,87
6492,2016-12-23,NOP,,MIA,W 91-87,240,33,89,.371,22,61,.361,11,28,.393,14,21,.667,91
6493,2016-12-23,LAL,@,ORL,L 90-109,240,31,87,.356,23,64,.359,8,23,.348,20,24,.833,90
6494,2016-12-23,ORL,,LAL,W 109-90,240,45,89,.506,34,62,.548,11,27,.407,8,14,.571,109
6495,2016-12-23,PHI,@,PHO,L 116-123,240,42,83,.506,29,52,.558,13,31,.419,19,22,.864,116
6496,2016-12-23,PHO,,PHI,W 123-116,240,42,79,.532,30,53,.566,12,26,.462,27,37,.730,123
6497,2016-12-23,POR,,SAS,L 90-110,240,35,79,.443,23,49,.469,12,30,.400,8,16,.500,90
6498,2016-12-23,SAS,@,POR,W 110-90,240,39,78,.500,27,58,.466,12,20,.600,20,21,.952,110
6499,2016-12-23,TOR,@,UTA,W 104-98,240,43,81,.531,35,60,.583,8,21,.381,10,15,.667,104
6500,2016-12-23,UTA,,TOR,L 98-104,240,35,79,.443,25,52,.481,10,27,.370,18,21,.857,98
6501,2016-12-22,BRK,,GSW,L 101-117,240,38,86,.442,25,51,.490,13,35,.371,12,16,.750,101
6502,2016-12-22,GSW,@,BRK,W 117-101,240,47,104,.452,35,67,.522,12,37,.324,11,14,.786,117
6503,2016-12-22,BOS,@,IND,W 109-102,240,38,92,.413,28,53,.528,10,39,.256,23,27,.852,109
6504,2016-12-22,IND,,BOS,L 102-109,240,35,82,.427,28,59,.475,7,23,.304,25,29,.862,102
6505,2016-12-22,LAC,,SAS,W 106-101,240,39,83,.470,28,55,.509,11,28,.393,17,22,.773,106
6506,2016-12-22,SAS,@,LAC,L 101-106,240,37,92,.402,31,73,.425,6,19,.316,21,25,.840,101
6507,2016-12-22,LAL,@,MIA,L 107-115,240,40,90,.444,26,52,.500,14,38,.368,13,15,.867,107
6508,2016-12-22,MIA,,LAL,W 115-107,240,45,84,.536,34,62,.548,11,22,.500,14,21,.667,115
6509,2016-12-22,NYK,,ORL,W 106-95,240,41,96,.427,32,76,.421,9,20,.450,15,17,.882,106
6510,2016-12-22,ORL,@,NYK,L 95-106,240,39,90,.433,34,63,.540,5,27,.185,12,16,.750,95
6511,2016-12-21,ATL,,MIN,L 84-92,240,34,82,.415,27,56,.482,7,26,.269,9,13,.692,84
6512,2016-12-21,MIN,@,ATL,W 92-84,240,35,83,.422,26,54,.481,9,29,.310,13,14,.929,92
6513,2016-12-21,CHI,,WAS,L 97-107,240,38,95,.400,32,74,.432,6,21,.286,15,19,.789,97
6514,2016-12-21,WAS,@,CHI,W 107-97,240,43,82,.524,40,64,.625,3,18,.167,18,25,.720,107
6515,2016-12-21,CLE,,MIL,W 113-102,240,43,87,.494,28,60,.467,15,27,.556,12,19,.632,113
6516,2016-12-21,MIL,@,CLE,L 102-113,240,36,77,.468,27,55,.491,9,22,.409,21,29,.724,102
6517,2016-12-21,DET,,MEM,L 86-98,240,26,72,.361,20,49,.408,6,23,.261,28,37,.757,86
6518,2016-12-21,MEM,@,DET,W 98-86,240,35,82,.427,23,52,.442,12,30,.400,16,19,.842,98
6519,2016-12-21,NOP,,OKC,L 110-121,240,42,88,.477,34,68,.500,8,20,.400,18,23,.783,110
6520,2016-12-21,OKC,@,NOP,W 121-110,240,45,88,.511,34,60,.567,11,28,.393,20,24,.833,121
6521,2016-12-21,HOU,@,PHO,W 125-111,240,46,86,.535,28,48,.583,18,38,.474,15,26,.577,125
6522,2016-12-21,PHO,,HOU,L 111-125,240,44,93,.473,35,68,.515,9,25,.360,14,20,.700,111
6523,2016-12-21,DAL,@,POR,W 96-95,240,35,83,.422,28,52,.538,7,31,.226,19,23,.826,96
6524,2016-12-21,POR,,DAL,L 95-96,240,32,72,.444,22,45,.489,10,27,.370,21,28,.750,95
6525,2016-12-21,SAC,@,UTA,W 94-93,240,34,74,.459,24,53,.453,10,21,.476,16,24,.667,94
6526,2016-12-21,UTA,,SAC,L 93-94,240,33,74,.446,24,47,.511,9,27,.333,18,22,.818,93
6527,2016-12-20,CHA,,LAL,W 117-113,240,43,94,.457,32,69,.464,11,25,.440,20,24,.833,117
6528,2016-12-20,LAL,@,CHO,L 113-117,240,44,90,.489,28,57,.491,16,33,.485,9,11,.818,113
6529,2016-12-20,GSW,,UTA,W 104-74,240,40,90,.444,31,67,.463,9,23,.391,15,17,.882,104
6530,2016-12-20,UTA,@,GSW,L 74-104,240,27,76,.355,18,46,.391,9,30,.300,11,20,.550,74
6531,2016-12-20,HOU,,SAS,L 100-102,240,35,92,.380,29,54,.537,6,38,.158,24,27,.889,100
6532,2016-12-20,SAS,@,HOU,W 102-100,240,36,77,.468,24,54,.444,12,23,.522,18,25,.720,102
6533,2016-12-20,DEN,@,LAC,L 102-119,240,39,90,.433,28,51,.549,11,39,.282,13,20,.650,102
6534,2016-12-20,LAC,,DEN,W 119-102,240,47,86,.547,31,50,.620,16,36,.444,9,13,.692,119
6535,2016-12-20,BOS,@,MEM,W 112-109 (OT),265,33,81,.407,21,44,.477,12,37,.324,34,38,.895,112
6536,2016-12-20,MEM,,BOS,L 109-112 (OT),265,38,94,.404,26,64,.406,12,30,.400,21,26,.808,109
6537,2016-12-20,MIA,,ORL,L 130-136 (2OT),290,50,108,.463,38,78,.487,12,30,.400,18,26,.692,130
6538,2016-12-20,ORL,@,MIA,W 136-130 (2OT),290,52,105,.495,41,83,.494,11,22,.500,21,31,.677,136
6539,2016-12-20,CLE,@,MIL,W 114-108 (OT),265,37,91,.407,20,51,.392,17,40,.425,23,27,.852,114
6540,2016-12-20,MIL,,CLE,L 108-114 (OT),265,40,87,.460,33,60,.550,7,27,.259,21,29,.724,108
6541,2016-12-20,IND,@,NYK,L 111-118,240,39,91,.429,33,68,.485,6,23,.261,27,33,.818,111
6542,2016-12-20,NYK,,IND,W 118-111,240,44,88,.500,31,65,.477,13,23,.565,17,21,.810,118
6543,2016-12-20,NOP,@,PHI,W 108-93,240,40,93,.430,30,76,.395,10,17,.588,18,26,.692,108
6544,2016-12-20,PHI,,NOP,L 93-108,240,33,82,.402,22,49,.449,11,33,.333,16,21,.762,93
6545,2016-12-20,POR,@,SAC,L 121-126,240,44,86,.512,40,58,.690,4,28,.143,29,40,.725,121
6546,2016-12-20,SAC,,POR,W 126-121,240,40,72,.556,30,49,.612,10,23,.435,36,43,.837,126
6547,2016-12-20,BRK,@,TOR,L 104-116,240,36,91,.396,26,56,.464,10,35,.286,22,28,.786,104
6548,2016-12-20,TOR,,BRK,W 116-104,240,42,91,.462,34,73,.466,8,18,.444,24,31,.774,116
6549,2016-12-19,CHI,,DET,W 113-82,240,49,82,.598,41,66,.621,8,16,.500,7,7,1.000,113
6550,2016-12-19,DET,@,CHI,L 82-113,240,34,83,.410,31,60,.517,3,23,.130,11,13,.846,82
6551,2016-12-19,DAL,@,DEN,L 107-117,240,43,80,.538,29,55,.527,14,25,.560,7,9,.778,107
6552,2016-12-19,DEN,,DAL,W 117-107,240,45,80,.563,32,55,.582,13,25,.520,14,18,.778,117
6553,2016-12-19,IND,,WAS,W 107-105,240,41,87,.471,34,66,.515,7,21,.333,18,21,.857,107
6554,2016-12-19,WAS,@,IND,L 105-107,240,38,88,.432,30,55,.545,8,33,.242,21,26,.808,105
6555,2016-12-19,MIN,,PHO,W 115-108,240,42,86,.488,35,67,.522,7,19,.368,24,25,.960,115
6556,2016-12-19,PHO,@,MIN,L 108-115,240,37,82,.451,28,61,.459,9,21,.429,25,35,.714,108
6557,2016-12-19,ATL,@,OKC,W 110-108,240,41,75,.547,32,52,.615,9,23,.391,19,24,.792,110
6558,2016-12-19,OKC,,ATL,L 108-110,240,39,87,.448,29,52,.558,10,35,.286,20,26,.769,108
6559,2016-12-18,DAL,,SAC,W 99-79,240,34,77,.442,21,44,.477,13,33,.394,18,22,.818,99
6560,2016-12-18,SAC,@,DAL,L 79-99,240,30,76,.395,22,45,.489,8,31,.258,11,17,.647,79
6561,2016-12-18,MEM,,UTA,L 73-82,240,28,93,.301,26,70,.371,2,23,.087,15,18,.833,73
6562,2016-12-18,UTA,@,MEM,W 82-73,240,30,66,.455,22,39,.564,8,27,.296,14,25,.560,82
6563,2016-12-18,BOS,@,MIA,W 105-95,240,41,90,.456,32,62,.516,9,28,.321,14,19,.737,105
6564,2016-12-18,MIA,,BOS,L 95-105,240,36,69,.522,27,45,.600,9,24,.375,14,25,.560,95
6565,2016-12-18,ORL,,TOR,L 79-109,240,34,83,.410,31,62,.500,3,21,.143,8,9,.889,79
6566,2016-12-18,TOR,@,ORL,W 109-79,240,43,87,.494,36,60,.600,7,27,.259,16,21,.762,109
6567,2016-12-18,BRK,@,PHI,L 107-108,240,36,81,.444,24,47,.511,12,34,.353,23,31,.742,107
6568,2016-12-18,PHI,,BRK,W 108-107,240,38,88,.432,26,60,.433,12,28,.429,20,23,.870,108
6569,2016-12-18,NOP,@,SAS,L 100-113,240,41,89,.461,31,63,.492,10,26,.385,8,14,.571,100
6570,2016-12-18,SAS,,NOP,W 113-100,240,42,86,.488,31,64,.484,11,22,.500,18,22,.818,113
6571,2016-12-18,LAC,@,WAS,L 110-117,240,43,87,.494,36,63,.571,7,24,.292,17,24,.708,110
6572,2016-12-18,WAS,,LAC,W 117-110,240,43,81,.531,33,62,.532,10,19,.526,21,30,.700,117
6573,2016-12-17,ATL,,CHO,L 99-107,240,40,86,.465,30,60,.500,10,26,.385,9,16,.563,99
6574,2016-12-17,CHA,@,ATL,W 107-99,240,43,88,.489,31,61,.508,12,27,.444,9,13,.692,107
6575,2016-12-17,CLE,,LAL,W 119-108,240,46,89,.517,31,56,.554,15,33,.455,12,18,.667,119
6576,2016-12-17,LAL,@,CLE,L 108-119,240,41,86,.477,25,49,.510,16,37,.432,10,13,.769,108
6577,2016-12-17,DEN,,NYK,W 127-114,240,50,90,.556,40,63,.635,10,27,.370,17,29,.586,127
6578,2016-12-17,NYK,@,DEN,L 114-127,240,35,80,.438,27,57,.474,8,23,.348,36,39,.923,114
6579,2016-12-17,DET,,IND,L 90-105,240,32,84,.381,22,54,.407,10,30,.333,16,22,.727,90
6580,2016-12-17,IND,@,DET,W 105-90,240,40,83,.482,34,64,.531,6,19,.316,19,25,.760,105
6581,2016-12-17,GSW,,POR,W 135-90,240,51,87,.586,37,59,.627,14,28,.500,19,26,.731,135
6582,2016-12-17,POR,@,GSW,L 90-135,240,34,86,.395,26,58,.448,8,28,.286,14,20,.700,90
6583,2016-12-17,HOU,@,MIN,W 111-109 (OT),265,39,96,.406,22,45,.489,17,51,.333,16,20,.800,111
6584,2016-12-17,MIN,,HOU,L 109-111 (OT),265,41,92,.446,34,71,.479,7,21,.333,20,27,.741,109
6585,2016-12-17,OKC,,PHO,W 114-101,240,41,81,.506,34,65,.523,7,16,.438,25,34,.735,114
6586,2016-12-17,PHO,@,OKC,L 101-114,240,39,90,.433,31,68,.456,8,22,.364,15,20,.750,101
6587,2016-12-16,BOS,,CHO,W 96-88,240,34,78,.436,25,50,.500,9,28,.321,19,26,.731,96
6588,2016-12-16,CHA,@,BOS,L 88-96,240,32,97,.330,24,67,.358,8,30,.267,16,19,.842,88
6589,2016-12-16,CHI,,MIL,L 69-95,240,28,92,.304,23,71,.324,5,21,.238,8,15,.533,69
6590,2016-12-16,MIL,@,CHI,W 95-69,240,38,82,.463,28,57,.491,10,25,.400,9,13,.692,95
6591,2016-12-16,HOU,,NOP,W 122-100,240,42,94,.447,18,33,.545,24,61,.393,14,19,.737,122
6592,2016-12-16,NOP,@,HOU,L 100-122,240,40,98,.408,31,71,.437,9,27,.333,11,20,.550,100
6593,2016-12-16,MEM,,SAC,L 92-96,240,29,77,.377,24,52,.462,5,25,.200,29,36,.806,92
6594,2016-12-16,SAC,@,MEM,W 96-92,240,31,80,.388,24,56,.429,7,24,.292,27,37,.730,96
6595,2016-12-16,LAC,@,MIA,W 102-98,240,36,83,.434,29,58,.500,7,25,.280,23,29,.793,102
6596,2016-12-16,MIA,,LAC,L 98-102,240,38,93,.409,32,66,.485,6,27,.222,16,25,.640,98
6597,2016-12-16,BRK,@,ORL,L 111-118,240,39,83,.470,28,56,.500,11,27,.407,22,26,.846,111
6598,2016-12-16,ORL,,BRK,W 118-111,240,39,97,.402,32,68,.471,7,29,.241,33,42,.786,118
6599,2016-12-16,LAL,@,PHI,W 100-89,240,36,79,.456,27,49,.551,9,30,.300,19,22,.864,100
6600,2016-12-16,PHI,,LAL,L 89-100,240,32,88,.364,26,57,.456,6,31,.194,19,24,.792,89
6601,2016-12-16,ATL,@,TOR,W 125-121,240,46,86,.535,35,61,.574,11,25,.440,22,32,.688,125
6602,2016-12-16,TOR,,ATL,L 121-125,240,47,86,.547,37,65,.569,10,21,.476,17,26,.654,121
6603,2016-12-16,DAL,@,UTA,L 100-103,240,35,77,.455,23,49,.469,12,28,.429,18,21,.857,100
6604,2016-12-16,UTA,,DAL,W 103-100,240,37,65,.569,29,43,.674,8,22,.364,21,27,.778,103
6605,2016-12-16,DET,@,WAS,L 108-122,240,42,86,.488,32,58,.552,10,28,.357,14,21,.667,108
6606,2016-12-16,WAS,,DET,W 122-108,240,44,77,.571,32,52,.615,12,25,.480,22,27,.815,122
6607,2016-12-15,DEN,,POR,W 132-120,240,43,84,.512,28,53,.528,15,31,.484,31,35,.886,132
6608,2016-12-15,POR,@,DEN,L 120-132,240,41,88,.466,33,65,.508,8,23,.348,30,36,.833,120
6609,2016-12-15,GSW,,NYK,W 103-90,240,45,96,.469,36,64,.563,9,32,.281,4,8,.500,103
6610,2016-12-15,NYK,@,GSW,L 90-103,240,38,93,.409,33,72,.458,5,21,.238,9,19,.474,90
6611,2016-12-15,CHI,@,MIL,L 97-108,240,35,74,.473,30,54,.556,5,20,.250,22,29,.759,97
6612,2016-12-15,MIL,,CHI,W 108-97,240,45,95,.474,34,75,.453,11,20,.550,7,13,.538,108
6613,2016-12-15,IND,@,NOP,L 95-102,240,36,87,.414,33,66,.500,3,21,.143,20,24,.833,95
6614,2016-12-15,NOP,,IND,W 102-95,240,36,85,.424,26,58,.448,10,27,.370,20,28,.714,102
6615,2016-12-15,PHO,,SAS,L 92-107,240,34,85,.400,24,58,.414,10,27,.370,14,18,.778,92
6616,2016-12-15,SAS,@,PHO,W 107-92,240,39,74,.527,34,58,.586,5,16,.313,24,26,.923,107
6617,2016-12-14,BRK,,LAL,W 107-97,240,33,86,.384,22,51,.431,11,35,.314,30,40,.750,107
6618,2016-12-14,LAL,@,BRK,L 97-107,240,35,91,.385,29,64,.453,6,27,.222,21,34,.618,97
6619,2016-12-14,DAL,,DET,L 85-95,240,32,78,.410,24,53,.453,8,25,.320,13,16,.813,85
6620,2016-12-14,DET,@,DAL,W 95-85,240,36,71,.507,31,54,.574,5,17,.294,18,22,.818,95
6621,2016-12-14,HOU,,SAC,W 132-98,240,50,85,.588,28,43,.651,22,42,.524,10,16,.625,132
6622,2016-12-14,SAC,@,HOU,L 98-132,240,39,92,.424,28,60,.467,11,32,.344,9,11,.818,98
6623,2016-12-14,CLE,@,MEM,L 85-93,240,28,75,.373,19,50,.380,9,25,.360,20,31,.645,85
6624,2016-12-14,MEM,,CLE,W 93-85,240,35,81,.432,23,58,.397,12,23,.522,11,16,.688,93
6625,2016-12-14,IND,@,MIA,L 89-95,240,33,89,.371,24,62,.387,9,27,.333,14,17,.824,89
6626,2016-12-14,MIA,,IND,W 95-89,240,37,82,.451,30,57,.526,7,25,.280,14,25,.560,95
6627,2016-12-14,LAC,@,ORL,W 113-108,240,37,74,.500,24,49,.490,13,25,.520,26,37,.703,113
6628,2016-12-14,ORL,,LAC,L 108-113,240,42,89,.472,28,56,.500,14,33,.424,10,20,.500,108
6629,2016-12-14,PHI,,TOR,L 114-123,240,43,86,.500,34,57,.596,9,29,.310,19,25,.760,114
6630,2016-12-14,TOR,@,PHI,W 123-114,240,41,87,.471,31,58,.534,10,29,.345,31,36,.861,123
6631,2016-12-14,BOS,@,SAS,L 101-108,240,37,84,.440,27,53,.509,10,31,.323,17,20,.850,101
6632,2016-12-14,SAS,,BOS,W 108-101,240,44,80,.550,36,58,.621,8,22,.364,12,14,.857,108
6633,2016-12-14,OKC,@,UTA,L 89-109,240,30,82,.366,24,63,.381,6,19,.316,23,27,.852,89
6634,2016-12-14,UTA,,OKC,W 109-89,240,42,72,.583,29,49,.592,13,23,.565,12,15,.800,109
6635,2016-12-14,CHA,@,WAS,L 106-109,240,38,74,.514,24,41,.585,14,33,.424,16,21,.762,106
6636,2016-12-14,WAS,,CHO,W 109-106,240,45,87,.517,40,69,.580,5,18,.278,14,17,.824,109
6637,2016-12-13,ATL,,ORL,L 120-131,240,45,89,.506,34,61,.557,11,28,.393,19,21,.905,120
6638,2016-12-13,ORL,@,ATL,W 131-120,240,51,87,.586,36,53,.679,15,34,.441,14,20,.700,131
6639,2016-12-13,CHI,,MIN,L 94-99,240,38,87,.437,34,72,.472,4,15,.267,14,19,.737,94
6640,2016-12-13,MIN,@,CHI,W 99-94,240,38,86,.442,32,65,.492,6,21,.286,17,22,.773,99
6641,2016-12-13,CLE,,MEM,W 103-86,240,37,81,.457,25,50,.500,12,31,.387,17,23,.739,103
6642,2016-12-13,MEM,@,CLE,L 86-103,240,35,86,.407,31,64,.484,4,22,.182,12,15,.800,86
6643,2016-12-13,GSW,@,NOP,W 113-109,240,42,95,.442,28,61,.459,14,34,.412,15,19,.789,113
6644,2016-12-13,NOP,,GSW,L 109-113,240,39,82,.476,25,47,.532,14,35,.400,17,21,.810,109
6645,2016-12-13,NYK,@,PHO,L 111-113 (OT),265,38,97,.392,31,77,.403,7,20,.350,28,38,.737,111
6646,2016-12-13,PHO,,NYK,W 113-111 (OT),265,38,93,.409,29,63,.460,9,30,.300,28,33,.848,113
6647,2016-12-13,OKC,@,POR,L 95-114,240,33,87,.379,25,60,.417,8,27,.296,21,28,.750,95
6648,2016-12-13,POR,,OKC,W 114-95,240,43,80,.538,35,57,.614,8,23,.348,20,27,.741,114
6649,2016-12-12,DAL,,DEN,W 112-92,240,45,77,.584,33,51,.647,12,26,.462,10,12,.833,112
6650,2016-12-12,DEN,@,DAL,L 92-112,240,35,83,.422,28,58,.483,7,25,.280,15,18,.833,92
6651,2016-12-12,BRK,@,HOU,L 118-122,240,42,80,.525,35,60,.583,7,20,.350,27,36,.750,118
6652,2016-12-12,HOU,,BRK,W 122-118,240,42,91,.462,25,48,.521,17,43,.395,21,36,.583,122
6653,2016-12-12,CHA,@,IND,L 94-110,240,28,84,.333,18,58,.310,10,26,.385,28,32,.875,94
6654,2016-12-12,IND,,CHO,W 110-94,240,43,88,.489,26,52,.500,17,36,.472,7,10,.700,110
6655,2016-12-12,LAC,,POR,W 121-120,240,42,89,.472,31,66,.470,11,23,.478,26,28,.929,121
6656,2016-12-12,POR,@,LAC,L 120-121,240,44,87,.506,34,66,.515,10,21,.476,22,25,.880,120
6657,2016-12-12,MIA,,WAS,W 112-101,240,45,88,.511,36,62,.581,9,26,.346,13,19,.684,112
6658,2016-12-12,WAS,@,MIA,L 101-112,240,39,84,.464,34,61,.557,5,23,.217,18,22,.818,101
6659,2016-12-12,LAL,@,SAC,L 92-116,240,33,84,.393,23,61,.377,10,23,.435,16,21,.762,92
6660,2016-12-12,SAC,,LAL,W 116-92,240,47,84,.560,37,61,.607,10,23,.435,12,21,.571,116
6661,2016-12-12,MIL,@,TOR,L 100-122,240,42,89,.472,38,65,.585,4,24,.167,12,17,.706,100
6662,2016-12-12,TOR,,MIL,W 122-100,240,42,81,.519,28,56,.500,14,25,.560,24,28,.857,122
6663,2016-12-11,DET,,PHI,L 79-97,240,32,82,.390,27,63,.429,5,19,.263,10,14,.714,79
6664,2016-12-11,PHI,@,DET,W 97-79,240,38,68,.559,31,51,.608,7,17,.412,14,17,.824,97
6665,2016-12-11,LAL,,NYK,L 112-118,240,42,88,.477,32,60,.533,10,28,.357,18,22,.818,112
6666,2016-12-11,NYK,@,LAL,W 118-112,240,41,84,.488,31,62,.500,10,22,.455,26,31,.839,118
6667,2016-12-11,GSW,@,MIN,W 116-108,240,38,83,.458,25,51,.490,13,32,.406,27,30,.900,116
6668,2016-12-11,MIN,,GSW,L 108-116,240,36,81,.444,27,57,.474,9,24,.375,27,36,.750,108
6669,2016-12-11,BOS,@,OKC,L 96-99,240,40,90,.444,29,58,.500,11,32,.344,5,8,.625,96
6670,2016-12-11,OKC,,BOS,W 99-96,240,41,83,.494,38,62,.613,3,21,.143,14,27,.519,99
6671,2016-12-11,NOP,@,PHO,W 120-119 (OT),265,38,97,.392,22,57,.386,16,40,.400,28,35,.800,120
6672,2016-12-11,PHO,,NOP,L 119-120 (OT),265,44,96,.458,30,55,.545,14,41,.341,17,26,.654,119
6673,2016-12-10,CHI,,MIA,W 105-100,240,38,84,.452,37,76,.487,1,8,.125,28,31,.903,105
6674,2016-12-10,MIA,@,CHI,L 100-105,240,42,91,.462,37,71,.521,5,20,.250,11,18,.611,100
6675,2016-12-10,CHA,@,CLE,L 105-116,240,39,86,.453,29,59,.492,10,27,.370,17,24,.708,105
6676,2016-12-10,CLE,,CHO,W 116-105,240,42,73,.575,29,42,.690,13,31,.419,19,28,.679,116
6677,2016-12-10,DAL,@,HOU,L 87-109,240,32,79,.405,21,45,.467,11,34,.324,12,14,.857,87
6678,2016-12-10,HOU,,DAL,W 109-87,240,37,74,.500,18,37,.486,19,37,.514,16,22,.727,109
6679,2016-12-10,IND,,POR,W 118-111,240,40,83,.482,25,54,.463,15,29,.517,23,28,.821,118
6680,2016-12-10,POR,@,IND,L 111-118,240,40,82,.488,24,45,.533,16,37,.432,15,16,.938,111
6681,2016-12-10,LAC,,NOP,W 133-105,240,54,94,.574,37,58,.638,17,36,.472,8,9,.889,133
6682,2016-12-10,NOP,@,LAC,L 105-133,240,40,83,.482,32,64,.500,8,19,.421,17,26,.654,105
6683,2016-12-10,GSW,@,MEM,L 89-110,240,34,77,.442,25,50,.500,9,27,.333,12,20,.600,89
6684,2016-12-10,MEM,,GSW,W 110-89,240,38,87,.437,30,61,.492,8,26,.308,26,29,.897,110
6685,2016-12-10,DEN,@,ORL,W 121-113,240,47,83,.566,39,64,.609,8,19,.421,19,25,.760,121
6686,2016-12-10,ORL,,DEN,L 113-121,240,43,88,.489,32,61,.525,11,27,.407,16,24,.667,113
6687,2016-12-10,BRK,@,SAS,L 101-130,240,36,87,.414,29,60,.483,7,27,.259,22,25,.880,101
6688,2016-12-10,SAS,,BRK,W 130-101,240,50,94,.532,36,68,.529,14,26,.538,16,18,.889,130
6689,2016-12-10,SAC,@,UTA,L 84-104,240,34,90,.378,25,64,.391,9,26,.346,7,13,.538,84
6690,2016-12-10,UTA,,SAC,W 104-84,240,37,77,.481,24,48,.500,13,29,.448,17,18,.944,104
6691,2016-12-10,MIL,@,WAS,L 105-110,240,40,79,.506,27,54,.500,13,25,.520,12,15,.800,105
6692,2016-12-10,WAS,,MIL,W 110-105,240,40,88,.455,32,67,.478,8,21,.381,22,28,.786,110
6693,2016-12-09,BOS,,TOR,L 94-101,240,31,83,.373,14,41,.341,17,42,.405,15,22,.682,94
6694,2016-12-09,TOR,@,BOS,W 101-94,240,34,82,.415,25,62,.403,9,20,.450,24,27,.889,101
6695,2016-12-09,CHA,,ORL,W 109-88,240,41,85,.482,32,63,.508,9,22,.409,18,23,.783,109
6696,2016-12-09,ORL,@,CHO,L 88-109,240,34,91,.374,25,57,.439,9,34,.265,11,14,.786,88
6697,2016-12-09,CLE,,MIA,W 114-84,240,46,83,.554,37,59,.627,9,24,.375,13,19,.684,114
6698,2016-12-09,MIA,@,CLE,L 84-114,240,31,90,.344,25,63,.397,6,27,.222,16,21,.762,84
6699,2016-12-09,DAL,,IND,W 111-103,240,39,80,.488,24,48,.500,15,32,.469,18,24,.750,111
6700,2016-12-09,IND,@,DAL,L 103-111,240,32,69,.464,18,44,.409,14,25,.560,25,26,.962,103
6701,2016-12-09,LAL,,PHO,L 115-119,240,40,87,.460,31,61,.508,9,26,.346,26,34,.765,115
6702,2016-12-09,PHO,@,LAL,W 119-115,240,45,95,.474,32,65,.492,13,30,.433,16,21,.762,119
6703,2016-12-09,ATL,@,MIL,W 114-110,240,40,84,.476,28,50,.560,12,34,.353,22,29,.759,114
6704,2016-12-09,MIL,,ATL,L 110-114,240,44,94,.468,32,66,.485,12,28,.429,10,14,.714,110
6705,2016-12-09,DET,@,MIN,W 117-90,240,42,84,.500,28,55,.509,14,29,.483,19,23,.826,117
6706,2016-12-09,MIN,,DET,L 90-117,240,37,78,.474,34,62,.548,3,16,.188,13,20,.650,90
6707,2016-12-09,HOU,@,OKC,W 102-99,240,36,92,.391,25,50,.500,11,42,.262,19,30,.633,102
6708,2016-12-09,OKC,,HOU,L 99-102,240,34,81,.420,27,53,.509,7,28,.250,24,31,.774,99
6709,2016-12-09,NYK,@,SAC,W 103-100,240,36,84,.429,26,55,.473,10,29,.345,21,25,.840,103
6710,2016-12-09,SAC,,NYK,L 100-103,240,35,87,.402,28,59,.475,7,28,.250,23,27,.852,100
6711,2016-12-08,CHI,,SAS,W 95-91,240,35,80,.438,31,63,.492,4,17,.235,21,27,.778,95
6712,2016-12-08,SAS,@,CHI,L 91-95,240,39,97,.402,30,69,.435,9,28,.321,4,5,.800,91
6713,2016-12-08,MEM,,POR,W 88-86,240,31,87,.356,25,67,.373,6,20,.300,20,30,.667,88
6714,2016-12-08,POR,@,MEM,L 86-88,240,25,82,.305,18,54,.333,7,28,.250,29,40,.725,86
6715,2016-12-08,NOP,,PHI,L 88-99,240,33,84,.393,26,59,.441,7,25,.280,15,22,.682,88
6716,2016-12-08,PHI,@,NOP,W 99-88,240,39,91,.429,27,51,.529,12,40,.300,9,13,.692,99
6717,2016-12-08,MIN,@,TOR,L 110-124,240,45,88,.511,36,60,.600,9,28,.321,11,15,.733,110
6718,2016-12-08,TOR,,MIN,W 124-110,240,43,87,.494,31,60,.517,12,27,.444,26,33,.788,124
6719,2016-12-08,GSW,@,UTA,W 106-99,240,39,80,.488,27,51,.529,12,29,.414,16,23,.696,106
6720,2016-12-08,UTA,,GSW,L 99-106,240,37,89,.416,27,51,.529,10,38,.263,15,21,.714,99
6721,2016-12-08,DEN,@,WAS,L 85-92,240,31,76,.408,24,44,.545,7,32,.219,16,24,.667,85
6722,2016-12-08,WAS,,DEN,W 92-85,240,35,78,.449,29,59,.492,6,19,.316,16,17,.941,92
6723,2016-12-07,ATL,,MIA,W 103-95,240,43,88,.489,39,69,.565,4,19,.211,13,15,.867,103
6724,2016-12-07,MIA,@,ATL,L 95-103,240,34,80,.425,23,53,.434,11,27,.407,16,20,.800,95
6725,2016-12-07,BRK,,DEN,W 116-111,240,41,85,.482,32,59,.542,9,26,.346,25,31,.806,116
6726,2016-12-07,DEN,@,BRK,L 111-116,240,42,105,.400,31,68,.456,11,37,.297,16,21,.762,111
6727,2016-12-07,CHA,,DET,W 87-77,240,30,88,.341,24,67,.358,6,21,.286,21,29,.724,87
6728,2016-12-07,DET,@,CHO,L 77-87,240,34,89,.382,30,62,.484,4,27,.148,5,8,.625,77
6729,2016-12-07,DAL,,SAC,L 89-120,240,32,78,.410,22,48,.458,10,30,.333,15,20,.750,89
6730,2016-12-07,SAC,@,DAL,W 120-89,240,47,84,.560,37,62,.597,10,22,.455,16,21,.762,120
6731,2016-12-07,HOU,,LAL,W 134-95,240,51,94,.543,36,58,.621,15,36,.417,17,21,.810,134
6732,2016-12-07,LAL,@,HOU,L 95-134,240,34,87,.391,29,67,.433,5,20,.250,22,27,.815,95
6733,2016-12-07,GSW,@,LAC,W 115-98,240,42,89,.472,35,58,.603,7,31,.226,24,29,.828,115
6734,2016-12-07,LAC,,GSW,L 98-115,240,36,92,.391,28,66,.424,8,26,.308,18,24,.750,98
6735,2016-12-07,MIL,,POR,W 115-107,240,40,77,.519,30,53,.566,10,24,.417,25,37,.676,115
6736,2016-12-07,POR,@,MIL,L 107-115,240,37,85,.435,20,45,.444,17,40,.425,16,19,.842,107
6737,2016-12-07,CLE,@,NYK,W 126-94,240,39,80,.488,17,40,.425,22,40,.550,26,31,.839,126
6738,2016-12-07,NYK,,CLE,L 94-126,240,35,87,.402,24,56,.429,11,31,.355,13,15,.867,94
6739,2016-12-07,BOS,@,ORL,W 117-87,240,43,84,.512,36,58,.621,7,26,.269,24,29,.828,117
6740,2016-12-07,ORL,,BOS,L 87-117,240,30,81,.370,19,55,.345,11,26,.423,16,24,.667,87
6741,2016-12-07,IND,@,PHO,W 109-94,240,35,78,.449,28,55,.509,7,23,.304,32,41,.780,109
6742,2016-12-07,PHO,,IND,L 94-109,240,34,85,.400,25,52,.481,9,33,.273,17,18,.944,94
6743,2016-12-06,CHI,@,DET,L 91-102,240,33,75,.440,31,60,.517,2,15,.133,23,32,.719,91
6744,2016-12-06,DET,,CHI,W 102-91,240,40,88,.455,32,67,.478,8,21,.381,14,21,.667,102
6745,2016-12-06,MEM,,PHI,W 96-91,240,33,86,.384,31,69,.449,2,17,.118,28,35,.800,96
6746,2016-12-06,PHI,@,MEM,L 91-96,240,32,82,.390,18,41,.439,14,41,.341,13,26,.500,91
6747,2016-12-06,MIA,,NYK,L 103-114,240,38,89,.427,27,64,.422,11,25,.440,16,27,.593,103
6748,2016-12-06,NYK,@,MIA,W 114-103,240,48,98,.490,41,73,.562,7,25,.280,11,16,.688,114
6749,2016-12-06,MIN,,SAS,L 91-105,240,36,82,.439,29,62,.468,7,20,.350,12,18,.667,91
6750,2016-12-06,SAS,@,MIN,W 105-91,240,39,74,.527,28,50,.560,11,24,.458,16,19,.842,105
6751,2016-12-06,PHO,@,UTA,L 105-112,240,39,84,.464,33,66,.500,6,18,.333,21,25,.840,105
6752,2016-12-06,UTA,,PHO,W 112-105,240,36,73,.493,24,46,.522,12,27,.444,28,32,.875,112
6753,2016-12-06,ORL,@,WAS,W 124-116,240,43,83,.518,31,57,.544,12,26,.462,26,36,.722,124
6754,2016-12-06,WAS,,ORL,L 116-124,240,44,93,.473,33,70,.471,11,23,.478,17,24,.708,116
6755,2016-12-05,ATL,,OKC,L 99-102,240,34,77,.442,27,55,.491,7,22,.318,24,32,.750,99
6756,2016-12-05,OKC,@,ATL,W 102-99,240,37,80,.463,27,49,.551,10,31,.323,18,28,.643,102
6757,2016-12-05,BRK,,WAS,L 113-118,240,40,81,.494,29,54,.537,11,27,.407,22,30,.733,113
6758,2016-12-05,WAS,@,BRK,W 118-113,240,45,92,.489,31,58,.534,14,34,.412,14,18,.778,118
6759,2016-12-05,CHI,,POR,L 110-112,240,35,83,.422,28,60,.467,7,23,.304,33,38,.868,110
6760,2016-12-05,POR,@,CHI,W 112-110,240,45,93,.484,36,69,.522,9,24,.375,13,18,.722,112
6761,2016-12-05,CHA,@,DAL,W 109-101,240,40,79,.506,37,61,.607,3,18,.167,26,28,.929,109
6762,2016-12-05,DAL,,CHO,L 101-109,240,37,89,.416,24,53,.453,13,36,.361,14,18,.778,101
6763,2016-12-05,GSW,,IND,W 142-106,240,54,104,.519,40,67,.597,14,37,.378,20,26,.769,142
6764,2016-12-05,IND,@,GSW,L 106-142,240,35,85,.412,32,70,.457,3,15,.200,33,35,.943,106
6765,2016-12-05,BOS,@,HOU,L 106-107,240,42,99,.424,31,67,.463,11,32,.344,11,12,.917,106
6766,2016-12-05,HOU,,BOS,W 107-106,240,34,76,.447,22,38,.579,12,38,.316,27,31,.871,107
6767,2016-12-05,LAL,,UTA,L 101-107,240,39,87,.448,34,73,.466,5,14,.357,18,23,.783,101
6768,2016-12-05,UTA,@,LAL,W 107-101,240,38,80,.475,25,48,.521,13,32,.406,18,29,.621,107
6769,2016-12-05,MIL,,SAS,L 96-97,240,30,73,.411,24,49,.490,6,24,.250,30,34,.882,96
6770,2016-12-05,SAS,@,MIL,W 97-96,240,40,93,.430,32,65,.492,8,28,.286,9,14,.643,97
6771,2016-12-05,MEM,@,NOP,W 110-108 (2OT),290,42,104,.404,29,70,.414,13,34,.382,13,21,.619,110
6772,2016-12-05,NOP,,MEM,L 108-110 (2OT),290,39,99,.394,29,67,.433,10,32,.313,20,21,.952,108
6773,2016-12-05,DEN,@,PHI,W 106-98,240,35,76,.461,25,49,.510,10,27,.370,26,34,.765,106
6774,2016-12-05,PHI,,DEN,L 98-106,240,35,86,.407,24,55,.436,11,31,.355,17,23,.739,98
6775,2016-12-05,CLE,@,TOR,W 116-112,240,40,84,.476,26,52,.500,14,32,.438,22,27,.815,116
6776,2016-12-05,TOR,,CLE,L 112-116,240,38,88,.432,25,56,.446,13,32,.406,23,27,.852,112
6777,2016-12-04,DET,,ORL,L 92-98,240,38,86,.442,28,59,.475,10,27,.370,6,13,.462,92
6778,2016-12-04,ORL,@,DET,W 98-92,240,42,79,.532,35,56,.625,7,23,.304,7,14,.500,98
6779,2016-12-04,IND,@,LAC,W 111-102,240,39,79,.494,34,65,.523,5,14,.357,28,35,.800,111
6780,2016-12-04,LAC,,IND,L 102-111,240,36,81,.444,26,51,.510,10,30,.333,20,28,.714,102
6781,2016-12-04,NYK,,SAC,W 106-98,240,39,88,.443,28,59,.475,11,29,.379,17,24,.708,106
6782,2016-12-04,SAC,@,NYK,L 98-106,240,31,97,.320,22,69,.319,9,28,.321,27,31,.871,98
6783,2016-12-04,NOP,@,OKC,L 92-101,240,36,98,.367,30,70,.429,6,28,.214,14,19,.737,92
6784,2016-12-04,OKC,,NOP,W 101-92,240,41,89,.461,35,61,.574,6,28,.214,13,26,.500,101
6785,2016-12-03,CHA,,MIN,L 120-125 (OT),265,44,101,.436,30,65,.462,14,36,.389,18,26,.692,120
6786,2016-12-03,MIN,@,CHO,W 125-120 (OT),265,48,106,.453,38,79,.481,10,27,.370,19,22,.864,125
6787,2016-12-03,CHI,@,DAL,L 82-107,240,32,71,.451,29,58,.500,3,13,.231,15,21,.714,82
6788,2016-12-03,DAL,,CHI,W 107-82,240,40,87,.460,27,56,.482,13,31,.419,14,18,.778,107
6789,2016-12-03,GSW,,PHO,W 138-109,240,49,78,.628,35,57,.614,14,21,.667,26,34,.765,138
6790,2016-12-03,PHO,@,GSW,L 109-138,240,41,91,.451,30,59,.508,11,32,.344,16,21,.762,109
6791,2016-12-03,LAL,@,MEM,L 100-103,240,35,81,.432,28,60,.467,7,21,.333,23,29,.793,100
6792,2016-12-03,MEM,,LAL,W 103-100,240,41,88,.466,31,58,.534,10,30,.333,11,15,.733,103
6793,2016-12-03,BRK,@,MIL,L 103-112,240,34,91,.374,23,50,.460,11,41,.268,24,33,.727,103
6794,2016-12-03,MIL,,BRK,W 112-103,240,40,85,.471,34,61,.557,6,24,.250,26,36,.722,112
6795,2016-12-03,BOS,@,PHI,W 107-106,240,38,76,.500,30,50,.600,8,26,.308,23,29,.793,107
6796,2016-12-03,PHI,,BOS,L 106-107,240,35,76,.461,20,43,.465,15,33,.455,21,26,.808,106
6797,2016-12-03,MIA,@,POR,L 92-99,240,38,86,.442,32,64,.500,6,22,.273,10,15,.667,92
6798,2016-12-03,POR,,MIA,W 99-92,240,36,89,.404,27,65,.415,9,24,.375,18,24,.750,99
6799,2016-12-03,ATL,@,TOR,L 84-128,240,35,88,.398,28,60,.467,7,28,.250,7,14,.500,84
6800,2016-12-03,TOR,,ATL,W 128-84,240,53,92,.576,40,68,.588,13,24,.542,9,11,.818,128
6801,2016-12-03,DEN,@,UTA,L 98-105,240,37,83,.446,24,59,.407,13,24,.542,11,14,.786,98
6802,2016-12-03,UTA,,DEN,W 105-98,240,35,78,.449,26,53,.491,9,25,.360,26,28,.929,105
6803,2016-12-02,ATL,,DET,L 85-121,240,32,88,.364,26,64,.406,6,24,.250,15,20,.750,85
6804,2016-12-02,DET,@,ATL,W 121-85,240,48,89,.539,31,60,.517,17,29,.586,8,12,.667,121
6805,2016-12-02,BOS,,SAC,W 97-92,240,36,88,.409,25,60,.417,11,28,.393,14,15,.933,97
6806,2016-12-02,SAC,@,BOS,L 92-97,240,33,88,.375,27,62,.435,6,26,.231,20,25,.800,92
6807,2016-12-02,CHI,,CLE,W 111-105,240,47,96,.490,44,78,.564,3,18,.167,14,17,.824,111
6808,2016-12-02,CLE,@,CHI,L 105-111,240,45,83,.542,35,57,.614,10,26,.385,5,10,.500,105
6809,2016-12-02,DEN,,HOU,L 110-128,240,46,104,.442,37,73,.507,9,31,.290,9,16,.563,110
6810,2016-12-02,HOU,@,DEN,W 128-110,240,45,88,.511,28,51,.549,17,37,.459,21,25,.840,128
6811,2016-12-02,LAC,@,NOP,W 114-96,240,45,88,.511,35,64,.547,10,24,.417,14,16,.875,114
6812,2016-12-02,NOP,,LAC,L 96-114,240,39,85,.459,34,65,.523,5,20,.250,13,21,.619,96
6813,2016-12-02,MIN,@,NYK,L 114-118,240,41,88,.466,31,60,.517,10,28,.357,22,24,.917,114
6814,2016-12-02,NYK,,MIN,W 118-114,240,41,86,.477,29,55,.527,12,31,.387,24,30,.800,118
6815,2016-12-02,ORL,@,PHI,W 105-88,240,37,78,.474,24,52,.462,13,26,.500,18,26,.692,105
6816,2016-12-02,PHI,,ORL,L 88-105,240,36,95,.379,27,63,.429,9,32,.281,7,10,.700,88
6817,2016-12-02,SAS,,WAS,W 107-105,240,39,80,.488,31,60,.517,8,20,.400,21,33,.636,107
6818,2016-12-02,WAS,@,SAS,L 105-107,240,41,81,.506,34,70,.486,7,11,.636,16,18,.889,105
6819,2016-12-02,LAL,@,TOR,L 80-113,240,32,93,.344,26,67,.388,6,26,.231,10,17,.588,80
6820,2016-12-02,TOR,,LAL,W 113-80,240,45,83,.542,33,54,.611,12,29,.414,11,13,.846,113
6821,2016-12-01,BRK,,MIL,L 93-111,240,34,89,.382,22,49,.449,12,40,.300,13,16,.813,93
6822,2016-12-01,MIL,@,BRK,W 111-93,240,36,80,.450,21,46,.457,15,34,.441,24,29,.828,111
6823,2016-12-01,CHA,,DAL,W 97-87,240,35,74,.473,30,56,.536,5,18,.278,22,31,.710,97
6824,2016-12-01,DAL,@,CHO,L 87-97,240,32,86,.372,23,55,.418,9,31,.290,14,18,.778,87
6825,2016-12-01,CLE,,LAC,L 94-113,240,28,69,.406,19,45,.422,9,24,.375,29,39,.744,94
6826,2016-12-01,LAC,@,CLE,W 113-94,240,42,89,.472,29,58,.500,13,31,.419,16,24,.667,113
6827,2016-12-01,GSW,,HOU,L 127-132 (2OT),290,43,104,.413,31,60,.517,12,44,.273,29,37,.784,127
6828,2016-12-01,HOU,@,GSW,W 132-127 (2OT),290,48,108,.444,34,64,.531,14,44,.318,22,30,.733,132
6829,2016-12-01,MEM,,ORL,W 95-94,240,33,79,.418,26,61,.426,7,18,.389,22,28,.786,95
6830,2016-12-01,ORL,@,MEM,L 94-95,240,33,74,.446,27,50,.540,6,24,.250,22,31,.710,94
6831,2016-12-01,MIA,@,UTA,W 111-110,240,44,86,.512,36,67,.537,8,19,.421,15,19,.789,111
6832,2016-12-01,UTA,,MIA,L 110-111,240,40,73,.548,23,43,.535,17,30,.567,13,17,.765,110
6833,2016-11-30,BOS,,DET,L 114-121,240,40,91,.440,25,49,.510,15,42,.357,19,20,.950,114
6834,2016-11-30,DET,@,BOS,W 121-114,240,48,87,.552,39,67,.582,9,20,.450,16,21,.762,121
6835,2016-11-30,CHI,,LAL,L 90-96,240,32,91,.352,28,70,.400,4,21,.190,22,29,.759,90
6836,2016-11-30,LAL,@,CHI,W 96-90,240,33,81,.407,31,73,.425,2,8,.250,28,41,.683,96
6837,2016-11-30,DAL,,SAS,L 87-94,240,33,77,.429,23,47,.489,10,30,.333,11,14,.786,87
6838,2016-11-30,SAS,@,DAL,W 94-87,240,33,71,.465,22,52,.423,11,19,.579,17,24,.708,94
6839,2016-11-30,DEN,,MIA,L 98-106,240,38,91,.418,31,69,.449,7,22,.318,15,24,.625,98
6840,2016-11-30,MIA,@,DEN,W 106-98,240,41,93,.441,32,69,.464,9,24,.375,15,26,.577,106
6841,2016-11-30,MIN,,NYK,L 104-106,240,34,77,.442,30,58,.517,4,19,.211,32,39,.821,104
6842,2016-11-30,NYK,@,MIN,W 106-104,240,41,91,.451,28,59,.475,13,32,.406,11,15,.733,106
6843,2016-11-30,OKC,,WAS,W 126-115 (OT),265,46,95,.484,34,65,.523,12,30,.400,22,31,.710,126
6844,2016-11-30,WAS,@,OKC,L 115-126 (OT),265,44,98,.449,34,70,.486,10,28,.357,17,26,.654,115
6845,2016-11-30,ATL,@,PHO,L 107-109,240,45,89,.506,36,64,.563,9,25,.360,8,10,.800,107
6846,2016-11-30,PHO,,ATL,W 109-107,240,40,89,.449,30,68,.441,10,21,.476,19,25,.760,109
6847,2016-11-30,IND,@,POR,L 109-131,240,36,72,.500,30,58,.517,6,14,.429,31,35,.886,109
6848,2016-11-30,POR,,IND,W 131-109,240,51,94,.543,39,62,.629,12,32,.375,17,19,.895,131
6849,2016-11-30,MEM,@,TOR,L 105-120,240,36,82,.439,25,55,.455,11,27,.407,22,26,.846,105
6850,2016-11-30,TOR,,MEM,W 120-105,240,38,69,.551,22,37,.595,16,32,.500,28,33,.848,120
6851,2016-11-29,BRK,,LAC,W 127-122 (2OT),290,45,104,.433,32,66,.485,13,38,.342,24,36,.667,127
6852,2016-11-29,LAC,@,BRK,L 122-127 (2OT),290,46,109,.422,33,69,.478,13,40,.325,17,22,.773,122
6853,2016-11-29,CHA,,DET,L 89-112,240,31,78,.397,22,51,.431,9,27,.333,18,21,.857,89
6854,2016-11-29,DET,@,CHO,W 112-89,240,45,92,.489,33,64,.516,12,28,.429,10,11,.909,112
6855,2016-11-29,CLE,@,MIL,L 101-118,240,32,75,.427,18,36,.500,14,39,.359,23,31,.742,101
6856,2016-11-29,MIL,,CLE,W 118-101,240,46,86,.535,39,67,.582,7,19,.368,19,23,.826,118
6857,2016-11-29,LAL,@,NOP,L 88-105,240,37,87,.425,32,57,.561,5,30,.167,9,18,.500,88
6858,2016-11-29,NOP,,LAL,W 105-88,240,38,88,.432,30,57,.526,8,31,.258,21,25,.840,105
6859,2016-11-29,ORL,@,SAS,W 95-83,240,39,86,.453,33,71,.465,6,15,.400,11,12,.917,95
6860,2016-11-29,SAS,,ORL,L 83-95,240,28,76,.368,23,56,.411,5,20,.250,22,26,.846,83
6861,2016-11-29,HOU,@,UTA,L 101-120,240,37,91,.407,26,61,.426,11,30,.367,16,22,.727,101
6862,2016-11-29,UTA,,HOU,W 120-101,240,41,74,.554,26,46,.565,15,28,.536,23,27,.852,120
6863,2016-11-28,ATL,@,GSW,L 100-105,240,36,85,.424,29,56,.518,7,29,.241,21,30,.700,100
6864,2016-11-28,GSW,,ATL,W 105-100,240,37,85,.435,25,50,.500,12,35,.343,19,24,.792,105
6865,2016-11-28,CHA,@,MEM,W 104-85,240,36,82,.439,27,56,.482,9,26,.346,23,31,.742,104
6866,2016-11-28,MEM,,CHO,L 85-104,240,36,89,.404,29,60,.483,7,29,.241,6,13,.462,85
6867,2016-11-28,BOS,@,MIA,W 112-104,240,40,83,.482,29,56,.518,11,27,.407,21,26,.808,112
6868,2016-11-28,MIA,,BOS,L 104-112,240,38,80,.475,32,50,.640,6,30,.200,22,32,.688,104
6869,2016-11-28,MIN,,UTA,L 103-112,240,36,81,.444,29,62,.468,7,19,.368,24,25,.960,103
6870,2016-11-28,UTA,@,MIN,W 112-103,240,40,79,.506,36,61,.590,4,18,.222,28,34,.824,112
6871,2016-11-28,NYK,,OKC,L 103-112,240,36,91,.396,30,72,.417,6,19,.316,25,28,.893,103
6872,2016-11-28,OKC,@,NYK,W 112-103,240,46,92,.500,38,70,.543,8,22,.364,12,18,.667,112
6873,2016-11-28,PHI,@,TOR,L 95-122,240,36,86,.419,22,52,.423,14,34,.412,9,13,.692,95
6874,2016-11-28,TOR,,PHI,W 122-95,240,42,77,.545,29,58,.500,13,19,.684,25,31,.806,122
6875,2016-11-28,SAC,@,WAS,L 95-101 (OT),265,38,93,.409,35,72,.486,3,21,.143,16,26,.615,95
6876,2016-11-28,WAS,,SAC,W 101-95 (OT),265,35,85,.412,25,60,.417,10,25,.400,21,26,.808,101
6877,2016-11-27,BRK,,SAC,L 105-122,240,38,87,.437,22,47,.468,16,40,.400,13,14,.929,105
6878,2016-11-27,SAC,@,BRK,W 122-105,240,46,86,.535,33,63,.524,13,23,.565,17,22,.773,122
6879,2016-11-27,DAL,,NOP,W 91-81,240,32,77,.416,22,50,.440,10,27,.370,17,20,.850,91
6880,2016-11-27,NOP,@,DAL,L 81-91,240,30,77,.390,25,57,.439,5,20,.250,16,18,.889,81
6881,2016-11-27,IND,,LAC,W 91-70,240,40,92,.435,35,73,.479,5,19,.263,6,7,.857,91
6882,2016-11-27,LAC,@,IND,L 70-91,240,22,70,.314,18,46,.391,4,24,.167,22,27,.815,70
6883,2016-11-27,ATL,@,LAL,L 94-109,240,39,88,.443,27,53,.509,12,35,.343,4,10,.400,94
6884,2016-11-27,LAL,,ATL,W 109-94,240,42,95,.442,34,75,.453,8,20,.400,17,20,.850,109
6885,2016-11-27,MIL,@,ORL,W 104-96,240,41,86,.477,33,62,.532,8,24,.333,14,20,.700,104
6886,2016-11-27,ORL,,MIL,L 96-104,240,38,92,.413,31,64,.484,7,28,.250,13,17,.765,96
6887,2016-11-27,CLE,@,PHI,W 112-108,240,38,92,.413,26,52,.500,12,40,.300,24,28,.857,112
6888,2016-11-27,PHI,,CLE,L 108-112,240,43,92,.467,28,58,.483,15,34,.441,7,10,.700,108
6889,2016-11-27,DEN,@,PHO,W 120-114,240,39,89,.438,26,60,.433,13,29,.448,29,32,.906,120
6890,2016-11-27,PHO,,DEN,L 114-120,240,36,89,.404,25,64,.391,11,25,.440,31,36,.861,114
6891,2016-11-27,HOU,@,POR,W 130-114,240,46,82,.561,29,46,.630,17,36,.472,21,28,.750,130
6892,2016-11-27,POR,,HOU,L 114-130,240,40,83,.482,28,50,.560,12,33,.364,22,29,.759,114
6893,2016-11-26,CHA,,NYK,W 107-102,240,35,80,.438,27,58,.466,8,22,.364,29,42,.690,107
6894,2016-11-26,NYK,@,CHO,L 102-107,240,37,99,.374,25,67,.373,12,32,.375,16,20,.800,102
6895,2016-11-26,GSW,,MIN,W 115-102,240,45,81,.556,34,59,.576,11,22,.500,14,17,.824,115
6896,2016-11-26,MIN,@,GSW,L 102-115,240,41,89,.461,31,54,.574,10,35,.286,10,12,.833,102
6897,2016-11-26,MEM,@,MIA,W 110-107,240,37,73,.507,28,48,.583,9,25,.360,27,33,.818,110
6898,2016-11-26,MIA,,MEM,L 107-110,240,40,81,.494,29,50,.580,11,31,.355,16,24,.667,107
6899,2016-11-26,DET,@,OKC,L 88-106,240,37,82,.451,36,63,.571,1,19,.053,13,17,.765,88
6900,2016-11-26,OKC,,DET,W 106-88,240,42,83,.506,34,60,.567,8,23,.348,14,26,.538,106
6901,2016-11-26,SAS,@,WAS,W 112-100,240,40,75,.533,31,51,.608,9,24,.375,23,29,.793,112
6902,2016-11-26,WAS,,SAS,L 100-112,240,42,88,.477,36,66,.545,6,22,.273,10,14,.714,100
6903,2016-11-25,BOS,,SAS,L 103-109,240,42,91,.462,30,57,.526,12,34,.353,7,9,.778,103
6904,2016-11-25,SAS,@,BOS,W 109-103,240,38,81,.469,27,57,.474,11,24,.458,22,25,.880,109
6905,2016-11-25,CLE,,DAL,W 128-90,240,43,85,.506,23,42,.548,20,43,.465,22,24,.917,128
6906,2016-11-25,DAL,@,CLE,L 90-128,240,37,91,.407,29,56,.518,8,35,.229,8,12,.667,90
6907,2016-11-25,DEN,,OKC,L 129-132 (OT),265,48,101,.475,36,67,.537,12,34,.353,21,27,.778,129
6908,2016-11-25,OKC,@,DEN,W 132-129 (OT),265,48,96,.500,35,70,.500,13,26,.500,23,29,.793,132
6909,2016-11-25,DET,,LAC,W 108-97,240,47,90,.522,38,71,.535,9,19,.474,5,7,.714,108
6910,2016-11-25,LAC,@,DET,L 97-108,240,35,73,.479,28,52,.538,7,21,.333,20,26,.769,97
6911,2016-11-25,BRK,@,IND,L 97-118,240,36,79,.456,25,45,.556,11,34,.324,14,23,.609,97
6912,2016-11-25,IND,,BRK,W 118-97,240,48,87,.552,37,61,.607,11,26,.423,11,16,.688,118
6913,2016-11-25,GSW,@,LAL,W 109-85,240,43,83,.518,32,55,.582,11,28,.393,12,17,.706,109
6914,2016-11-25,LAL,,GSW,L 85-109,240,32,90,.356,27,68,.397,5,22,.227,16,23,.696,85
6915,2016-11-25,MEM,,MIA,L 81-90,240,29,82,.354,25,63,.397,4,19,.211,19,23,.826,81
6916,2016-11-25,MIA,@,MEM,W 90-81,240,33,85,.388,21,54,.389,12,31,.387,12,18,.667,90
6917,2016-11-25,MIL,,TOR,L 99-105,240,40,79,.506,28,50,.560,12,29,.414,7,12,.583,99
6918,2016-11-25,TOR,@,MIL,W 105-99,240,38,82,.463,24,50,.480,14,32,.438,15,19,.789,105
6919,2016-11-25,CHA,@,NYK,L 111-113 (OT),265,43,93,.462,35,64,.547,8,29,.276,17,27,.630,111
6920,2016-11-25,NYK,,CHO,W 113-111 (OT),265,45,97,.464,34,69,.493,11,28,.393,12,13,.923,113
6921,2016-11-25,ORL,,WAS,L 91-94,240,35,80,.438,28,57,.491,7,23,.304,14,20,.700,91
6922,2016-11-25,WAS,@,ORL,W 94-91,240,40,88,.455,34,59,.576,6,29,.207,8,10,.800,94
6923,2016-11-25,CHI,@,PHI,W 105-89,240,40,90,.444,34,69,.493,6,21,.286,19,26,.731,105
6924,2016-11-25,PHI,,CHI,L 89-105,240,31,78,.397,22,56,.393,9,22,.409,18,22,.818,89
6925,2016-11-25,MIN,@,PHO,W 98-85,240,34,85,.400,27,63,.429,7,22,.318,23,25,.920,98
6926,2016-11-25,PHO,,MIN,L 85-98,240,32,79,.405,26,53,.491,6,26,.231,15,21,.714,85
6927,2016-11-25,NOP,@,POR,L 104-119,240,36,76,.474,23,53,.434,13,23,.565,19,29,.655,104
6928,2016-11-25,POR,,NOP,W 119-104,240,47,100,.470,35,68,.515,12,32,.375,13,17,.765,119
6929,2016-11-25,HOU,@,SAC,W 117-104,240,40,85,.471,19,35,.543,21,50,.420,16,20,.800,117
6930,2016-11-25,SAC,,HOU,L 104-117,240,39,80,.488,30,48,.625,9,32,.281,17,21,.810,104
6931,2016-11-25,ATL,@,UTA,L 68-95,240,26,83,.313,18,58,.310,8,25,.320,8,12,.667,68
6932,2016-11-25,UTA,,ATL,W 95-68,240,35,80,.438,25,46,.543,10,34,.294,15,18,.833,95
6933,2016-11-23,BOS,@,BRK,W 111-92,240,45,98,.459,30,60,.500,15,38,.395,6,8,.750,111
6934,2016-11-23,BRK,,BOS,L 92-111,240,34,86,.395,24,55,.436,10,31,.323,14,22,.636,92
6935,2016-11-23,CHA,,SAS,L 114-119,240,45,89,.506,34,69,.493,11,20,.550,13,18,.722,114
6936,2016-11-23,SAS,@,CHO,W 119-114,240,44,86,.512,31,55,.564,13,31,.419,18,20,.900,119
6937,2016-11-23,CLE,,POR,W 137-125,240,48,90,.533,27,54,.500,21,36,.583,20,27,.741,137
6938,2016-11-23,POR,@,CLE,L 125-137,240,47,90,.522,34,61,.557,13,29,.448,18,19,.947,125
6939,2016-11-23,DAL,,LAC,L 104-124,240,38,84,.452,27,60,.450,11,24,.458,17,18,.944,104
6940,2016-11-23,LAC,@,DAL,W 124-104,240,43,85,.506,28,53,.528,15,32,.469,23,31,.742,124
6941,2016-11-23,DET,,MIA,W 107-84,240,40,81,.494,34,62,.548,6,19,.316,21,25,.840,107
6942,2016-11-23,MIA,@,DET,L 84-107,240,27,75,.360,20,49,.408,7,26,.269,23,30,.767,84
6943,2016-11-23,GSW,,LAL,W 149-106,240,53,86,.616,34,50,.680,19,36,.528,24,35,.686,149
6944,2016-11-23,LAL,@,GSW,L 106-149,240,40,93,.430,32,73,.438,8,20,.400,18,22,.818,106
6945,2016-11-23,HOU,,TOR,L 102-115,240,38,78,.487,24,36,.667,14,42,.333,12,12,1.000,102
6946,2016-11-23,TOR,@,HOU,W 115-102,240,43,88,.489,31,65,.477,12,23,.522,17,21,.810,115
6947,2016-11-23,ATL,@,IND,W 96-85,240,36,85,.424,31,65,.477,5,20,.250,19,22,.864,96
6948,2016-11-23,IND,,ATL,L 85-96,240,34,84,.405,27,57,.474,7,27,.259,10,14,.714,85
6949,2016-11-23,MIN,@,NOP,L 96-117,240,33,86,.384,30,69,.435,3,17,.176,27,33,.818,96
6950,2016-11-23,NOP,,MIN,W 117-96,240,45,83,.542,36,59,.610,9,24,.375,18,23,.783,117
6951,2016-11-23,ORL,,PHO,L 87-92,240,33,91,.363,26,66,.394,7,25,.280,14,23,.609,87
6952,2016-11-23,PHO,@,ORL,W 92-87,240,33,73,.452,24,51,.471,9,22,.409,17,22,.773,92
6953,2016-11-23,MEM,@,PHI,W 104-99 (2OT),290,38,99,.384,28,70,.400,10,29,.345,18,24,.750,104
6954,2016-11-23,PHI,,MEM,L 99-104 (2OT),290,35,93,.376,23,57,.404,12,36,.333,17,23,.739,99
6955,2016-11-23,OKC,@,SAC,L 101-116,240,32,76,.421,25,51,.490,7,25,.280,30,38,.789,101
6956,2016-11-23,SAC,,OKC,W 116-101,240,44,94,.468,32,66,.485,12,28,.429,16,17,.941,116
6957,2016-11-23,DEN,@,UTA,L 83-108,240,28,88,.318,19,61,.311,9,27,.333,18,31,.581,83
6958,2016-11-23,UTA,,DEN,W 108-83,240,39,79,.494,31,53,.585,8,26,.308,22,31,.710,108
6959,2016-11-22,ATL,,NOP,L 94-112,240,39,85,.459,29,56,.518,10,29,.345,6,10,.600,94
6960,2016-11-22,NOP,@,ATL,W 112-94,240,45,86,.523,34,61,.557,11,25,.440,11,12,.917,112
6961,2016-11-22,CHI,@,DEN,L 107-110,240,43,95,.453,37,77,.481,6,18,.333,15,18,.833,107
6962,2016-11-22,DEN,,CHI,W 110-107,240,43,100,.430,33,78,.423,10,22,.455,14,17,.824,110
6963,2016-11-22,LAL,,OKC,W 111-109,240,42,83,.506,28,56,.500,14,27,.519,13,16,.813,111
6964,2016-11-22,OKC,@,LAL,L 109-111,240,45,92,.489,34,65,.523,11,27,.407,8,11,.727,109
6965,2016-11-22,NYK,,POR,W 107-103,240,45,96,.469,36,67,.537,9,29,.310,8,8,1.000,107
6966,2016-11-22,POR,@,NYK,L 103-107,240,38,86,.442,32,64,.500,6,22,.273,21,26,.808,103
6967,2016-11-21,CHA,,MEM,L 90-105,240,30,73,.411,21,42,.500,9,31,.290,21,33,.636,90
6968,2016-11-21,MEM,@,CHO,W 105-90,240,40,84,.476,28,58,.483,12,26,.462,13,17,.765,105
6969,2016-11-21,DET,,HOU,L 96-99,240,36,87,.414,29,70,.414,7,17,.412,17,24,.708,96
6970,2016-11-21,HOU,@,DET,W 99-96,240,35,78,.449,25,47,.532,10,31,.323,19,27,.704,99
6971,2016-11-21,GSW,@,IND,W 120-83,240,40,90,.444,27,54,.500,13,36,.361,27,32,.844,120
6972,2016-11-21,IND,,GSW,L 83-120,240,33,103,.320,27,80,.338,6,23,.261,11,12,.917,83
6973,2016-11-21,LAC,,TOR,W 123-115,240,39,74,.527,29,49,.592,10,25,.400,35,42,.833,123
6974,2016-11-21,TOR,@,LAC,L 115-123,240,40,80,.500,32,61,.525,8,19,.421,27,32,.844,115
6975,2016-11-21,MIL,,ORL,W 93-89,240,35,86,.407,27,57,.474,8,29,.276,15,21,.714,93
6976,2016-11-21,ORL,@,MIL,L 89-93,240,32,77,.416,25,52,.481,7,25,.280,18,24,.750,89
6977,2016-11-21,BOS,@,MIN,W 99-93,240,38,84,.452,26,46,.565,12,38,.316,11,14,.786,99
6978,2016-11-21,MIN,,BOS,L 93-99,240,36,86,.419,32,62,.516,4,24,.167,17,25,.680,93
6979,2016-11-21,MIA,@,PHI,L 94-101,240,34,88,.386,27,57,.474,7,31,.226,19,28,.679,94
6980,2016-11-21,PHI,,MIA,W 101-94,240,37,78,.474,26,52,.500,11,26,.423,16,20,.800,101
6981,2016-11-21,DAL,@,SAS,L 91-96,240,35,74,.473,27,47,.574,8,27,.296,13,20,.650,91
6982,2016-11-21,SAS,,DAL,W 96-91,240,35,75,.467,27,55,.491,8,20,.400,18,25,.720,96
6983,2016-11-21,PHO,@,WAS,L 101-106,240,39,91,.429,28,64,.438,11,27,.407,12,15,.800,101
6984,2016-11-21,WAS,,PHO,W 106-101,240,37,91,.407,27,63,.429,10,28,.357,22,34,.647,106
6985,2016-11-20,BRK,,POR,L 109-129,240,37,93,.398,27,58,.466,10,35,.286,25,31,.806,109
6986,2016-11-20,POR,@,BRK,W 129-109,240,49,85,.576,34,49,.694,15,36,.417,16,21,.762,129
6987,2016-11-20,DEN,,UTA,W 105-91,240,42,86,.488,34,64,.531,8,22,.364,13,30,.433,105
6988,2016-11-20,UTA,@,DEN,L 91-105,240,33,85,.388,26,58,.448,7,27,.259,18,23,.783,91
6989,2016-11-20,CHI,@,LAL,W 118-110,240,45,87,.517,37,65,.569,8,22,.364,20,28,.714,118
6990,2016-11-20,LAL,,CHI,L 110-118,240,41,93,.441,28,62,.452,13,31,.419,15,21,.714,110
6991,2016-11-20,ATL,@,NYK,L 94-104,240,34,85,.400,28,64,.438,6,21,.286,20,29,.690,94
6992,2016-11-20,NYK,,ATL,W 104-94,240,42,88,.477,32,61,.525,10,27,.370,10,14,.714,104
6993,2016-11-20,IND,@,OKC,W 115-111 (OT),265,40,89,.449,29,67,.433,11,22,.500,24,31,.774,115
6994,2016-11-20,OKC,,IND,L 111-115 (OT),265,44,101,.436,34,65,.523,10,36,.278,13,18,.722,111
6995,2016-11-20,SAC,,TOR,W 102-99,240,36,81,.444,25,54,.463,11,27,.407,19,25,.760,102
6996,2016-11-20,TOR,@,SAC,L 99-102,240,34,85,.400,25,61,.410,9,24,.375,22,24,.917,99
6997,2016-11-19,BOS,@,DET,W 94-92,240,33,82,.402,21,51,.412,12,31,.387,16,17,.941,94
6998,2016-11-19,DET,,BOS,L 92-94,240,37,86,.430,30,66,.455,7,20,.350,11,16,.688,92
6999,2016-11-19,HOU,,UTA,W 111-102,240,42,94,.447,30,62,.484,12,32,.375,15,20,.750,111
7000,2016-11-19,UTA,@,HOU,L 102-111,240,39,76,.513,27,49,.551,12,27,.444,12,17,.706,102
7001,2016-11-19,CHI,@,LAC,L 95-102,240,33,77,.429,24,47,.511,9,30,.300,20,24,.833,95
7002,2016-11-19,LAC,,CHI,W 102-95,240,36,77,.468,25,50,.500,11,27,.407,19,23,.826,102
7003,2016-11-19,MEM,,MIN,W 93-71,240,29,76,.382,27,58,.466,2,18,.111,33,38,.868,93
7004,2016-11-19,MIN,@,MEM,L 71-93,240,25,64,.391,18,42,.429,7,22,.318,14,22,.636,71
7005,2016-11-19,GSW,@,MIL,W 124-121,240,42,95,.442,28,57,.491,14,38,.368,26,32,.813,124
7006,2016-11-19,MIL,,GSW,L 121-124,240,46,89,.517,36,69,.522,10,20,.500,19,25,.760,121
7007,2016-11-19,CHA,@,NOP,L 116-121 (OT),265,40,97,.412,25,54,.463,15,43,.349,21,28,.750,116
7008,2016-11-19,NOP,,CHO,W 121-116 (OT),265,43,98,.439,29,62,.468,14,36,.389,21,25,.840,121
7009,2016-11-19,DAL,@,ORL,L 87-95,240,26,77,.338,13,49,.265,13,28,.464,22,27,.815,87
7010,2016-11-19,ORL,,DAL,W 95-87,240,34,78,.436,26,57,.456,8,21,.381,19,22,.864,95
7011,2016-11-19,PHI,,PHO,W 120-105,240,45,86,.523,28,51,.549,17,35,.486,13,20,.650,120
7012,2016-11-19,PHO,@,PHI,L 105-120,240,39,92,.424,33,71,.465,6,21,.286,21,34,.618,105
7013,2016-11-19,MIA,@,WAS,W 114-111,240,43,85,.506,30,58,.517,13,27,.481,15,26,.577,114
7014,2016-11-19,WAS,,MIA,L 111-114,240,42,89,.472,31,62,.500,11,27,.407,16,22,.727,111
7015,2016-11-18,BOS,,GSW,L 88-104,240,31,83,.373,20,51,.392,11,32,.344,15,19,.789,88
7016,2016-11-18,GSW,@,BOS,W 104-88,240,44,90,.489,35,62,.565,9,28,.321,7,12,.583,104
7017,2016-11-18,ATL,@,CHO,L 96-100,240,39,84,.464,32,56,.571,7,28,.250,11,17,.647,96
7018,2016-11-18,CHA,,ATL,W 100-96,240,37,90,.411,27,61,.443,10,29,.345,16,24,.667,100
7019,2016-11-18,CLE,,DET,W 104-81,240,40,83,.482,29,58,.500,11,25,.440,13,14,.929,104
7020,2016-11-18,DET,@,CLE,L 81-104,240,29,93,.312,23,74,.311,6,19,.316,17,20,.850,81
7021,2016-11-18,DAL,,MEM,L 64-80,240,21,73,.288,16,48,.333,5,25,.200,17,22,.773,64
7022,2016-11-18,MEM,@,DAL,W 80-64,240,31,77,.403,22,52,.423,9,25,.360,9,12,.750,80
7023,2016-11-18,DEN,,TOR,L 111-113 (OT),265,39,83,.470,35,58,.603,4,25,.160,29,39,.744,111
7024,2016-11-18,TOR,@,DEN,W 113-111 (OT),265,43,94,.457,35,71,.493,8,23,.348,19,31,.613,113
7025,2016-11-18,IND,,PHO,L 96-116,240,36,76,.474,35,69,.507,1,7,.143,23,29,.793,96
7026,2016-11-18,PHO,@,IND,W 116-96,240,46,97,.474,37,71,.521,9,26,.346,15,18,.833,116
7027,2016-11-18,LAL,,SAS,L 107-116,240,39,87,.448,27,62,.435,12,25,.480,17,21,.810,107
7028,2016-11-18,SAS,@,LAL,W 116-107,240,44,78,.564,34,54,.630,10,24,.417,18,19,.947,116
7029,2016-11-18,NOP,,POR,W 113-101,240,45,82,.549,36,58,.621,9,24,.375,14,20,.700,113
7030,2016-11-18,POR,@,NOP,L 101-113,240,33,88,.375,21,54,.389,12,34,.353,23,26,.885,101
7031,2016-11-18,BRK,@,OKC,L 105-124,240,35,83,.422,24,54,.444,11,29,.379,24,30,.800,105
7032,2016-11-18,OKC,,BRK,W 124-105,240,49,89,.551,42,63,.667,7,26,.269,19,24,.792,124
7033,2016-11-18,LAC,@,SAC,W 121-115,240,40,76,.526,27,47,.574,13,29,.448,28,34,.824,121
7034,2016-11-18,SAC,,LAC,L 115-121,240,38,86,.442,28,60,.467,10,26,.385,29,35,.829,115
7035,2016-11-17,HOU,,POR,W 126-109,240,46,95,.484,32,63,.508,14,32,.438,20,25,.800,126
7036,2016-11-17,POR,@,HOU,L 109-126,240,41,90,.456,31,62,.500,10,28,.357,17,21,.810,109
7037,2016-11-17,MIA,,MIL,W 96-73,240,39,97,.402,32,67,.478,7,30,.233,11,21,.524,96
7038,2016-11-17,MIL,@,MIA,L 73-96,240,28,85,.329,21,62,.339,7,23,.304,10,13,.769,73
7039,2016-11-17,MIN,,PHI,W 110-86,240,43,84,.512,37,59,.627,6,25,.240,18,20,.900,110
7040,2016-11-17,PHI,@,MIN,L 86-110,240,31,83,.373,22,51,.431,9,32,.281,15,19,.789,86
7041,2016-11-17,CHI,@,UTA,W 85-77,240,33,90,.367,28,73,.384,5,17,.294,14,16,.875,85
7042,2016-11-17,UTA,,CHI,L 77-85,240,30,78,.385,25,53,.472,5,25,.200,12,14,.857,77
7043,2016-11-17,NYK,@,WAS,L 112-119,240,41,86,.477,29,57,.509,12,29,.414,18,20,.900,112
7044,2016-11-17,WAS,,NYK,W 119-112,240,44,81,.543,29,56,.518,15,25,.600,16,18,.889,119
7045,2016-11-16,ATL,,MIL,W 107-100,240,35,72,.486,25,40,.625,10,32,.313,27,31,.871,107
7046,2016-11-16,MIL,@,ATL,L 100-107,240,39,98,.398,31,66,.470,8,32,.250,14,18,.778,100
7047,2016-11-16,BOS,,DAL,W 90-83,240,33,76,.434,26,55,.473,7,21,.333,17,23,.739,90
7048,2016-11-16,DAL,@,BOS,L 83-90,240,34,83,.410,26,60,.433,8,23,.348,7,10,.700,83
7049,2016-11-16,DEN,,PHO,W 120-104,240,45,93,.484,37,76,.487,8,17,.471,22,24,.917,120
7050,2016-11-16,PHO,@,DEN,L 104-120,240,39,79,.494,31,59,.525,8,20,.400,18,29,.621,104
7051,2016-11-16,CLE,@,IND,L 93-103,240,35,86,.407,24,56,.429,11,30,.367,12,20,.600,93
7052,2016-11-16,IND,,CLE,W 103-93,240,43,86,.500,33,58,.569,10,28,.357,7,11,.636,103
7053,2016-11-16,LAC,,MEM,L 107-111,240,37,81,.457,28,56,.500,9,25,.360,24,34,.706,107
7054,2016-11-16,MEM,@,LAC,W 111-107,240,40,82,.488,25,56,.446,15,26,.577,16,19,.842,111
7055,2016-11-16,DET,@,NYK,L 102-105,240,42,85,.494,34,62,.548,8,23,.348,10,12,.833,102
7056,2016-11-16,NYK,,DET,W 105-102,240,42,93,.452,33,68,.485,9,25,.360,12,19,.632,105
7057,2016-11-16,HOU,@,OKC,L 103-105,240,40,92,.435,26,52,.500,14,40,.350,9,14,.643,103
7058,2016-11-16,OKC,,HOU,W 105-103,240,40,84,.476,28,59,.475,12,25,.480,13,14,.929,105
7059,2016-11-16,NOP,@,ORL,L 82-89,240,30,82,.366,23,61,.377,7,21,.333,15,19,.789,82
7060,2016-11-16,ORL,,NOP,W 89-82,240,34,88,.386,24,61,.393,10,27,.370,11,19,.579,89
7061,2016-11-16,PHI,,WAS,W 109-102,240,42,77,.545,32,49,.653,10,28,.357,15,22,.682,109
7062,2016-11-16,WAS,@,PHI,L 102-109,240,38,91,.418,30,68,.441,8,23,.348,18,25,.720,102
7063,2016-11-16,SAC,,SAS,L 105-110,240,36,76,.474,27,56,.482,9,20,.450,24,31,.774,105
7064,2016-11-16,SAS,@,SAC,W 110-105,240,43,88,.489,32,58,.552,11,30,.367,13,17,.765,110
7065,2016-11-16,GSW,@,TOR,W 127-121,240,44,87,.506,31,51,.608,13,36,.361,26,28,.929,127
7066,2016-11-16,TOR,,GSW,L 121-127,240,37,82,.451,27,57,.474,10,25,.400,37,41,.902,121
7067,2016-11-15,CLE,,TOR,W 121-117,240,44,83,.530,31,50,.620,13,33,.394,20,28,.714,121
7068,2016-11-15,TOR,@,CLE,L 117-121,240,46,96,.479,33,67,.493,13,29,.448,12,18,.667,117
7069,2016-11-15,BRK,@,LAL,L 118-125,240,45,99,.455,33,58,.569,12,41,.293,16,20,.800,118
7070,2016-11-15,LAL,,BRK,W 125-118,240,41,92,.446,32,64,.500,9,28,.321,34,43,.791,125
7071,2016-11-15,ATL,@,MIA,W 93-90,240,37,80,.463,31,63,.492,6,17,.353,13,19,.684,93
7072,2016-11-15,MIA,,ATL,L 90-93,240,36,89,.404,29,66,.439,7,23,.304,11,14,.786,90
7073,2016-11-15,CHA,@,MIN,W 115-108,240,43,80,.538,32,56,.571,11,24,.458,18,22,.818,115
7074,2016-11-15,MIN,,CHO,L 108-115,240,38,89,.427,23,54,.426,15,35,.429,17,21,.810,108
7075,2016-11-15,CHI,@,POR,W 113-88,240,41,98,.418,34,78,.436,7,20,.350,24,28,.857,113
7076,2016-11-15,POR,,CHI,L 88-113,240,34,95,.358,25,61,.410,9,34,.265,11,18,.611,88
7077,2016-11-14,DET,,OKC,W 104-88,240,43,92,.467,38,76,.500,5,16,.313,13,16,.813,104
7078,2016-11-14,OKC,@,DET,L 88-104,240,33,88,.375,28,61,.459,5,27,.185,17,22,.773,88
7079,2016-11-14,HOU,,PHI,W 115-88,240,44,91,.484,27,51,.529,17,40,.425,10,17,.588,115
7080,2016-11-14,PHI,@,HOU,L 88-115,240,34,90,.378,29,68,.426,5,22,.227,15,17,.882,88
7081,2016-11-14,IND,,ORL,W 88-69,240,35,90,.389,27,65,.415,8,25,.320,10,10,1.000,88
7082,2016-11-14,ORL,@,IND,L 69-88,240,27,84,.321,22,59,.373,5,25,.200,10,13,.769,69
7083,2016-11-14,BRK,@,LAC,L 95-127,240,34,77,.442,24,44,.545,10,33,.303,17,22,.773,95
7084,2016-11-14,LAC,,BRK,W 127-95,240,48,90,.533,34,65,.523,14,25,.560,17,21,.810,127
7085,2016-11-14,BOS,@,NOP,L 105-106,240,38,95,.400,26,54,.481,12,41,.293,17,20,.850,105
7086,2016-11-14,NOP,,BOS,W 106-105,240,35,79,.443,29,58,.500,6,21,.286,30,36,.833,106
7087,2016-11-14,DAL,@,NYK,L 77-93,240,32,84,.381,27,57,.474,5,27,.185,8,11,.727,77
7088,2016-11-14,NYK,,DAL,W 93-77,240,34,78,.436,25,53,.472,9,25,.360,16,18,.889,93
7089,2016-11-14,MIA,@,SAS,L 90-94,240,37,84,.440,33,69,.478,4,15,.267,12,21,.571,90
7090,2016-11-14,SAS,,MIA,W 94-90,240,33,82,.402,25,67,.373,8,15,.533,20,27,.741,94
7091,2016-11-14,MEM,@,UTA,W 102-96,240,36,76,.474,28,55,.509,8,21,.381,22,26,.846,102
7092,2016-11-14,UTA,,MEM,L 96-102,240,35,73,.479,27,45,.600,8,28,.286,18,22,.818,96
7093,2016-11-13,CHA,@,CLE,L 93-100,240,36,95,.379,25,66,.379,11,29,.379,10,12,.833,93
7094,2016-11-13,CLE,,CHO,W 100-93,240,39,92,.424,25,54,.463,14,38,.368,8,15,.533,100
7095,2016-11-13,GSW,,PHO,W 133-120,240,45,87,.517,29,54,.537,16,33,.485,27,31,.871,133
7096,2016-11-13,PHO,@,GSW,L 120-133,240,46,90,.511,38,66,.576,8,24,.333,20,26,.769,120
7097,2016-11-13,LAL,@,MIN,L 99-125,240,33,71,.465,25,47,.532,8,24,.333,25,30,.833,99
7098,2016-11-13,MIN,,LAL,W 125-99,240,42,80,.525,29,53,.547,13,27,.481,28,42,.667,125
7099,2016-11-13,OKC,,ORL,L 117-119,240,47,92,.511,40,67,.597,7,25,.280,16,26,.615,117
7100,2016-11-13,ORL,@,OKC,W 119-117,240,46,86,.535,35,62,.565,11,24,.458,16,20,.800,119
7101,2016-11-13,DEN,@,POR,L 105-112,240,36,91,.396,25,62,.403,11,29,.379,22,29,.759,105
7102,2016-11-13,POR,,DEN,W 112-105,240,39,99,.394,31,70,.443,8,29,.276,26,32,.813,112
7103,2016-11-12,ATL,,PHI,W 117-96,240,48,95,.505,35,63,.556,13,32,.406,8,14,.571,117
7104,2016-11-12,PHI,@,ATL,L 96-117,240,36,83,.434,25,54,.463,11,29,.379,13,20,.650,96
7105,2016-11-12,CHI,,WAS,W 106-95,240,39,97,.402,34,82,.415,5,15,.333,23,25,.920,106
7106,2016-11-12,WAS,@,CHI,L 95-106,240,38,91,.418,34,78,.436,4,13,.308,15,18,.833,95
7107,2016-11-12,DEN,,DET,L 95-106,240,36,84,.429,27,59,.458,9,25,.360,14,19,.737,95
7108,2016-11-12,DET,@,DEN,W 106-95,240,46,90,.511,42,72,.583,4,18,.222,10,14,.714,106
7109,2016-11-12,HOU,,SAS,L 100-106,240,34,89,.382,19,42,.452,15,47,.319,17,21,.810,100
7110,2016-11-12,SAS,@,HOU,W 106-100,240,41,76,.539,36,58,.621,5,18,.278,19,24,.792,106
7111,2016-11-12,BOS,@,IND,W 105-99,240,35,80,.438,27,55,.491,8,25,.320,27,33,.818,105
7112,2016-11-12,IND,,BOS,L 99-105,240,36,86,.419,30,59,.508,6,27,.222,21,28,.750,99
7113,2016-11-12,MIA,,UTA,L 91-102,240,38,81,.469,33,64,.516,5,17,.294,10,19,.526,91
7114,2016-11-12,UTA,@,MIA,W 102-91,240,40,81,.494,34,61,.557,6,20,.300,16,19,.842,102
7115,2016-11-12,MEM,@,MIL,L 96-106,240,35,78,.449,29,48,.604,6,30,.200,20,21,.952,96
7116,2016-11-12,MIL,,MEM,W 106-96,240,36,68,.529,29,50,.580,7,18,.389,27,36,.750,106
7117,2016-11-12,LAC,@,MIN,W 119-105,240,40,76,.526,29,52,.558,11,24,.458,28,37,.757,119
7118,2016-11-12,MIN,,LAC,L 105-119,240,40,89,.449,32,67,.478,8,22,.364,17,21,.810,105
7119,2016-11-12,LAL,@,NOP,W 126-99,240,52,94,.553,36,64,.563,16,30,.533,6,7,.857,126
7120,2016-11-12,NOP,,LAL,L 99-126,240,39,90,.433,33,70,.471,6,20,.300,15,19,.789,99
7121,2016-11-12,BRK,@,PHO,W 122-104,240,40,84,.476,24,47,.511,16,37,.432,26,30,.867,122
7122,2016-11-12,PHO,,BRK,L 104-122,240,40,107,.374,32,74,.432,8,33,.242,16,21,.762,104
7123,2016-11-12,NYK,@,TOR,L 107-118,240,44,97,.454,37,74,.500,7,23,.304,12,16,.750,107
7124,2016-11-12,TOR,,NYK,W 118-107,240,39,83,.470,32,61,.525,7,22,.318,33,38,.868,118
7125,2016-11-11,BOS,,NYK,W 115-87,240,35,90,.389,24,63,.381,11,27,.407,34,43,.791,115
7126,2016-11-11,NYK,@,BOS,L 87-115,240,33,94,.351,27,71,.380,6,23,.261,15,17,.882,87
7127,2016-11-11,CHA,,TOR,L 111-113,240,38,93,.409,21,52,.404,17,41,.415,18,24,.750,111
7128,2016-11-11,TOR,@,CHO,W 113-111,240,43,90,.478,37,68,.544,6,22,.273,21,22,.955,113
7129,2016-11-11,LAC,@,OKC,W 110-108,240,39,86,.453,28,59,.475,11,27,.407,21,35,.600,110
7130,2016-11-11,OKC,,LAC,L 108-110,240,38,88,.432,22,60,.367,16,28,.571,16,19,.842,108
7131,2016-11-11,ORL,,UTA,L 74-87,240,26,78,.333,18,58,.310,8,20,.400,14,19,.737,74
7132,2016-11-11,UTA,@,ORL,W 87-74,240,33,81,.407,26,53,.491,7,28,.250,14,16,.875,87
7133,2016-11-11,IND,@,PHI,L 105-109 (OT),265,39,88,.443,34,69,.493,5,19,.263,22,23,.957,105
7134,2016-11-11,PHI,,IND,W 109-105 (OT),265,36,86,.419,25,54,.463,11,32,.344,26,31,.839,109
7135,2016-11-11,POR,,SAC,W 122-120 (OT),265,45,86,.523,32,53,.604,13,33,.394,19,27,.704,122
7136,2016-11-11,SAC,@,POR,L 120-122 (OT),265,43,88,.489,37,67,.552,6,21,.286,28,35,.800,120
7137,2016-11-11,DET,@,SAS,L 86-96,240,32,76,.421,27,51,.529,5,25,.200,17,21,.810,86
7138,2016-11-11,SAS,,DET,W 96-86,240,36,81,.444,27,61,.443,9,20,.450,15,19,.789,96
7139,2016-11-11,CLE,@,WAS,W 105-94,240,36,86,.419,22,53,.415,14,33,.424,19,26,.731,105
7140,2016-11-11,WAS,,CLE,L 94-105,240,38,87,.437,35,72,.486,3,15,.200,15,19,.789,94
7141,2016-11-10,DEN,,GSW,L 101-125,240,38,94,.404,25,58,.431,13,36,.361,12,17,.706,101
7142,2016-11-10,GSW,@,DEN,W 125-101,240,46,85,.541,32,55,.582,14,30,.467,19,20,.950,125
7143,2016-11-10,CHI,@,MIA,W 98-95,240,37,89,.416,31,73,.425,6,16,.375,18,20,.900,98
7144,2016-11-10,MIA,,CHI,L 95-98,240,36,88,.409,23,59,.390,13,29,.448,10,15,.667,95
7145,2016-11-10,MIL,,NOP,L 106-112,240,40,91,.440,34,73,.466,6,18,.333,20,25,.800,106
7146,2016-11-10,NOP,@,MIL,W 112-106,240,39,89,.438,30,64,.469,9,25,.360,25,27,.926,112
7147,2016-11-10,LAL,@,SAC,W 101-91,240,38,74,.514,29,47,.617,9,27,.333,16,22,.727,101
7148,2016-11-10,SAC,,LAL,L 91-101,240,34,85,.400,26,64,.406,8,21,.381,15,20,.750,91
7149,2016-11-09,ATL,,CHI,W 115-107,240,42,83,.506,33,63,.524,9,20,.450,22,27,.815,115
7150,2016-11-09,CHI,@,ATL,L 107-115,240,41,91,.451,32,64,.500,9,27,.333,16,21,.762,107
7151,2016-11-09,CHA,,UTA,W 104-98,240,38,82,.463,30,56,.536,8,26,.308,20,29,.690,104
7152,2016-11-09,UTA,@,CHO,L 98-104,240,38,82,.463,30,48,.625,8,34,.235,14,18,.778,98
7153,2016-11-09,DAL,@,GSW,L 95-116,240,34,86,.395,28,58,.483,6,28,.214,21,28,.750,95
7154,2016-11-09,GSW,,DAL,W 116-95,240,43,74,.581,26,41,.634,17,33,.515,13,22,.591,116
7155,2016-11-09,IND,,PHI,W 122-115 (OT),265,49,90,.544,40,71,.563,9,19,.474,15,20,.750,122
7156,2016-11-09,PHI,@,IND,L 115-122 (OT),265,46,95,.484,32,59,.542,14,36,.389,9,19,.474,115
7157,2016-11-09,LAC,,POR,W 111-80,240,38,87,.437,27,55,.491,11,32,.344,24,33,.727,111
7158,2016-11-09,POR,@,LAC,L 80-111,240,31,88,.352,25,58,.431,6,30,.200,12,14,.857,80
7159,2016-11-09,BRK,@,NYK,L 96-110,240,33,79,.418,22,46,.478,11,33,.333,19,27,.704,96
7160,2016-11-09,NYK,,BRK,W 110-96,240,44,92,.478,34,62,.548,10,30,.333,12,17,.706,110
7161,2016-11-09,OKC,,TOR,L 102-112,240,31,74,.419,19,40,.475,12,34,.353,28,31,.903,102
7162,2016-11-09,TOR,@,OKC,W 112-102,240,43,83,.518,32,57,.561,11,26,.423,15,22,.682,112
7163,2016-11-09,MIN,@,ORL,W 123-107,240,45,87,.517,32,64,.500,13,23,.565,20,26,.769,123
7164,2016-11-09,ORL,,MIN,L 107-123,240,38,85,.447,30,61,.492,8,24,.333,23,30,.767,107
7165,2016-11-09,DET,@,PHO,L 100-107,240,32,89,.360,23,67,.343,9,22,.409,27,32,.844,100
7166,2016-11-09,PHO,,DET,W 107-100,240,38,84,.452,30,62,.484,8,22,.364,23,30,.767,107
7167,2016-11-09,HOU,@,SAS,W 101-99,240,37,78,.474,27,48,.563,10,30,.333,17,22,.773,101
7168,2016-11-09,SAS,,HOU,L 99-101,240,33,84,.393,26,61,.426,7,23,.304,26,30,.867,99
7169,2016-11-09,BOS,@,WAS,L 93-118,240,35,81,.432,25,50,.500,10,31,.323,13,22,.591,93
7170,2016-11-09,WAS,,BOS,W 118-93,240,46,92,.500,36,71,.507,10,21,.476,16,20,.800,118
7171,2016-11-08,BRK,,MIN,W 119-110,240,42,76,.553,30,43,.698,12,33,.364,23,26,.885,119
7172,2016-11-08,MIN,@,BRK,L 110-119,240,39,92,.424,27,64,.422,12,28,.429,20,28,.714,110
7173,2016-11-08,ATL,@,CLE,W 110-106,240,41,81,.506,30,52,.577,11,29,.379,17,24,.708,110
7174,2016-11-08,CLE,,ATL,L 106-110,240,37,99,.374,26,57,.456,11,42,.262,21,25,.840,106
7175,2016-11-08,DAL,@,LAL,W 109-97,240,43,82,.524,33,59,.559,10,23,.435,13,15,.867,109
7176,2016-11-08,LAL,,DAL,L 97-109,240,38,78,.487,28,52,.538,10,26,.385,11,14,.786,97
7177,2016-11-08,DEN,@,MEM,L 107-108,240,35,70,.500,25,46,.543,10,24,.417,27,34,.794,107
7178,2016-11-08,MEM,,DEN,W 108-107,240,44,86,.512,37,62,.597,7,24,.292,13,19,.684,108
7179,2016-11-08,PHO,@,POR,L 121-124,240,43,86,.500,36,65,.554,7,21,.333,28,33,.848,121
7180,2016-11-08,POR,,PHO,W 124-121,240,45,81,.556,31,50,.620,14,31,.452,20,28,.714,124
7181,2016-11-08,NOP,@,SAC,L 94-102,240,38,84,.452,33,63,.524,5,21,.238,13,18,.722,94
7182,2016-11-08,SAC,,NOP,W 102-94,240,39,81,.481,31,56,.554,8,25,.320,16,20,.800,102
7183,2016-11-07,CHI,,ORL,W 112-80,240,42,89,.472,39,70,.557,3,19,.158,25,31,.806,112
7184,2016-11-07,ORL,@,CHI,L 80-112,240,33,85,.388,24,55,.436,9,30,.300,5,6,.833,80
7185,2016-11-07,CHA,,IND,W 122-100,240,41,84,.488,29,52,.558,12,32,.375,28,32,.875,122
7186,2016-11-07,IND,@,CHO,L 100-122,240,40,94,.426,31,61,.508,9,33,.273,11,15,.733,100
7187,2016-11-07,GSW,,NOP,W 116-106,240,45,90,.500,29,55,.527,16,35,.457,10,12,.833,116
7188,2016-11-07,NOP,@,GSW,L 106-116,240,39,80,.488,32,59,.542,7,21,.333,21,27,.778,106
7189,2016-11-07,DET,@,LAC,L 82-114,240,30,82,.366,26,70,.371,4,12,.333,18,26,.692,82
7190,2016-11-07,LAC,,DET,W 114-82,240,41,76,.539,28,51,.549,13,25,.520,19,22,.864,114
7191,2016-11-07,MIA,@,OKC,L 85-97,240,31,84,.369,27,67,.403,4,17,.235,19,22,.864,85
7192,2016-11-07,OKC,,MIA,W 97-85,240,37,85,.435,28,57,.491,9,28,.321,14,17,.824,97
7193,2016-11-07,PHI,,UTA,L 84-109,240,31,77,.403,24,56,.429,7,21,.333,15,22,.682,84
7194,2016-11-07,UTA,@,PHI,W 109-84,240,43,85,.506,32,66,.485,11,19,.579,12,20,.600,109
7195,2016-11-07,HOU,@,WAS,W 114-106,240,41,79,.519,24,42,.571,17,37,.459,15,18,.833,114
7196,2016-11-07,WAS,,HOU,L 106-114,240,39,94,.415,29,67,.433,10,27,.370,18,20,.900,106
7197,2016-11-06,BOS,,DEN,L 107-123,240,41,90,.456,33,65,.508,8,25,.320,17,21,.810,107
7198,2016-11-06,DEN,@,BOS,W 123-107,240,44,84,.524,33,61,.541,11,23,.478,24,31,.774,123
7199,2016-11-06,DAL,,MIL,W 86-75 (OT),265,33,88,.375,24,50,.480,9,38,.237,11,12,.917,86
7200,2016-11-06,MIL,@,DAL,L 75-86 (OT),265,30,82,.366,24,53,.453,6,29,.207,9,12,.750,75
7201,2016-11-06,LAL,,PHO,W 119-108,240,41,90,.456,31,67,.463,10,23,.435,27,35,.771,119
7202,2016-11-06,PHO,@,LAL,L 108-119,240,40,91,.440,34,71,.479,6,20,.300,22,28,.786,108
7203,2016-11-06,MEM,,POR,L 94-100,240,31,81,.383,25,55,.455,6,26,.231,26,32,.813,94
7204,2016-11-06,POR,@,MEM,W 100-94,240,32,71,.451,18,38,.474,14,33,.424,22,27,.815,100
7205,2016-11-06,NYK,,UTA,L 109-114,240,42,83,.506,34,63,.540,8,20,.400,17,19,.895,109
7206,2016-11-06,UTA,@,NYK,W 114-109,240,38,75,.507,30,50,.600,8,25,.320,30,35,.857,114
7207,2016-11-06,SAC,@,TOR,W 96-91,240,34,78,.436,29,62,.468,5,16,.313,23,31,.742,96
7208,2016-11-06,TOR,,SAC,L 91-96,240,30,84,.357,23,54,.426,7,30,.233,24,31,.774,91
7209,2016-11-05,ATL,,HOU,W 112-97,240,45,85,.529,37,65,.569,8,20,.400,14,24,.583,112
7210,2016-11-05,HOU,@,ATL,L 97-112,240,37,85,.435,25,49,.510,12,36,.333,11,13,.846,97
7211,2016-11-05,DEN,@,DET,L 86-103,240,31,94,.330,24,69,.348,7,25,.280,17,20,.850,86
7212,2016-11-05,DET,,DEN,W 103-86,240,40,84,.476,33,64,.516,7,20,.350,16,22,.727,103
7213,2016-11-05,CHI,@,IND,L 94-111,240,34,79,.430,28,61,.459,6,18,.333,20,25,.800,94
7214,2016-11-05,IND,,CHI,W 111-94,240,46,86,.535,34,60,.567,12,26,.462,7,12,.583,111
7215,2016-11-05,MIL,,SAC,W 117-91,240,41,82,.500,27,49,.551,14,33,.424,21,25,.840,117
7216,2016-11-05,SAC,@,MIL,L 91-117,240,33,84,.393,23,56,.411,10,28,.357,15,19,.789,91
7217,2016-11-05,MIN,@,OKC,L 92-112,240,33,84,.393,29,65,.446,4,19,.211,22,29,.759,92
7218,2016-11-05,OKC,,MIN,W 112-92,240,45,86,.523,38,70,.543,7,16,.438,15,24,.625,112
7219,2016-11-05,ORL,,WAS,W 88-86,240,31,78,.397,22,50,.440,9,28,.321,17,27,.630,88
7220,2016-11-05,WAS,@,ORL,L 86-88,240,34,86,.395,28,69,.406,6,17,.353,12,17,.706,86
7221,2016-11-05,CLE,@,PHI,W 102-101,240,37,91,.407,23,53,.434,14,38,.368,14,18,.778,102
7222,2016-11-05,PHI,,CLE,L 101-102,240,40,87,.460,26,49,.531,14,38,.368,7,12,.583,101
7223,2016-11-05,LAC,@,SAS,W 116-92,240,47,91,.516,38,68,.559,9,23,.391,13,14,.929,116
7224,2016-11-05,SAS,,LAC,L 92-116,240,30,74,.405,20,49,.408,10,25,.400,22,25,.880,92
7225,2016-11-04,BRK,,CHO,L 95-99,240,35,87,.402,26,51,.510,9,36,.250,16,21,.762,95
7226,2016-11-04,CHA,@,BRK,W 99-95,240,36,86,.419,26,56,.464,10,30,.333,17,24,.708,99
7227,2016-11-04,CHI,,NYK,L 104-117,240,37,84,.440,29,61,.475,8,23,.348,22,27,.815,104
7228,2016-11-04,NYK,@,CHI,W 117-104,240,46,89,.517,37,68,.544,9,21,.429,16,21,.762,117
7229,2016-11-04,DAL,,POR,L 95-105,240,34,83,.410,24,55,.436,10,28,.357,17,20,.850,95
7230,2016-11-04,POR,@,DAL,W 105-95,240,36,80,.450,24,49,.490,12,31,.387,21,26,.808,105
7231,2016-11-04,GSW,@,LAL,L 97-117,240,39,86,.453,34,54,.630,5,32,.156,14,20,.700,97
7232,2016-11-04,LAL,,GSW,W 117-97,240,45,95,.474,37,65,.569,8,30,.267,19,21,.905,117
7233,2016-11-04,LAC,@,MEM,W 99-88,240,32,85,.376,24,58,.414,8,27,.296,27,33,.818,99
7234,2016-11-04,MEM,,LAC,L 88-99,240,31,84,.369,22,58,.379,9,26,.346,17,22,.773,88
7235,2016-11-04,NOP,,PHO,L 111-112 (OT),265,43,94,.457,33,64,.516,10,30,.333,15,28,.536,111
7236,2016-11-04,PHO,@,NOP,W 112-111 (OT),265,40,93,.430,32,69,.464,8,24,.333,24,28,.857,112
7237,2016-11-04,MIA,@,TOR,L 87-96,240,34,88,.386,25,60,.417,9,28,.321,10,15,.667,87
7238,2016-11-04,TOR,,MIA,W 96-87,240,37,84,.440,31,59,.525,6,25,.240,16,18,.889,96
7239,2016-11-04,SAS,@,UTA,W 100-86,240,37,83,.446,31,63,.492,6,20,.300,20,22,.909,100
7240,2016-11-04,UTA,,SAS,L 86-100,240,30,80,.375,19,54,.352,11,26,.423,15,24,.625,86
7241,2016-11-04,ATL,@,WAS,L 92-95,240,32,83,.386,27,58,.466,5,25,.200,23,36,.639,92
7242,2016-11-04,WAS,,ATL,W 95-92,240,31,80,.388,26,60,.433,5,20,.250,28,35,.800,95
7243,2016-11-03,BOS,@,CLE,L 122-128,240,46,96,.479,35,64,.547,11,32,.344,19,22,.864,122
7244,2016-11-03,CLE,,BOS,W 128-122,240,41,84,.488,27,50,.540,14,34,.412,32,37,.865,128
7245,2016-11-03,GSW,,OKC,W 122-96,240,46,89,.517,32,59,.542,14,30,.467,16,20,.800,122
7246,2016-11-03,OKC,@,GSW,L 96-122,240,35,87,.402,25,60,.417,10,27,.370,16,28,.571,96
7247,2016-11-03,IND,@,MIL,L 107-125,240,38,81,.469,28,58,.483,10,23,.435,21,27,.778,107
7248,2016-11-03,MIL,,IND,W 125-107,240,47,82,.573,35,55,.636,12,27,.444,19,24,.792,125
7249,2016-11-03,DEN,@,MIN,W 102-99,240,39,81,.481,33,59,.559,6,22,.273,18,25,.720,102
7250,2016-11-03,MIN,,DEN,L 99-102,240,35,88,.398,26,66,.394,9,22,.409,20,25,.800,99
7251,2016-11-03,ORL,,SAC,W 102-94,240,38,84,.452,28,54,.519,10,30,.333,16,23,.696,102
7252,2016-11-03,SAC,@,ORL,L 94-102,240,38,80,.475,31,62,.500,7,18,.389,11,17,.647,94
7253,2016-11-02,ATL,,LAL,L 116-123,240,41,85,.482,30,53,.566,11,32,.344,23,29,.793,116
7254,2016-11-02,LAL,@,ATL,W 123-116,240,48,90,.533,39,68,.574,9,22,.409,18,20,.900,123
7255,2016-11-02,BOS,,CHI,W 107-100,240,41,87,.471,27,55,.491,14,32,.438,11,17,.647,107
7256,2016-11-02,CHI,@,BOS,L 100-107,240,35,81,.432,28,61,.459,7,20,.350,23,31,.742,100
7257,2016-11-02,BRK,,DET,W 109-101,240,41,76,.539,28,49,.571,13,27,.481,14,17,.824,109
7258,2016-11-02,DET,@,BRK,L 101-109,240,37,88,.420,28,63,.444,9,25,.360,18,21,.857,101
7259,2016-11-02,CHA,,PHI,W 109-93,240,39,79,.494,26,45,.578,13,34,.382,18,26,.692,109
7260,2016-11-02,PHI,@,CHO,L 93-109,240,34,86,.395,22,48,.458,12,38,.316,13,15,.867,93
7261,2016-11-02,LAC,,OKC,L 83-85,240,34,87,.391,27,65,.415,7,22,.318,8,18,.444,83
7262,2016-11-02,OKC,@,LAC,W 85-83,240,34,84,.405,29,64,.453,5,20,.250,12,20,.600,85
7263,2016-11-02,MEM,,NOP,W 89-83 (OT),265,33,94,.351,25,67,.373,8,27,.296,15,20,.750,89
7264,2016-11-02,NOP,@,MEM,L 83-89 (OT),265,30,81,.370,19,47,.404,11,34,.324,12,16,.750,83
7265,2016-11-02,HOU,@,NYK,W 118-99,240,42,89,.472,27,49,.551,15,40,.375,19,27,.704,118
7266,2016-11-02,NYK,,HOU,L 99-118,240,37,85,.435,29,65,.446,8,20,.400,17,25,.680,99
7267,2016-11-02,PHO,,POR,W 118-115 (OT),265,44,103,.427,39,87,.448,5,16,.313,25,30,.833,118
7268,2016-11-02,POR,@,PHO,L 115-118 (OT),265,42,101,.416,30,68,.441,12,33,.364,19,21,.905,115
7269,2016-11-02,DAL,@,UTA,L 81-97,240,33,77,.429,26,51,.510,7,26,.269,8,10,.800,81
7270,2016-11-02,UTA,,DAL,W 97-81,240,35,77,.455,23,52,.442,12,25,.480,15,26,.577,97
7271,2016-11-02,TOR,@,WAS,W 113-103,240,43,77,.558,33,52,.635,10,25,.400,17,25,.680,113
7272,2016-11-02,WAS,,TOR,L 103-113,240,42,72,.583,39,62,.629,3,10,.300,16,24,.667,103
7273,2016-11-01,CLE,,HOU,W 128-120,240,43,83,.518,27,51,.529,16,32,.500,26,31,.839,128
7274,2016-11-01,HOU,@,CLE,L 120-128,240,43,90,.478,26,46,.565,17,44,.386,17,25,.680,120
7275,2016-11-01,DET,,NYK,W 102-89,240,41,89,.461,33,76,.434,8,13,.615,12,21,.571,102
7276,2016-11-01,NYK,@,DET,L 89-102,240,35,86,.407,28,64,.438,7,22,.318,12,15,.800,89
7277,2016-11-01,IND,,LAL,W 115-108,240,41,87,.471,31,59,.525,10,28,.357,23,29,.793,115
7278,2016-11-01,LAL,@,IND,L 108-115,240,40,89,.449,34,61,.557,6,28,.214,22,25,.880,108
7279,2016-11-01,MIA,,SAC,W 108-96 (OT),265,37,86,.430,24,57,.421,13,29,.448,21,29,.724,108
7280,2016-11-01,SAC,@,MIA,L 96-108 (OT),265,34,89,.382,29,66,.439,5,23,.217,23,27,.852,96
7281,2016-11-01,MEM,@,MIN,L 80-116,240,27,75,.360,23,51,.451,4,24,.167,22,29,.759,80
7282,2016-11-01,MIN,,MEM,W 116-80,240,43,78,.551,31,58,.534,12,20,.600,18,23,.783,116
7283,2016-11-01,MIL,@,NOP,W 117-113,240,44,91,.484,34,59,.576,10,32,.313,19,21,.905,117
7284,2016-11-01,NOP,,MIL,L 113-117,240,36,82,.439,27,56,.482,9,26,.346,32,41,.780,113
7285,2016-11-01,ORL,@,PHI,W 103-101,240,42,93,.452,36,68,.529,6,25,.240,13,17,.765,103
7286,2016-11-01,PHI,,ORL,L 101-103,240,40,81,.494,31,61,.508,9,20,.450,12,16,.750,101
7287,2016-11-01,GSW,@,POR,W 127-104,240,50,89,.562,40,63,.635,10,26,.385,17,23,.739,127
7288,2016-11-01,POR,,GSW,L 104-127,240,37,86,.430,23,47,.489,14,39,.359,16,21,.762,104
7289,2016-11-01,SAS,,UTA,L 91-106,240,33,76,.434,27,56,.482,6,20,.300,19,21,.905,91
7290,2016-11-01,UTA,@,SAS,W 106-91,240,38,76,.500,23,45,.511,15,31,.484,15,18,.833,106
7291,2016-10-31,ATL,,SAC,W 106-95,240,33,79,.418,22,49,.449,11,30,.367,29,47,.617,106
7292,2016-10-31,SAC,@,ATL,L 95-106,240,36,75,.480,26,52,.500,10,23,.435,13,19,.684,95
7293,2016-10-31,BRK,,CHI,L 88-118,240,33,96,.344,28,65,.431,5,31,.161,17,21,.810,88
7294,2016-10-31,CHI,@,BRK,W 118-88,240,45,89,.506,34,62,.548,11,27,.407,17,18,.944,118
7295,2016-10-31,LAC,,PHO,W 116-98,240,40,80,.500,34,64,.531,6,16,.375,30,38,.789,116
7296,2016-10-31,PHO,@,LAC,L 98-116,240,35,84,.417,30,69,.435,5,15,.333,23,31,.742,98
7297,2016-10-31,DEN,@,TOR,L 102-105,240,33,81,.407,24,59,.407,9,22,.409,27,35,.771,102
7298,2016-10-31,TOR,,DEN,W 105-102,240,41,88,.466,37,72,.514,4,16,.250,19,25,.760,105
7299,2016-10-30,DET,,MIL,W 98-83,240,39,88,.443,34,68,.500,5,20,.250,15,20,.750,98
7300,2016-10-30,MIL,@,DET,L 83-98,240,34,87,.391,30,70,.429,4,17,.235,11,14,.786,83
7301,2016-10-30,DAL,@,HOU,L 92-93,240,32,86,.372,21,55,.382,11,31,.355,17,20,.850,92
7302,2016-10-30,HOU,,DAL,W 93-92,240,34,81,.420,23,50,.460,11,31,.355,14,21,.667,93
7303,2016-10-30,LAC,,UTA,W 88-75,240,34,83,.410,28,56,.500,6,27,.222,14,20,.700,88
7304,2016-10-30,UTA,@,LAC,L 75-88,240,29,73,.397,22,54,.407,7,19,.368,10,13,.769,75
7305,2016-10-30,MEM,,WAS,W 112-103 (OT),265,39,88,.443,24,57,.421,15,31,.484,19,26,.731,112
7306,2016-10-30,WAS,@,MEM,L 103-112 (OT),265,38,86,.442,33,61,.541,5,25,.200,22,25,.880,103
7307,2016-10-30,MIA,,SAS,L 99-106,240,37,80,.463,30,60,.500,7,20,.350,18,26,.692,99
7308,2016-10-30,SAS,@,MIA,W 106-99,240,37,82,.451,27,64,.422,10,18,.556,22,26,.846,106
7309,2016-10-30,LAL,@,OKC,L 96-113,240,35,87,.402,28,55,.509,7,32,.219,19,24,.792,96
7310,2016-10-30,OKC,,LAL,W 113-96,240,45,95,.474,36,69,.522,9,26,.346,14,17,.824,113
7311,2016-10-30,GSW,@,PHO,W 106-100,240,35,83,.422,27,54,.500,8,29,.276,28,33,.848,106
7312,2016-10-30,PHO,,GSW,L 100-106,240,37,90,.411,29,67,.433,8,23,.348,18,25,.720,100
7313,2016-10-29,CHI,,IND,W 118-101,240,45,86,.523,36,65,.554,9,21,.429,19,21,.905,118
7314,2016-10-29,IND,@,CHI,L 101-118,240,43,88,.489,36,70,.514,7,18,.389,8,9,.889,101
7315,2016-10-29,BOS,@,CHO,W 104-98,240,39,81,.481,24,50,.480,15,31,.484,11,17,.647,104
7316,2016-10-29,CHA,,BOS,L 98-104,240,32,79,.405,23,47,.489,9,32,.281,25,33,.758,98
7317,2016-10-29,CLE,,ORL,W 105-99,240,36,88,.409,25,51,.490,11,37,.297,22,30,.733,105
7318,2016-10-29,ORL,@,CLE,L 99-105,240,38,84,.452,30,56,.536,8,28,.286,15,26,.577,99
7319,2016-10-29,DEN,,POR,L 113-115 (OT),265,38,100,.380,32,77,.416,6,23,.261,31,39,.795,113
7320,2016-10-29,POR,@,DEN,W 115-113 (OT),265,45,98,.459,35,66,.530,10,32,.313,15,21,.714,115
7321,2016-10-29,BRK,@,MIL,L 108-110,240,37,84,.440,26,50,.520,11,34,.324,23,28,.821,108
7322,2016-10-29,MIL,,BRK,W 110-108,240,41,88,.466,33,66,.500,8,22,.364,20,24,.833,110
7323,2016-10-29,MEM,@,NYK,L 104-111,240,37,86,.430,28,61,.459,9,25,.360,21,26,.808,104
7324,2016-10-29,NYK,,MEM,W 111-104,240,40,76,.526,34,55,.618,6,21,.286,25,39,.641,111
7325,2016-10-29,ATL,@,PHI,W 104-72,240,42,85,.494,37,65,.569,5,20,.250,15,23,.652,104
7326,2016-10-29,PHI,,ATL,L 72-104,240,28,80,.350,23,62,.371,5,18,.278,11,15,.733,72
7327,2016-10-29,MIN,@,SAC,L 103-106,240,37,70,.529,30,48,.625,7,22,.318,22,31,.710,103
7328,2016-10-29,SAC,,MIN,W 106-103,240,39,85,.459,30,59,.508,9,26,.346,19,25,.760,106
7329,2016-10-29,NOP,@,SAS,L 79-98,240,32,86,.372,28,64,.438,4,22,.182,11,15,.733,79
7330,2016-10-29,SAS,,NOP,W 98-79,240,35,83,.422,25,59,.424,10,24,.417,18,23,.783,98
7331,2016-10-28,BRK,,IND,W 103-94,240,38,87,.437,28,54,.519,10,33,.303,17,20,.850,103
7332,2016-10-28,IND,@,BRK,L 94-103,240,37,98,.378,30,74,.405,7,24,.292,13,20,.650,94
7333,2016-10-28,DAL,,HOU,L 98-106,240,35,80,.438,27,51,.529,8,29,.276,20,24,.833,98
7334,2016-10-28,HOU,@,DAL,W 106-98,240,33,70,.471,18,38,.474,15,32,.469,25,31,.806,106
7335,2016-10-28,DET,,ORL,W 108-82,240,48,95,.505,41,76,.539,7,19,.368,5,6,.833,108
7336,2016-10-28,ORL,@,DET,L 82-108,240,33,95,.347,25,69,.362,8,26,.308,8,12,.667,82
7337,2016-10-28,CHA,@,MIA,W 97-91,240,35,92,.380,28,70,.400,7,22,.318,20,24,.833,97
7338,2016-10-28,MIA,,CHO,L 91-97,240,32,86,.372,18,52,.346,14,34,.412,13,20,.650,91
7339,2016-10-28,GSW,@,NOP,W 122-114,240,44,91,.484,35,63,.556,9,28,.321,25,28,.893,122
7340,2016-10-28,NOP,,GSW,L 114-122,240,47,100,.470,42,78,.538,5,22,.227,15,23,.652,114
7341,2016-10-28,OKC,,PHO,W 113-110 (OT),265,40,96,.417,35,75,.467,5,21,.238,28,38,.737,113
7342,2016-10-28,PHO,@,OKC,L 110-113 (OT),265,42,94,.447,37,66,.561,5,28,.179,21,32,.656,110
7343,2016-10-28,CLE,@,TOR,W 94-91,240,33,79,.418,21,47,.447,12,32,.375,16,22,.727,94
7344,2016-10-28,TOR,,CLE,L 91-94,240,35,90,.389,31,74,.419,4,16,.250,17,18,.944,91
7345,2016-10-28,LAL,@,UTA,L 89-96,240,32,84,.381,23,61,.377,9,23,.391,16,21,.762,89
7346,2016-10-28,UTA,,LAL,W 96-89,240,31,75,.413,25,50,.500,6,25,.240,28,40,.700,96
7347,2016-10-27,ATL,,WAS,W 114-99,240,44,88,.500,32,62,.516,12,26,.462,14,18,.778,114
7348,2016-10-27,WAS,@,ATL,L 99-114,240,40,94,.426,34,74,.459,6,20,.300,13,18,.722,99
7349,2016-10-27,BOS,@,CHI,L 99-105,240,38,76,.500,30,53,.566,8,23,.348,15,24,.625,99
7350,2016-10-27,CHI,,BOS,W 105-99,240,36,92,.391,25,67,.373,11,25,.440,22,30,.733,105
7351,2016-10-27,LAC,@,POR,W 114-106,240,37,91,.407,29,62,.468,8,29,.276,32,46,.696,114
7352,2016-10-27,POR,,LAC,L 106-114,240,39,85,.459,35,67,.522,4,18,.222,24,32,.750,106
7353,2016-10-27,SAC,,SAS,L 94-102,240,28,70,.400,22,50,.440,6,20,.300,32,38,.842,94
7354,2016-10-27,SAS,@,SAC,W 102-94,240,36,79,.456,30,61,.492,6,18,.333,24,27,.889,102
7355,2016-10-26,BOS,,BRK,W 122-117,240,48,89,.539,37,57,.649,11,32,.344,15,18,.833,122
7356,2016-10-26,BRK,@,BOS,L 117-122,240,43,97,.443,28,53,.528,15,44,.341,16,20,.800,117
7357,2016-10-26,DAL,@,IND,L 121-130 (OT),265,45,104,.433,27,56,.482,18,48,.375,13,18,.722,121
7358,2016-10-26,IND,,DAL,W 130-121 (OT),265,47,93,.505,37,74,.500,10,19,.526,26,34,.765,130
7359,2016-10-26,HOU,@,LAL,L 114-120,240,44,86,.512,37,57,.649,7,29,.241,19,27,.704,114
7360,2016-10-26,LAL,,HOU,W 120-114,240,45,89,.506,33,54,.611,12,35,.343,18,22,.818,120
7361,2016-10-26,MEM,,MIN,W 102-98,240,36,80,.450,25,56,.446,11,24,.458,19,27,.704,102
7362,2016-10-26,MIN,@,MEM,L 98-102,240,36,86,.419,30,68,.441,6,18,.333,20,29,.690,98
7363,2016-10-26,CHA,@,MIL,W 107-96,240,40,89,.449,33,66,.500,7,23,.304,20,24,.833,107
7364,2016-10-26,MIL,,CHO,L 96-107,240,39,92,.424,36,76,.474,3,16,.188,15,20,.750,96
7365,2016-10-26,DEN,@,NOP,W 107-102,240,37,83,.446,29,59,.492,8,24,.333,25,33,.758,107
7366,2016-10-26,NOP,,DEN,L 102-107,240,38,92,.413,35,73,.479,3,19,.158,23,26,.885,102
7367,2016-10-26,MIA,@,ORL,W 108-96,240,47,97,.485,43,81,.531,4,16,.250,10,16,.625,108
7368,2016-10-26,ORL,,MIA,L 96-108,240,34,89,.382,28,71,.394,6,18,.333,22,28,.786,96
7369,2016-10-26,OKC,@,PHI,W 103-97,240,39,94,.415,33,72,.458,6,22,.273,19,26,.731,103
7370,2016-10-26,PHI,,OKC,L 97-103,240,36,84,.429,29,60,.483,7,24,.292,18,25,.720,97
7371,2016-10-26,PHO,,SAC,L 94-113,240,36,77,.468,32,61,.525,4,16,.250,18,27,.667,94
7372,2016-10-26,SAC,@,PHO,W 113-94,240,44,86,.512,38,65,.585,6,21,.286,19,26,.731,113
7373,2016-10-26,DET,@,TOR,L 91-109,240,35,84,.417,31,62,.500,4,22,.182,17,22,.773,91
7374,2016-10-26,TOR,,DET,W 109-91,240,41,86,.477,38,68,.559,3,18,.167,24,29,.828,109
7375,2016-10-25,CLE,,NYK,W 117-88,240,45,94,.479,32,59,.542,13,35,.371,14,19,.737,117
7376,2016-10-25,NYK,@,CLE,L 88-117,240,32,87,.368,23,60,.383,9,27,.333,15,20,.750,88
7377,2016-10-25,GSW,,SAS,L 100-129,240,40,85,.471,33,52,.635,7,33,.212,13,18,.722,100
7378,2016-10-25,SAS,@,GSW,W 129-100,240,47,98,.480,35,74,.473,12,24,.500,23,26,.885,129
7379,2016-10-25,POR,,UTA,W 113-104,240,39,75,.520,26,56,.464,13,19,.684,22,22,1.000,113
7380,2016-10-25,UTA,@,POR,L 104-113,240,40,82,.488,32,58,.552,8,24,.333,16,16,1.000,104
7381,2016-04-13,BOS,,MIA,W 98-88,240,37,86,.430,32,72,.444,5,14,.357,19,22,.864,98
7382,2016-04-13,MIA,@,BOS,L 88-98,240,38,88,.432,36,69,.522,2,19,.105,10,12,.833,88
7383,2016-04-13,BRK,,TOR,L 96-103,240,39,89,.438,29,63,.460,10,26,.385,8,12,.667,96
7384,2016-04-13,TOR,@,BRK,W 103-96,240,41,93,.441,28,56,.500,13,37,.351,8,15,.533,103
7385,2016-04-13,CHI,,PHI,W 115-105,240,39,83,.470,24,59,.407,15,24,.625,22,27,.815,115
7386,2016-04-13,PHI,@,CHI,L 105-115,240,37,81,.457,20,46,.435,17,35,.486,14,18,.778,105
7387,2016-04-13,CHA,,ORL,W 117-103,240,47,86,.547,36,57,.632,11,29,.379,12,19,.632,117
7388,2016-04-13,ORL,@,CHO,L 103-117,240,42,91,.462,34,64,.531,8,27,.296,11,18,.611,103
7389,2016-04-13,CLE,,DET,L 110-112 (OT),265,46,97,.474,39,79,.494,7,18,.389,11,15,.733,110
7390,2016-04-13,DET,@,CLE,W 112-110 (OT),265,37,85,.435,21,52,.404,16,33,.485,22,28,.786,112
7391,2016-04-13,DAL,,SAS,L 91-96,240,31,77,.403,19,38,.500,12,39,.308,17,21,.810,91
7392,2016-04-13,SAS,@,DAL,W 96-91,240,35,74,.473,29,51,.569,6,23,.261,20,26,.769,96
7393,2016-04-13,GSW,,MEM,W 125-104,240,46,87,.529,26,40,.650,20,47,.426,13,16,.813,125
7394,2016-04-13,MEM,@,GSW,L 104-125,240,42,98,.429,34,74,.459,8,24,.333,12,16,.750,104
7395,2016-04-13,HOU,,SAC,W 116-81,240,47,97,.485,37,62,.597,10,35,.286,12,19,.632,116
7396,2016-04-13,SAC,@,HOU,L 81-116,240,32,96,.333,21,59,.356,11,37,.297,6,13,.462,81
7397,2016-04-13,LAL,,UTA,W 101-96,240,41,85,.482,35,60,.583,6,25,.240,13,15,.867,101
7398,2016-04-13,UTA,@,LAL,L 96-101,240,39,83,.470,30,53,.566,9,30,.300,9,15,.600,96
7399,2016-04-13,IND,@,MIL,W 97-92,240,39,90,.433,28,66,.424,11,24,.458,8,10,.800,97
7400,2016-04-13,MIL,,IND,L 92-97,240,37,87,.425,30,64,.469,7,23,.304,11,13,.846,92
7401,2016-04-13,MIN,,NOP,W 144-109,240,56,86,.651,43,58,.741,13,28,.464,19,23,.826,144
7402,2016-04-13,NOP,@,MIN,L 109-144,240,40,92,.435,29,62,.468,11,30,.367,18,22,.818,109
7403,2016-04-13,LAC,@,PHO,L 105-114,240,43,96,.448,34,65,.523,9,31,.290,10,12,.833,105
7404,2016-04-13,PHO,,LAC,W 114-105,240,45,99,.455,38,73,.521,7,26,.269,17,22,.773,114
7405,2016-04-13,DEN,@,POR,L 99-107,240,40,94,.426,33,69,.478,7,25,.280,12,18,.667,99
7406,2016-04-13,POR,,DEN,W 107-99,240,39,89,.438,28,53,.528,11,36,.306,18,22,.818,107
7407,2016-04-13,ATL,@,WAS,L 98-109,240,32,81,.395,21,52,.404,11,29,.379,23,31,.742,98
7408,2016-04-13,WAS,,ATL,W 109-98,240,42,88,.477,33,60,.550,9,28,.321,16,30,.533,109
7409,2016-04-12,DET,,MIA,L 93-99,240,34,84,.405,29,66,.439,5,18,.278,20,30,.667,93
7410,2016-04-12,MIA,@,DET,W 99-93,240,38,78,.487,31,58,.534,7,20,.350,16,22,.727,99
7411,2016-04-12,IND,,NYK,W 102-90,240,41,80,.513,35,61,.574,6,19,.316,14,20,.700,102
7412,2016-04-12,NYK,@,IND,L 90-102,240,36,80,.450,26,53,.491,10,27,.370,8,9,.889,90
7413,2016-04-12,LAC,,MEM,W 110-84,240,41,75,.547,29,50,.580,12,25,.480,16,21,.762,110
7414,2016-04-12,MEM,@,LAC,L 84-110,240,35,86,.407,30,66,.455,5,20,.250,9,14,.643,84
7415,2016-04-12,OKC,@,SAS,L 98-102 (OT),265,35,87,.402,29,62,.468,6,25,.240,22,25,.880,98
7416,2016-04-12,SAS,,OKC,W 102-98 (OT),265,37,87,.425,33,73,.452,4,14,.286,24,32,.750,102
7417,2016-04-12,PHI,@,TOR,L 98-122,240,35,77,.455,20,42,.476,15,35,.429,13,25,.520,98
7418,2016-04-12,TOR,,PHI,W 122-98,240,48,95,.505,38,70,.543,10,25,.400,16,19,.842,122
7419,2016-04-11,BOS,,CHO,L 100-114,240,34,89,.382,26,65,.400,8,24,.333,24,29,.828,100
7420,2016-04-11,CHA,@,BOS,W 114-100,240,41,81,.506,27,49,.551,14,32,.438,18,22,.818,114
7421,2016-04-11,BRK,,WAS,L 111-120,240,44,98,.449,34,67,.507,10,31,.323,13,21,.619,111
7422,2016-04-11,WAS,@,BRK,W 120-111,240,46,89,.517,37,64,.578,9,25,.360,19,24,.792,120
7423,2016-04-11,ATL,@,CLE,L 94-109,240,39,87,.448,31,57,.544,8,30,.267,8,15,.533,94
7424,2016-04-11,CLE,,ATL,W 109-94,240,40,83,.482,29,54,.537,11,29,.379,18,20,.900,109
7425,2016-04-11,HOU,@,MIN,W 129-105,240,48,86,.558,33,56,.589,15,30,.500,18,26,.692,129
7426,2016-04-11,MIN,,HOU,L 105-129,240,38,83,.458,33,62,.532,5,21,.238,24,33,.727,105
7427,2016-04-11,CHI,@,NOP,W 121-116,240,44,77,.571,34,54,.630,10,23,.435,23,26,.885,121
7428,2016-04-11,NOP,,CHI,L 116-121,240,41,80,.513,29,54,.537,12,26,.462,22,28,.786,116
7429,2016-04-11,LAL,@,OKC,L 79-112,240,23,81,.284,16,50,.320,7,31,.226,26,30,.867,79
7430,2016-04-11,OKC,,LAL,W 112-79,240,42,96,.438,30,59,.508,12,37,.324,16,27,.593,112
7431,2016-04-11,MIL,@,ORL,L 98-107,240,41,78,.526,38,63,.603,3,15,.200,13,19,.684,98
7432,2016-04-11,ORL,,MIL,W 107-98,240,41,84,.488,34,61,.557,7,23,.304,18,28,.643,107
7433,2016-04-11,PHO,,SAC,L 101-105,240,41,100,.410,36,78,.462,5,22,.227,14,17,.824,101
7434,2016-04-11,SAC,@,PHO,W 105-101,240,41,83,.494,35,66,.530,6,17,.353,17,28,.607,105
7435,2016-04-11,DAL,@,UTA,W 101-92,240,36,81,.444,25,49,.510,11,32,.344,18,22,.818,101
7436,2016-04-11,UTA,,DAL,L 92-101,240,35,77,.455,26,44,.591,9,33,.273,13,18,.722,92
7437,2016-04-10,DEN,,UTA,L 84-100,240,32,80,.400,26,53,.491,6,27,.222,14,19,.737,84
7438,2016-04-10,UTA,@,DEN,W 100-84,240,36,79,.456,24,48,.500,12,31,.387,16,21,.762,100
7439,2016-04-10,HOU,,LAL,W 130-110,240,50,98,.510,33,57,.579,17,41,.415,13,18,.722,130
7440,2016-04-10,LAL,@,HOU,L 110-130,240,41,83,.494,29,55,.527,12,28,.429,16,19,.842,110
7441,2016-04-10,BRK,@,IND,L 105-129,240,35,91,.385,21,54,.389,14,37,.378,21,26,.808,105
7442,2016-04-10,IND,,BRK,W 129-105,240,48,86,.558,37,59,.627,11,27,.407,22,27,.815,129
7443,2016-04-10,DAL,@,LAC,L 91-98,240,30,74,.405,22,44,.500,8,30,.267,23,33,.697,91
7444,2016-04-10,LAC,,DAL,W 98-91,240,37,76,.487,28,58,.483,9,18,.500,15,37,.405,98
7445,2016-04-10,MIA,,ORL,W 118-96,240,43,77,.558,37,57,.649,6,20,.300,26,30,.867,118
7446,2016-04-10,ORL,@,MIA,L 96-118,240,37,83,.446,30,65,.462,7,18,.389,15,19,.789,96
7447,2016-04-10,NYK,,TOR,L 89-93,240,32,89,.360,25,69,.362,7,20,.350,18,21,.857,89
7448,2016-04-10,TOR,@,NYK,W 93-89,240,37,78,.474,30,58,.517,7,20,.350,12,19,.632,93
7449,2016-04-10,MIL,@,PHI,W 109-108 (OT),265,40,87,.460,33,64,.516,7,23,.304,22,24,.917,109
7450,2016-04-10,PHI,,MIL,L 108-109 (OT),265,39,96,.406,26,50,.520,13,46,.283,17,25,.680,108
7451,2016-04-10,GSW,@,SAS,W 92-86,240,34,77,.442,24,50,.480,10,27,.370,14,18,.778,92
7452,2016-04-10,SAS,,GSW,L 86-92,240,34,90,.378,31,73,.425,3,17,.176,15,19,.789,86
7453,2016-04-10,CHA,@,WAS,L 98-113,240,28,81,.346,16,48,.333,12,33,.364,30,35,.857,98
7454,2016-04-10,WAS,,CHO,W 113-98,240,42,80,.525,33,59,.559,9,21,.429,20,28,.714,113
7455,2016-04-09,ATL,,BOS,W 118-107,240,46,88,.523,29,55,.527,17,33,.515,9,11,.818,118
7456,2016-04-09,BOS,@,ATL,L 107-118,240,40,90,.444,29,62,.468,11,28,.393,16,24,.667,107
7457,2016-04-09,CHI,,CLE,W 105-102,240,40,89,.449,32,65,.492,8,24,.333,17,21,.810,105
7458,2016-04-09,CLE,@,CHI,L 102-105,240,36,83,.434,17,43,.395,19,40,.475,11,18,.611,102
7459,2016-04-09,GSW,@,MEM,W 100-99,240,39,87,.448,29,51,.569,10,36,.278,12,13,.923,100
7460,2016-04-09,MEM,,GSW,L 99-100,240,37,96,.385,30,75,.400,7,21,.333,18,20,.900,99
7461,2016-04-09,NOP,,PHO,L 100-121,240,39,95,.411,32,74,.432,7,21,.333,15,20,.750,100
7462,2016-04-09,PHO,@,NOP,W 121-100,240,43,83,.518,33,58,.569,10,25,.400,25,31,.806,121
7463,2016-04-09,MIN,@,POR,W 106-105,240,41,84,.488,36,71,.507,5,13,.385,19,25,.760,106
7464,2016-04-09,POR,,MIN,L 105-106,240,40,80,.500,31,56,.554,9,24,.375,16,18,.889,105
7465,2016-04-09,OKC,@,SAC,L 112-114,240,39,81,.481,26,49,.531,13,32,.406,21,28,.750,112
7466,2016-04-09,SAC,,OKC,W 114-112,240,45,94,.479,32,62,.516,13,32,.406,11,20,.550,114
7467,2016-04-08,BOS,,MIL,W 124-109,240,44,78,.564,38,64,.594,6,14,.429,30,38,.789,124
7468,2016-04-08,MIL,@,BOS,L 109-124,240,41,84,.488,34,67,.507,7,17,.412,20,29,.690,109
7469,2016-04-08,BRK,@,CHO,L 99-113,240,39,92,.424,29,67,.433,10,25,.400,11,20,.550,99
7470,2016-04-08,CHA,,BRK,W 113-99,240,41,83,.494,27,46,.587,14,37,.378,17,20,.850,113
7471,2016-04-08,DAL,,MEM,W 103-93,240,30,60,.500,18,29,.621,12,31,.387,31,39,.795,103
7472,2016-04-08,MEM,@,DAL,L 93-103,240,35,87,.402,28,65,.431,7,22,.318,16,22,.727,93
7473,2016-04-08,DEN,,SAS,W 102-98,240,40,86,.465,34,64,.531,6,22,.273,16,19,.842,102
7474,2016-04-08,SAS,@,DEN,L 98-102,240,36,85,.424,33,71,.465,3,14,.214,23,28,.821,98
7475,2016-04-08,DET,,WAS,W 112-99,240,36,77,.468,22,45,.489,14,32,.438,26,29,.897,112
7476,2016-04-08,WAS,@,DET,L 99-112,240,38,86,.442,32,67,.478,6,19,.316,17,23,.739,99
7477,2016-04-08,LAL,@,NOP,L 102-110,240,34,81,.420,23,57,.404,11,24,.458,23,27,.852,102
7478,2016-04-08,NOP,,LAL,W 110-102,240,42,79,.532,32,57,.561,10,22,.455,16,21,.762,110
7479,2016-04-08,MIA,@,ORL,L 109-112,240,45,100,.450,37,78,.474,8,22,.364,11,21,.524,109
7480,2016-04-08,ORL,,MIA,W 112-109,240,43,82,.524,38,71,.535,5,11,.455,21,28,.750,112
7481,2016-04-08,NYK,@,PHI,W 109-102,240,43,91,.473,39,75,.520,4,16,.250,19,30,.633,109
7482,2016-04-08,PHI,,NYK,L 102-109,240,32,91,.352,18,54,.333,14,37,.378,24,36,.667,102
7483,2016-04-08,IND,@,TOR,L 98-111,240,37,83,.446,29,56,.518,8,27,.296,16,20,.800,98
7484,2016-04-08,TOR,,IND,W 111-98,240,37,68,.544,27,46,.587,10,22,.455,27,38,.711,111
7485,2016-04-08,LAC,@,UTA,W 102-99 (OT),265,37,83,.446,24,54,.444,13,29,.448,15,19,.789,102
7486,2016-04-08,UTA,,LAC,L 99-102 (OT),265,36,82,.439,25,51,.490,11,31,.355,16,23,.696,99
7487,2016-04-07,ATL,,TOR,W 95-87,240,33,76,.434,21,44,.477,12,32,.375,17,21,.810,95
7488,2016-04-07,TOR,@,ATL,L 87-95,240,32,84,.381,24,63,.381,8,21,.381,15,20,.750,87
7489,2016-04-07,GSW,,SAS,W 112-101,240,45,83,.542,33,58,.569,12,25,.480,10,11,.909,112
7490,2016-04-07,SAS,@,GSW,L 101-112,240,39,80,.488,32,64,.500,7,16,.438,16,23,.696,101
7491,2016-04-07,HOU,,PHO,L 115-124,240,42,74,.568,28,41,.683,14,33,.424,17,28,.607,115
7492,2016-04-07,PHO,@,HOU,W 124-115,240,44,94,.468,32,63,.508,12,31,.387,24,29,.828,124
7493,2016-04-07,CHI,@,MIA,L 98-106,240,35,78,.449,32,64,.500,3,14,.214,25,28,.893,98
7494,2016-04-07,MIA,,CHI,W 106-98,240,44,92,.478,40,78,.513,4,14,.286,14,17,.824,106
7495,2016-04-07,MIN,@,SAC,W 105-97,240,36,80,.450,25,59,.424,11,21,.524,22,31,.710,105
7496,2016-04-07,SAC,,MIN,L 97-105,240,36,85,.424,30,68,.441,6,17,.353,19,21,.905,97
7497,2016-04-06,BOS,,NOP,W 104-97,240,36,87,.414,26,53,.491,10,34,.294,22,27,.815,104
7498,2016-04-06,NOP,@,BOS,L 97-104,240,34,78,.436,25,54,.463,9,24,.375,20,23,.870,97
7499,2016-04-06,DAL,,HOU,W 88-86,240,33,80,.413,23,47,.489,10,33,.303,12,14,.857,88
7500,2016-04-06,HOU,@,DAL,L 86-88,240,34,78,.436,28,58,.483,6,20,.300,12,18,.667,86
7501,2016-04-06,CLE,@,IND,L 109-123,240,35,74,.473,27,45,.600,8,29,.276,31,34,.912,109
7502,2016-04-06,IND,,CLE,W 123-109,240,45,80,.563,29,49,.592,16,31,.516,17,22,.773,123
7503,2016-04-06,LAC,@,LAL,W 91-81,240,37,83,.446,30,58,.517,7,25,.280,10,14,.714,91
7504,2016-04-06,LAL,,LAC,L 81-91,240,32,90,.356,28,71,.394,4,19,.211,13,17,.765,81
7505,2016-04-06,CHA,@,NYK,W 111-97,240,42,90,.467,30,64,.469,12,26,.462,15,17,.882,111
7506,2016-04-06,NYK,,CHO,L 97-111,240,37,78,.474,27,52,.519,10,26,.385,13,15,.867,97
7507,2016-04-06,DET,@,ORL,W 108-104,240,39,86,.453,28,59,.475,11,27,.407,19,31,.613,108
7508,2016-04-06,ORL,,DET,L 104-108,240,43,90,.478,39,75,.520,4,15,.267,14,19,.737,104
7509,2016-04-06,OKC,@,POR,L 115-120,240,43,91,.473,34,69,.493,9,22,.409,20,31,.645,115
7510,2016-04-06,POR,,OKC,W 120-115,240,43,84,.512,28,51,.549,15,33,.455,19,24,.792,120
7511,2016-04-06,BRK,@,WAS,L 103-121,240,39,92,.424,32,75,.427,7,17,.412,18,24,.750,103
7512,2016-04-06,WAS,,BRK,W 121-103,240,48,95,.505,40,67,.597,8,28,.286,17,20,.850,121
7513,2016-04-05,ATL,,PHO,W 103-90,240,39,95,.411,28,61,.459,11,34,.324,14,19,.737,103
7514,2016-04-05,PHO,@,ATL,L 90-103,240,30,81,.370,18,50,.360,12,31,.387,18,30,.600,90
7515,2016-04-05,DEN,,OKC,L 102-124,240,37,88,.420,27,58,.466,10,30,.333,18,27,.667,102
7516,2016-04-05,OKC,@,DEN,W 124-102,240,46,87,.529,31,54,.574,15,33,.455,17,24,.708,124
7517,2016-04-05,GSW,,MIN,L 117-124 (OT),265,49,98,.500,37,63,.587,12,35,.343,7,8,.875,117
7518,2016-04-05,MIN,@,GSW,W 124-117 (OT),265,44,86,.512,36,69,.522,8,17,.471,28,36,.778,124
7519,2016-04-05,LAC,,LAL,W 103-81,240,40,78,.513,33,58,.569,7,20,.350,16,26,.615,103
7520,2016-04-05,LAL,@,LAC,L 81-103,240,26,83,.313,20,63,.317,6,20,.300,23,25,.920,81
7521,2016-04-05,CHI,@,MEM,L 92-108,240,34,77,.442,23,48,.479,11,29,.379,13,19,.684,92
7522,2016-04-05,MEM,,CHI,W 108-92,240,39,87,.448,32,68,.471,7,19,.368,23,26,.885,108
7523,2016-04-05,DET,@,MIA,L 89-107,240,32,80,.400,27,58,.466,5,22,.227,20,25,.800,89
7524,2016-04-05,MIA,,DET,W 107-89,240,44,84,.524,35,70,.500,9,14,.643,10,14,.714,107
7525,2016-04-05,CLE,@,MIL,W 109-80,240,41,75,.547,23,39,.590,18,36,.500,9,10,.900,109
7526,2016-04-05,MIL,,CLE,L 80-109,240,35,88,.398,31,72,.431,4,16,.250,6,12,.500,80
7527,2016-04-05,NOP,@,PHI,L 93-107,240,37,82,.451,30,64,.469,7,18,.389,12,16,.750,93
7528,2016-04-05,PHI,,NOP,W 107-93,240,40,88,.455,27,54,.500,13,34,.382,14,17,.824,107
7529,2016-04-05,POR,@,SAC,W 115-107,240,40,93,.430,28,62,.452,12,31,.387,23,27,.852,115
7530,2016-04-05,SAC,,POR,L 107-115,240,41,78,.526,30,56,.536,11,22,.500,14,21,.667,107
7531,2016-04-05,CHA,@,TOR,L 90-96,240,32,88,.364,21,53,.396,11,35,.314,15,21,.714,90
7532,2016-04-05,TOR,,CHO,W 96-90,240,34,78,.436,28,55,.509,6,23,.261,22,31,.710,96
7533,2016-04-05,SAS,@,UTA,W 88-86,240,32,72,.444,25,55,.455,7,17,.412,17,19,.895,88
7534,2016-04-05,UTA,,SAS,L 86-88,240,32,68,.471,27,51,.529,5,17,.294,17,21,.810,86
7535,2016-04-03,BRK,,NOP,L 87-106,240,33,85,.388,25,62,.403,8,23,.348,13,21,.619,87
7536,2016-04-03,NOP,@,BRK,W 106-87,240,42,76,.553,34,54,.630,8,22,.364,14,23,.609,106
7537,2016-04-03,CHA,@,CLE,L 103-112,240,34,76,.447,25,50,.500,9,26,.346,26,27,.963,103
7538,2016-04-03,CLE,,CHO,W 112-103,240,45,83,.542,29,54,.537,16,29,.552,6,13,.462,112
7539,2016-04-03,GSW,,POR,W 136-111,240,50,88,.568,32,58,.552,18,30,.600,18,22,.818,136
7540,2016-04-03,POR,@,GSW,L 111-136,240,38,85,.447,29,61,.475,9,24,.375,26,33,.788,111
7541,2016-04-03,HOU,,OKC,W 118-110,240,41,102,.402,28,60,.467,13,42,.310,23,26,.885,118
7542,2016-04-03,OKC,@,HOU,L 110-118,240,38,82,.463,31,55,.564,7,27,.259,27,32,.844,110
7543,2016-04-03,LAC,,WAS,W 114-109,240,43,85,.506,35,66,.530,8,19,.421,20,33,.606,114
7544,2016-04-03,WAS,@,LAC,L 109-114,240,43,94,.457,32,64,.500,11,30,.367,12,21,.571,109
7545,2016-04-03,BOS,@,LAL,W 107-100,240,41,91,.451,33,61,.541,8,30,.267,17,22,.773,107
7546,2016-04-03,LAL,,BOS,L 100-107,240,37,90,.411,31,69,.449,6,21,.286,20,29,.690,100
7547,2016-04-03,CHI,@,MIL,W 102-98,240,39,74,.527,32,48,.667,7,26,.269,17,22,.773,102
7548,2016-04-03,MIL,,CHI,L 98-102,240,40,85,.471,38,78,.487,2,7,.286,16,20,.800,98
7549,2016-04-03,DAL,@,MIN,W 88-78,240,32,83,.386,18,43,.419,14,40,.350,10,17,.588,88
7550,2016-04-03,MIN,,DAL,L 78-88,240,29,71,.408,25,50,.500,4,21,.190,16,18,.889,78
7551,2016-04-03,IND,@,NYK,W 92-87,240,34,81,.420,27,59,.458,7,22,.318,17,20,.850,92
7552,2016-04-03,NYK,,IND,L 87-92,240,33,96,.344,26,71,.366,7,25,.280,14,20,.700,87
7553,2016-04-03,MEM,@,ORL,L 107-119,240,41,89,.461,33,68,.485,8,21,.381,17,26,.654,107
7554,2016-04-03,ORL,,MEM,W 119-107,240,43,90,.478,33,64,.516,10,26,.385,23,29,.793,119
7555,2016-04-03,PHO,,UTA,L 86-101,240,33,78,.423,25,51,.490,8,27,.296,12,19,.632,86
7556,2016-04-03,UTA,@,PHO,W 101-86,240,39,81,.481,29,54,.537,10,27,.370,13,17,.765,101
7557,2016-04-02,CHI,,DET,L 90-94,240,34,88,.386,25,63,.397,9,25,.360,13,15,.867,90
7558,2016-04-02,DET,@,CHI,W 94-90,240,32,76,.421,22,56,.393,10,20,.500,20,34,.588,94
7559,2016-04-02,DEN,,SAC,L 106-115,240,40,92,.435,31,63,.492,9,29,.310,17,24,.708,106
7560,2016-04-02,SAC,@,DEN,W 115-106,240,41,88,.466,33,67,.493,8,21,.381,25,31,.806,115
7561,2016-04-02,IND,@,PHI,W 115-102,240,44,84,.524,36,61,.590,8,23,.348,19,23,.826,115
7562,2016-04-02,PHI,,IND,L 102-115,240,34,83,.410,18,46,.391,16,37,.432,18,26,.692,102
7563,2016-04-02,MIA,@,POR,L 93-110,240,34,88,.386,28,69,.406,6,19,.316,19,27,.704,93
7564,2016-04-02,POR,,MIA,W 110-93,240,41,79,.519,31,64,.484,10,15,.667,18,23,.783,110
7565,2016-04-02,SAS,,TOR,W 102-95,240,35,77,.455,30,57,.526,5,20,.250,27,30,.900,102
7566,2016-04-02,TOR,@,SAS,L 95-102,240,40,80,.500,34,62,.548,6,18,.333,9,10,.900,95
7567,2016-04-01,ATL,,CLE,L 108-110 (OT),265,38,95,.400,29,65,.446,9,30,.300,23,26,.885,108
7568,2016-04-01,CLE,@,ATL,W 110-108 (OT),265,39,98,.398,27,60,.450,12,38,.316,20,31,.645,110
7569,2016-04-01,CHA,,PHI,W 100-91,240,36,84,.429,29,57,.509,7,27,.259,21,27,.778,100
7570,2016-04-01,PHI,@,CHO,L 91-100,240,33,90,.367,23,51,.451,10,39,.256,15,21,.714,91
7571,2016-04-01,DAL,@,DET,W 98-89,240,39,85,.459,31,61,.508,8,24,.333,12,14,.857,98
7572,2016-04-01,DET,,DAL,L 89-98,240,31,81,.383,18,48,.375,13,33,.394,14,24,.583,89
7573,2016-04-01,BOS,@,GSW,W 109-106,240,41,87,.471,33,64,.516,8,23,.348,19,30,.633,109
7574,2016-04-01,GSW,,BOS,L 106-109,240,38,83,.458,18,40,.450,20,43,.465,10,13,.769,106
7575,2016-04-01,MEM,,TOR,L 95-99,240,37,91,.407,30,72,.417,7,19,.368,14,17,.824,95
7576,2016-04-01,TOR,@,MEM,W 99-95,240,30,71,.423,18,43,.419,12,28,.429,27,29,.931,99
7577,2016-04-01,MIL,,ORL,W 113-110,240,47,86,.547,43,69,.623,4,17,.235,15,25,.600,113
7578,2016-04-01,ORL,@,MIL,L 110-113,240,46,86,.535,38,62,.613,8,24,.333,10,12,.833,110
7579,2016-04-01,BRK,@,NYK,L 91-105,240,36,101,.356,32,77,.416,4,24,.167,15,20,.750,91
7580,2016-04-01,NYK,,BRK,W 105-91,240,42,84,.500,28,61,.459,14,23,.609,7,7,1.000,105
7581,2016-04-01,PHO,,WAS,L 99-106,240,36,93,.387,29,70,.414,7,23,.304,20,26,.769,99
7582,2016-04-01,WAS,@,PHO,W 106-99,240,38,86,.442,28,60,.467,10,26,.385,20,25,.800,106
7583,2016-04-01,MIA,@,SAC,W 112-106,240,42,82,.512,30,60,.500,12,22,.545,16,17,.941,112
7584,2016-04-01,SAC,,MIA,L 106-112,240,38,87,.437,31,66,.470,7,21,.333,23,29,.793,106
7585,2016-04-01,MIN,@,UTA,L 85-98,240,35,79,.443,26,56,.464,9,23,.391,6,10,.600,85
7586,2016-04-01,UTA,,MIN,W 98-85,240,38,72,.528,30,50,.600,8,22,.364,14,23,.609,98
7587,2016-03-31,BRK,@,CLE,L 87-107,240,35,94,.372,31,73,.425,4,21,.190,13,21,.619,87
7588,2016-03-31,CLE,,BRK,W 107-87,240,38,87,.437,26,49,.531,12,38,.316,19,24,.792,107
7589,2016-03-31,CHI,@,HOU,W 103-100,240,37,77,.481,26,53,.491,11,24,.458,18,22,.818,103
7590,2016-03-31,HOU,,CHI,L 100-103,240,36,90,.400,27,65,.415,9,25,.360,19,22,.864,100
7591,2016-03-31,IND,,ORL,L 94-114,240,36,86,.419,29,67,.433,7,19,.368,15,21,.714,94
7592,2016-03-31,ORL,@,IND,W 114-94,240,48,90,.533,43,74,.581,5,16,.313,13,18,.722,114
7593,2016-03-31,DEN,@,NOP,L 95-101,240,36,83,.434,26,56,.464,10,27,.370,13,17,.765,95
7594,2016-03-31,NOP,,DEN,W 101-95,240,40,90,.444,27,61,.443,13,29,.448,8,9,.889,101
7595,2016-03-31,LAC,@,OKC,L 117-119,240,42,76,.553,26,47,.553,16,29,.552,17,22,.773,117
7596,2016-03-31,OKC,,LAC,W 119-117,240,45,87,.517,35,55,.636,10,32,.313,19,24,.792,119
7597,2016-03-31,BOS,@,POR,L 109-116,240,37,88,.420,28,64,.438,9,24,.375,26,34,.765,109
7598,2016-03-31,POR,,BOS,W 116-109,240,41,90,.456,27,56,.482,14,34,.412,20,27,.741,116
7599,2016-03-30,DAL,,NYK,W 91-89,240,35,85,.412,27,60,.450,8,25,.320,13,17,.765,91
7600,2016-03-30,NYK,@,DAL,L 89-91,240,35,77,.455,32,60,.533,3,17,.176,16,18,.889,89
7601,2016-03-30,LAL,,MIA,W 102-100 (OT),265,37,102,.363,31,82,.378,6,20,.300,22,29,.759,102
7602,2016-03-30,MIA,@,LAL,L 100-102 (OT),265,41,86,.477,38,69,.551,3,17,.176,15,26,.577,100
7603,2016-03-30,DEN,@,MEM,W 109-105,240,38,78,.487,25,49,.510,13,29,.448,20,24,.833,109
7604,2016-03-30,MEM,,DEN,L 105-109,240,41,95,.432,35,76,.461,6,19,.316,17,27,.630,105
7605,2016-03-30,MIL,,PHO,W 105-94,240,37,77,.481,31,62,.500,6,15,.400,25,34,.735,105
7606,2016-03-30,PHO,@,MIL,L 94-105,240,38,84,.452,33,60,.550,5,24,.208,13,17,.765,94
7607,2016-03-30,LAC,@,MIN,W 99-79,240,37,84,.440,28,53,.528,9,31,.290,16,18,.889,99
7608,2016-03-30,MIN,,LAC,L 79-99,240,30,87,.345,22,64,.344,8,23,.348,11,17,.647,79
7609,2016-03-30,SAC,,WAS,W 120-111,240,47,84,.560,39,66,.591,8,18,.444,18,25,.720,120
7610,2016-03-30,WAS,@,SAC,L 111-120,240,43,89,.483,34,63,.540,9,26,.346,16,20,.800,111
7611,2016-03-30,NOP,@,SAS,L 92-100,240,36,80,.450,28,63,.444,8,17,.471,12,18,.667,92
7612,2016-03-30,SAS,,NOP,W 100-92,240,36,75,.480,24,51,.471,12,24,.500,16,22,.727,100
7613,2016-03-30,ATL,@,TOR,L 97-105,240,37,83,.446,23,50,.460,14,33,.424,9,13,.692,97
7614,2016-03-30,TOR,,ATL,W 105-97,240,36,80,.450,25,57,.439,11,23,.478,22,28,.786,105
7615,2016-03-30,GSW,@,UTA,W 103-96 (OT),265,39,89,.438,27,54,.500,12,35,.343,13,18,.722,103
7616,2016-03-30,UTA,,GSW,L 96-103 (OT),265,37,92,.402,28,60,.467,9,32,.281,13,29,.448,96
7617,2016-03-29,CLE,,HOU,L 100-106,240,31,86,.360,17,46,.370,14,40,.350,24,28,.857,100
7618,2016-03-29,HOU,@,CLE,W 106-100,240,38,79,.481,29,54,.537,9,25,.360,21,42,.500,106
7619,2016-03-29,DET,,OKC,W 88-82,240,33,87,.379,29,68,.426,4,19,.211,18,20,.900,88
7620,2016-03-29,OKC,@,DET,L 82-88,240,31,82,.378,25,61,.410,6,21,.286,14,22,.636,82
7621,2016-03-29,GSW,,WAS,W 102-94,240,38,87,.437,27,62,.435,11,25,.440,15,23,.652,102
7622,2016-03-29,WAS,@,GSW,L 94-102,240,36,86,.419,31,63,.492,5,23,.217,17,27,.630,94
7623,2016-03-29,CHI,@,IND,W 98-96,240,37,87,.425,27,61,.443,10,26,.385,14,16,.875,98
7624,2016-03-29,IND,,CHI,L 96-98,240,39,90,.433,36,71,.507,3,19,.158,15,17,.882,96
7625,2016-03-29,BRK,@,ORL,L 105-139,240,37,79,.468,32,65,.492,5,14,.357,26,39,.667,105
7626,2016-03-29,ORL,,BRK,W 139-105,240,56,91,.615,42,64,.656,14,27,.519,13,19,.684,139
7627,2016-03-29,CHA,@,PHI,W 100-85,240,38,87,.437,31,62,.500,7,25,.280,17,18,.944,100
7628,2016-03-29,PHI,,CHO,L 85-100,240,30,96,.313,14,52,.269,16,44,.364,9,10,.900,85
7629,2016-03-28,ATL,@,CHI,W 102-100,240,36,85,.424,31,63,.492,5,22,.227,25,28,.893,102
7630,2016-03-28,CHI,,ATL,L 100-102,240,40,106,.377,31,84,.369,9,22,.409,11,15,.733,100
7631,2016-03-28,DAL,@,DEN,W 97-88,240,36,88,.409,25,56,.446,11,32,.344,14,15,.933,97
7632,2016-03-28,DEN,,DAL,L 88-97,240,31,70,.443,22,46,.478,9,24,.375,17,19,.895,88
7633,2016-03-28,BOS,@,LAC,L 90-114,240,31,89,.348,24,70,.343,7,19,.368,21,27,.778,90
7634,2016-03-28,LAC,,BOS,W 114-90,240,44,84,.524,33,59,.559,11,25,.440,15,18,.833,114
7635,2016-03-28,MEM,,SAS,L 87-101,240,33,83,.398,27,64,.422,6,19,.316,15,24,.625,87
7636,2016-03-28,SAS,@,MEM,W 101-87,240,37,72,.514,32,57,.561,5,15,.333,22,30,.733,101
7637,2016-03-28,BRK,@,MIA,L 99-110,240,41,77,.532,38,66,.576,3,11,.273,14,18,.778,99
7638,2016-03-28,MIA,,BRK,W 110-99,240,48,84,.571,43,68,.632,5,16,.313,9,12,.750,110
7639,2016-03-28,MIN,,PHO,W 121-116,240,41,81,.506,34,55,.618,7,26,.269,32,40,.800,121
7640,2016-03-28,PHO,@,MIN,L 116-121,240,41,84,.488,26,51,.510,15,33,.455,19,23,.826,116
7641,2016-03-28,NOP,,NYK,W 99-91,240,32,75,.427,24,56,.429,8,19,.421,27,37,.730,99
7642,2016-03-28,NYK,@,NOP,L 91-99,240,36,89,.404,26,58,.448,10,31,.323,9,13,.692,91
7643,2016-03-28,POR,,SAC,W 105-93,240,38,80,.475,24,51,.471,14,29,.483,15,18,.833,105
7644,2016-03-28,SAC,@,POR,L 93-105,240,37,89,.416,30,74,.405,7,15,.467,12,19,.632,93
7645,2016-03-28,OKC,@,TOR,W 119-100,240,41,86,.477,30,60,.500,11,26,.423,26,32,.813,119
7646,2016-03-28,TOR,,OKC,L 100-119,240,38,93,.409,30,69,.435,8,24,.333,16,23,.696,100
7647,2016-03-28,LAL,@,UTA,L 75-123,240,26,85,.306,19,65,.292,7,20,.350,16,22,.727,75
7648,2016-03-28,UTA,,LAL,W 123-75,240,46,89,.517,29,57,.509,17,32,.531,14,19,.737,123
7649,2016-03-27,GSW,,PHI,W 117-105,240,44,83,.530,30,50,.600,14,33,.424,15,20,.750,117
7650,2016-03-27,PHI,@,GSW,L 105-117,240,42,90,.467,32,60,.533,10,30,.333,11,12,.917,105
7651,2016-03-27,HOU,@,IND,L 101-104,240,38,85,.447,31,52,.596,7,33,.212,18,27,.667,101
7652,2016-03-27,IND,,HOU,W 104-101,240,41,87,.471,32,61,.525,9,26,.346,13,20,.650,104
7653,2016-03-27,DEN,@,LAC,L 90-105,240,37,94,.394,30,65,.462,7,29,.241,9,13,.692,90
7654,2016-03-27,LAC,,DEN,W 105-90,240,38,80,.475,28,52,.538,10,28,.357,19,26,.731,105
7655,2016-03-27,LAL,,WAS,L 88-101,240,33,87,.379,26,59,.441,7,28,.250,15,17,.882,88
7656,2016-03-27,WAS,@,LAL,W 101-88,240,39,72,.542,32,54,.593,7,18,.389,16,29,.552,101
7657,2016-03-27,DAL,@,SAC,L 111-133,240,42,88,.477,34,64,.531,8,24,.333,19,24,.792,111
7658,2016-03-27,SAC,,DAL,W 133-111,240,51,82,.622,42,62,.677,9,20,.450,22,30,.733,133
7659,2016-03-26,BRK,,IND,W 120-110,240,42,77,.545,37,66,.561,5,11,.455,31,36,.861,120
7660,2016-03-26,IND,@,BRK,L 110-120,240,37,77,.481,26,53,.491,11,24,.458,25,30,.833,110
7661,2016-03-26,ATL,@,DET,W 112-95,240,43,95,.453,30,61,.492,13,34,.382,13,14,.929,112
7662,2016-03-26,DET,,ATL,L 95-112,240,34,88,.386,27,59,.458,7,29,.241,20,28,.714,95
7663,2016-03-26,CHA,@,MIL,W 115-91,240,41,74,.554,25,45,.556,16,29,.552,17,21,.810,115
7664,2016-03-26,MIL,,CHO,L 91-115,240,37,84,.440,33,69,.478,4,15,.267,13,15,.867,91
7665,2016-03-26,MIN,,UTA,L 84-93,240,32,84,.381,28,73,.384,4,11,.364,16,19,.842,84
7666,2016-03-26,UTA,@,MIN,W 93-84,240,39,83,.470,30,62,.484,9,21,.429,6,7,.857,93
7667,2016-03-26,NOP,,TOR,L 91-115,240,37,85,.435,33,70,.471,4,15,.267,13,20,.650,91
7668,2016-03-26,TOR,@,NOP,W 115-91,240,39,73,.534,27,44,.614,12,29,.414,25,28,.893,115
7669,2016-03-26,CLE,@,NYK,W 107-93,240,37,83,.446,23,49,.469,14,34,.412,19,25,.760,107
7670,2016-03-26,NYK,,CLE,L 93-107,240,33,79,.418,25,56,.446,8,23,.348,19,28,.679,93
7671,2016-03-26,OKC,,SAS,W 111-92,240,44,85,.518,37,65,.569,7,20,.350,16,18,.889,111
7672,2016-03-26,SAS,@,OKC,L 92-111,240,37,86,.430,33,71,.465,4,15,.267,14,17,.824,92
7673,2016-03-26,CHI,@,ORL,L 89-111,240,36,88,.409,30,64,.469,6,24,.250,11,17,.647,89
7674,2016-03-26,ORL,,CHI,W 111-89,240,48,89,.539,41,70,.586,7,19,.368,8,12,.667,111
7675,2016-03-26,BOS,@,PHO,W 102-99,240,35,84,.417,27,55,.491,8,29,.276,24,27,.889,102
7676,2016-03-26,PHO,,BOS,L 99-102,240,37,85,.435,30,54,.556,7,31,.226,18,21,.857,99
7677,2016-03-26,PHI,@,POR,L 105-108,240,39,93,.419,29,55,.527,10,38,.263,17,24,.708,105
7678,2016-03-26,POR,,PHI,W 108-105,240,38,91,.418,30,66,.455,8,25,.320,24,30,.800,108
7679,2016-03-25,ATL,,MIL,W 101-90,240,41,97,.423,36,65,.554,5,32,.156,14,17,.824,101
7680,2016-03-25,MIL,@,ATL,L 90-101,240,35,84,.417,32,71,.451,3,13,.231,17,26,.654,90
7681,2016-03-25,CHA,@,DET,L 105-112,240,37,93,.398,23,63,.365,14,30,.467,17,22,.773,105
7682,2016-03-25,DET,,CHO,W 112-105,240,42,91,.462,34,61,.557,8,30,.267,20,26,.769,112
7683,2016-03-25,DAL,@,GSW,L 120-128,240,43,96,.448,25,61,.410,18,35,.514,16,21,.762,120
7684,2016-03-25,GSW,,DAL,W 128-120,240,43,88,.489,22,43,.512,21,45,.467,21,23,.913,128
7685,2016-03-25,HOU,,TOR,W 112-109,240,42,81,.519,30,59,.508,12,22,.545,16,35,.457,112
7686,2016-03-25,TOR,@,HOU,L 109-112,240,39,94,.415,26,63,.413,13,31,.419,18,26,.692,109
7687,2016-03-25,DEN,@,LAL,W 116-105,240,45,94,.479,35,68,.515,10,26,.385,16,24,.667,116
7688,2016-03-25,LAL,,DEN,L 105-116,240,37,85,.435,27,62,.435,10,23,.435,21,26,.808,105
7689,2016-03-25,MIA,,ORL,W 108-97,240,40,80,.500,35,65,.538,5,15,.333,23,33,.697,108
7690,2016-03-25,ORL,@,MIA,L 97-108,240,36,84,.429,30,66,.455,6,18,.333,19,28,.679,97
7691,2016-03-25,PHO,@,SAC,L 94-116,240,35,94,.372,26,62,.419,9,32,.281,15,23,.652,94
7692,2016-03-25,SAC,,PHO,W 116-94,240,40,90,.444,33,68,.485,7,22,.318,29,39,.744,116
7693,2016-03-25,MEM,@,SAS,L 104-110,240,44,83,.530,37,65,.569,7,18,.389,9,13,.692,104
7694,2016-03-25,SAS,,MEM,W 110-104,240,44,77,.571,37,59,.627,7,18,.389,15,18,.833,110
7695,2016-03-25,MIN,@,WAS,W 132-129 (2OT),290,51,96,.531,43,70,.614,8,26,.308,22,22,1.000,132
7696,2016-03-25,WAS,,MIN,L 129-132 (2OT),290,50,100,.500,37,71,.521,13,29,.448,16,23,.696,129
7697,2016-03-24,BRK,,CLE,W 104-95,240,41,89,.461,33,67,.493,8,22,.364,14,19,.737,104
7698,2016-03-24,CLE,@,BRK,L 95-104,240,39,89,.438,29,51,.569,10,38,.263,7,9,.778,95
7699,2016-03-24,IND,,NOP,W 92-84,240,36,79,.456,29,59,.492,7,20,.350,13,15,.867,92
7700,2016-03-24,NOP,@,IND,L 84-92,240,35,85,.412,31,69,.449,4,16,.250,10,14,.714,84
7701,2016-03-24,LAC,,POR,W 96-94,240,37,82,.451,33,63,.524,4,19,.211,18,28,.643,96
7702,2016-03-24,POR,@,LAC,L 94-96,240,32,80,.400,26,56,.464,6,24,.250,24,32,.750,94
7703,2016-03-24,CHI,@,NYK,L 94-106,240,37,89,.416,31,64,.484,6,25,.240,14,18,.778,94
7704,2016-03-24,NYK,,CHI,W 106-94,240,39,76,.513,26,46,.565,13,30,.433,15,16,.938,106
7705,2016-03-24,OKC,,UTA,W 113-91,240,45,83,.542,36,61,.590,9,22,.409,14,22,.636,113
7706,2016-03-24,UTA,@,OKC,L 91-113,240,35,73,.479,30,51,.588,5,22,.227,16,23,.696,91
7707,2016-03-23,BOS,,TOR,W 91-79,240,35,80,.438,27,60,.450,8,20,.400,13,21,.619,91
7708,2016-03-23,TOR,@,BOS,L 79-91,240,31,89,.348,25,67,.373,6,22,.273,11,20,.550,79
7709,2016-03-23,CHI,,NYK,L 107-115,240,38,82,.463,23,50,.460,15,32,.469,16,21,.762,107
7710,2016-03-23,NYK,@,CHI,W 115-107,240,45,87,.517,31,62,.500,14,25,.560,11,15,.733,115
7711,2016-03-23,CLE,,MIL,W 113-104,240,40,83,.482,30,49,.612,10,34,.294,23,27,.852,113
7712,2016-03-23,MIL,@,CLE,L 104-113,240,43,80,.538,36,64,.563,7,16,.438,11,15,.733,104
7713,2016-03-23,DEN,,PHI,W 104-103,240,33,76,.434,27,59,.458,6,17,.353,32,40,.800,104
7714,2016-03-23,PHI,@,DEN,L 103-104,240,37,94,.394,22,57,.386,15,37,.405,14,15,.933,103
7715,2016-03-23,DET,,ORL,W 118-102,240,43,80,.538,32,56,.571,11,24,.458,21,25,.840,118
7716,2016-03-23,ORL,@,DET,L 102-118,240,39,98,.398,31,73,.425,8,25,.320,16,19,.842,102
7717,2016-03-23,GSW,,LAC,W 114-98,240,39,87,.448,24,53,.453,15,34,.441,21,28,.750,114
7718,2016-03-23,LAC,@,GSW,L 98-114,240,36,85,.424,28,57,.491,8,28,.286,18,27,.667,98
7719,2016-03-23,HOU,,UTA,L 87-89,240,33,74,.446,24,51,.471,9,23,.391,12,22,.545,87
7720,2016-03-23,UTA,@,HOU,W 89-87,240,31,77,.403,20,48,.417,11,29,.379,16,20,.800,89
7721,2016-03-23,MIN,,SAC,W 113-104,240,45,80,.563,40,67,.597,5,13,.385,18,32,.563,113
7722,2016-03-23,SAC,@,MIN,L 104-113,240,42,91,.462,34,71,.479,8,20,.400,12,23,.522,104
7723,2016-03-23,LAL,@,PHO,L 107-119,240,39,93,.419,32,66,.485,7,27,.259,22,26,.846,107
7724,2016-03-23,PHO,,LAL,W 119-107,240,47,93,.505,34,65,.523,13,28,.464,12,20,.600,119
7725,2016-03-23,DAL,@,POR,L 103-109,240,42,96,.438,33,66,.500,9,30,.300,10,11,.909,103
7726,2016-03-23,POR,,DAL,W 109-103,240,40,89,.449,33,62,.532,7,27,.259,22,25,.880,109
7727,2016-03-23,MIA,@,SAS,L 88-112,240,37,77,.481,30,63,.476,7,14,.500,7,12,.583,88
7728,2016-03-23,SAS,,MIA,W 112-88,240,42,81,.519,34,67,.507,8,14,.571,20,24,.833,112
7729,2016-03-23,ATL,@,WAS,W 122-101,240,45,84,.536,28,42,.667,17,42,.405,15,22,.682,122
7730,2016-03-23,WAS,,ATL,L 101-122,240,39,92,.424,27,62,.435,12,30,.400,11,12,.917,101
7731,2016-03-22,BRK,,CHO,L 100-105,240,34,74,.459,26,56,.464,8,18,.444,24,27,.889,100
7732,2016-03-22,CHA,@,BRK,W 105-100,240,39,82,.476,29,54,.537,10,28,.357,17,21,.810,105
7733,2016-03-22,LAL,,MEM,W 107-100,240,39,77,.506,33,58,.569,6,19,.316,23,24,.958,107
7734,2016-03-22,MEM,@,LAL,L 100-107,240,40,80,.500,36,65,.554,4,15,.267,16,23,.696,100
7735,2016-03-22,MIA,@,NOP,W 113-99,240,44,88,.500,41,69,.594,3,19,.158,22,27,.815,113
7736,2016-03-22,NOP,,MIA,L 99-113,240,34,87,.391,27,71,.380,7,16,.438,24,30,.800,99
7737,2016-03-22,HOU,@,OKC,L 107-111,240,40,92,.435,27,55,.491,13,37,.351,14,17,.824,107
7738,2016-03-22,OKC,,HOU,W 111-107,240,41,91,.451,33,56,.589,8,35,.229,21,29,.724,111
7739,2016-03-21,ATL,,WAS,L 102-117,240,38,78,.487,25,45,.556,13,33,.394,13,17,.765,102
7740,2016-03-21,WAS,@,ATL,W 117-102,240,46,91,.505,33,66,.500,13,25,.520,12,20,.600,117
7741,2016-03-21,BOS,,ORL,W 107-96,240,40,85,.471,33,63,.524,7,22,.318,20,24,.833,107
7742,2016-03-21,ORL,@,BOS,L 96-107,240,39,93,.419,34,74,.459,5,19,.263,13,19,.684,96
7743,2016-03-21,CHI,,SAC,W 109-102,240,41,91,.451,29,67,.433,12,24,.500,15,23,.652,109
7744,2016-03-21,SAC,@,CHI,L 102-109,240,40,88,.455,31,59,.525,9,29,.310,13,16,.813,102
7745,2016-03-21,CHA,,SAS,W 91-88,240,35,87,.402,27,68,.397,8,19,.421,13,19,.684,91
7746,2016-03-21,SAS,@,CHO,L 88-91,240,37,86,.430,33,69,.478,4,17,.235,10,13,.769,88
7747,2016-03-21,CLE,,DEN,W 124-91,240,48,86,.558,33,55,.600,15,31,.484,13,17,.765,124
7748,2016-03-21,DEN,@,CLE,L 91-124,240,32,81,.395,24,59,.407,8,22,.364,19,25,.760,91
7749,2016-03-21,DET,,MIL,W 92-91,240,35,85,.412,26,52,.500,9,33,.273,13,17,.765,92
7750,2016-03-21,MIL,@,DET,L 91-92,240,41,76,.539,36,67,.537,5,9,.556,4,7,.571,91
7751,2016-03-21,IND,,PHI,W 91-75,240,35,81,.432,25,55,.455,10,26,.385,11,13,.846,91
7752,2016-03-21,PHI,@,IND,L 75-91,240,31,80,.388,27,62,.435,4,18,.222,9,14,.643,75
7753,2016-03-21,GSW,@,MIN,W 109-104,240,43,87,.494,35,63,.556,8,24,.333,15,24,.625,109
7754,2016-03-21,MIN,,GSW,L 104-109,240,36,82,.439,29,63,.460,7,19,.368,25,30,.833,104
7755,2016-03-21,MEM,@,PHO,W 103-97,240,39,90,.433,31,70,.443,8,20,.400,17,19,.895,103
7756,2016-03-21,PHO,,MEM,L 97-103,240,30,76,.395,19,48,.396,11,28,.393,26,34,.765,97
7757,2016-03-20,DAL,,POR,W 132-120 (OT),265,49,89,.551,34,64,.531,15,25,.600,19,23,.826,132
7758,2016-03-20,POR,@,DAL,L 120-132 (OT),265,42,104,.404,24,58,.414,18,46,.391,18,28,.643,120
7759,2016-03-20,MIL,,UTA,L 85-94,240,34,65,.523,31,57,.544,3,8,.375,14,17,.824,85
7760,2016-03-20,UTA,@,MIL,W 94-85,240,34,83,.410,21,45,.467,13,38,.342,13,14,.929,94
7761,2016-03-20,LAC,@,NOP,L 105-109,240,33,82,.402,23,43,.535,10,39,.256,29,42,.690,105
7762,2016-03-20,NOP,,LAC,W 109-105,240,35,71,.493,28,50,.560,7,21,.333,32,40,.800,109
7763,2016-03-20,NYK,,SAC,L 80-88,240,32,91,.352,28,72,.389,4,19,.211,12,15,.800,80
7764,2016-03-20,SAC,@,NYK,W 88-80,240,35,88,.398,28,63,.444,7,25,.280,11,14,.786,88
7765,2016-03-20,BOS,@,PHI,W 120-105,240,46,94,.489,36,69,.522,10,25,.400,18,21,.857,120
7766,2016-03-20,PHI,,BOS,L 105-120,240,39,92,.424,31,71,.437,8,21,.381,19,27,.704,105
7767,2016-03-20,ORL,@,TOR,L 100-105,240,40,83,.482,32,61,.525,8,22,.364,12,18,.667,100
7768,2016-03-20,TOR,,ORL,W 105-100,240,35,81,.432,29,61,.475,6,20,.300,29,45,.644,105
7769,2016-03-19,ATL,,HOU,W 109-97,240,44,88,.500,30,50,.600,14,38,.368,7,12,.583,109
7770,2016-03-19,HOU,@,ATL,L 97-109,240,33,84,.393,28,61,.459,5,23,.217,26,31,.839,97
7771,2016-03-19,CHI,,UTA,W 92-85,240,39,80,.488,33,61,.541,6,19,.316,8,11,.727,92
7772,2016-03-19,UTA,@,CHI,L 85-92,240,35,86,.407,27,59,.458,8,27,.296,7,12,.583,85
7773,2016-03-19,CHA,,DEN,L 93-101,240,35,83,.422,26,51,.510,9,32,.281,14,20,.700,93
7774,2016-03-19,DEN,@,CHO,W 101-93,240,38,87,.437,29,69,.420,9,18,.500,16,23,.696,101
7775,2016-03-19,BRK,@,DET,L 103-115,240,42,80,.525,37,66,.561,5,14,.357,14,21,.667,103
7776,2016-03-19,DET,,BRK,W 115-103,240,46,94,.489,36,70,.514,10,24,.417,13,21,.619,115
7777,2016-03-19,IND,,OKC,L 111-115,240,40,83,.482,31,61,.508,9,22,.409,22,30,.733,111
7778,2016-03-19,OKC,@,IND,W 115-111,240,42,80,.525,32,52,.615,10,28,.357,21,26,.808,115
7779,2016-03-19,LAC,@,MEM,L 102-113,240,31,66,.470,19,36,.528,12,30,.400,28,39,.718,102
7780,2016-03-19,MEM,,LAC,W 113-102,240,40,82,.488,36,67,.537,4,15,.267,29,36,.806,113
7781,2016-03-19,CLE,@,MIA,L 101-122,240,40,76,.526,30,52,.577,10,24,.417,11,13,.846,101
7782,2016-03-19,MIA,,CLE,W 122-101,240,46,84,.548,35,65,.538,11,19,.579,19,23,.826,122
7783,2016-03-19,GSW,@,SAS,L 79-87,240,31,82,.378,22,46,.478,9,36,.250,8,10,.800,79
7784,2016-03-19,SAS,,GSW,W 87-79,240,32,78,.410,24,57,.421,8,21,.381,15,18,.833,87
7785,2016-03-19,NYK,@,WAS,L 89-99,240,32,81,.395,22,60,.367,10,21,.476,15,17,.882,89
7786,2016-03-19,WAS,,NYK,W 99-89,240,39,87,.448,31,58,.534,8,29,.276,13,17,.765,99
7787,2016-03-18,DAL,,GSW,L 112-130,240,41,93,.441,32,64,.500,9,29,.310,21,22,.955,112
7788,2016-03-18,GSW,@,DAL,W 130-112,240,48,95,.505,26,57,.456,22,38,.579,12,14,.857,130
7789,2016-03-18,DET,,SAC,W 115-108,240,44,92,.478,32,66,.485,12,26,.462,15,18,.833,115
7790,2016-03-18,SAC,@,DET,L 108-115,240,40,79,.506,36,64,.563,4,15,.267,24,29,.828,108
7791,2016-03-18,HOU,,MIN,W 116-111,240,48,85,.565,37,56,.661,11,29,.379,9,14,.643,116
7792,2016-03-18,MIN,@,HOU,L 111-116,240,43,85,.506,37,69,.536,6,16,.375,19,24,.792,111
7793,2016-03-18,LAL,,PHO,L 90-95,240,31,86,.360,25,63,.397,6,23,.261,22,26,.846,90
7794,2016-03-18,PHO,@,LAL,W 95-90,240,32,89,.360,24,59,.407,8,30,.267,23,26,.885,95
7795,2016-03-18,NOP,,POR,L 112-117,240,40,83,.482,30,62,.484,10,21,.476,22,28,.786,112
7796,2016-03-18,POR,@,NOP,W 117-112,240,36,78,.462,27,51,.529,9,27,.333,36,40,.900,117
7797,2016-03-18,CLE,@,ORL,W 109-103,240,38,76,.500,25,48,.521,13,28,.464,20,27,.741,109
7798,2016-03-18,ORL,,CLE,L 103-109,240,37,82,.451,26,60,.433,11,22,.500,18,22,.818,103
7799,2016-03-18,OKC,@,PHI,W 111-97,240,45,89,.506,38,67,.567,7,22,.318,14,18,.778,111
7800,2016-03-18,PHI,,OKC,L 97-111,240,35,89,.393,25,60,.417,10,29,.345,17,27,.630,97
7801,2016-03-18,BOS,@,TOR,L 91-105,240,36,82,.439,27,61,.443,9,21,.429,10,12,.833,91
7802,2016-03-18,TOR,,BOS,W 105-91,240,37,77,.481,24,49,.490,13,28,.464,18,25,.720,105
7803,2016-03-17,ATL,,DEN,W 116-98,240,40,80,.500,28,54,.519,12,26,.462,24,28,.857,116
7804,2016-03-17,DEN,@,ATL,L 98-116,240,39,87,.448,33,65,.508,6,22,.273,14,17,.824,98
7805,2016-03-17,BRK,@,CHI,L 102-118,240,40,86,.465,34,65,.523,6,21,.286,16,20,.800,102
7806,2016-03-17,CHI,,BRK,W 118-102,240,46,94,.489,35,70,.500,11,24,.458,15,15,1.000,118
7807,2016-03-17,IND,,TOR,L 94-101 (OT),265,35,91,.385,27,63,.429,8,28,.286,16,23,.696,94
7808,2016-03-17,TOR,@,IND,W 101-94 (OT),265,32,88,.364,25,66,.379,7,22,.318,30,38,.789,101
7809,2016-03-17,CHA,@,MIA,W 109-106,240,40,86,.465,27,60,.450,13,26,.500,16,21,.762,109
7810,2016-03-17,MIA,,CHO,L 106-109,240,40,75,.533,33,58,.569,7,17,.412,19,24,.792,106
7811,2016-03-17,MEM,@,MIL,L 86-96,240,34,92,.370,31,79,.392,3,13,.231,15,17,.882,86
7812,2016-03-17,MIL,,MEM,W 96-86,240,37,75,.493,32,56,.571,5,19,.263,17,25,.680,96
7813,2016-03-17,PHI,,WAS,L 94-99,240,35,91,.385,29,58,.500,6,33,.182,18,26,.692,94
7814,2016-03-17,WAS,@,PHI,W 99-94,240,40,90,.444,34,63,.540,6,27,.222,13,19,.684,99
7815,2016-03-17,POR,@,SAS,L 110-118,240,39,89,.438,29,67,.433,10,22,.455,22,30,.733,110
7816,2016-03-17,SAS,,POR,W 118-110,240,45,86,.523,37,70,.529,8,16,.500,20,22,.909,118
7817,2016-03-17,PHO,@,UTA,L 69-103,240,28,82,.341,22,56,.393,6,26,.231,7,14,.500,69
7818,2016-03-17,UTA,,PHO,W 103-69,240,43,88,.489,32,63,.508,11,25,.440,6,9,.667,103
7819,2016-03-16,BOS,,OKC,L 109-130,240,40,93,.430,35,74,.473,5,19,.263,24,27,.889,109
7820,2016-03-16,OKC,@,BOS,W 130-109,240,47,96,.490,35,67,.522,12,29,.414,24,30,.800,130
7821,2016-03-16,CHA,,ORL,W 107-99,240,40,100,.400,29,63,.460,11,37,.297,16,21,.762,107
7822,2016-03-16,ORL,@,CHO,L 99-107,240,35,83,.422,24,58,.414,11,25,.440,18,21,.857,99
7823,2016-03-16,CLE,,DAL,W 99-98,240,39,88,.443,29,51,.569,10,37,.270,11,13,.846,99
7824,2016-03-16,DAL,@,CLE,L 98-99,240,37,79,.468,30,57,.526,7,22,.318,17,19,.895,98
7825,2016-03-16,ATL,@,DET,W 118-114,240,39,89,.438,27,55,.491,12,34,.353,28,34,.824,118
7826,2016-03-16,DET,,ATL,L 114-118,240,39,84,.464,31,59,.525,8,25,.320,28,39,.718,114
7827,2016-03-16,GSW,,NYK,W 121-85,240,46,91,.505,28,54,.519,18,37,.486,11,12,.917,121
7828,2016-03-16,NYK,@,GSW,L 85-121,240,36,91,.396,29,72,.403,7,19,.368,6,10,.600,85
7829,2016-03-16,HOU,,LAC,L 106-122,240,40,82,.488,31,57,.544,9,25,.360,17,24,.708,106
7830,2016-03-16,LAC,@,HOU,W 122-106,240,43,76,.566,31,46,.674,12,30,.400,24,32,.750,122
7831,2016-03-16,MEM,,MIN,L 108-114,240,44,100,.440,40,80,.500,4,20,.200,16,21,.762,108
7832,2016-03-16,MIN,@,MEM,W 114-108,240,40,71,.563,30,50,.600,10,21,.476,24,31,.774,114
7833,2016-03-16,NOP,@,SAC,W 123-108,240,49,90,.544,37,69,.536,12,21,.571,13,16,.813,123
7834,2016-03-16,SAC,,NOP,L 108-123,240,42,90,.467,33,72,.458,9,18,.500,15,17,.882,108
7835,2016-03-16,CHI,@,WAS,L 96-117,240,35,87,.402,29,67,.433,6,20,.300,20,23,.870,96
7836,2016-03-16,WAS,,CHI,W 117-96,240,43,88,.489,30,67,.448,13,21,.619,18,24,.750,117
7837,2016-03-15,BRK,,PHI,W 131-114,240,47,90,.522,37,66,.561,10,24,.417,27,31,.871,131
7838,2016-03-15,PHI,@,BRK,L 114-131,240,41,88,.466,30,58,.517,11,30,.367,21,26,.808,114
7839,2016-03-15,BOS,@,IND,L 98-103,240,36,94,.383,28,63,.444,8,31,.258,18,22,.818,98
7840,2016-03-15,IND,,BOS,W 103-98,240,39,84,.464,34,72,.472,5,12,.417,20,28,.714,103
7841,2016-03-15,LAL,,SAC,L 98-106,240,37,84,.440,32,58,.552,5,26,.192,19,26,.731,98
7842,2016-03-15,SAC,@,LAL,W 106-98,240,38,79,.481,34,61,.557,4,18,.222,26,33,.788,106
7843,2016-03-15,MIL,,TOR,L 89-107,240,34,77,.442,32,64,.500,2,13,.154,19,26,.731,89
7844,2016-03-15,TOR,@,MIL,W 107-89,240,39,83,.470,25,53,.472,14,30,.467,15,17,.882,107
7845,2016-03-15,DEN,@,ORL,L 110-116,240,40,80,.500,31,56,.554,9,24,.375,21,24,.875,110
7846,2016-03-15,ORL,,DEN,W 116-110,240,44,81,.543,36,56,.643,8,25,.320,20,25,.800,116
7847,2016-03-15,LAC,@,SAS,L 87-108,240,32,69,.464,24,50,.480,8,19,.421,15,22,.682,87
7848,2016-03-15,SAS,,LAC,W 108-87,240,44,82,.537,36,62,.581,8,20,.400,12,16,.750,108
7849,2016-03-14,CHA,,DAL,L 96-107,240,32,76,.421,22,46,.478,10,30,.333,22,34,.647,96
7850,2016-03-14,DAL,@,CHO,W 107-96,240,42,87,.483,33,57,.579,9,30,.300,14,18,.778,107
7851,2016-03-14,GSW,,NOP,W 125-107,240,47,81,.580,35,56,.625,12,25,.480,19,23,.826,125
7852,2016-03-14,NOP,@,GSW,L 107-125,240,35,93,.376,28,68,.412,7,25,.280,30,34,.882,107
7853,2016-03-14,HOU,,MEM,W 130-81,240,46,85,.541,30,52,.577,16,33,.485,22,34,.647,130
7854,2016-03-14,MEM,@,HOU,L 81-130,240,30,101,.297,26,84,.310,4,17,.235,17,28,.607,81
7855,2016-03-14,DEN,@,MIA,L 119-124,240,49,93,.527,42,73,.575,7,20,.350,14,20,.700,119
7856,2016-03-14,MIA,,DEN,W 124-119,240,47,79,.595,39,62,.629,8,17,.471,22,28,.786,124
7857,2016-03-14,OKC,,POR,W 128-94,240,49,83,.590,40,66,.606,9,17,.529,21,26,.808,128
7858,2016-03-14,POR,@,OKC,L 94-128,240,31,91,.341,24,64,.375,7,27,.259,25,27,.926,94
7859,2016-03-14,MIN,@,PHO,L 104-107,240,37,84,.440,33,68,.485,4,16,.250,26,30,.867,104
7860,2016-03-14,PHO,,MIN,W 107-104,240,40,95,.421,29,60,.483,11,35,.314,16,20,.800,107
7861,2016-03-14,CHI,@,TOR,W 109-107,240,41,83,.494,32,58,.552,9,25,.360,18,20,.900,109
7862,2016-03-14,TOR,,CHI,L 107-109,240,37,83,.446,31,63,.492,6,20,.300,27,31,.871,107
7863,2016-03-14,CLE,@,UTA,L 85-94,240,35,88,.398,25,45,.556,10,43,.233,5,8,.625,85
7864,2016-03-14,UTA,,CLE,W 94-85,240,35,71,.493,23,44,.523,12,27,.444,12,14,.857,94
7865,2016-03-14,DET,@,WAS,L 81-124,240,32,79,.405,29,56,.518,3,23,.130,14,22,.636,81
7866,2016-03-14,WAS,,DET,W 124-81,240,51,90,.567,43,72,.597,8,18,.444,14,18,.778,124
7867,2016-03-13,ATL,,IND,W 104-75,240,40,85,.471,25,55,.455,15,30,.500,9,10,.900,104
7868,2016-03-13,IND,@,ATL,L 75-104,240,33,87,.379,28,63,.444,5,24,.208,4,7,.571,75
7869,2016-03-13,BRK,,MIL,L 100-109,240,39,70,.557,27,43,.628,12,27,.444,10,13,.769,100
7870,2016-03-13,MIL,@,BRK,W 109-100,240,45,89,.506,39,75,.520,6,14,.429,13,21,.619,109
7871,2016-03-13,CLE,@,LAC,W 114-90,240,41,84,.488,23,47,.489,18,37,.486,14,20,.700,114
7872,2016-03-13,LAC,,CLE,L 90-114,240,32,79,.405,22,47,.468,10,32,.313,16,19,.842,90
7873,2016-03-13,LAL,,NYK,L 87-90,240,34,85,.400,31,69,.449,3,16,.188,16,21,.762,87
7874,2016-03-13,NYK,@,LAL,W 90-87,240,33,75,.440,28,54,.519,5,21,.238,19,27,.704,90
7875,2016-03-13,SAC,,UTA,L 99-108,240,38,81,.469,29,60,.483,9,21,.429,14,21,.667,99
7876,2016-03-13,UTA,@,SAC,W 108-99,240,39,82,.476,27,54,.500,12,28,.429,18,22,.818,108
7877,2016-03-12,ATL,,MEM,W 95-83,240,36,84,.429,25,50,.500,11,34,.324,12,17,.706,95
7878,2016-03-12,MEM,@,ATL,L 83-95,240,33,95,.347,27,72,.375,6,23,.261,11,14,.786,83
7879,2016-03-12,CHA,,HOU,W 125-109,240,48,88,.545,33,57,.579,15,31,.484,14,16,.875,125
7880,2016-03-12,HOU,@,CHO,L 109-125,240,43,93,.462,38,67,.567,5,26,.192,18,28,.643,109
7881,2016-03-12,DAL,,IND,L 105-112,240,41,85,.482,33,63,.524,8,22,.364,15,18,.833,105
7882,2016-03-12,IND,@,DAL,W 112-105,240,38,81,.469,29,53,.547,9,28,.321,27,29,.931,112
7883,2016-03-12,DEN,,WAS,W 116-100,240,42,80,.525,34,56,.607,8,24,.333,24,29,.828,116
7884,2016-03-12,WAS,@,DEN,L 100-116,240,36,86,.419,29,65,.446,7,21,.333,21,29,.724,100
7885,2016-03-12,GSW,,PHO,W 123-116,240,42,84,.500,31,51,.608,11,33,.333,28,33,.848,123
7886,2016-03-12,PHO,@,GSW,L 116-123,240,45,92,.489,34,63,.540,11,29,.379,15,20,.750,116
7887,2016-03-12,MIL,,NOP,W 103-92,240,40,81,.494,36,68,.529,4,13,.308,19,24,.792,103
7888,2016-03-12,NOP,@,MIL,L 92-103,240,35,89,.393,29,60,.483,6,29,.207,16,21,.762,92
7889,2016-03-12,DET,@,PHI,W 125-111,240,49,91,.538,40,73,.548,9,18,.500,18,22,.818,125
7890,2016-03-12,PHI,,DET,L 111-125,240,39,84,.464,29,59,.492,10,25,.400,23,27,.852,111
7891,2016-03-12,ORL,@,POR,L 84-121,240,34,91,.374,27,65,.415,7,26,.269,9,18,.500,84
7892,2016-03-12,POR,,ORL,W 121-84,240,47,84,.560,30,49,.612,17,35,.486,10,11,.909,121
7893,2016-03-12,OKC,@,SAS,L 85-93,240,31,81,.383,29,63,.460,2,18,.111,21,25,.840,85
7894,2016-03-12,SAS,,OKC,W 93-85,240,34,85,.400,30,61,.492,4,24,.167,21,25,.840,93
7895,2016-03-12,MIA,@,TOR,L 104-112 (OT),265,37,98,.378,28,73,.384,9,25,.360,21,26,.808,104
7896,2016-03-12,TOR,,MIA,W 112-104 (OT),265,37,84,.440,31,66,.470,6,18,.333,32,38,.842,112
7897,2016-03-11,BOS,,HOU,L 98-102,240,34,91,.374,26,60,.433,8,31,.258,22,28,.786,98
7898,2016-03-11,HOU,@,BOS,W 102-98,240,40,88,.455,35,62,.565,5,26,.192,17,25,.680,102
7899,2016-03-11,CHI,,MIA,L 96-118,240,38,81,.469,30,60,.500,8,21,.381,12,15,.800,96
7900,2016-03-11,MIA,@,CHI,W 118-96,240,47,91,.516,37,73,.507,10,18,.556,14,20,.700,118
7901,2016-03-11,CHA,,DET,W 118-103,240,42,83,.506,32,58,.552,10,25,.400,24,29,.828,118
7902,2016-03-11,DET,@,CHO,L 103-118,240,36,76,.474,27,46,.587,9,30,.300,22,27,.815,103
7903,2016-03-11,GSW,,POR,W 128-112,240,40,89,.449,22,49,.449,18,40,.450,30,39,.769,128
7904,2016-03-11,POR,@,GSW,L 112-128,240,37,86,.430,18,50,.360,19,36,.528,19,23,.826,112
7905,2016-03-11,LAC,,NYK,W 101-94,240,38,85,.447,25,56,.446,13,29,.448,12,16,.750,101
7906,2016-03-11,NYK,@,LAC,L 94-101,240,34,83,.410,30,63,.476,4,20,.200,22,25,.880,94
7907,2016-03-11,MEM,,NOP,W 121-114 (OT),265,47,96,.490,41,82,.500,6,14,.429,21,32,.656,121
7908,2016-03-11,NOP,@,MEM,L 114-121 (OT),265,42,96,.438,35,72,.486,7,24,.292,23,34,.676,114
7909,2016-03-11,MIN,@,OKC,W 99-96,240,37,86,.430,30,65,.462,7,21,.333,18,21,.857,99
7910,2016-03-11,OKC,,MIN,L 96-99,240,36,84,.429,30,57,.526,6,27,.222,18,25,.720,96
7911,2016-03-11,BRK,@,PHI,L 89-95,240,33,87,.379,28,70,.400,5,17,.294,18,22,.818,89
7912,2016-03-11,PHI,,BRK,W 95-89,240,38,84,.452,29,56,.518,9,28,.321,10,15,.667,95
7913,2016-03-11,ORL,@,SAC,W 107-100,240,41,79,.519,37,64,.578,4,15,.267,21,34,.618,107
7914,2016-03-11,SAC,,ORL,L 100-107,240,35,88,.398,27,63,.429,8,25,.320,22,25,.880,100
7915,2016-03-11,UTA,,WAS,W 114-93,240,38,67,.567,29,51,.569,9,16,.563,29,38,.763,114
7916,2016-03-11,WAS,@,UTA,L 93-114,240,35,80,.438,28,56,.500,7,24,.292,16,22,.727,93
7917,2016-03-10,DEN,,PHO,W 116-98,240,44,91,.484,31,63,.492,13,28,.464,15,19,.789,116
7918,2016-03-10,PHO,@,DEN,L 98-116,240,33,89,.371,27,61,.443,6,28,.214,26,33,.788,98
7919,2016-03-10,CLE,@,LAL,W 120-108,240,45,85,.529,29,50,.580,16,35,.457,14,20,.700,120
7920,2016-03-10,LAL,,CLE,L 108-120,240,42,80,.525,35,58,.603,7,22,.318,17,21,.810,108
7921,2016-03-10,CHI,@,SAS,L 101-109,240,39,86,.453,28,64,.438,11,22,.500,12,13,.923,101
7922,2016-03-10,SAS,,CHI,W 109-101,240,44,93,.473,38,76,.500,6,17,.353,15,19,.789,109
7923,2016-03-10,ATL,@,TOR,L 96-104,240,35,82,.427,28,59,.475,7,23,.304,19,27,.704,96
7924,2016-03-10,TOR,,ATL,W 104-96,240,38,82,.463,31,58,.534,7,24,.292,21,29,.724,104
7925,2016-03-09,BOS,,MEM,W 116-96,240,41,87,.471,26,55,.473,15,32,.469,19,24,.792,116
7926,2016-03-09,MEM,@,BOS,L 96-116,240,32,84,.381,25,58,.431,7,26,.269,25,31,.806,96
7927,2016-03-09,CHA,,NOP,W 122-113,240,38,82,.463,23,47,.489,15,35,.429,31,38,.816,122
7928,2016-03-09,NOP,@,CHO,L 113-122,240,40,85,.471,30,52,.577,10,33,.303,23,28,.821,113
7929,2016-03-09,DAL,,DET,L 96-102,240,39,86,.453,30,56,.536,9,30,.300,9,11,.818,96
7930,2016-03-09,DET,@,DAL,W 102-96,240,38,85,.447,29,58,.500,9,27,.333,17,30,.567,102
7931,2016-03-09,GSW,,UTA,W 115-94,240,48,84,.571,35,54,.648,13,30,.433,6,10,.600,115
7932,2016-03-09,UTA,@,GSW,L 94-115,240,32,79,.405,24,59,.407,8,20,.400,22,31,.710,94
7933,2016-03-09,MIA,@,MIL,L 108-114,240,42,80,.525,36,65,.554,6,15,.400,18,19,.947,108
7934,2016-03-09,MIL,,MIA,W 114-108,240,42,80,.525,38,72,.528,4,8,.500,26,37,.703,114
7935,2016-03-09,LAC,@,OKC,L 108-120,240,41,81,.506,29,47,.617,12,34,.353,14,23,.609,108
7936,2016-03-09,OKC,,LAC,W 120-108,240,48,91,.527,39,67,.582,9,24,.375,15,18,.833,120
7937,2016-03-09,HOU,@,PHI,W 118-104,240,38,86,.442,27,53,.509,11,33,.333,31,41,.756,118
7938,2016-03-09,PHI,,HOU,L 104-118,240,35,86,.407,23,53,.434,12,33,.364,22,32,.688,104
7939,2016-03-09,NYK,@,PHO,W 128-97,240,46,82,.561,30,58,.517,16,24,.667,20,24,.833,128
7940,2016-03-09,PHO,,NYK,L 97-128,240,39,89,.438,30,60,.500,9,29,.310,10,15,.667,97
7941,2016-03-09,CLE,@,SAC,W 120-111,240,39,90,.433,26,46,.565,13,44,.295,29,35,.829,120
7942,2016-03-09,SAC,,CLE,L 111-120,240,40,84,.476,32,62,.516,8,22,.364,23,32,.719,111
7943,2016-03-08,DEN,,NYK,W 110-94,240,45,99,.455,39,78,.500,6,21,.286,14,19,.737,110
7944,2016-03-08,NYK,@,DEN,L 94-110,240,33,75,.440,27,57,.474,6,18,.333,22,26,.846,94
7945,2016-03-08,LAL,,ORL,W 107-98,240,40,81,.494,31,54,.574,9,27,.333,18,23,.783,107
7946,2016-03-08,ORL,@,LAL,L 98-107,240,37,76,.487,32,57,.561,5,19,.263,19,27,.704,98
7947,2016-03-08,MIN,,SAS,L 91-116,240,36,79,.456,32,64,.500,4,15,.267,15,19,.789,91
7948,2016-03-08,SAS,@,MIN,W 116-91,240,47,85,.553,43,66,.652,4,19,.211,18,19,.947,116
7949,2016-03-08,POR,,WAS,W 116-109 (OT),265,41,89,.461,31,65,.477,10,24,.417,24,31,.774,116
7950,2016-03-08,WAS,@,POR,L 109-116 (OT),265,45,99,.455,37,79,.468,8,20,.400,11,23,.478,109
7951,2016-03-08,BRK,@,TOR,L 99-104,240,42,82,.512,36,70,.514,6,12,.500,9,9,1.000,99
7952,2016-03-08,TOR,,BRK,W 104-99,240,37,78,.474,27,55,.491,10,23,.435,20,25,.800,104
7953,2016-03-08,ATL,@,UTA,W 91-84,240,38,80,.475,30,55,.545,8,25,.320,7,14,.500,91
7954,2016-03-08,UTA,,ATL,L 84-91,240,30,86,.349,23,60,.383,7,26,.269,17,23,.739,84
7955,2016-03-07,CHI,,MIL,W 100-90,240,39,78,.500,29,53,.547,10,25,.400,12,15,.800,100
7956,2016-03-07,MIL,@,CHI,L 90-100,240,36,91,.396,29,73,.397,7,18,.389,11,17,.647,90
7957,2016-03-07,CHA,,MIN,W 108-103,240,41,90,.456,29,60,.483,12,30,.400,14,17,.824,108
7958,2016-03-07,MIN,@,CHO,L 103-108,240,39,80,.488,35,65,.538,4,15,.267,21,24,.875,103
7959,2016-03-07,CLE,,MEM,L 103-106,240,36,80,.450,29,51,.569,7,29,.241,24,29,.828,103
7960,2016-03-07,MEM,@,CLE,W 106-103,240,41,86,.477,35,66,.530,6,20,.300,18,22,.818,106
7961,2016-03-07,DAL,,LAC,L 90-109,240,30,81,.370,26,56,.464,4,25,.160,26,32,.813,90
7962,2016-03-07,LAC,@,DAL,W 109-90,240,39,83,.470,27,51,.529,12,32,.375,19,29,.655,109
7963,2016-03-07,GSW,,ORL,W 119-113,240,42,84,.500,26,49,.531,16,35,.457,19,27,.704,119
7964,2016-03-07,ORL,@,GSW,L 113-119,240,40,90,.444,35,69,.507,5,21,.238,28,34,.824,113
7965,2016-03-07,IND,,SAS,W 99-91,240,32,78,.410,25,62,.403,7,16,.438,28,30,.933,99
7966,2016-03-07,SAS,@,IND,L 91-99,240,34,96,.354,30,68,.441,4,28,.143,19,22,.864,91
7967,2016-03-07,NOP,,SAC,W 115-112,240,45,94,.479,38,69,.551,7,25,.280,18,26,.692,115
7968,2016-03-07,SAC,@,NOP,L 112-115,240,41,83,.494,34,58,.586,7,25,.280,23,27,.852,112
7969,2016-03-06,DAL,@,DEN,L 114-116 (OT),265,41,93,.441,25,52,.481,16,41,.390,16,20,.800,114
7970,2016-03-06,DEN,,DAL,W 116-114 (OT),265,44,107,.411,35,81,.432,9,26,.346,19,25,.760,116
7971,2016-03-06,DET,,POR,W 123-103,240,44,84,.524,32,62,.516,12,22,.545,23,28,.821,123
7972,2016-03-06,POR,@,DET,L 103-123,240,35,78,.449,24,47,.511,11,31,.355,22,23,.957,103
7973,2016-03-06,GSW,@,LAL,L 95-112,240,37,92,.402,33,62,.532,4,30,.133,17,21,.810,95
7974,2016-03-06,LAL,,GSW,W 112-95,240,41,87,.471,32,62,.516,9,25,.360,21,22,.955,112
7975,2016-03-06,MEM,,PHO,L 100-109,240,32,80,.400,22,58,.379,10,22,.455,26,33,.788,100
7976,2016-03-06,PHO,@,MEM,W 109-100,240,37,71,.521,25,43,.581,12,28,.429,23,30,.767,109
7977,2016-03-06,MIA,,PHI,W 103-98,240,36,81,.444,28,67,.418,8,14,.571,23,30,.767,103
7978,2016-03-06,PHI,@,MIA,L 98-103,240,37,85,.435,26,54,.481,11,31,.355,13,22,.591,98
7979,2016-03-06,MIL,,OKC,L 96-104,240,34,90,.378,31,71,.437,3,19,.158,25,30,.833,96
7980,2016-03-06,OKC,@,MIL,W 104-96,240,32,76,.421,25,51,.490,7,25,.280,33,43,.767,104
7981,2016-03-06,HOU,@,TOR,W 113-107,240,38,78,.487,25,49,.510,13,29,.448,24,37,.649,113
7982,2016-03-06,TOR,,HOU,L 107-113,240,37,77,.481,25,44,.568,12,33,.364,21,27,.778,107
7983,2016-03-05,CHI,,HOU,W 108-100,240,36,79,.456,27,58,.466,9,21,.429,27,34,.794,108
7984,2016-03-05,HOU,@,CHI,L 100-108,240,35,87,.402,26,52,.500,9,35,.257,21,30,.700,100
7985,2016-03-05,BOS,@,CLE,L 103-120,240,37,80,.463,27,57,.474,10,23,.435,19,27,.704,103
7986,2016-03-05,CLE,,BOS,W 120-103,240,42,82,.512,32,52,.615,10,30,.333,26,34,.765,120
7987,2016-03-05,ATL,@,LAC,W 107-97,240,40,89,.449,30,62,.484,10,27,.370,17,20,.850,107
7988,2016-03-05,LAC,,ATL,L 97-107,240,34,79,.430,22,47,.468,12,32,.375,17,28,.607,97
7989,2016-03-05,BRK,@,MIN,L 118-132,240,45,92,.489,36,66,.545,9,26,.346,19,26,.731,118
7990,2016-03-05,MIN,,BRK,W 132-118,240,52,76,.684,42,58,.724,10,18,.556,18,22,.818,132
7991,2016-03-05,NOP,,UTA,L 94-106,240,38,92,.413,29,73,.397,9,19,.474,9,11,.818,94
7992,2016-03-05,UTA,@,NOP,W 106-94,240,37,78,.474,31,58,.534,6,20,.300,26,27,.963,106
7993,2016-03-05,DET,@,NYK,L 89-102,240,36,92,.391,30,66,.455,6,26,.231,11,15,.733,89
7994,2016-03-05,NYK,,DET,W 102-89,240,42,79,.532,38,63,.603,4,16,.250,14,18,.778,102
7995,2016-03-05,SAC,@,SAS,L 94-104,240,37,81,.457,31,65,.477,6,16,.375,14,21,.667,94
7996,2016-03-05,SAS,,SAC,W 104-94,240,40,81,.494,32,58,.552,8,23,.348,16,19,.842,104
7997,2016-03-05,IND,@,WAS,W 100-99,240,37,83,.446,30,62,.484,7,21,.333,19,20,.950,100
7998,2016-03-05,WAS,,IND,L 99-100,240,39,89,.438,33,74,.446,6,15,.400,15,24,.625,99
7999,2016-03-04,BOS,,NYK,W 105-104,240,41,90,.456,37,70,.529,4,20,.200,19,25,.760,105
8000,2016-03-04,NYK,@,BOS,L 104-105,240,42,92,.457,33,69,.478,9,23,.391,11,14,.786,104
8001,2016-03-04,CHA,,IND,W 108-101,240,38,79,.481,25,48,.521,13,31,.419,19,23,.826,108
8002,2016-03-04,IND,@,CHO,L 101-108,240,37,90,.411,28,62,.452,9,28,.321,18,21,.857,101
8003,2016-03-04,CLE,,WAS,W 108-83,240,42,90,.467,30,63,.476,12,27,.444,12,16,.750,108
8004,2016-03-04,WAS,@,CLE,L 83-108,240,32,81,.395,29,61,.475,3,20,.150,16,24,.667,83
8005,2016-03-04,BRK,@,DEN,W 121-120 (OT),265,46,91,.505,33,69,.478,13,22,.591,16,21,.762,121
8006,2016-03-04,DEN,,BRK,L 120-121 (OT),265,46,96,.479,40,70,.571,6,26,.231,22,25,.880,120
8007,2016-03-04,ATL,@,LAL,W 106-77,240,37,68,.544,24,40,.600,13,28,.464,19,26,.731,106
8008,2016-03-04,LAL,,ATL,L 77-106,240,29,85,.341,24,58,.414,5,27,.185,14,20,.700,77
8009,2016-03-04,MEM,,UTA,W 94-88,240,37,81,.457,33,63,.524,4,18,.222,16,19,.842,94
8010,2016-03-04,UTA,@,MEM,L 88-94,240,32,75,.427,27,56,.482,5,19,.263,19,29,.655,88
8011,2016-03-04,MIL,,MIN,W 116-101,240,43,83,.518,29,59,.492,14,24,.583,16,20,.800,116
8012,2016-03-04,MIN,@,MIL,L 101-116,240,42,87,.483,35,65,.538,7,22,.318,10,14,.714,101
8013,2016-03-04,ORL,,PHO,L 84-102,240,35,101,.347,28,74,.378,7,27,.259,7,14,.500,84
8014,2016-03-04,PHO,@,ORL,W 102-84,240,35,78,.449,30,64,.469,5,14,.357,27,39,.692,102
8015,2016-03-04,MIA,@,PHI,W 112-102,240,39,88,.443,34,72,.472,5,16,.313,29,36,.806,112
8016,2016-03-04,PHI,,MIA,L 102-112,240,36,95,.379,27,64,.422,9,31,.290,21,27,.778,102
8017,2016-03-04,POR,@,TOR,L 115-117,240,39,83,.470,28,56,.500,11,27,.407,26,35,.743,115
8018,2016-03-04,TOR,,POR,W 117-115,240,34,67,.507,28,55,.509,6,12,.500,43,54,.796,117
8019,2016-03-03,DAL,,SAC,L 101-104,240,45,94,.479,38,65,.585,7,29,.241,4,6,.667,101
8020,2016-03-03,SAC,@,DAL,W 104-101,240,42,80,.525,35,55,.636,7,25,.280,13,24,.542,104
8021,2016-03-03,GSW,,OKC,W 121-106,240,47,87,.540,36,53,.679,11,34,.324,16,21,.762,121
8022,2016-03-03,OKC,@,GSW,L 106-121,240,40,86,.465,36,66,.545,4,20,.200,22,27,.815,106
8023,2016-03-03,MIA,,PHO,W 108-92,240,40,83,.482,31,66,.470,9,17,.529,19,25,.760,108
8024,2016-03-03,PHO,@,MIA,L 92-108,240,33,82,.402,28,60,.467,5,22,.227,21,27,.778,92
8025,2016-03-03,NOP,,SAS,L 86-94,240,35,89,.393,27,65,.415,8,24,.333,8,8,1.000,86
8026,2016-03-03,SAS,@,NOP,W 94-86,240,36,81,.444,28,60,.467,8,21,.381,14,15,.933,94
8027,2016-03-02,BOS,,POR,W 116-93,240,43,107,.402,36,81,.444,7,26,.269,23,24,.958,116
8028,2016-03-02,POR,@,BOS,L 93-116,240,34,84,.405,23,55,.418,11,29,.379,14,20,.700,93
8029,2016-03-02,DEN,,LAL,W 117-107,240,38,78,.487,26,55,.473,12,23,.522,29,38,.763,117
8030,2016-03-02,LAL,@,DEN,L 107-117,240,35,79,.443,24,48,.500,11,31,.355,26,32,.813,107
8031,2016-03-02,HOU,,NOP,W 100-95,240,36,81,.444,33,46,.717,3,35,.086,25,38,.658,100
8032,2016-03-02,NOP,@,HOU,L 95-100,240,36,90,.400,22,53,.415,14,37,.378,9,13,.692,95
8033,2016-03-02,LAC,,OKC,W 103-98,240,40,98,.408,31,66,.470,9,32,.281,14,21,.667,103
8034,2016-03-02,OKC,@,LAC,L 98-103,240,39,98,.398,29,63,.460,10,35,.286,10,11,.909,98
8035,2016-03-02,MEM,,SAC,W 104-98,240,35,79,.443,30,61,.492,5,18,.278,29,33,.879,104
8036,2016-03-02,SAC,@,MEM,L 98-104,240,39,82,.476,30,56,.536,9,26,.346,11,20,.550,98
8037,2016-03-02,IND,@,MIL,W 104-99,240,38,80,.475,28,60,.467,10,20,.500,18,26,.692,104
8038,2016-03-02,MIL,,IND,L 99-104,240,34,76,.447,31,62,.500,3,14,.214,28,32,.875,99
8039,2016-03-02,MIN,,WAS,L 98-104,240,32,75,.427,27,61,.443,5,14,.357,29,34,.853,98
8040,2016-03-02,WAS,@,MIN,W 104-98,240,42,84,.500,31,55,.564,11,29,.379,9,13,.692,104
8041,2016-03-02,CHI,@,ORL,L 89-102,240,38,99,.384,32,80,.400,6,19,.316,7,11,.636,89
8042,2016-03-02,ORL,,CHI,W 102-89,240,39,97,.402,32,76,.421,7,21,.333,17,22,.773,102
8043,2016-03-02,CHA,@,PHI,W 119-99,240,40,81,.494,30,56,.536,10,25,.400,29,35,.829,119
8044,2016-03-02,PHI,,CHO,L 99-119,240,34,85,.400,21,52,.404,13,33,.394,18,26,.692,99
8045,2016-03-02,DET,@,SAS,L 81-97,240,31,78,.397,25,59,.424,6,19,.316,13,23,.565,81
8046,2016-03-02,SAS,,DET,W 97-81,240,43,84,.512,40,70,.571,3,14,.214,8,9,.889,97
8047,2016-03-02,TOR,,UTA,W 104-94,240,40,80,.500,34,58,.586,6,22,.273,18,21,.857,104
8048,2016-03-02,UTA,@,TOR,L 94-104,240,37,83,.446,27,57,.474,10,26,.385,10,16,.625,94
8049,2016-03-01,CHA,,PHO,W 126-92,240,45,93,.484,32,66,.485,13,27,.481,23,27,.852,126
8050,2016-03-01,PHO,@,CHO,L 92-126,240,33,91,.363,27,64,.422,6,27,.222,20,27,.741,92
8051,2016-03-01,DAL,,ORL,W 121-108,240,43,77,.558,34,58,.586,9,19,.474,26,31,.839,121
8052,2016-03-01,ORL,@,DAL,L 108-121,240,41,91,.451,32,61,.525,9,30,.300,17,20,.850,108
8053,2016-03-01,ATL,@,GSW,L 105-109 (OT),265,37,80,.463,25,47,.532,12,33,.364,19,24,.792,105
8054,2016-03-01,GSW,,ATL,W 109-105 (OT),265,41,103,.398,29,67,.433,12,36,.333,15,17,.882,109
8055,2016-03-01,BRK,@,LAL,L 101-107,240,39,89,.438,34,71,.479,5,18,.278,18,27,.667,101
8056,2016-03-01,LAL,,BRK,W 107-101,240,41,83,.494,30,57,.526,11,26,.423,14,21,.667,107
8057,2016-03-01,CHI,@,MIA,L 111-129,240,41,90,.456,30,67,.448,11,23,.478,18,26,.692,111
8058,2016-03-01,MIA,,CHI,W 129-111,240,52,77,.675,46,65,.708,6,12,.500,19,25,.760,129
8059,2016-03-01,NYK,,POR,L 85-104,240,33,88,.375,27,67,.403,6,21,.286,13,18,.722,85
8060,2016-03-01,POR,@,NYK,W 104-85,240,37,88,.420,25,58,.431,12,30,.400,18,20,.900,104
8061,2016-02-29,BOS,,UTA,W 100-95,240,37,84,.440,31,66,.470,6,18,.333,20,29,.690,100
8062,2016-02-29,UTA,@,BOS,L 95-100,240,38,101,.376,31,77,.403,7,24,.292,12,17,.706,95
8063,2016-02-29,CLE,,IND,W 100-96,240,35,83,.422,26,54,.481,9,29,.310,21,25,.840,100
8064,2016-02-29,IND,@,CLE,L 96-100,240,37,80,.463,29,62,.468,8,18,.444,14,15,.933,96
8065,2016-02-29,DEN,,MEM,L 96-103,240,40,75,.533,32,50,.640,8,25,.320,8,10,.800,96
8066,2016-02-29,MEM,@,DEN,W 103-96,240,36,75,.480,33,55,.600,3,20,.150,28,36,.778,103
8067,2016-02-29,BRK,@,LAC,L 95-105,240,32,77,.416,24,58,.414,8,19,.421,23,33,.697,95
8068,2016-02-29,LAC,,BRK,W 105-95,240,41,83,.494,32,60,.533,9,23,.391,14,16,.875,105
8069,2016-02-29,HOU,@,MIL,L 121-128,240,41,87,.471,26,51,.510,15,36,.417,24,35,.686,121
8070,2016-02-29,MIL,,HOU,W 128-121,240,48,81,.593,40,66,.606,8,15,.533,24,33,.727,128
8071,2016-02-29,OKC,@,SAC,W 131-116,240,47,82,.573,33,48,.688,14,34,.412,23,26,.885,131
8072,2016-02-29,SAC,,OKC,L 116-131,240,48,107,.449,41,82,.500,7,25,.280,13,19,.684,116
8073,2016-02-29,PHI,@,WAS,L 108-116,240,43,89,.483,33,57,.579,10,32,.313,12,21,.571,108
8074,2016-02-29,WAS,,PHI,W 116-108,240,43,89,.483,37,69,.536,6,20,.300,24,31,.774,116
8075,2016-02-28,ATL,,CHO,W 87-76,240,38,77,.494,30,60,.500,8,17,.471,3,5,.600,87
8076,2016-02-28,CHA,@,ATL,L 76-87,240,27,81,.333,20,49,.408,7,32,.219,15,23,.652,76
8077,2016-02-28,DAL,,MIN,W 128-101,240,47,89,.528,34,53,.642,13,36,.361,21,21,1.000,128
8078,2016-02-28,MIN,@,DAL,L 101-128,240,34,90,.378,27,67,.403,7,23,.304,26,37,.703,101
8079,2016-02-28,DET,,TOR,W 114-101,240,41,71,.577,29,48,.604,12,23,.522,20,27,.741,114
8080,2016-02-28,TOR,@,DET,L 101-114,240,39,80,.488,29,59,.492,10,21,.476,13,18,.722,101
8081,2016-02-28,IND,,POR,L 102-111,240,40,93,.430,37,79,.468,3,14,.214,19,25,.760,102
8082,2016-02-28,POR,@,IND,W 111-102,240,41,81,.506,27,57,.474,14,24,.583,15,21,.714,111
8083,2016-02-28,MIA,@,NYK,W 98-81,240,40,84,.476,39,76,.513,1,8,.125,17,21,.810,98
8084,2016-02-28,NYK,,MIA,L 81-98,240,32,87,.368,26,72,.361,6,15,.400,11,12,.917,81
8085,2016-02-28,ORL,,PHI,W 130-116,240,49,86,.570,39,70,.557,10,16,.625,22,25,.880,130
8086,2016-02-28,PHI,@,ORL,L 116-130,240,41,77,.532,36,55,.655,5,22,.227,29,37,.784,116
8087,2016-02-28,CLE,@,WAS,L 99-113,240,32,80,.400,23,51,.451,9,29,.310,26,30,.867,99
8088,2016-02-28,WAS,,CLE,W 113-99,240,39,79,.494,28,48,.583,11,31,.355,24,34,.706,113
8089,2016-02-27,BOS,,MIA,W 101-89,240,39,96,.406,34,80,.425,5,16,.313,18,22,.818,101
8090,2016-02-27,MIA,@,BOS,L 89-101,240,36,87,.414,35,74,.473,1,13,.077,16,23,.696,89
8091,2016-02-27,CHI,,POR,L 95-103,240,39,94,.415,32,72,.444,7,22,.318,10,12,.833,95
8092,2016-02-27,POR,@,CHI,W 103-95,240,38,87,.437,33,66,.500,5,21,.238,22,27,.815,103
8093,2016-02-27,HOU,,SAS,L 94-104,240,35,84,.417,27,59,.458,8,25,.320,16,22,.727,94
8094,2016-02-27,SAS,@,HOU,W 104-94,240,37,76,.487,29,57,.509,8,19,.421,22,28,.786,104
8095,2016-02-27,DET,@,MIL,W 102-91,240,37,88,.420,25,58,.431,12,30,.400,16,24,.667,102
8096,2016-02-27,MIL,,DET,L 91-102,240,38,78,.487,31,66,.470,7,12,.583,8,12,.667,91
8097,2016-02-27,MIN,@,NOP,W 112-110,240,42,84,.500,37,69,.536,5,15,.333,23,30,.767,112
8098,2016-02-27,NOP,,MIN,L 110-112,240,39,84,.464,29,57,.509,10,27,.370,22,26,.846,110
8099,2016-02-27,GSW,@,OKC,W 121-118 (OT),265,45,95,.474,31,63,.492,14,32,.438,17,25,.680,121
8100,2016-02-27,OKC,,GSW,L 118-121 (OT),265,46,96,.479,37,70,.529,9,26,.346,17,26,.654,118
8101,2016-02-27,MEM,@,PHO,L 106-111,240,32,80,.400,26,60,.433,6,20,.300,36,42,.857,106
8102,2016-02-27,PHO,,MEM,W 111-106,240,37,80,.463,25,48,.521,12,32,.375,25,35,.714,111
8103,2016-02-27,BRK,@,UTA,W 98-96,240,40,84,.476,33,69,.478,7,15,.467,11,17,.647,98
8104,2016-02-27,UTA,,BRK,L 96-98,240,37,89,.416,32,69,.464,5,20,.250,17,25,.680,96
8105,2016-02-26,ATL,,CHI,W 103-88,240,37,89,.416,30,55,.545,7,34,.206,22,24,.917,103
8106,2016-02-26,CHI,@,ATL,L 88-103,240,32,88,.364,27,68,.397,5,20,.250,19,22,.864,88
8107,2016-02-26,DAL,,DEN,W 122-116 (OT),265,45,88,.511,34,59,.576,11,29,.379,21,27,.778,122
8108,2016-02-26,DEN,@,DAL,L 116-122 (OT),265,43,93,.462,34,64,.531,9,29,.310,21,31,.677,116
8109,2016-02-26,CHA,@,IND,W 96-95,240,36,83,.434,25,55,.455,11,28,.393,13,19,.684,96
8110,2016-02-26,IND,,CHO,L 95-96,240,35,85,.412,31,66,.470,4,19,.211,21,24,.875,95
8111,2016-02-26,LAL,,MEM,L 95-112,240,32,78,.410,27,55,.491,5,23,.217,26,39,.667,95
8112,2016-02-26,MEM,@,LAL,W 112-95,240,43,85,.506,30,53,.566,13,32,.406,13,15,.867,112
8113,2016-02-26,NYK,,ORL,W 108-95,240,37,80,.463,33,64,.516,4,16,.250,30,36,.833,108
8114,2016-02-26,ORL,@,NYK,L 95-108,240,39,93,.419,33,66,.500,6,27,.222,11,16,.688,95
8115,2016-02-26,PHI,,WAS,L 94-103,240,35,82,.427,27,57,.474,8,25,.320,16,21,.762,94
8116,2016-02-26,WAS,@,PHI,W 103-94,240,40,94,.426,33,71,.465,7,23,.304,16,17,.941,103
8117,2016-02-26,LAC,@,SAC,W 117-107,240,43,89,.483,34,60,.567,9,29,.310,22,26,.846,117
8118,2016-02-26,SAC,,LAC,L 107-117,240,34,78,.436,22,54,.407,12,24,.500,27,37,.730,107
8119,2016-02-26,CLE,@,TOR,L 97-99,240,35,74,.473,23,50,.460,12,24,.500,15,21,.714,97
8120,2016-02-26,TOR,,CLE,W 99-97,240,37,73,.507,31,56,.554,6,17,.353,19,26,.731,99
8121,2016-02-25,BOS,,MIL,W 112-107,240,41,84,.488,36,61,.590,5,23,.217,25,33,.758,112
8122,2016-02-25,MIL,@,BOS,L 107-112,240,42,87,.483,38,72,.528,4,15,.267,19,25,.760,107
8123,2016-02-25,NOP,,OKC,W 123-119,240,47,90,.522,35,70,.500,12,20,.600,17,18,.944,123
8124,2016-02-25,OKC,@,NOP,L 119-123,240,47,86,.547,39,67,.582,8,19,.421,17,22,.773,119
8125,2016-02-25,GSW,@,ORL,W 130-114,240,53,88,.602,40,63,.635,13,25,.520,11,16,.688,130
8126,2016-02-25,ORL,,GSW,L 114-130,240,41,90,.456,31,64,.484,10,26,.385,22,28,.786,114
8127,2016-02-25,BRK,@,PHO,W 116-106,240,37,75,.493,29,57,.509,8,18,.444,34,42,.810,116
8128,2016-02-25,PHO,,BRK,L 106-116,240,42,98,.429,33,71,.465,9,27,.333,13,23,.565,106
8129,2016-02-25,HOU,@,POR,W 119-105,240,44,82,.537,34,53,.642,10,29,.345,21,35,.600,119
8130,2016-02-25,POR,,HOU,L 105-119,240,37,80,.463,24,45,.533,13,35,.371,18,22,.818,105
8131,2016-02-25,SAS,@,UTA,W 96-78,240,38,79,.481,29,61,.475,9,18,.500,11,12,.917,96
8132,2016-02-25,UTA,,SAS,L 78-96,240,33,77,.429,30,60,.500,3,17,.176,9,12,.750,78
8133,2016-02-24,CHI,,WAS,W 109-104,240,44,88,.500,36,65,.554,8,23,.348,13,16,.813,109
8134,2016-02-24,WAS,@,CHI,L 104-109,240,38,90,.422,29,62,.468,9,28,.321,19,26,.731,104
8135,2016-02-24,CHA,@,CLE,L 103-114,240,37,76,.487,27,47,.574,10,29,.345,19,27,.704,103
8136,2016-02-24,CLE,,CHO,W 114-103,240,45,91,.495,32,59,.542,13,32,.406,11,17,.647,114
8137,2016-02-24,DAL,,OKC,L 103-116,240,35,86,.407,26,58,.448,9,28,.321,24,30,.800,103
8138,2016-02-24,OKC,@,DAL,W 116-103,240,43,89,.483,31,56,.554,12,33,.364,18,22,.818,116
8139,2016-02-24,DET,,PHI,W 111-91,240,39,83,.470,28,55,.509,11,28,.393,22,34,.647,111
8140,2016-02-24,PHI,@,DET,L 91-111,240,33,83,.398,26,60,.433,7,23,.304,18,26,.692,91
8141,2016-02-24,IND,,NYK,W 108-105,240,46,91,.505,43,76,.566,3,15,.200,13,16,.813,108
8142,2016-02-24,NYK,@,IND,L 105-108,240,35,77,.455,22,51,.431,13,26,.500,22,25,.880,105
8143,2016-02-24,DEN,@,LAC,W 87-81,240,34,90,.378,28,66,.424,6,24,.250,13,17,.765,87
8144,2016-02-24,LAC,,DEN,L 81-87,240,30,85,.353,17,39,.436,13,46,.283,8,14,.571,81
8145,2016-02-24,LAL,@,MEM,L 119-128,240,39,88,.443,22,49,.449,17,39,.436,24,33,.727,119
8146,2016-02-24,MEM,,LAL,W 128-119,240,48,85,.565,35,58,.603,13,27,.481,19,29,.655,128
8147,2016-02-24,GSW,@,MIA,W 118-112,240,42,90,.467,29,62,.468,13,28,.464,21,25,.840,118
8148,2016-02-24,MIA,,GSW,L 112-118,240,40,86,.465,34,72,.472,6,14,.429,26,31,.839,112
8149,2016-02-24,SAC,,SAS,L 92-108,240,39,96,.406,33,78,.423,6,18,.333,8,15,.533,92
8150,2016-02-24,SAS,@,SAC,W 108-92,240,44,85,.518,36,66,.545,8,19,.421,12,15,.800,108
8151,2016-02-24,MIN,@,TOR,L 105-114,240,37,74,.500,31,64,.484,6,10,.600,25,33,.758,105
8152,2016-02-24,TOR,,MIN,W 114-105,240,41,85,.482,31,59,.525,10,26,.385,22,26,.846,114
8153,2016-02-23,DEN,,SAC,L 110-114,240,41,100,.410,31,73,.425,10,27,.370,18,22,.818,110
8154,2016-02-23,SAC,@,DEN,W 114-110,240,43,83,.518,36,66,.545,7,17,.412,21,28,.750,114
8155,2016-02-23,ORL,@,PHI,W 124-115,240,41,85,.482,34,71,.479,7,14,.500,35,41,.854,124
8156,2016-02-23,PHI,,ORL,L 115-124,240,43,79,.544,33,58,.569,10,21,.476,19,26,.731,115
8157,2016-02-23,BRK,@,POR,L 104-112,240,43,90,.478,40,78,.513,3,12,.250,15,19,.789,104
8158,2016-02-23,POR,,BRK,W 112-104,240,40,80,.500,30,57,.526,10,23,.435,22,25,.880,112
8159,2016-02-23,HOU,@,UTA,L 114-117 (OT),265,36,87,.414,25,53,.472,11,34,.324,31,41,.756,114
8160,2016-02-23,UTA,,HOU,W 117-114 (OT),265,38,74,.514,28,50,.560,10,24,.417,31,38,.816,117
8161,2016-02-23,NOP,@,WAS,L 89-109,240,29,83,.349,23,60,.383,6,23,.261,25,33,.758,89
8162,2016-02-23,WAS,,NOP,W 109-89,240,43,94,.457,31,68,.456,12,26,.462,11,17,.647,109
8163,2016-02-22,ATL,,GSW,L 92-102,240,36,86,.419,26,52,.500,10,34,.294,10,16,.625,92
8164,2016-02-22,GSW,@,ATL,W 102-92,240,39,89,.438,25,44,.568,14,45,.311,10,12,.833,102
8165,2016-02-22,CLE,,DET,L 88-96,240,34,79,.430,26,53,.491,8,26,.308,12,13,.923,88
8166,2016-02-22,DET,@,CLE,W 96-88,240,37,80,.463,29,55,.527,8,25,.320,14,21,.667,96
8167,2016-02-22,LAC,,PHO,W 124-84,240,44,80,.550,31,56,.554,13,24,.542,23,35,.657,124
8168,2016-02-22,PHO,@,LAC,L 84-124,240,31,88,.352,24,64,.375,7,24,.292,15,20,.750,84
8169,2016-02-22,IND,@,MIA,L 93-101 (OT),265,36,92,.391,31,77,.403,5,15,.333,16,25,.640,93
8170,2016-02-22,MIA,,IND,W 101-93 (OT),265,38,100,.380,36,87,.414,2,13,.154,23,34,.676,101
8171,2016-02-22,LAL,@,MIL,L 101-108,240,28,76,.368,16,47,.340,12,29,.414,33,43,.767,101
8172,2016-02-22,MIL,,LAL,W 108-101,240,44,86,.512,39,70,.557,5,16,.313,15,25,.600,108
8173,2016-02-22,BOS,@,MIN,L 122-124,240,49,101,.485,39,73,.534,10,28,.357,14,17,.824,122
8174,2016-02-22,MIN,,BOS,W 124-122,240,43,83,.518,35,68,.515,8,15,.533,30,40,.750,124
8175,2016-02-22,NYK,,TOR,L 95-122,240,37,84,.440,31,64,.484,6,20,.300,15,23,.652,95
8176,2016-02-22,TOR,@,NYK,W 122-95,240,46,87,.529,35,62,.565,11,25,.440,19,25,.760,122
8177,2016-02-21,BRK,,CHO,L 96-104,240,35,81,.432,30,59,.508,5,22,.227,21,24,.875,96
8178,2016-02-21,CHA,@,BRK,W 104-96,240,40,79,.506,30,52,.577,10,27,.370,14,15,.933,104
8179,2016-02-21,CHI,,LAL,W 126-115,240,44,79,.557,31,60,.517,13,19,.684,25,26,.962,126
8180,2016-02-21,LAL,@,CHI,L 115-126,240,43,93,.462,36,72,.500,7,21,.333,22,33,.667,115
8181,2016-02-21,DAL,,PHI,W 129-103,240,41,85,.482,28,51,.549,13,34,.382,34,36,.944,129
8182,2016-02-21,PHI,@,DAL,L 103-129,240,37,77,.481,25,49,.510,12,28,.429,17,27,.630,103
8183,2016-02-21,BOS,@,DEN,W 121-101,240,47,97,.485,37,65,.569,10,32,.313,17,20,.850,121
8184,2016-02-21,DEN,,BOS,L 101-121,240,34,73,.466,28,52,.538,6,21,.286,27,34,.794,101
8185,2016-02-21,DET,,NOP,L 106-111,240,37,89,.416,25,56,.446,12,33,.364,20,32,.625,106
8186,2016-02-21,NOP,@,DET,W 111-106,240,41,86,.477,37,66,.561,4,20,.200,25,29,.862,111
8187,2016-02-21,CLE,@,OKC,W 115-92,240,41,80,.513,31,57,.544,10,23,.435,23,27,.852,115
8188,2016-02-21,OKC,,CLE,L 92-115,240,37,90,.411,32,69,.464,5,21,.238,13,19,.684,92
8189,2016-02-21,IND,@,ORL,W 105-102,240,41,82,.500,32,58,.552,9,24,.375,14,21,.667,105
8190,2016-02-21,ORL,,IND,L 102-105,240,38,91,.418,31,66,.470,7,25,.280,19,29,.655,102
8191,2016-02-21,PHO,,SAS,L 111-118,240,43,93,.462,34,69,.493,9,24,.375,16,22,.727,111
8192,2016-02-21,SAS,@,PHO,W 118-111,240,43,82,.524,33,66,.500,10,16,.625,22,34,.647,118
8193,2016-02-21,POR,,UTA,W 115-111,240,39,90,.433,27,58,.466,12,32,.375,25,38,.658,115
8194,2016-02-21,UTA,@,POR,L 111-115,240,43,86,.500,35,70,.500,8,16,.500,17,23,.739,111
8195,2016-02-21,MEM,@,TOR,L 85-98,240,28,76,.368,25,56,.446,3,20,.150,26,32,.813,85
8196,2016-02-21,TOR,,MEM,W 98-85,240,33,81,.407,26,53,.491,7,28,.250,25,31,.806,98
8197,2016-02-20,ATL,,MIL,L 109-117 (2OT),290,44,106,.415,35,65,.538,9,41,.220,12,18,.667,109
8198,2016-02-20,MIL,@,ATL,W 117-109 (2OT),290,46,104,.442,43,87,.494,3,17,.176,22,32,.688,117
8199,2016-02-20,GSW,@,LAC,W 115-112,240,42,82,.512,31,51,.608,11,31,.355,20,26,.769,115
8200,2016-02-20,LAC,,GSW,L 112-115,240,42,94,.447,29,58,.500,13,36,.361,15,18,.833,112
8201,2016-02-20,MIA,,WAS,W 114-94,240,47,96,.490,45,83,.542,2,13,.154,18,28,.643,114
8202,2016-02-20,WAS,@,MIA,L 94-114,240,40,99,.404,37,77,.481,3,22,.136,11,21,.524,94
8203,2016-02-20,MIN,,NYK,L 95-103,240,36,84,.429,31,72,.431,5,12,.417,18,25,.720,95
8204,2016-02-20,NYK,@,MIN,W 103-95,240,42,83,.506,37,66,.561,5,17,.294,14,16,.875,103
8205,2016-02-19,ATL,,MIA,L 111-115,240,41,87,.471,25,51,.490,16,36,.444,13,13,1.000,111
8206,2016-02-19,MIA,@,ATL,W 115-111,240,44,88,.500,36,68,.529,8,20,.400,19,28,.679,115
8207,2016-02-19,BRK,,NYK,W 109-98,240,42,86,.488,34,69,.493,8,17,.471,17,20,.850,109
8208,2016-02-19,NYK,@,BRK,L 98-109,240,36,82,.439,26,56,.464,10,26,.385,16,18,.889,98
8209,2016-02-19,CHI,,TOR,W 116-106,240,48,93,.516,41,77,.532,7,16,.438,13,20,.650,116
8210,2016-02-19,TOR,@,CHI,L 106-116,240,38,88,.432,33,70,.471,5,18,.278,25,34,.735,106
8211,2016-02-19,LAL,,SAS,L 113-119,240,40,81,.494,30,59,.508,10,22,.455,23,26,.885,113
8212,2016-02-19,SAS,@,LAL,W 119-113,240,48,88,.545,42,76,.553,6,12,.500,17,18,.944,119
8213,2016-02-19,MEM,,MIN,W 109-104,240,40,82,.488,33,61,.541,7,21,.333,22,28,.786,109
8214,2016-02-19,MIN,@,MEM,L 104-109,240,31,75,.413,20,49,.408,11,26,.423,31,31,1.000,104
8215,2016-02-19,CHA,@,MIL,W 98-95,240,37,86,.430,28,55,.509,9,31,.290,15,18,.833,98
8216,2016-02-19,MIL,,CHO,L 95-98,240,36,81,.444,29,62,.468,7,19,.368,16,21,.762,95
8217,2016-02-19,NOP,,PHI,W 121-114,240,41,81,.506,34,64,.531,7,17,.412,32,40,.800,121
8218,2016-02-19,PHI,@,NOP,L 114-121,240,40,76,.526,28,49,.571,12,27,.444,22,26,.846,114
8219,2016-02-19,IND,@,OKC,W 101-98,240,39,88,.443,30,66,.455,9,22,.409,14,22,.636,101
8220,2016-02-19,OKC,,IND,L 98-101,240,42,96,.438,37,70,.529,5,26,.192,9,10,.900,98
8221,2016-02-19,DAL,@,ORL,L 104-110 (OT),265,37,89,.416,18,48,.375,19,41,.463,11,18,.611,104
8222,2016-02-19,ORL,,DAL,W 110-104 (OT),265,41,102,.402,28,67,.418,13,35,.371,15,17,.882,110
8223,2016-02-19,HOU,@,PHO,W 116-100,240,37,78,.474,30,54,.556,7,24,.292,35,56,.625,116
8224,2016-02-19,PHO,,HOU,L 100-116,240,30,82,.366,19,47,.404,11,35,.314,29,35,.829,100
8225,2016-02-19,GSW,@,POR,L 105-137,240,36,92,.391,24,58,.414,12,34,.353,21,28,.750,105
8226,2016-02-19,POR,,GSW,W 137-105,240,52,97,.536,35,67,.522,17,30,.567,16,23,.696,137
8227,2016-02-19,DEN,@,SAC,L 110-116,240,42,90,.467,34,66,.515,8,24,.333,18,26,.692,110
8228,2016-02-19,SAC,,DEN,W 116-110,240,41,83,.494,31,62,.500,10,21,.476,24,31,.774,116
8229,2016-02-19,BOS,@,UTA,L 93-111,240,30,81,.370,23,56,.411,7,25,.280,26,36,.722,93
8230,2016-02-19,UTA,,BOS,W 111-93,240,37,68,.544,27,45,.600,10,23,.435,27,44,.614,111
8231,2016-02-19,DET,@,WAS,L 86-98,240,35,82,.427,28,59,.475,7,23,.304,9,17,.529,86
8232,2016-02-19,WAS,,DET,W 98-86,240,36,78,.462,29,56,.518,7,22,.318,19,26,.731,98
8233,2016-02-18,CHI,@,CLE,L 95-106,240,37,93,.398,29,72,.403,8,21,.381,13,22,.591,95
8234,2016-02-18,CLE,,CHI,W 106-95,240,42,91,.462,35,67,.522,7,24,.292,15,17,.882,106
8235,2016-02-18,LAC,,SAS,W 105-86,240,39,78,.500,27,53,.509,12,25,.480,15,20,.750,105
8236,2016-02-18,SAS,@,LAC,L 86-105,240,35,83,.422,31,66,.470,4,17,.235,12,15,.800,86
8237,2016-02-18,UTA,@,WAS,L 89-103,240,31,77,.403,27,62,.435,4,15,.267,23,29,.793,89
8238,2016-02-18,WAS,,UTA,W 103-89,240,42,86,.488,35,68,.515,7,18,.389,12,21,.571,103
8239,2016-02-11,MIL,,WAS,W 99-92,240,36,82,.439,32,68,.471,4,14,.286,23,32,.719,99
8240,2016-02-11,WAS,@,MIL,L 92-99,240,34,88,.386,28,56,.500,6,32,.188,18,24,.750,92
8241,2016-02-11,NOP,@,OKC,L 95-121,240,38,88,.432,35,72,.486,3,16,.188,16,24,.667,95
8242,2016-02-11,OKC,,NOP,W 121-95,240,45,86,.523,33,54,.611,12,32,.375,19,23,.826,121
8243,2016-02-10,BOS,,LAC,W 139-134 (OT),265,47,95,.495,34,62,.548,13,33,.394,32,37,.865,139
8244,2016-02-10,LAC,@,BOS,L 134-139 (OT),265,44,85,.518,32,55,.582,12,30,.400,34,50,.680,134
8245,2016-02-10,BRK,,MEM,L 90-109,240,33,71,.465,22,49,.449,11,22,.500,13,19,.684,90
8246,2016-02-10,MEM,@,BRK,W 109-90,240,45,86,.523,36,66,.545,9,20,.450,10,12,.833,109
8247,2016-02-10,ATL,@,CHI,W 113-90,240,43,90,.478,30,57,.526,13,33,.394,14,15,.933,113
8248,2016-02-10,CHI,,ATL,L 90-113,240,38,86,.442,33,72,.458,5,14,.357,9,12,.750,90
8249,2016-02-10,CLE,,LAL,W 120-111,240,48,94,.511,35,63,.556,13,31,.419,11,18,.611,120
8250,2016-02-10,LAL,@,CLE,L 111-120,240,38,86,.442,25,58,.431,13,28,.464,22,27,.815,111
8251,2016-02-10,DEN,@,DET,W 103-92,240,39,83,.470,33,64,.516,6,19,.316,19,24,.792,103
8252,2016-02-10,DET,,DEN,L 92-103,240,38,88,.432,28,61,.459,10,27,.370,6,7,.857,92
8253,2016-02-10,CHA,@,IND,W 117-95,240,45,87,.517,33,59,.559,12,28,.429,15,19,.789,117
8254,2016-02-10,IND,,CHO,L 95-117,240,40,92,.435,36,74,.486,4,18,.222,11,15,.733,95
8255,2016-02-10,MIN,,TOR,W 117-112,240,35,76,.461,31,62,.500,4,14,.286,43,53,.811,117
8256,2016-02-10,TOR,@,MIN,L 112-117,240,39,86,.453,29,55,.527,10,31,.323,24,32,.750,112
8257,2016-02-10,NOP,,UTA,W 100-96,240,39,82,.476,31,63,.492,8,19,.421,14,21,.667,100
8258,2016-02-10,UTA,@,NOP,L 96-100,240,33,70,.471,26,49,.531,7,21,.333,23,30,.767,96
8259,2016-02-10,ORL,,SAS,L 96-98,240,37,91,.407,29,71,.408,8,20,.400,14,16,.875,96
8260,2016-02-10,SAS,@,ORL,W 98-96,240,38,89,.427,30,69,.435,8,20,.400,14,15,.933,98
8261,2016-02-10,PHI,,SAC,L 110-114,240,42,91,.462,27,56,.482,15,35,.429,11,17,.647,110
8262,2016-02-10,SAC,@,PHI,W 114-110,240,44,87,.506,40,71,.563,4,16,.250,22,29,.759,114
8263,2016-02-10,GSW,@,PHO,W 112-104,240,37,89,.416,23,49,.469,14,40,.350,24,29,.828,112
8264,2016-02-10,PHO,,GSW,L 104-112,240,41,93,.441,35,72,.486,6,21,.286,16,22,.727,104
8265,2016-02-10,HOU,@,POR,L 103-116,240,37,77,.481,26,43,.605,11,34,.324,18,34,.529,103
8266,2016-02-10,POR,,HOU,W 116-103,240,41,89,.461,33,61,.541,8,28,.286,26,34,.765,116
8267,2016-02-09,DAL,,UTA,L 119-121 (OT),265,36,75,.480,25,46,.543,11,29,.379,36,41,.878,119
8268,2016-02-09,UTA,@,DAL,W 121-119 (OT),265,48,92,.522,42,66,.636,6,26,.231,19,27,.704,121
8269,2016-02-09,GSW,,HOU,W 123-110,240,44,94,.468,32,60,.533,12,34,.353,23,26,.885,123
8270,2016-02-09,HOU,@,GSW,L 110-123,240,37,87,.425,24,54,.444,13,33,.394,23,35,.657,110
8271,2016-02-09,MIA,,SAS,L 101-119,240,40,70,.571,36,58,.621,4,12,.333,17,24,.708,101
8272,2016-02-09,SAS,@,MIA,W 119-101,240,47,89,.528,41,75,.547,6,14,.429,19,26,.731,119
8273,2016-02-09,BOS,@,MIL,L 111-112,240,39,84,.464,29,55,.527,10,29,.345,23,24,.958,111
8274,2016-02-09,MIL,,BOS,W 112-111,240,45,88,.511,38,69,.551,7,19,.368,15,23,.652,112
8275,2016-02-09,NYK,,WAS,L 108-111,240,44,83,.530,36,57,.632,8,26,.308,12,14,.857,108
8276,2016-02-09,WAS,@,NYK,W 111-108,240,39,78,.500,23,52,.442,16,26,.615,17,25,.680,111
8277,2016-02-08,ATL,,ORL,L 110-117 (OT),265,43,92,.467,31,63,.492,12,29,.414,12,20,.600,110
8278,2016-02-08,ORL,@,ATL,W 117-110 (OT),265,46,93,.495,37,64,.578,9,29,.310,16,22,.727,117
8279,2016-02-08,BRK,,DEN,W 105-104,240,42,81,.519,33,62,.532,9,19,.474,12,15,.800,105
8280,2016-02-08,DEN,@,BRK,L 104-105,240,42,90,.467,33,65,.508,9,25,.360,11,13,.846,104
8281,2016-02-08,CHI,@,CHO,L 91-108,240,35,90,.389,25,65,.385,10,25,.400,11,14,.786,91
8282,2016-02-08,CHA,,CHI,W 108-91,240,35,80,.438,21,44,.477,14,36,.389,24,31,.774,108
8283,2016-02-08,CLE,,SAC,W 120-100,240,45,94,.479,29,59,.492,16,35,.457,14,19,.737,120
8284,2016-02-08,SAC,@,CLE,L 100-120,240,36,82,.439,27,59,.458,9,23,.391,19,29,.655,100
8285,2016-02-08,DET,,TOR,L 89-103,240,36,80,.450,28,52,.538,8,28,.286,9,17,.529,89
8286,2016-02-08,TOR,@,DET,W 103-89,240,39,70,.557,28,50,.560,11,20,.550,14,17,.824,103
8287,2016-02-08,IND,,LAL,W 89-87,240,31,78,.397,27,51,.529,4,27,.148,23,33,.697,89
8288,2016-02-08,LAL,@,IND,L 87-89,240,29,93,.312,21,58,.362,8,35,.229,21,26,.808,87
8289,2016-02-08,MEM,,POR,L 106-112 (OT),265,43,86,.500,36,67,.537,7,19,.368,13,19,.684,106
8290,2016-02-08,POR,@,MEM,W 112-106 (OT),265,44,89,.494,34,60,.567,10,29,.345,14,20,.700,112
8291,2016-02-08,MIN,,NOP,L 102-116,240,36,81,.444,34,69,.493,2,12,.167,28,35,.800,102
8292,2016-02-08,NOP,@,MIN,W 116-102,240,47,97,.485,37,73,.507,10,24,.417,12,20,.600,116
8293,2016-02-08,LAC,@,PHI,W 98-92 (OT),265,35,95,.368,30,73,.411,5,22,.227,23,31,.742,98
8294,2016-02-08,PHI,,LAC,L 92-98 (OT),265,34,90,.378,28,65,.431,6,25,.240,18,21,.857,92
8295,2016-02-08,OKC,@,PHO,W 122-106,240,42,85,.494,27,52,.519,15,33,.455,23,30,.767,122
8296,2016-02-08,PHO,,OKC,L 106-122,240,37,73,.507,36,62,.581,1,11,.091,31,39,.795,106
8297,2016-02-07,BOS,,SAC,W 128-119,240,51,91,.560,38,67,.567,13,24,.542,13,15,.867,128
8298,2016-02-07,SAC,@,BOS,L 119-128,240,47,95,.495,37,69,.536,10,26,.385,15,19,.789,119
8299,2016-02-07,LAC,@,MIA,W 100-93,240,37,81,.457,28,56,.500,9,25,.360,17,33,.515,100
8300,2016-02-07,MIA,,LAC,L 93-100,240,33,83,.398,26,66,.394,7,17,.412,20,29,.690,93
8301,2016-02-07,DEN,@,NYK,W 101-96,240,37,86,.430,32,65,.492,5,21,.238,22,28,.786,101
8302,2016-02-07,NYK,,DEN,L 96-101,240,37,84,.440,29,62,.468,8,22,.364,14,20,.700,96
8303,2016-02-07,ATL,@,ORL,L 94-96,240,35,91,.385,22,63,.349,13,28,.464,11,15,.733,94
8304,2016-02-07,ORL,,ATL,W 96-94,240,39,85,.459,32,60,.533,7,25,.280,11,12,.917,96
8305,2016-02-06,CHA,,WAS,W 108-104,240,38,81,.469,26,54,.481,12,27,.444,20,25,.800,108
8306,2016-02-06,WAS,@,CHO,L 104-108,240,38,86,.442,29,61,.475,9,25,.360,19,24,.792,104
8307,2016-02-06,CLE,,NOP,W 99-84,240,39,90,.433,25,49,.510,14,41,.341,7,7,1.000,99
8308,2016-02-06,NOP,@,CLE,L 84-99,240,34,87,.391,29,64,.453,5,23,.217,11,16,.688,84
8309,2016-02-06,GSW,,OKC,W 116-108,240,48,97,.495,41,71,.577,7,26,.269,13,20,.650,116
8310,2016-02-06,OKC,@,GSW,L 108-116,240,36,85,.424,29,63,.460,7,22,.318,29,37,.784,108
8311,2016-02-06,HOU,,POR,L 79-96,240,25,77,.325,18,41,.439,7,36,.194,22,30,.733,79
8312,2016-02-06,POR,@,HOU,W 96-79,240,35,87,.402,24,52,.462,11,35,.314,15,23,.652,96
8313,2016-02-06,DET,@,IND,L 104-112,240,38,79,.481,26,46,.565,12,33,.364,16,31,.516,104
8314,2016-02-06,IND,,DET,W 112-104,240,41,76,.539,35,65,.538,6,11,.545,24,29,.828,112
8315,2016-02-06,DAL,@,MEM,W 114-110 (OT),265,38,88,.432,23,50,.460,15,38,.395,23,33,.697,114
8316,2016-02-06,MEM,,DAL,L 110-114 (OT),265,44,88,.500,35,65,.538,9,23,.391,13,23,.565,110
8317,2016-02-06,CHI,@,MIN,L 105-112,240,40,85,.471,32,65,.492,8,20,.400,17,19,.895,105
8318,2016-02-06,MIN,,CHI,W 112-105,240,45,87,.517,44,75,.587,1,12,.083,21,22,.955,112
8319,2016-02-06,BRK,@,PHI,L 98-103,240,35,76,.461,30,61,.492,5,15,.333,23,26,.885,98
8320,2016-02-06,PHI,,BRK,W 103-98,240,38,81,.469,28,52,.538,10,29,.345,17,22,.773,103
8321,2016-02-06,PHO,,UTA,L 89-98,240,30,80,.375,21,56,.375,9,24,.375,20,26,.769,89
8322,2016-02-06,UTA,@,PHO,W 98-89,240,34,78,.436,29,62,.468,5,16,.313,25,31,.806,98
8323,2016-02-06,LAL,@,SAS,L 102-106,240,34,86,.395,24,56,.429,10,30,.333,24,27,.889,102
8324,2016-02-06,SAS,,LAL,W 106-102,240,39,88,.443,31,64,.484,8,24,.333,20,25,.800,106
8325,2016-02-05,ATL,,IND,W 102-96,240,39,76,.513,29,49,.592,10,27,.370,14,20,.700,102
8326,2016-02-05,IND,@,ATL,L 96-102,240,38,91,.418,25,60,.417,13,31,.419,7,9,.778,96
8327,2016-02-05,BRK,,SAC,W 128-119,240,48,86,.558,30,58,.517,18,28,.643,14,15,.933,128
8328,2016-02-05,SAC,@,BRK,L 119-128,240,45,89,.506,37,63,.587,8,26,.308,21,22,.955,119
8329,2016-02-05,CHA,,MIA,L 95-98,240,36,81,.444,26,55,.473,10,26,.385,13,15,.867,95
8330,2016-02-05,MIA,@,CHO,W 98-95,240,43,94,.457,43,85,.506,0,9,.000,12,18,.667,98
8331,2016-02-05,BOS,@,CLE,W 104-103,240,38,88,.432,31,68,.456,7,20,.350,21,25,.840,104
8332,2016-02-05,CLE,,BOS,L 103-104,240,37,87,.425,29,57,.509,8,30,.267,21,35,.600,103
8333,2016-02-05,DAL,,SAS,L 90-116,240,33,73,.452,30,58,.517,3,15,.200,21,27,.778,90
8334,2016-02-05,SAS,@,DAL,W 116-90,240,41,80,.513,29,58,.500,12,22,.545,22,25,.880,116
8335,2016-02-05,CHI,@,DEN,L 110-115,240,43,93,.462,38,81,.469,5,12,.417,19,27,.704,110
8336,2016-02-05,DEN,,CHI,W 115-110,240,39,87,.448,33,69,.478,6,18,.333,31,44,.705,115
8337,2016-02-05,MEM,@,NYK,W 91-85,240,33,76,.434,29,58,.500,4,18,.222,21,24,.875,91
8338,2016-02-05,NYK,,MEM,L 85-91,240,30,80,.375,20,51,.392,10,29,.345,15,17,.882,85
8339,2016-02-05,LAC,@,ORL,W 107-93,240,40,74,.541,32,47,.681,8,27,.296,19,23,.826,107
8340,2016-02-05,ORL,,LAC,L 93-107,240,34,81,.420,30,61,.492,4,20,.200,21,28,.750,93
8341,2016-02-05,MIL,@,UTA,L 81-84,240,30,71,.423,23,57,.404,7,14,.500,14,21,.667,81
8342,2016-02-05,UTA,,MIL,W 84-81,240,30,77,.390,22,50,.440,8,27,.296,16,23,.696,84
8343,2016-02-05,PHI,@,WAS,L 94-106,240,37,87,.425,28,61,.459,9,26,.346,11,14,.786,94
8344,2016-02-05,WAS,,PHI,W 106-94,240,44,84,.524,38,62,.613,6,22,.273,12,20,.600,106
8345,2016-02-04,DET,,NYK,W 111-105,240,40,79,.506,31,62,.500,9,17,.529,22,33,.667,111
8346,2016-02-04,NYK,@,DET,L 105-111,240,36,84,.429,30,62,.484,6,22,.273,27,34,.794,105
8347,2016-02-04,LAL,@,NOP,W 99-96,240,39,81,.481,32,61,.525,7,20,.350,14,20,.700,99
8348,2016-02-04,NOP,,LAL,L 96-99,240,39,85,.459,35,65,.538,4,20,.200,14,26,.538,96
8349,2016-02-04,HOU,@,PHO,W 111-105,240,37,86,.430,22,44,.500,15,42,.357,22,32,.688,111
8350,2016-02-04,PHO,,HOU,L 105-111,240,32,83,.386,21,54,.389,11,29,.379,30,32,.938,105
8351,2016-02-04,POR,,TOR,L 103-110,240,38,81,.469,28,56,.500,10,25,.400,17,23,.739,103
8352,2016-02-04,TOR,@,POR,W 110-103,240,40,85,.471,28,66,.424,12,19,.632,18,25,.720,110
8353,2016-02-03,BOS,,DET,W 102-95,240,42,96,.438,35,75,.467,7,21,.333,11,13,.846,102
8354,2016-02-03,DET,@,BOS,L 95-102,240,32,85,.376,21,51,.412,11,34,.324,20,28,.714,95
8355,2016-02-03,BRK,,IND,L 100-114,240,36,81,.444,29,58,.500,7,23,.304,21,31,.677,100
8356,2016-02-03,IND,@,BRK,W 114-100,240,44,88,.500,32,64,.500,12,24,.500,14,17,.824,114
8357,2016-02-03,CHA,,CLE,W 106-97,240,39,79,.494,30,52,.577,9,27,.333,19,23,.826,106
8358,2016-02-03,CLE,@,CHO,L 97-106,240,38,83,.458,28,55,.509,10,28,.357,11,14,.786,97
8359,2016-02-03,DAL,,MIA,L 90-93,240,34,87,.391,26,67,.388,8,20,.400,14,19,.737,90
8360,2016-02-03,MIA,@,DAL,W 93-90,240,37,88,.420,35,73,.479,2,15,.133,17,23,.739,93
8361,2016-02-03,LAC,,MIN,L 102-108,240,33,75,.440,22,43,.512,11,32,.344,25,34,.735,102
8362,2016-02-03,MIN,@,LAC,W 108-102,240,39,77,.506,31,60,.517,8,17,.471,22,26,.846,108
8363,2016-02-03,OKC,,ORL,W 117-114,240,44,93,.473,35,66,.530,9,27,.333,20,25,.800,117
8364,2016-02-03,ORL,@,OKC,L 114-117,240,47,95,.495,37,72,.514,10,23,.435,10,12,.833,114
8365,2016-02-03,ATL,@,PHI,W 124-86,240,48,92,.522,38,72,.528,10,20,.500,18,25,.720,124
8366,2016-02-03,PHI,,ATL,L 86-124,240,35,84,.417,29,57,.509,6,27,.222,10,14,.714,86
8367,2016-02-03,CHI,@,SAC,W 107-102,240,40,88,.455,29,67,.433,11,21,.524,16,21,.762,107
8368,2016-02-03,SAC,,CHI,L 102-107,240,42,88,.477,36,68,.529,6,20,.300,12,19,.632,102
8369,2016-02-03,NOP,@,SAS,L 97-110,240,41,90,.456,38,71,.535,3,19,.158,12,14,.857,97
8370,2016-02-03,SAS,,NOP,W 110-97,240,42,81,.519,33,66,.500,9,15,.600,17,18,.944,110
8371,2016-02-03,DEN,@,UTA,L 81-85,240,26,70,.371,22,52,.423,4,18,.222,25,33,.758,81
8372,2016-02-03,UTA,,DEN,W 85-81,240,33,74,.446,28,52,.538,5,22,.227,14,20,.700,85
8373,2016-02-03,GSW,@,WAS,W 134-121,240,49,93,.527,29,52,.558,20,41,.488,16,29,.552,134
8374,2016-02-03,WAS,,GSW,L 121-134,240,46,91,.505,38,68,.559,8,23,.348,21,30,.700,121
8375,2016-02-02,HOU,,MIA,W 115-102,240,44,84,.524,28,49,.571,16,35,.457,11,16,.688,115
8376,2016-02-02,MIA,@,HOU,L 102-115,240,38,85,.447,32,68,.471,6,17,.353,20,27,.741,102
8377,2016-02-02,LAL,,MIN,W 119-115,240,40,80,.500,28,54,.519,12,26,.462,27,35,.771,119
8378,2016-02-02,MIN,@,LAL,L 115-119,240,46,80,.575,42,63,.667,4,17,.235,19,25,.760,115
8379,2016-02-02,BOS,@,NYK,W 97-89,240,40,90,.444,37,71,.521,3,19,.158,14,17,.824,97
8380,2016-02-02,NYK,,BOS,L 89-97,240,31,82,.378,25,62,.403,6,20,.300,21,28,.750,89
8381,2016-02-02,PHO,,TOR,L 97-104,240,37,79,.468,25,48,.521,12,31,.387,11,15,.733,97
8382,2016-02-02,TOR,@,PHO,W 104-97,240,35,74,.473,26,47,.553,9,27,.333,25,32,.781,104
8383,2016-02-02,MIL,@,POR,L 95-107,240,38,86,.442,33,72,.458,5,14,.357,14,24,.583,95
8384,2016-02-02,POR,,MIL,W 107-95,240,39,85,.459,28,54,.519,11,31,.355,18,25,.720,107
8385,2016-02-01,ATL,,DAL,W 112-97,240,42,80,.525,28,45,.622,14,35,.400,14,19,.737,112
8386,2016-02-01,DAL,@,ATL,L 97-112,240,31,85,.365,24,59,.407,7,26,.269,28,38,.737,97
8387,2016-02-01,BRK,,DET,L 100-105,240,40,82,.488,33,66,.500,7,16,.438,13,15,.867,100
8388,2016-02-01,DET,@,BRK,W 105-100,240,42,98,.429,32,68,.471,10,30,.333,11,16,.688,105
8389,2016-02-01,DEN,,TOR,W 112-93,240,45,83,.542,35,61,.574,10,22,.455,12,15,.800,112
8390,2016-02-01,TOR,@,DEN,L 93-112,240,29,78,.372,21,53,.396,8,25,.320,27,39,.692,93
8391,2016-02-01,CLE,@,IND,W 111-106 (OT),265,44,88,.500,37,66,.561,7,22,.318,16,23,.696,111
8392,2016-02-01,IND,,CLE,L 106-111 (OT),265,43,101,.426,35,74,.473,8,27,.296,12,14,.857,106
8393,2016-02-01,MEM,@,NOP,W 110-95,240,43,71,.606,34,55,.618,9,16,.563,15,18,.833,110
8394,2016-02-01,NOP,,MEM,L 95-110,240,36,88,.409,26,62,.419,10,26,.385,13,21,.619,95
8395,2016-02-01,OKC,,WAS,W 114-98,240,43,83,.518,36,61,.590,7,22,.318,21,27,.778,114
8396,2016-02-01,WAS,@,OKC,L 98-114,240,40,86,.465,33,60,.550,7,26,.269,11,15,.733,98
8397,2016-02-01,MIL,@,SAC,L 104-111,240,42,84,.500,34,64,.531,8,20,.400,12,17,.706,104
8398,2016-02-01,SAC,,MIL,W 111-104,240,39,86,.453,30,60,.500,9,26,.346,24,30,.800,111
8399,2016-02-01,ORL,@,SAS,L 92-107,240,39,96,.406,34,79,.430,5,17,.294,9,11,.818,92
8400,2016-02-01,SAS,,ORL,W 107-92,240,40,78,.513,31,54,.574,9,24,.375,18,21,.857,107
8401,2016-02-01,CHI,@,UTA,L 96-105 (OT),265,39,90,.433,34,69,.493,5,21,.238,13,20,.650,96
8402,2016-02-01,UTA,,CHI,W 105-96 (OT),265,38,85,.447,31,67,.463,7,18,.389,22,33,.667,105
8403,2016-01-31,DAL,,PHO,W 91-78,240,31,78,.397,23,49,.469,8,29,.276,21,23,.913,91
8404,2016-01-31,PHO,@,DAL,L 78-91,240,27,74,.365,22,51,.431,5,23,.217,19,24,.792,78
8405,2016-01-31,CHI,@,LAC,L 93-120,240,40,93,.430,35,78,.449,5,15,.333,8,11,.727,93
8406,2016-01-31,LAC,,CHI,W 120-93,240,45,84,.536,28,52,.538,17,32,.531,13,19,.684,120
8407,2016-01-31,CHA,@,LAL,W 101-82,240,36,96,.375,23,60,.383,13,36,.361,16,26,.615,101
8408,2016-01-31,LAL,,CHO,L 82-101,240,27,80,.338,19,51,.373,8,29,.276,20,23,.870,82
8409,2016-01-31,ATL,@,MIA,L 87-105,240,27,70,.386,22,48,.458,5,22,.227,28,32,.875,87
8410,2016-01-31,MIA,,ATL,W 105-87,240,39,81,.481,34,61,.557,5,20,.250,22,26,.846,105
8411,2016-01-31,GSW,@,NYK,W 116-95,240,42,73,.575,26,44,.591,16,29,.552,16,23,.696,116
8412,2016-01-31,NYK,,GSW,L 95-116,240,33,90,.367,27,72,.375,6,18,.333,23,26,.885,95
8413,2016-01-31,BOS,@,ORL,L 114-119,240,39,93,.419,23,47,.489,16,46,.348,20,25,.800,114
8414,2016-01-31,ORL,,BOS,W 119-114,240,44,82,.537,34,58,.586,10,24,.417,21,35,.600,119
8415,2016-01-31,MIN,@,POR,L 93-96,240,35,80,.438,31,64,.484,4,16,.250,19,28,.679,93
8416,2016-01-31,POR,,MIN,W 96-93,240,32,76,.421,26,49,.531,6,27,.222,26,30,.867,96
8417,2016-01-30,CLE,,SAS,W 117-103,240,45,82,.549,36,59,.610,9,23,.391,18,21,.857,117
8418,2016-01-30,SAS,@,CLE,L 103-117,240,40,81,.494,34,63,.540,6,18,.333,17,21,.810,103
8419,2016-01-30,HOU,,WAS,L 122-123,240,41,86,.477,24,51,.471,17,35,.486,23,33,.697,122
8420,2016-01-30,WAS,@,HOU,W 123-122,240,45,86,.523,34,54,.630,11,32,.344,22,30,.733,123
8421,2016-01-30,DEN,@,IND,L 105-109 (OT),265,40,87,.460,36,69,.522,4,18,.222,21,25,.840,105
8422,2016-01-30,IND,,DEN,W 109-105 (OT),265,44,100,.440,35,73,.479,9,27,.333,12,16,.750,109
8423,2016-01-30,MEM,,SAC,W 121-117,240,41,79,.519,33,61,.541,8,18,.444,31,37,.838,121
8424,2016-01-30,SAC,@,MEM,L 117-121,240,38,92,.413,29,68,.426,9,24,.375,32,38,.842,117
8425,2016-01-30,BRK,@,NOP,L 103-105,240,40,84,.476,31,64,.484,9,20,.450,14,23,.609,103
8426,2016-01-30,NOP,,BRK,W 105-103,240,43,93,.462,32,66,.485,11,27,.407,8,10,.800,105
8427,2016-01-30,GSW,@,PHI,W 108-105,240,47,95,.495,34,65,.523,13,30,.433,1,2,.500,108
8428,2016-01-30,PHI,,GSW,L 105-108,240,42,92,.457,32,63,.508,10,29,.345,11,21,.524,105
8429,2016-01-30,DET,@,TOR,L 107-111,240,39,87,.448,30,58,.517,9,29,.310,20,34,.588,107
8430,2016-01-30,TOR,,DET,W 111-107,240,36,78,.462,32,64,.500,4,14,.286,35,47,.745,111
8431,2016-01-29,BOS,,ORL,W 113-94,240,43,86,.500,33,62,.532,10,24,.417,17,21,.810,113
8432,2016-01-29,ORL,@,BOS,L 94-113,240,32,79,.405,25,59,.424,7,20,.350,23,29,.793,94
8433,2016-01-29,BRK,@,DAL,L 79-91,240,28,78,.359,24,58,.414,4,20,.200,19,23,.826,79
8434,2016-01-29,DAL,,BRK,W 91-79,240,37,80,.463,29,59,.492,8,21,.381,9,15,.600,91
8435,2016-01-29,CLE,@,DET,W 114-106,240,39,83,.470,30,60,.500,9,23,.391,27,29,.931,114
8436,2016-01-29,DET,,CLE,L 106-114,240,40,84,.476,33,61,.541,7,23,.304,19,26,.731,106
8437,2016-01-29,LAC,,LAL,W 105-93,240,40,81,.494,32,55,.582,8,26,.308,17,24,.708,105
8438,2016-01-29,LAL,@,LAC,L 93-105,240,34,78,.436,29,65,.446,5,13,.385,20,25,.800,93
8439,2016-01-29,MIA,@,MIL,W 107-103,240,37,74,.500,30,56,.536,7,18,.389,26,32,.813,107
8440,2016-01-29,MIL,,MIA,L 103-107,240,38,80,.475,36,68,.529,2,12,.167,25,28,.893,103
8441,2016-01-29,NYK,,PHO,W 102-84,240,36,84,.429,29,64,.453,7,20,.350,23,26,.885,102
8442,2016-01-29,PHO,@,NYK,L 84-102,240,35,85,.412,28,59,.475,7,26,.269,7,12,.583,84
8443,2016-01-29,HOU,@,OKC,L 108-116,240,36,95,.379,27,56,.482,9,39,.231,27,43,.628,108
8444,2016-01-29,OKC,,HOU,W 116-108,240,41,86,.477,33,67,.493,8,19,.421,26,30,.867,116
8445,2016-01-29,CHA,@,POR,L 91-109,240,31,80,.388,21,51,.412,10,29,.345,19,28,.679,91
8446,2016-01-29,POR,,CHO,W 109-91,240,45,92,.489,38,72,.528,7,20,.350,12,16,.750,109
8447,2016-01-29,MIN,@,UTA,L 90-103,240,35,75,.467,33,65,.508,2,10,.200,18,26,.692,90
8448,2016-01-29,UTA,,MIN,W 103-90,240,40,76,.526,30,51,.588,10,25,.400,13,16,.813,103
8449,2016-01-28,ATL,@,IND,L 92-111,240,33,83,.398,26,55,.473,7,28,.250,19,21,.905,92
8450,2016-01-28,IND,,ATL,W 111-92,240,38,78,.487,29,63,.460,9,15,.600,26,30,.867,111
8451,2016-01-28,CHI,@,LAL,W 114-91,240,47,95,.495,41,78,.526,6,17,.353,14,16,.875,114
8452,2016-01-28,LAL,,CHI,L 91-114,240,32,85,.376,23,60,.383,9,25,.360,18,23,.783,91
8453,2016-01-28,MEM,,MIL,W 103-83,240,38,80,.475,28,52,.538,10,28,.357,17,20,.850,103
8454,2016-01-28,MIL,@,MEM,L 83-103,240,29,79,.367,28,63,.444,1,16,.063,24,27,.889,83
8455,2016-01-28,NOP,,SAC,W 114-105,240,43,98,.439,33,72,.458,10,26,.385,18,24,.750,114
8456,2016-01-28,SAC,@,NOP,L 105-114,240,40,89,.449,30,61,.492,10,28,.357,15,20,.750,105
8457,2016-01-28,NYK,@,TOR,L 93-103,240,38,87,.437,31,69,.449,7,18,.389,10,20,.500,93
8458,2016-01-28,TOR,,NYK,W 103-93,240,37,85,.435,29,65,.446,8,20,.400,21,29,.724,103
8459,2016-01-28,DEN,@,WAS,W 117-113,240,41,81,.506,32,63,.508,9,18,.500,26,33,.788,117
8460,2016-01-28,WAS,,DEN,L 113-117,240,39,88,.443,28,60,.467,11,28,.393,24,30,.800,113
8461,2016-01-27,ATL,,LAC,L 83-85,240,33,79,.418,23,56,.411,10,23,.435,7,14,.500,83
8462,2016-01-27,LAC,@,ATL,W 85-83,240,33,85,.388,28,58,.483,5,27,.185,14,21,.667,85
8463,2016-01-27,BOS,,DEN,W 111-103,240,41,96,.427,32,68,.471,9,28,.321,20,24,.833,111
8464,2016-01-27,DEN,@,BOS,L 103-111,240,36,84,.429,29,63,.460,7,21,.333,24,32,.750,103
8465,2016-01-27,CLE,,PHO,W 115-93,240,45,81,.556,34,53,.642,11,28,.393,14,16,.875,115
8466,2016-01-27,PHO,@,CLE,L 93-115,240,33,70,.471,25,50,.500,8,20,.400,19,25,.760,93
8467,2016-01-27,DET,,PHI,W 110-97,240,39,91,.429,34,70,.486,5,21,.238,27,38,.711,110
8468,2016-01-27,PHI,@,DET,L 97-110,240,39,82,.476,32,63,.508,7,19,.368,12,17,.706,97
8469,2016-01-27,DAL,@,GSW,L 107-127,240,44,87,.506,33,56,.589,11,31,.355,8,12,.667,107
8470,2016-01-27,GSW,,DAL,W 127-107,240,47,81,.580,33,52,.635,14,29,.483,19,21,.905,127
8471,2016-01-27,MIN,,OKC,L 123-126,240,50,90,.556,45,76,.592,5,14,.357,18,28,.643,123
8472,2016-01-27,OKC,@,MIN,W 126-123,240,48,91,.527,38,71,.535,10,20,.500,20,21,.952,126
8473,2016-01-27,HOU,@,SAS,L 99-130,240,28,73,.384,20,43,.465,8,30,.267,35,52,.673,99
8474,2016-01-27,SAS,,HOU,W 130-99,240,50,90,.556,38,67,.567,12,23,.522,18,21,.857,130
8475,2016-01-27,CHA,@,UTA,L 73-102,240,25,68,.368,19,43,.442,6,25,.240,17,21,.810,73
8476,2016-01-27,UTA,,CHO,W 102-73,240,40,81,.494,28,50,.560,12,31,.387,10,15,.667,102
8477,2016-01-26,BRK,,MIA,L 98-102,240,36,71,.507,27,53,.509,9,18,.500,17,23,.739,98
8478,2016-01-26,MIA,@,BRK,W 102-98,240,45,83,.542,42,74,.568,3,9,.333,9,10,.900,102
8479,2016-01-26,IND,,LAC,L 89-91,240,35,83,.422,30,67,.448,5,16,.313,14,24,.583,89
8480,2016-01-26,LAC,@,IND,W 91-89,240,32,78,.410,17,41,.415,15,37,.405,12,24,.500,91
8481,2016-01-26,DAL,@,LAL,W 92-90,240,33,76,.434,27,51,.529,6,25,.240,20,26,.769,92
8482,2016-01-26,LAL,,DAL,L 90-92,240,30,74,.405,23,49,.469,7,25,.280,23,28,.821,90
8483,2016-01-26,MIL,,ORL,W 107-100,240,38,77,.494,33,64,.516,5,13,.385,26,31,.839,107
8484,2016-01-26,ORL,@,MIL,L 100-107,240,33,80,.413,20,56,.357,13,24,.542,21,29,.724,100
8485,2016-01-26,NYK,,OKC,L 122-128 (OT),265,44,95,.463,33,72,.458,11,23,.478,23,30,.767,122
8486,2016-01-26,OKC,@,NYK,W 128-122 (OT),265,46,99,.465,35,79,.443,11,20,.550,25,29,.862,128
8487,2016-01-26,PHI,,PHO,W 113-103,240,39,81,.481,28,53,.528,11,28,.393,24,36,.667,113
8488,2016-01-26,PHO,@,PHI,L 103-113,240,39,83,.470,33,64,.516,6,19,.316,19,28,.679,103
8489,2016-01-26,POR,,SAC,W 112-97,240,44,90,.489,35,60,.583,9,30,.300,15,19,.789,112
8490,2016-01-26,SAC,@,POR,L 97-112,240,36,86,.419,29,67,.433,7,19,.368,18,32,.563,97
8491,2016-01-26,TOR,,WAS,W 106-89,240,35,79,.443,24,50,.480,11,29,.379,25,32,.781,106
8492,2016-01-26,WAS,@,TOR,L 89-106,240,32,78,.410,28,63,.444,4,15,.267,21,28,.750,89
8493,2016-01-25,CHI,,MIA,L 84-89,240,35,88,.398,30,70,.429,5,18,.278,9,12,.750,84
8494,2016-01-25,MIA,@,CHI,W 89-84,240,37,81,.457,34,67,.507,3,14,.214,12,17,.706,89
8495,2016-01-25,CLE,,MIN,W 114-107,240,45,89,.506,34,58,.586,11,31,.355,13,20,.650,114
8496,2016-01-25,MIN,@,CLE,L 107-114,240,41,84,.488,37,68,.544,4,16,.250,21,23,.913,107
8497,2016-01-25,ATL,@,DEN,W 119-105,240,43,86,.500,34,59,.576,9,27,.333,24,26,.923,119
8498,2016-01-25,DEN,,ATL,L 105-119,240,33,84,.393,27,64,.422,6,20,.300,33,37,.892,105
8499,2016-01-25,GSW,,SAS,W 120-90,240,44,85,.518,33,59,.559,11,26,.423,21,25,.840,120
8500,2016-01-25,SAS,@,GSW,L 90-120,240,31,74,.419,26,60,.433,5,14,.357,23,31,.742,90
8501,2016-01-25,MEM,,ORL,W 108-102 (OT),265,43,100,.430,37,82,.451,6,18,.333,16,25,.640,108
8502,2016-01-25,ORL,@,MEM,L 102-108 (OT),265,40,86,.465,30,58,.517,10,28,.357,12,14,.857,102
8503,2016-01-25,HOU,@,NOP,W 112-111,240,38,80,.475,19,40,.475,19,40,.475,17,21,.810,112
8504,2016-01-25,NOP,,HOU,L 111-112,240,42,91,.462,29,62,.468,13,29,.448,14,25,.560,111
8505,2016-01-25,CHA,@,SAC,W 129-128 (2OT),290,44,110,.400,24,66,.364,20,44,.455,21,26,.808,129
8506,2016-01-25,SAC,,CHO,L 128-129 (2OT),290,48,91,.527,41,68,.603,7,23,.304,25,32,.781,128
8507,2016-01-25,DET,@,UTA,W 95-92,240,34,75,.453,23,53,.434,11,22,.500,16,33,.485,95
8508,2016-01-25,UTA,,DET,L 92-95,240,34,85,.400,25,56,.446,9,29,.310,15,18,.833,92
8509,2016-01-25,BOS,@,WAS,W 116-91,240,44,90,.489,35,68,.515,9,22,.409,19,23,.826,116
8510,2016-01-25,WAS,,BOS,L 91-116,240,32,75,.427,25,51,.490,7,24,.292,20,30,.667,91
8511,2016-01-24,BRK,,OKC,W 116-106,240,45,94,.479,37,77,.481,8,17,.471,18,25,.720,116
8512,2016-01-24,OKC,@,BRK,L 106-116,240,43,93,.462,35,67,.522,8,26,.308,12,19,.632,106
8513,2016-01-24,DAL,@,HOU,L 104-115,240,36,79,.456,21,49,.429,15,30,.500,17,22,.773,104
8514,2016-01-24,HOU,,DAL,W 115-104,240,43,89,.483,28,45,.622,15,44,.341,14,21,.667,115
8515,2016-01-24,BOS,@,PHI,W 112-92,240,43,97,.443,32,72,.444,11,25,.440,15,19,.789,112
8516,2016-01-24,PHI,,BOS,L 92-112,240,35,89,.393,27,63,.429,8,26,.308,14,20,.700,92
8517,2016-01-24,LAC,@,TOR,L 94-112,240,34,76,.447,26,50,.520,8,26,.308,18,30,.600,94
8518,2016-01-24,TOR,,LAC,W 112-94,240,41,83,.494,29,61,.475,12,22,.545,18,26,.692,112
8519,2016-01-23,CHA,,NYK,W 97-84,240,28,82,.341,19,51,.373,9,31,.290,32,37,.865,97
8520,2016-01-23,NYK,@,CHO,L 84-97,240,29,77,.377,22,53,.415,7,24,.292,19,32,.594,84
8521,2016-01-23,CHI,@,CLE,W 96-83,240,38,87,.437,31,70,.443,7,17,.412,13,15,.867,96
8522,2016-01-23,CLE,,CHI,L 83-96,240,35,94,.372,31,70,.443,4,24,.167,9,22,.409,83
8523,2016-01-23,DEN,,DET,W 104-101,240,36,78,.462,28,56,.500,8,22,.364,24,29,.828,104
8524,2016-01-23,DET,@,DEN,L 101-104,240,40,84,.476,29,55,.527,11,29,.379,10,19,.526,101
8525,2016-01-23,MEM,@,MIN,L 101-106,240,37,79,.468,28,60,.467,9,19,.474,18,22,.818,101
8526,2016-01-23,MIN,,MEM,W 106-101,240,34,68,.500,29,51,.569,5,17,.294,33,36,.917,106
8527,2016-01-23,MIL,@,NOP,L 99-116,240,39,74,.527,33,59,.559,6,15,.400,15,18,.833,99
8528,2016-01-23,NOP,,MIL,W 116-99,240,43,94,.457,26,63,.413,17,31,.548,13,17,.765,116
8529,2016-01-23,ATL,@,PHO,L 95-98,240,34,84,.405,22,50,.440,12,34,.353,15,18,.833,95
8530,2016-01-23,PHO,,ATL,W 98-95,240,34,85,.400,24,61,.393,10,24,.417,20,26,.769,98
8531,2016-01-23,LAL,@,POR,L 103-121,240,34,69,.493,27,52,.519,7,17,.412,28,32,.875,103
8532,2016-01-23,POR,,LAL,W 121-103,240,47,93,.505,37,62,.597,10,31,.323,17,22,.773,121
8533,2016-01-23,IND,@,SAC,L 97-108,240,36,86,.419,29,67,.433,7,19,.368,18,25,.720,97
8534,2016-01-23,SAC,,IND,W 108-97,240,38,85,.447,33,69,.478,5,16,.313,27,36,.750,108
8535,2016-01-22,BOS,,CHI,W 110-101,240,43,96,.448,35,73,.479,8,23,.348,16,21,.762,110
8536,2016-01-22,CHI,@,BOS,L 101-110,240,38,89,.427,35,76,.461,3,13,.231,22,26,.846,101
8537,2016-01-22,BRK,,UTA,L 86-108,240,33,75,.440,27,59,.458,6,16,.375,14,18,.778,86
8538,2016-01-22,UTA,@,BRK,W 108-86,240,43,75,.573,34,59,.576,9,16,.563,13,15,.867,108
8539,2016-01-22,DAL,,OKC,L 106-109,240,40,87,.460,30,54,.556,10,33,.303,16,18,.889,106
8540,2016-01-22,OKC,@,DAL,W 109-106,240,45,91,.495,37,61,.607,8,30,.267,11,15,.733,109
8541,2016-01-22,GSW,,IND,W 122-110,240,43,90,.478,29,57,.509,14,33,.424,22,25,.880,122
8542,2016-01-22,IND,@,GSW,L 110-122,240,44,95,.463,41,78,.526,3,17,.176,19,27,.704,110
8543,2016-01-22,HOU,,MIL,W 102-98,240,38,94,.404,23,50,.460,15,44,.341,11,16,.688,102
8544,2016-01-22,MIL,@,HOU,L 98-102,240,39,85,.459,36,71,.507,3,14,.214,17,22,.773,98
8545,2016-01-22,LAL,,SAS,L 95-108,240,38,84,.452,32,68,.471,6,16,.375,13,18,.722,95
8546,2016-01-22,SAS,@,LAL,W 108-95,240,43,85,.506,32,64,.500,11,21,.524,11,13,.846,108
8547,2016-01-22,LAC,@,NYK,W 116-88,240,43,76,.566,30,53,.566,13,23,.565,17,24,.708,116
8548,2016-01-22,NYK,,LAC,L 88-116,240,33,85,.388,29,67,.433,4,18,.222,18,20,.900,88
8549,2016-01-22,CHA,@,ORL,W 120-116 (OT),265,45,101,.446,35,74,.473,10,27,.370,20,22,.909,120
8550,2016-01-22,ORL,,CHO,L 116-120 (OT),265,45,91,.495,34,68,.500,11,23,.478,15,19,.789,116
8551,2016-01-22,MIA,@,TOR,L 81-101,240,33,81,.407,29,64,.453,4,17,.235,11,17,.647,81
8552,2016-01-22,TOR,,MIA,W 101-81,240,35,75,.467,22,50,.440,13,25,.520,18,21,.857,101
8553,2016-01-21,CLE,,LAC,W 115-102,240,42,83,.506,29,55,.527,13,28,.464,18,24,.750,115
8554,2016-01-21,LAC,@,CLE,L 102-115,240,36,80,.450,30,55,.545,6,25,.240,24,36,.667,102
8555,2016-01-21,DEN,,MEM,L 101-102,240,36,80,.450,27,50,.540,9,30,.300,20,26,.769,101
8556,2016-01-21,MEM,@,DEN,W 102-101,240,36,72,.500,30,51,.588,6,21,.286,24,29,.828,102
8557,2016-01-21,DET,@,NOP,L 99-115,240,38,91,.418,31,61,.508,7,30,.233,16,20,.800,99
8558,2016-01-21,NOP,,DET,W 115-99,240,46,86,.535,41,74,.554,5,12,.417,18,18,1.000,115
8559,2016-01-21,PHO,,SAS,L 89-117,240,32,81,.395,26,63,.413,6,18,.333,19,23,.826,89
8560,2016-01-21,SAS,@,PHO,W 117-89,240,42,86,.488,33,72,.458,9,14,.643,24,28,.857,117
8561,2016-01-21,ATL,@,SAC,L 88-91,240,35,84,.417,27,51,.529,8,33,.242,10,15,.667,88
8562,2016-01-21,SAC,,ATL,W 91-88,240,33,92,.359,26,68,.382,7,24,.292,18,24,.750,91
8563,2016-01-20,BRK,,CLE,L 78-91,240,35,84,.417,31,65,.477,4,19,.211,4,8,.500,78
8564,2016-01-20,CLE,@,BRK,W 91-78,240,36,77,.468,31,60,.517,5,17,.294,14,20,.700,91
8565,2016-01-20,CHI,,GSW,L 94-125,240,37,100,.370,36,80,.450,1,20,.050,19,24,.792,94
8566,2016-01-20,GSW,@,CHI,W 125-94,240,50,95,.526,38,63,.603,12,32,.375,13,20,.650,125
8567,2016-01-20,DAL,,MIN,W 106-94 (OT),265,42,97,.433,37,72,.514,5,25,.200,17,22,.773,106
8568,2016-01-20,MIN,@,DAL,L 94-106 (OT),265,40,91,.440,35,68,.515,5,23,.217,9,11,.818,94
8569,2016-01-20,DET,@,HOU,W 123-114,240,38,80,.475,26,50,.520,12,30,.400,35,59,.593,123
8570,2016-01-20,HOU,,DET,L 114-123,240,43,95,.453,31,71,.437,12,24,.500,16,18,.889,114
8571,2016-01-20,LAL,,SAC,L 93-112,240,32,90,.356,28,65,.431,4,25,.160,25,31,.806,93
8572,2016-01-20,SAC,@,LAL,W 112-93,240,43,89,.483,37,69,.536,6,20,.300,20,28,.714,112
8573,2016-01-20,NYK,,UTA,W 118-111 (OT),265,47,90,.522,40,73,.548,7,17,.412,17,18,.944,118
8574,2016-01-20,UTA,@,NYK,L 111-118 (OT),265,37,86,.430,25,59,.424,12,27,.444,25,31,.806,111
8575,2016-01-20,CHA,@,OKC,L 95-109,240,34,81,.420,25,54,.463,9,27,.333,18,21,.857,95
8576,2016-01-20,OKC,,CHO,W 109-95,240,39,83,.470,30,59,.508,9,24,.375,22,30,.733,109
8577,2016-01-20,ORL,,PHI,L 87-96,240,33,84,.393,29,67,.433,4,17,.235,17,26,.654,87
8578,2016-01-20,PHI,@,ORL,W 96-87,240,36,74,.486,27,55,.491,9,19,.474,15,21,.714,96
8579,2016-01-20,ATL,@,POR,W 104-98,240,39,87,.448,29,63,.460,10,24,.417,16,23,.696,104
8580,2016-01-20,POR,,ATL,L 98-104,240,41,94,.436,32,63,.508,9,31,.290,7,11,.636,98
8581,2016-01-20,BOS,@,TOR,L 109-115,240,43,85,.506,31,59,.525,12,26,.462,11,15,.733,109
8582,2016-01-20,TOR,,BOS,W 115-109,240,46,83,.554,35,54,.648,11,29,.379,12,17,.706,115
8583,2016-01-20,MIA,@,WAS,L 87-106,240,33,68,.485,26,53,.491,7,15,.467,14,18,.778,87
8584,2016-01-20,WAS,,MIA,W 106-87,240,45,86,.523,40,70,.571,5,16,.313,11,13,.846,106
8585,2016-01-19,DEN,,OKC,L 104-110,240,35,83,.422,28,63,.444,7,20,.350,27,36,.750,104
8586,2016-01-19,OKC,@,DEN,W 110-104,240,41,97,.423,35,69,.507,6,28,.214,22,30,.733,110
8587,2016-01-19,MIA,,MIL,L 79-91,240,27,74,.365,22,52,.423,5,22,.227,20,26,.769,79
8588,2016-01-19,MIL,@,MIA,W 91-79,240,36,74,.486,31,62,.500,5,12,.417,14,16,.875,91
8589,2016-01-19,MIN,@,NOP,L 99-114,240,36,76,.474,33,62,.532,3,14,.214,24,31,.774,99
8590,2016-01-19,NOP,,MIN,W 114-99,240,42,83,.506,32,60,.533,10,23,.435,20,23,.870,114
8591,2016-01-19,IND,@,PHO,W 97-94,240,34,83,.410,30,63,.476,4,20,.200,25,34,.735,97
8592,2016-01-19,PHO,,IND,L 94-97,240,28,81,.346,17,46,.370,11,35,.314,27,29,.931,94
8593,2016-01-18,ATL,,ORL,W 98-81,240,41,80,.513,32,61,.525,9,19,.474,7,10,.700,98
8594,2016-01-18,ORL,@,ATL,L 81-98,240,30,87,.345,24,65,.369,6,22,.273,15,20,.750,81
8595,2016-01-18,CHA,,UTA,W 124-119 (2OT),290,41,88,.466,27,61,.443,14,27,.519,28,32,.875,124
8596,2016-01-18,UTA,@,CHO,L 119-124 (2OT),290,44,104,.423,29,59,.492,15,45,.333,16,20,.800,119
8597,2016-01-18,CLE,,GSW,L 98-132,240,37,77,.481,30,58,.517,7,19,.368,17,25,.680,98
8598,2016-01-18,GSW,@,CLE,W 132-98,240,46,85,.541,27,45,.600,19,40,.475,21,27,.778,132
8599,2016-01-18,BOS,@,DAL,L 113-118 (OT),265,40,94,.426,28,64,.438,12,30,.400,21,26,.808,113
8600,2016-01-18,DAL,,BOS,W 118-113 (OT),265,40,93,.430,24,59,.407,16,34,.471,22,24,.917,118
8601,2016-01-18,CHI,@,DET,W 111-101,240,44,84,.524,35,63,.556,9,21,.429,14,20,.700,111
8602,2016-01-18,DET,,CHI,L 101-111,240,42,95,.442,37,69,.536,5,26,.192,12,20,.600,101
8603,2016-01-18,HOU,@,LAC,L 132-140 (OT),265,44,88,.500,33,56,.589,11,32,.344,33,52,.635,132
8604,2016-01-18,LAC,,HOU,W 140-132 (OT),265,47,91,.516,25,54,.463,22,37,.595,24,33,.727,140
8605,2016-01-18,MEM,,NOP,W 101-99,240,35,75,.467,27,56,.482,8,19,.421,23,30,.767,101
8606,2016-01-18,NOP,@,MEM,L 99-101,240,36,74,.486,30,55,.545,6,19,.316,21,23,.913,99
8607,2016-01-18,NYK,,PHI,W 119-113 (2OT),290,43,97,.443,35,77,.455,8,20,.400,25,30,.833,119
8608,2016-01-18,PHI,@,NYK,L 113-119 (2OT),290,45,102,.441,35,74,.473,10,28,.357,13,25,.520,113
8609,2016-01-18,BRK,@,TOR,L 100-112,240,39,76,.513,34,62,.548,5,14,.357,17,19,.895,100
8610,2016-01-18,TOR,,BRK,W 112-100,240,43,85,.506,30,61,.492,13,24,.542,13,18,.722,112
8611,2016-01-18,POR,@,WAS,W 108-98,240,43,84,.512,26,53,.491,17,31,.548,5,11,.455,108
8612,2016-01-18,WAS,,POR,L 98-108,240,37,77,.481,28,56,.500,9,21,.429,15,20,.750,98
8613,2016-01-17,DEN,,IND,W 129-126,240,46,91,.505,36,65,.554,10,26,.385,27,38,.711,129
8614,2016-01-17,IND,@,DEN,L 126-129,240,48,82,.585,39,62,.629,9,20,.450,21,30,.700,126
8615,2016-01-17,HOU,@,LAL,W 112-95,240,44,91,.484,38,70,.543,6,21,.286,18,24,.750,112
8616,2016-01-17,LAL,,HOU,L 95-112,240,37,82,.451,31,63,.492,6,19,.316,15,19,.789,95
8617,2016-01-17,MIN,,PHO,W 117-87,240,39,69,.565,32,51,.627,7,18,.389,32,40,.800,117
8618,2016-01-17,PHO,@,MIN,L 87-117,240,35,81,.432,32,66,.485,3,15,.200,14,25,.560,87
8619,2016-01-17,MIA,@,OKC,L 74-99,240,30,72,.417,26,58,.448,4,14,.286,10,11,.909,74
8620,2016-01-17,OKC,,MIA,W 99-74,240,40,88,.455,33,66,.500,7,22,.318,12,12,1.000,99
8621,2016-01-17,DAL,@,SAS,L 83-112,240,29,81,.358,23,58,.397,6,23,.261,19,25,.760,83
8622,2016-01-17,SAS,,DAL,W 112-83,240,42,90,.467,37,70,.529,5,20,.250,23,28,.821,112
8623,2016-01-16,ATL,,BRK,W 114-86,240,44,79,.557,36,50,.720,8,29,.276,18,24,.750,114
8624,2016-01-16,BRK,@,ATL,L 86-114,240,34,78,.436,28,58,.483,6,20,.300,12,19,.632,86
8625,2016-01-16,CHA,,MIL,L 92-105,240,33,87,.379,24,51,.471,9,36,.250,17,22,.773,92
8626,2016-01-16,MIL,@,CHO,W 105-92,240,39,72,.542,34,60,.567,5,12,.417,22,26,.846,105
8627,2016-01-16,DET,,GSW,W 113-95,240,47,101,.465,39,78,.500,8,23,.348,11,20,.550,113
8628,2016-01-16,GSW,@,DET,L 95-113,240,34,94,.362,24,69,.348,10,25,.400,17,23,.739,95
8629,2016-01-16,LAC,,SAC,L 103-110,240,38,96,.396,25,57,.439,13,39,.333,14,19,.737,103
8630,2016-01-16,SAC,@,LAC,W 110-103,240,36,76,.474,23,51,.451,13,25,.520,25,33,.758,110
8631,2016-01-16,MEM,,NYK,W 103-95,240,39,82,.476,34,72,.472,5,10,.500,20,26,.769,103
8632,2016-01-16,NYK,@,MEM,L 95-103,240,35,77,.455,30,57,.526,5,20,.250,20,24,.833,95
8633,2016-01-16,PHI,,POR,W 114-89,240,42,76,.553,32,53,.604,10,23,.435,20,30,.667,114
8634,2016-01-16,POR,@,PHI,L 89-114,240,34,87,.391,29,58,.500,5,29,.172,16,24,.667,89
8635,2016-01-16,LAL,@,UTA,L 82-109,240,31,90,.344,22,67,.328,9,23,.391,11,18,.611,82
8636,2016-01-16,UTA,,LAL,W 109-82,240,41,83,.494,29,59,.492,12,24,.500,15,18,.833,109
8637,2016-01-16,BOS,@,WAS,W 119-117,240,39,88,.443,30,59,.508,9,29,.310,32,36,.889,119
8638,2016-01-16,WAS,,BOS,L 117-119,240,40,89,.449,34,67,.507,6,22,.273,31,36,.861,117
8639,2016-01-15,BOS,,PHO,W 117-103,240,42,96,.438,28,66,.424,14,30,.467,19,29,.655,117
8640,2016-01-15,PHO,@,BOS,L 103-117,240,35,89,.393,25,62,.403,10,27,.370,23,28,.821,103
8641,2016-01-15,BRK,,POR,L 104-116,240,38,85,.447,30,66,.455,8,19,.421,20,28,.714,104
8642,2016-01-15,POR,@,BRK,W 116-104,240,47,93,.505,32,58,.552,15,35,.429,7,11,.636,116
8643,2016-01-15,CHI,,DAL,L 77-83,240,31,86,.360,29,67,.433,2,19,.105,13,15,.867,77
8644,2016-01-15,DAL,@,CHI,W 83-77,240,30,77,.390,22,55,.400,8,22,.364,15,17,.882,83
8645,2016-01-15,DEN,,MIA,L 95-98,240,32,78,.410,26,60,.433,6,18,.333,25,26,.962,95
8646,2016-01-15,MIA,@,DEN,W 98-95,240,40,81,.494,36,69,.522,4,12,.333,14,19,.737,98
8647,2016-01-15,CLE,@,HOU,W 91-77,240,34,87,.391,26,52,.500,8,35,.229,15,23,.652,91
8648,2016-01-15,HOU,,CLE,L 77-91,240,26,74,.351,20,49,.408,6,25,.240,19,29,.655,77
8649,2016-01-15,IND,,WAS,L 104-118,240,38,80,.475,35,63,.556,3,17,.176,25,32,.781,104
8650,2016-01-15,WAS,@,IND,W 118-104,240,51,98,.520,40,73,.548,11,25,.440,5,10,.500,118
8651,2016-01-15,ATL,@,MIL,L 101-108 (OT),265,43,100,.430,34,70,.486,9,30,.300,6,6,1.000,101
8652,2016-01-15,MIL,,ATL,W 108-101 (OT),265,40,96,.417,37,86,.430,3,10,.300,25,37,.676,108
8653,2016-01-15,CHA,@,NOP,L 107-109,240,42,86,.488,28,51,.549,14,35,.400,9,12,.750,107
8654,2016-01-15,NOP,,CHO,W 109-107,240,43,87,.494,31,60,.517,12,27,.444,11,13,.846,109
8655,2016-01-15,MIN,@,OKC,L 93-113,240,34,85,.400,29,73,.397,5,12,.417,20,23,.870,93
8656,2016-01-15,OKC,,MIN,W 113-93,240,47,89,.528,42,66,.636,5,23,.217,14,22,.636,113
8657,2016-01-14,GSW,,LAL,W 116-98,240,43,86,.500,30,53,.566,13,33,.394,17,20,.850,116
8658,2016-01-14,LAL,@,GSW,L 98-116,240,40,90,.444,36,67,.537,4,23,.174,14,24,.583,98
8659,2016-01-14,DET,@,MEM,L 101-103,240,37,72,.514,22,40,.550,15,32,.469,12,17,.706,101
8660,2016-01-14,MEM,,DET,W 103-101,240,37,76,.487,28,60,.467,9,16,.563,20,25,.800,103
8661,2016-01-14,ORL,,TOR,L 103-106 (OT),265,44,97,.454,35,74,.473,9,23,.391,6,8,.750,103
8662,2016-01-14,TOR,@,ORL,W 106-103 (OT),265,37,90,.411,29,66,.439,8,24,.333,24,31,.774,106
8663,2016-01-14,CHI,@,PHI,W 115-111 (OT),265,41,88,.466,34,71,.479,7,17,.412,26,31,.839,115
8664,2016-01-14,PHI,,CHI,L 111-115 (OT),265,42,93,.452,30,66,.455,12,27,.444,15,20,.750,111
8665,2016-01-14,CLE,@,SAS,L 95-99,240,38,82,.463,28,56,.500,10,26,.385,9,11,.818,95
8666,2016-01-14,SAS,,CLE,W 99-95,240,38,83,.458,33,66,.500,5,17,.294,18,22,.818,99
8667,2016-01-14,SAC,@,UTA,W 103-101,240,34,74,.459,29,63,.460,5,11,.455,30,42,.714,103
8668,2016-01-14,UTA,,SAC,L 101-103,240,35,83,.422,29,49,.592,6,34,.176,25,34,.735,101
8669,2016-01-13,BOS,,IND,W 103-94,240,40,90,.444,31,64,.484,9,26,.346,14,20,.700,103
8670,2016-01-13,IND,@,BOS,L 94-103,240,37,91,.407,32,61,.525,5,30,.167,15,20,.750,94
8671,2016-01-13,BRK,,NYK,W 110-104,240,45,86,.523,36,69,.522,9,17,.529,11,14,.786,110
8672,2016-01-13,NYK,@,BRK,L 104-110,240,41,91,.451,34,69,.493,7,22,.318,15,23,.652,104
8673,2016-01-13,ATL,@,CHO,L 84-107,240,30,81,.370,23,56,.411,7,25,.280,17,21,.810,84
8674,2016-01-13,CHA,,ATL,W 107-84,240,36,82,.439,23,43,.535,13,39,.333,22,26,.846,107
8675,2016-01-13,DEN,,GSW,W 112-110,240,37,87,.425,32,65,.492,5,22,.227,33,37,.892,112
8676,2016-01-13,GSW,@,DEN,L 110-112,240,42,88,.477,32,62,.516,10,26,.385,16,20,.800,110
8677,2016-01-13,HOU,,MIN,W 107-104,240,37,75,.493,30,45,.667,7,30,.233,26,38,.684,107
8678,2016-01-13,MIN,@,HOU,L 104-107,240,36,78,.462,28,61,.459,8,17,.471,24,30,.800,104
8679,2016-01-13,LAC,,MIA,W 104-90,240,40,94,.426,29,69,.420,11,25,.440,13,16,.813,104
8680,2016-01-13,MIA,@,LAC,L 90-104,240,31,70,.443,22,46,.478,9,24,.375,19,29,.655,90
8681,2016-01-13,DAL,@,OKC,L 89-108,240,32,82,.390,26,51,.510,6,31,.194,19,25,.760,89
8682,2016-01-13,OKC,,DAL,W 108-89,240,38,82,.463,23,49,.469,15,33,.455,17,29,.586,108
8683,2016-01-13,POR,,UTA,W 99-85,240,39,88,.443,28,62,.452,11,26,.423,10,15,.667,99
8684,2016-01-13,UTA,@,POR,L 85-99,240,31,76,.408,23,57,.404,8,19,.421,15,22,.682,85
8685,2016-01-13,NOP,@,SAC,W 109-97,240,42,100,.420,26,67,.388,16,33,.485,9,11,.818,109
8686,2016-01-13,SAC,,NOP,L 97-109,240,41,84,.488,35,61,.574,6,23,.261,9,14,.643,97
8687,2016-01-13,MIL,@,WAS,L 101-106,240,38,72,.528,37,64,.578,1,8,.125,24,34,.706,101
8688,2016-01-13,WAS,,MIL,W 106-101,240,38,84,.452,26,57,.456,12,27,.444,18,24,.750,106
8689,2016-01-12,CLE,@,DAL,W 110-107 (OT),265,40,97,.412,23,53,.434,17,44,.386,13,16,.813,110
8690,2016-01-12,DAL,,CLE,L 107-110 (OT),265,39,79,.494,28,51,.549,11,28,.393,18,22,.818,107
8691,2016-01-12,DET,,SAS,L 99-109,240,38,91,.418,32,68,.471,6,23,.261,17,26,.654,99
8692,2016-01-12,SAS,@,DET,W 109-99,240,41,85,.482,36,71,.507,5,14,.357,22,27,.815,109
8693,2016-01-12,IND,,PHO,W 116-97,240,41,79,.519,31,55,.564,10,24,.417,24,31,.774,116
8694,2016-01-12,PHO,@,IND,L 97-116,240,36,89,.404,28,64,.438,8,25,.320,17,27,.630,97
8695,2016-01-12,LAL,,NOP,W 95-91,240,32,87,.368,26,58,.448,6,29,.207,25,32,.781,95
8696,2016-01-12,NOP,@,LAL,L 91-95,240,38,91,.418,32,68,.471,6,23,.261,9,14,.643,91
8697,2016-01-12,HOU,@,MEM,W 107-91,240,33,77,.429,15,42,.357,18,35,.514,23,27,.852,107
8698,2016-01-12,MEM,,HOU,L 91-107,240,33,72,.458,26,54,.481,7,18,.389,18,24,.750,91
8699,2016-01-12,CHI,@,MIL,L 101-106,240,35,85,.412,23,56,.411,12,29,.414,19,24,.792,101
8700,2016-01-12,MIL,,CHI,W 106-101,240,43,93,.462,40,80,.500,3,13,.231,17,28,.607,106
8701,2016-01-12,MIN,,OKC,L 96-101,240,36,81,.444,29,63,.460,7,18,.389,17,23,.739,96
8702,2016-01-12,OKC,@,MIN,W 101-96,240,39,84,.464,30,62,.484,9,22,.409,14,18,.778,101
8703,2016-01-12,BOS,@,NYK,L 114-120,240,42,86,.488,33,57,.579,9,29,.310,21,26,.808,114
8704,2016-01-12,NYK,,BOS,W 120-114,240,43,81,.531,36,61,.590,7,20,.350,27,30,.900,120
8705,2016-01-11,BRK,,SAS,L 79-106,240,33,73,.452,31,61,.508,2,12,.167,11,13,.846,79
8706,2016-01-11,SAS,@,BRK,W 106-79,240,44,82,.537,40,69,.580,4,13,.308,14,19,.737,106
8707,2016-01-11,CHI,,WAS,L 100-114,240,34,81,.420,25,59,.424,9,22,.409,23,27,.852,100
8708,2016-01-11,WAS,@,CHI,W 114-100,240,48,99,.485,39,75,.520,9,24,.375,9,10,.900,114
8709,2016-01-11,GSW,,MIA,W 111-103,240,41,86,.477,34,63,.540,7,23,.304,22,30,.733,111
8710,2016-01-11,MIA,@,GSW,L 103-111,240,41,91,.451,34,72,.472,7,19,.368,14,16,.875,103
8711,2016-01-10,CHA,@,DEN,L 92-95,240,30,83,.361,18,47,.383,12,36,.333,20,24,.833,92
8712,2016-01-10,DEN,,CHO,W 95-92,240,32,77,.416,20,50,.400,12,27,.444,19,23,.826,95
8713,2016-01-10,HOU,,IND,W 107-103 (OT),265,39,89,.438,25,51,.490,14,38,.368,15,23,.652,107
8714,2016-01-10,IND,@,HOU,L 103-107 (OT),265,43,90,.478,34,59,.576,9,31,.290,8,10,.800,103
8715,2016-01-10,LAC,,NOP,W 114-111 (OT),265,42,89,.472,30,53,.566,12,36,.333,18,34,.529,114
8716,2016-01-10,NOP,@,LAC,L 111-114 (OT),265,40,100,.400,32,70,.457,8,30,.267,23,29,.793,111
8717,2016-01-10,LAL,,UTA,L 74-86,240,29,89,.326,26,68,.382,3,21,.143,13,15,.867,74
8718,2016-01-10,UTA,@,LAL,W 86-74,240,31,69,.449,26,53,.491,5,16,.313,19,25,.760,86
8719,2016-01-10,BOS,@,MEM,L 98-101,240,37,88,.420,30,66,.455,7,22,.318,17,23,.739,98
8720,2016-01-10,MEM,,BOS,W 101-98,240,31,84,.369,27,68,.397,4,16,.250,35,40,.875,101
8721,2016-01-10,DAL,@,MIN,W 93-87,240,36,77,.468,30,57,.526,6,20,.300,15,21,.714,93
8722,2016-01-10,MIN,,DAL,L 87-93,240,33,79,.418,29,63,.460,4,16,.250,17,22,.773,87
8723,2016-01-10,MIL,@,NYK,L 88-100,240,32,80,.400,29,67,.433,3,13,.231,21,30,.700,88
8724,2016-01-10,NYK,,MIL,W 100-88,240,39,84,.464,32,60,.533,7,24,.292,15,18,.833,100
8725,2016-01-10,CLE,@,PHI,W 95-85,240,35,90,.389,26,58,.448,9,32,.281,16,23,.696,95
8726,2016-01-10,PHI,,CLE,L 85-95,240,35,77,.455,29,59,.492,6,18,.333,9,19,.474,85
8727,2016-01-10,OKC,@,POR,L 110-115,240,37,76,.487,27,55,.491,10,21,.476,26,36,.722,110
8728,2016-01-10,POR,,OKC,W 115-110,240,42,100,.420,23,56,.411,19,44,.432,12,14,.857,115
8729,2016-01-09,ATL,,CHI,W 120-105,240,49,94,.521,39,70,.557,10,24,.417,12,15,.800,120
8730,2016-01-09,CHI,@,ATL,L 105-120,240,36,83,.434,29,65,.446,7,18,.389,26,31,.839,105
8731,2016-01-09,BRK,@,DET,L 89-103,240,38,82,.463,33,73,.452,5,9,.556,8,10,.800,89
8732,2016-01-09,DET,,BRK,W 103-89,240,43,92,.467,35,65,.538,8,27,.296,9,14,.643,103
8733,2016-01-09,CHA,@,LAC,L 83-97,240,31,84,.369,24,61,.393,7,23,.304,14,19,.737,83
8734,2016-01-09,LAC,,CHO,W 97-83,240,40,91,.440,32,60,.533,8,31,.258,9,10,.900,97
8735,2016-01-09,ORL,,WAS,L 99-105,240,38,74,.514,33,60,.550,5,14,.357,18,24,.750,99
8736,2016-01-09,WAS,@,ORL,W 105-99,240,42,76,.553,29,53,.547,13,23,.565,8,10,.800,105
8737,2016-01-09,PHI,,TOR,L 95-108,240,39,80,.488,28,63,.444,11,17,.647,6,14,.429,95
8738,2016-01-09,TOR,@,PHI,W 108-95,240,41,75,.547,36,58,.621,5,17,.294,21,27,.778,108
8739,2016-01-09,GSW,@,SAC,W 128-116,240,49,87,.563,30,50,.600,19,37,.514,11,15,.733,128
8740,2016-01-09,SAC,,GSW,L 116-128,240,43,92,.467,35,69,.507,8,23,.348,22,29,.759,116
8741,2016-01-09,MIA,@,UTA,L 83-98,240,34,82,.415,28,63,.444,6,19,.316,9,17,.529,83
8742,2016-01-09,UTA,,MIA,W 98-83,240,39,71,.549,30,51,.588,9,20,.450,11,18,.611,98
8743,2016-01-08,BRK,,ORL,L 77-83,240,29,73,.397,22,51,.431,7,22,.318,12,20,.600,77
8744,2016-01-08,ORL,@,BRK,W 83-77,240,33,83,.398,20,55,.364,13,28,.464,4,6,.667,83
8745,2016-01-08,LAL,,OKC,L 113-117,240,40,84,.476,31,58,.534,9,26,.346,24,25,.960,113
8746,2016-01-08,OKC,@,LAL,W 117-113,240,45,89,.506,40,72,.556,5,17,.294,22,26,.846,117
8747,2016-01-08,DEN,@,MEM,L 84-91,240,32,87,.368,28,68,.412,4,19,.211,16,19,.842,84
8748,2016-01-08,MEM,,DEN,W 91-84,240,30,82,.366,22,64,.344,8,18,.444,23,30,.767,91
8749,2016-01-08,DAL,@,MIL,L 95-96,240,35,84,.417,21,40,.525,14,44,.318,11,16,.688,95
8750,2016-01-08,MIL,,DAL,W 96-95,240,37,80,.463,33,71,.465,4,9,.444,18,29,.621,96
8751,2016-01-08,CLE,@,MIN,W 125-99,240,43,81,.531,30,54,.556,13,27,.481,26,29,.897,125
8752,2016-01-08,MIN,,CLE,L 99-125,240,36,79,.456,29,63,.460,7,16,.438,20,26,.769,99
8753,2016-01-08,IND,@,NOP,W 91-86,240,36,81,.444,31,60,.517,5,21,.238,14,19,.737,91
8754,2016-01-08,NOP,,IND,L 86-91,240,31,83,.373,22,54,.407,9,29,.310,15,20,.750,86
8755,2016-01-08,MIA,@,PHO,W 103-95,240,36,73,.493,29,55,.527,7,18,.389,24,30,.800,103
8756,2016-01-08,PHO,,MIA,L 95-103,240,40,92,.435,34,68,.500,6,24,.250,9,13,.692,95
8757,2016-01-08,GSW,@,POR,W 128-108,240,46,87,.529,28,55,.509,18,32,.563,18,21,.857,128
8758,2016-01-08,POR,,GSW,L 108-128,240,38,96,.396,26,63,.413,12,33,.364,20,28,.714,108
8759,2016-01-08,NYK,@,SAS,L 99-100,240,38,91,.418,29,70,.414,9,21,.429,14,17,.824,99
8760,2016-01-08,SAS,,NYK,W 100-99,240,41,93,.441,37,80,.463,4,13,.308,14,17,.824,100
8761,2016-01-08,TOR,@,WAS,W 97-88,240,34,75,.453,29,61,.475,5,14,.357,24,26,.923,97
8762,2016-01-08,WAS,,TOR,L 88-97,240,33,84,.393,25,59,.424,8,25,.320,14,15,.933,88
8763,2016-01-07,BOS,@,CHI,L 92-101,240,35,98,.357,30,73,.411,5,25,.200,17,22,.773,92
8764,2016-01-07,CHI,,BOS,W 101-92,240,39,94,.415,30,72,.417,9,22,.409,14,17,.824,101
8765,2016-01-07,HOU,,UTA,W 103-94,240,39,75,.520,32,52,.615,7,23,.304,18,26,.692,103
8766,2016-01-07,UTA,@,HOU,L 94-103,240,38,78,.487,31,50,.620,7,28,.250,11,17,.647,94
8767,2016-01-07,ATL,@,PHI,W 126-98,240,49,92,.533,36,60,.600,13,32,.406,15,19,.789,126
8768,2016-01-07,PHI,,ATL,L 98-126,240,39,86,.453,34,68,.500,5,18,.278,15,25,.600,98
8769,2016-01-07,LAL,@,SAC,L 115-118,240,41,76,.539,33,52,.635,8,24,.333,25,29,.862,115
8770,2016-01-07,SAC,,LAL,W 118-115,240,47,85,.553,41,64,.641,6,21,.286,18,27,.667,118
8771,2016-01-06,BOS,,DET,L 94-99,240,34,91,.374,28,63,.444,6,28,.214,20,27,.741,94
8772,2016-01-06,DET,@,BOS,W 99-94,240,33,74,.446,23,47,.489,10,27,.370,23,36,.639,99
8773,2016-01-06,BRK,,TOR,L 74-91,240,31,78,.397,26,62,.419,5,16,.313,7,12,.583,74
8774,2016-01-06,TOR,@,BRK,W 91-74,240,35,80,.438,31,58,.534,4,22,.182,17,18,.944,91
8775,2016-01-06,MIA,,NYK,L 90-98,240,37,82,.451,35,65,.538,2,17,.118,14,15,.933,90
8776,2016-01-06,NYK,@,MIA,W 98-90,240,39,70,.557,36,62,.581,3,8,.375,17,18,.944,98
8777,2016-01-06,DEN,@,MIN,W 78-74,240,29,81,.358,21,61,.344,8,20,.400,12,17,.706,78
8778,2016-01-06,MIN,,DEN,L 74-78,240,28,73,.384,25,62,.403,3,11,.273,15,20,.750,74
8779,2016-01-06,DAL,@,NOP,W 100-91,240,37,87,.425,30,59,.508,7,28,.250,19,22,.864,100
8780,2016-01-06,NOP,,DAL,L 91-100,240,34,92,.370,27,62,.435,7,30,.233,16,20,.800,91
8781,2016-01-06,MEM,@,OKC,L 94-112,240,35,90,.389,28,69,.406,7,21,.333,17,24,.708,94
8782,2016-01-06,OKC,,MEM,W 112-94,240,38,83,.458,30,66,.455,8,17,.471,28,33,.848,112
8783,2016-01-06,IND,@,ORL,W 95-86,240,32,76,.421,26,54,.481,6,22,.273,25,29,.862,95
8784,2016-01-06,ORL,,IND,L 86-95,240,32,79,.405,26,48,.542,6,31,.194,16,17,.941,86
8785,2016-01-06,CHA,@,PHO,L 102-111,240,38,87,.437,27,59,.458,11,28,.393,15,22,.682,102
8786,2016-01-06,PHO,,CHO,W 111-102,240,41,84,.488,22,51,.431,19,33,.576,10,13,.769,111
8787,2016-01-06,LAC,@,POR,W 109-98,240,42,83,.506,31,60,.517,11,23,.478,14,17,.824,109
8788,2016-01-06,POR,,LAC,L 98-109,240,38,86,.442,29,60,.483,9,26,.346,13,23,.565,98
8789,2016-01-06,SAS,,UTA,W 123-98,240,52,86,.605,43,65,.662,9,21,.429,10,13,.769,123
8790,2016-01-06,UTA,@,SAS,L 98-123,240,37,79,.468,30,61,.492,7,18,.389,17,18,.944,98
8791,2016-01-06,CLE,@,WAS,W 121-115,240,48,89,.539,36,60,.600,12,29,.414,13,19,.684,121
8792,2016-01-06,WAS,,CLE,L 115-121,240,42,76,.553,28,52,.538,14,24,.583,17,27,.630,115
8793,2016-01-05,ATL,,NYK,L 101-107,240,37,87,.425,22,48,.458,15,39,.385,12,19,.632,101
8794,2016-01-05,NYK,@,ATL,W 107-101,240,40,84,.476,35,66,.530,5,18,.278,22,24,.917,107
8795,2016-01-05,CHI,,MIL,W 117-106,240,46,83,.554,41,64,.641,5,19,.263,20,20,1.000,117
8796,2016-01-05,MIL,@,CHI,L 106-117,240,46,102,.451,40,86,.465,6,16,.375,8,14,.571,106
8797,2016-01-05,DAL,,SAC,W 117-116 (2OT),290,45,98,.459,33,69,.478,12,29,.414,15,23,.652,117
8798,2016-01-05,SAC,@,DAL,L 116-117 (2OT),290,47,99,.475,35,67,.522,12,32,.375,10,14,.714,116
8799,2016-01-05,GSW,@,LAL,W 109-88,240,40,86,.465,27,55,.491,13,31,.419,16,21,.762,109
8800,2016-01-05,LAL,,GSW,L 88-109,240,29,91,.319,24,70,.343,5,21,.238,25,30,.833,88
8801,2016-01-04,BOS,@,BRK,W 103-94,240,41,92,.446,35,71,.493,6,21,.286,15,19,.789,103
8802,2016-01-04,BRK,,BOS,L 94-103,240,32,85,.376,26,57,.456,6,28,.214,24,27,.889,94
8803,2016-01-04,CLE,,TOR,W 122-100,240,41,74,.554,24,41,.585,17,33,.515,23,26,.885,122
8804,2016-01-04,TOR,@,CLE,L 100-122,240,36,73,.493,28,54,.519,8,19,.421,20,29,.690,100
8805,2016-01-04,DET,,ORL,W 115-89,240,43,88,.489,29,58,.500,14,30,.467,15,21,.714,115
8806,2016-01-04,ORL,@,DET,L 89-115,240,36,81,.444,30,61,.492,6,20,.300,11,11,1.000,89
8807,2016-01-04,CHA,@,GSW,L 101-111,240,38,86,.442,31,65,.477,7,21,.333,18,19,.947,101
8808,2016-01-04,GSW,,CHO,W 111-101,240,45,87,.517,30,53,.566,15,34,.441,6,6,1.000,111
8809,2016-01-04,IND,@,MIA,L 100-103 (OT),265,37,94,.394,29,66,.439,8,28,.286,18,25,.720,100
8810,2016-01-04,MIA,,IND,W 103-100 (OT),265,34,90,.378,29,68,.426,5,22,.227,30,39,.769,103
8811,2016-01-04,MIL,,SAS,L 98-123,240,37,77,.481,34,65,.523,3,12,.250,21,30,.700,98
8812,2016-01-04,SAS,@,MIL,W 123-98,240,49,90,.544,40,70,.571,9,20,.450,16,20,.800,123
8813,2016-01-04,OKC,,SAC,L 104-116,240,39,89,.438,29,60,.483,10,29,.345,16,23,.696,104
8814,2016-01-04,SAC,@,OKC,W 116-104,240,40,89,.449,33,72,.458,7,17,.412,29,39,.744,116
8815,2016-01-04,MIN,@,PHI,L 99-109,240,39,73,.534,37,68,.544,2,5,.400,19,24,.792,99
8816,2016-01-04,PHI,,MIN,W 109-99,240,48,87,.552,44,67,.657,4,20,.200,9,14,.643,109
8817,2016-01-04,MEM,@,POR,W 91-78,240,35,91,.385,32,76,.421,3,15,.200,18,26,.692,91
8818,2016-01-04,POR,,MEM,L 78-91,240,28,72,.389,21,44,.477,7,28,.250,15,24,.625,78
8819,2016-01-04,HOU,@,UTA,W 93-91,240,33,68,.485,22,42,.524,11,26,.423,16,21,.762,93
8820,2016-01-04,UTA,,HOU,L 91-93,240,30,75,.400,18,46,.391,12,29,.414,19,25,.760,91
8821,2016-01-03,DEN,,POR,L 106-112,240,34,80,.425,27,58,.466,7,22,.318,31,48,.646,106
8822,2016-01-03,POR,@,DEN,W 112-106,240,40,78,.513,30,55,.545,10,23,.435,22,32,.688,112
8823,2016-01-03,LAL,,PHO,W 97-77,240,38,84,.452,30,62,.484,8,22,.364,13,17,.765,97
8824,2016-01-03,PHO,@,LAL,L 77-97,240,32,89,.360,26,62,.419,6,27,.222,7,9,.778,77
8825,2016-01-03,ATL,@,NYK,L 97-111,240,37,84,.440,29,58,.500,8,26,.308,15,20,.750,97
8826,2016-01-03,NYK,,ATL,W 111-97,240,44,88,.500,33,62,.532,11,26,.423,12,14,.857,111
8827,2016-01-03,CHI,@,TOR,W 115-113,240,42,82,.512,33,61,.541,9,21,.429,22,25,.880,115
8828,2016-01-03,TOR,,CHI,L 113-115,240,42,92,.457,29,61,.475,13,31,.419,16,19,.842,113
8829,2016-01-03,MIA,@,WAS,W 97-75,240,39,86,.453,30,63,.476,9,23,.391,10,12,.833,97
8830,2016-01-03,WAS,,MIA,L 75-97,240,31,91,.341,27,61,.443,4,30,.133,9,13,.692,75
8831,2016-01-02,BOS,,BRK,L 97-100,240,34,88,.386,27,56,.482,7,32,.219,22,28,.786,97
8832,2016-01-02,BRK,@,BOS,W 100-97,240,38,93,.409,35,75,.467,3,18,.167,21,22,.955,100
8833,2016-01-02,CHA,,OKC,L 90-109,240,29,84,.345,23,62,.371,6,22,.273,26,34,.765,90
8834,2016-01-02,OKC,@,CHO,W 109-90,240,35,79,.443,26,56,.464,9,23,.391,30,37,.811,109
8835,2016-01-02,CLE,,ORL,W 104-79,240,34,82,.415,22,45,.489,12,37,.324,24,39,.615,104
8836,2016-01-02,ORL,@,CLE,L 79-104,240,29,76,.382,23,51,.451,6,25,.240,15,17,.882,79
8837,2016-01-02,DAL,,NOP,L 98-105,240,36,83,.434,26,57,.456,10,26,.385,16,19,.842,98
8838,2016-01-02,NOP,@,DAL,W 105-98,240,40,83,.482,34,63,.540,6,20,.300,19,24,.792,105
8839,2016-01-02,DEN,@,GSW,L 108-111 (OT),265,44,105,.419,39,75,.520,5,30,.167,15,23,.652,108
8840,2016-01-02,GSW,,DEN,W 111-108 (OT),265,43,86,.500,33,58,.569,10,28,.357,15,23,.652,111
8841,2016-01-02,DET,@,IND,L 82-94,240,33,93,.355,30,73,.411,3,20,.150,13,23,.565,82
8842,2016-01-02,IND,,DET,W 94-82,240,33,73,.452,26,55,.473,7,18,.389,21,29,.724,94
8843,2016-01-02,LAC,,PHI,W 130-99,240,49,81,.605,37,58,.638,12,23,.522,20,25,.800,130
8844,2016-01-02,PHI,@,LAC,L 99-130,240,41,89,.461,32,66,.485,9,23,.391,8,17,.471,99
8845,2016-01-02,MIL,@,MIN,W 95-85,240,32,75,.427,24,59,.407,8,16,.500,23,28,.821,95
8846,2016-01-02,MIN,,MIL,L 85-95,240,33,84,.393,30,70,.429,3,14,.214,16,24,.667,85
8847,2016-01-02,PHO,@,SAC,L 119-142,240,43,83,.518,33,54,.611,10,29,.345,23,28,.821,119
8848,2016-01-02,SAC,,PHO,W 142-119,240,53,87,.609,44,64,.688,9,23,.391,27,34,.794,142
8849,2016-01-02,HOU,@,SAS,L 103-121,240,37,74,.500,28,52,.538,9,22,.409,20,33,.606,103
8850,2016-01-02,SAS,,HOU,W 121-103,240,45,86,.523,32,62,.516,13,24,.542,18,19,.947,121
8851,2016-01-02,MEM,@,UTA,L 87-92 (OT),265,33,81,.407,26,63,.413,7,18,.389,14,26,.538,87
8852,2016-01-02,UTA,,MEM,W 92-87 (OT),265,31,75,.413,22,48,.458,9,27,.333,21,28,.750,92
8853,2016-01-01,CHI,,NYK,W 108-81,240,39,85,.459,29,69,.420,10,16,.625,20,25,.800,108
8854,2016-01-01,NYK,@,CHI,L 81-108,240,31,84,.369,25,65,.385,6,19,.316,13,17,.765,81
8855,2016-01-01,LAL,,PHI,W 93-84,240,33,87,.379,28,71,.394,5,16,.313,22,29,.759,93
8856,2016-01-01,PHI,@,LAL,L 84-93,240,31,84,.369,27,60,.450,4,24,.167,18,25,.720,84
8857,2016-01-01,DAL,@,MIA,L 82-106,240,32,88,.364,25,57,.439,7,31,.226,11,14,.786,82
8858,2016-01-01,MIA,,DAL,W 106-82,240,46,82,.561,38,64,.594,8,18,.444,6,9,.667,106
8859,2016-01-01,CHA,@,TOR,L 94-104,240,34,85,.400,24,53,.453,10,32,.313,16,18,.889,94
8860,2016-01-01,TOR,,CHO,W 104-94,240,36,91,.396,21,58,.362,15,33,.455,17,18,.944,104
8861,2016-01-01,ORL,@,WAS,L 91-103,240,40,85,.471,35,65,.538,5,20,.250,6,8,.750,91
8862,2016-01-01,WAS,,ORL,W 103-91,240,43,92,.467,35,66,.530,8,26,.308,9,10,.900,103
8863,2015-12-31,DET,,MIN,W 115-90,240,41,86,.477,27,51,.529,14,35,.400,19,28,.679,115
8864,2015-12-31,MIN,@,DET,L 90-115,240,35,86,.407,30,72,.417,5,14,.357,15,19,.789,90
8865,2015-12-31,GSW,@,HOU,W 114-110,240,43,84,.512,32,61,.525,11,23,.478,17,27,.630,114
8866,2015-12-31,HOU,,GSW,L 110-114,240,36,78,.462,24,48,.500,12,30,.400,26,29,.897,110
8867,2015-12-31,IND,,MIL,L 116-120,240,41,82,.500,28,52,.538,13,30,.433,21,26,.808,116
8868,2015-12-31,MIL,@,IND,W 120-116,240,45,77,.584,39,63,.619,6,14,.429,24,35,.686,120
8869,2015-12-31,LAC,@,NOP,W 95-89,240,35,90,.389,25,56,.446,10,34,.294,15,19,.789,95
8870,2015-12-31,NOP,,LAC,L 89-95,240,36,82,.439,29,57,.509,7,25,.280,10,15,.667,89
8871,2015-12-31,OKC,,PHO,W 110-106,240,42,80,.525,35,59,.593,7,21,.333,19,24,.792,110
8872,2015-12-31,PHO,@,OKC,L 106-110,240,43,82,.524,35,62,.565,8,20,.400,12,13,.923,106
8873,2015-12-31,POR,@,UTA,L 96-109,240,35,78,.449,19,42,.452,16,36,.444,10,14,.714,96
8874,2015-12-31,UTA,,POR,W 109-96,240,43,86,.500,28,53,.528,15,33,.455,8,11,.727,109
8875,2015-12-30,BOS,,LAL,L 104-112,240,38,88,.432,31,61,.508,7,27,.259,21,25,.840,104
8876,2015-12-30,LAL,@,BOS,W 112-104,240,43,94,.457,34,75,.453,9,19,.474,17,23,.739,112
8877,2015-12-30,CHI,,IND,W 102-100 (OT),265,37,86,.430,31,68,.456,6,18,.333,22,27,.815,102
8878,2015-12-30,IND,@,CHI,L 100-102 (OT),265,37,97,.381,30,75,.400,7,22,.318,19,24,.792,100
8879,2015-12-30,CHA,,LAC,L 117-122,240,38,88,.432,29,58,.500,9,30,.300,32,36,.889,117
8880,2015-12-30,LAC,@,CHO,W 122-117,240,37,71,.521,22,41,.537,15,30,.500,33,41,.805,122
8881,2015-12-30,DAL,,GSW,W 114-91,240,42,82,.512,28,55,.509,14,27,.519,16,20,.800,114
8882,2015-12-30,GSW,@,DAL,L 91-114,240,33,81,.407,26,62,.419,7,19,.368,18,24,.750,91
8883,2015-12-30,MIN,,UTA,W 94-80,240,36,77,.468,31,67,.463,5,10,.500,17,27,.630,94
8884,2015-12-30,UTA,@,MIN,L 80-94,240,28,80,.350,18,41,.439,10,39,.256,14,20,.700,80
8885,2015-12-30,BRK,@,ORL,L 93-100,240,35,83,.422,32,63,.508,3,20,.150,20,22,.909,93
8886,2015-12-30,ORL,,BRK,W 100-93,240,36,82,.439,27,56,.482,9,26,.346,19,21,.905,100
8887,2015-12-30,DEN,@,POR,L 103-110,240,37,87,.425,25,60,.417,12,27,.444,17,19,.895,103
8888,2015-12-30,POR,,DEN,W 110-103,240,41,87,.471,29,55,.527,12,32,.375,16,20,.800,110
8889,2015-12-30,PHI,@,SAC,W 110-105,240,40,94,.426,31,63,.492,9,31,.290,21,34,.618,110
8890,2015-12-30,SAC,,PHI,L 105-110,240,36,74,.486,28,49,.571,8,25,.320,25,41,.610,105
8891,2015-12-30,PHO,@,SAS,L 79-112,240,32,81,.395,27,63,.429,5,18,.278,10,18,.556,79
8892,2015-12-30,SAS,,PHO,W 112-79,240,43,76,.566,37,62,.597,6,14,.429,20,33,.606,112
8893,2015-12-30,TOR,,WAS,W 94-91,240,28,82,.341,22,58,.379,6,24,.250,32,39,.821,94
8894,2015-12-30,WAS,@,TOR,L 91-94,240,35,87,.402,27,65,.415,8,22,.364,13,17,.765,91
8895,2015-12-29,CLE,@,DEN,W 93-87,240,38,86,.442,34,64,.531,4,22,.182,13,22,.591,93
8896,2015-12-29,DEN,,CLE,L 87-93,240,37,89,.416,32,65,.492,5,24,.208,8,11,.727,87
8897,2015-12-29,ATL,@,HOU,W 121-115,240,43,99,.434,29,58,.500,14,41,.341,21,25,.840,121
8898,2015-12-29,HOU,,ATL,L 115-121,240,39,72,.542,28,52,.538,11,20,.550,26,39,.667,115
8899,2015-12-29,MEM,,MIA,W 99-90 (OT),265,38,87,.437,34,72,.472,4,15,.267,19,20,.950,99
8900,2015-12-29,MIA,@,MEM,L 90-99 (OT),265,35,79,.443,24,50,.480,11,29,.379,9,18,.500,90
8901,2015-12-29,DET,@,NYK,L 96-108,240,37,89,.416,27,62,.435,10,27,.370,12,17,.706,96
8902,2015-12-29,NYK,,DET,W 108-96,240,43,79,.544,35,63,.556,8,16,.500,14,17,.824,108
8903,2015-12-29,MIL,@,OKC,L 123-131,240,49,100,.490,39,84,.464,10,16,.625,15,22,.682,123
8904,2015-12-29,OKC,,MIL,W 131-123,240,43,86,.500,35,64,.547,8,22,.364,37,40,.925,131
8905,2015-12-28,CHI,,TOR,W 104-97,240,40,87,.460,32,66,.485,8,21,.381,16,24,.667,104
8906,2015-12-28,TOR,@,CHI,L 97-104,240,38,88,.432,32,68,.471,6,20,.300,15,24,.625,97
8907,2015-12-28,CHA,,LAL,W 108-98,240,43,89,.483,37,64,.578,6,25,.240,16,22,.727,108
8908,2015-12-28,LAL,@,CHO,L 98-108,240,35,85,.412,26,56,.464,9,29,.310,19,23,.826,98
8909,2015-12-28,DAL,,MIL,W 103-93,240,38,84,.452,28,62,.452,10,22,.455,17,26,.654,103
8910,2015-12-28,MIL,@,DAL,L 93-103,240,38,79,.481,34,65,.523,4,14,.286,13,15,.867,93
8911,2015-12-28,GSW,,SAC,W 122-103,240,43,89,.483,23,47,.489,20,42,.476,16,24,.667,122
8912,2015-12-28,SAC,@,GSW,L 103-122,240,37,95,.389,24,64,.375,13,31,.419,16,28,.571,103
8913,2015-12-28,ATL,@,IND,L 87-93,240,31,74,.419,25,49,.510,6,25,.240,19,25,.760,87
8914,2015-12-28,IND,,ATL,W 93-87,240,38,87,.437,31,61,.508,7,26,.269,10,18,.556,93
8915,2015-12-28,BRK,@,MIA,W 111-105,240,36,82,.439,24,59,.407,12,23,.522,27,36,.750,111
8916,2015-12-28,MIA,,BRK,L 105-111,240,36,78,.462,26,54,.481,10,24,.417,23,30,.767,105
8917,2015-12-28,NOP,@,ORL,L 89-104,240,37,83,.446,32,63,.508,5,20,.250,10,15,.667,89
8918,2015-12-28,ORL,,NOP,W 104-89,240,45,82,.549,38,65,.585,7,17,.412,7,11,.636,104
8919,2015-12-28,CLE,@,PHO,W 101-97,240,33,71,.465,16,30,.533,17,41,.415,18,25,.720,101
8920,2015-12-28,PHO,,CLE,L 97-101,240,36,79,.456,25,54,.463,11,25,.440,14,20,.700,97
8921,2015-12-28,MIN,@,SAS,L 95-101,240,39,82,.476,36,71,.507,3,11,.273,14,24,.583,95
8922,2015-12-28,SAS,,MIN,W 101-95,240,37,72,.514,32,55,.582,5,17,.294,22,28,.786,101
8923,2015-12-28,PHI,@,UTA,L 91-95,240,36,86,.419,31,65,.477,5,21,.238,14,19,.737,91
8924,2015-12-28,UTA,,PHI,W 95-91,240,28,84,.333,21,58,.362,7,26,.269,32,36,.889,95
8925,2015-12-28,LAC,@,WAS,W 108-91,240,41,78,.526,34,55,.618,7,23,.304,19,25,.760,108
8926,2015-12-28,WAS,,LAC,L 91-108,240,34,87,.391,27,63,.429,7,24,.292,16,24,.667,91
8927,2015-12-27,BOS,,NYK,W 100-91,240,36,85,.424,28,65,.431,8,20,.400,20,29,.690,100
8928,2015-12-27,NYK,@,BOS,L 91-100,240,33,89,.371,29,70,.414,4,19,.211,21,24,.875,91
8929,2015-12-27,LAL,@,MEM,L 96-112,240,32,84,.381,24,55,.436,8,29,.276,24,32,.750,96
8930,2015-12-27,MEM,,LAL,W 112-96,240,45,80,.563,39,64,.609,6,16,.375,16,22,.727,112
8931,2015-12-27,DEN,@,OKC,L 112-122,240,46,94,.489,37,69,.536,9,25,.360,11,15,.733,112
8932,2015-12-27,OKC,,DEN,W 122-112,240,48,83,.578,40,68,.588,8,15,.533,18,21,.857,122
8933,2015-12-27,POR,@,SAC,W 98-94,240,38,92,.413,28,59,.475,10,33,.303,12,16,.750,98
8934,2015-12-27,SAC,,POR,L 94-98,240,30,76,.395,21,52,.404,9,24,.375,25,31,.806,94
8935,2015-12-26,ATL,,NYK,W 117-98,240,47,88,.534,39,63,.619,8,25,.320,15,18,.833,117
8936,2015-12-26,NYK,@,ATL,L 98-117,240,39,81,.481,32,57,.561,7,24,.292,13,17,.765,98
8937,2015-12-26,BRK,,WAS,L 96-111,240,43,89,.483,38,72,.528,5,17,.294,5,16,.313,96
8938,2015-12-26,WAS,@,BRK,W 111-96,240,42,84,.500,30,57,.526,12,27,.444,15,22,.682,111
8939,2015-12-26,CHA,,MEM,W 98-92,240,28,69,.406,14,37,.378,14,32,.438,28,32,.875,98
8940,2015-12-26,MEM,@,CHO,L 92-98,240,37,90,.411,30,71,.423,7,19,.368,11,21,.524,92
8941,2015-12-26,CHI,@,DAL,L 111-118,240,42,78,.538,34,57,.596,8,21,.381,19,26,.731,111
8942,2015-12-26,DAL,,CHI,W 118-111,240,40,87,.460,24,54,.444,16,33,.485,22,28,.786,118
8943,2015-12-26,BOS,@,DET,W 99-93,240,39,84,.464,35,61,.574,4,23,.174,17,23,.739,99
8944,2015-12-26,DET,,BOS,L 93-99,240,35,91,.385,29,66,.439,6,25,.240,17,25,.680,93
8945,2015-12-26,MIL,,TOR,L 90-111,240,34,81,.420,28,67,.418,6,14,.429,16,18,.889,90
8946,2015-12-26,TOR,@,MIL,W 111-90,240,42,81,.519,29,52,.558,13,29,.448,14,19,.737,111
8947,2015-12-26,IND,@,MIN,W 102-88,240,40,80,.500,31,54,.574,9,26,.346,13,14,.929,102
8948,2015-12-26,MIN,,IND,L 88-102,240,35,75,.467,31,63,.492,4,12,.333,14,18,.778,88
8949,2015-12-26,HOU,@,NOP,L 108-110,240,38,84,.452,23,51,.451,15,33,.455,17,20,.850,108
8950,2015-12-26,NOP,,HOU,W 110-108,240,38,75,.507,25,51,.490,13,24,.542,21,26,.808,110
8951,2015-12-26,MIA,@,ORL,W 108-101,240,38,77,.494,28,57,.491,10,20,.500,22,23,.957,108
8952,2015-12-26,ORL,,MIA,L 101-108,240,43,79,.544,34,60,.567,9,19,.474,6,13,.462,101
8953,2015-12-26,PHI,@,PHO,W 111-104,240,38,79,.481,26,52,.500,12,27,.444,23,27,.852,111
8954,2015-12-26,PHO,,PHI,L 104-111,240,34,88,.386,24,61,.393,10,27,.370,26,34,.765,104
8955,2015-12-26,CLE,@,POR,L 76-105,240,28,77,.364,17,46,.370,11,31,.355,9,15,.600,76
8956,2015-12-26,POR,,CLE,W 105-76,240,41,89,.461,32,67,.478,9,22,.409,14,19,.737,105
8957,2015-12-26,DEN,@,SAS,L 86-101,240,38,86,.442,33,68,.485,5,18,.278,5,6,.833,86
8958,2015-12-26,SAS,,DEN,W 101-86,240,39,81,.481,32,71,.451,7,10,.700,16,17,.941,101
8959,2015-12-26,LAC,@,UTA,W 109-104,240,38,79,.481,25,53,.472,13,26,.500,20,24,.833,109
8960,2015-12-26,UTA,,LAC,L 104-109,240,36,74,.486,26,47,.553,10,27,.370,22,27,.815,104
8961,2015-12-25,CLE,@,GSW,L 83-89,240,30,95,.316,25,65,.385,5,30,.167,18,25,.720,83
8962,2015-12-25,GSW,,CLE,W 89-83,240,32,78,.410,27,60,.450,5,18,.278,20,27,.741,89
8963,2015-12-25,HOU,,SAS,W 88-84,240,32,74,.432,25,59,.424,7,15,.467,17,26,.654,88
8964,2015-12-25,SAS,@,HOU,L 84-88,240,36,88,.409,31,68,.456,5,20,.250,7,8,.875,84
8965,2015-12-25,LAC,@,LAL,W 94-84,240,38,85,.447,28,59,.475,10,26,.385,8,11,.727,94
8966,2015-12-25,LAL,,LAC,L 84-94,240,32,77,.416,25,54,.463,7,23,.304,13,25,.520,84
8967,2015-12-25,MIA,,NOP,W 94-88 (OT),265,35,88,.398,29,62,.468,6,26,.231,18,27,.667,94
8968,2015-12-25,NOP,@,MIA,L 88-94 (OT),265,36,90,.400,30,70,.429,6,20,.300,10,11,.909,88
8969,2015-12-25,CHI,@,OKC,W 105-96,240,40,92,.435,33,74,.446,7,18,.389,18,20,.900,105
8970,2015-12-25,OKC,,CHI,L 96-105,240,37,96,.385,31,72,.431,6,24,.250,16,23,.696,96
8971,2015-12-23,ATL,,DET,W 107-100,240,43,89,.483,37,69,.536,6,20,.300,15,20,.750,107
8972,2015-12-23,DET,@,ATL,L 100-107,240,38,89,.427,31,68,.456,7,21,.333,17,33,.515,100
8973,2015-12-23,BRK,,DAL,L 118-119 (OT),265,51,101,.505,41,82,.500,10,19,.526,6,14,.429,118
8974,2015-12-23,DAL,@,BRK,W 119-118 (OT),265,45,82,.549,29,48,.604,16,34,.471,13,15,.867,119
8975,2015-12-23,BOS,@,CHO,W 102-89,240,36,85,.424,29,56,.518,7,29,.241,23,26,.885,102
8976,2015-12-23,CHA,,BOS,L 89-102,240,29,81,.358,21,53,.396,8,28,.286,23,32,.719,89
8977,2015-12-23,CLE,,NYK,W 91-84,240,32,83,.386,27,61,.443,5,22,.227,22,25,.880,91
8978,2015-12-23,NYK,@,CLE,L 84-91,240,32,82,.390,27,66,.409,5,16,.313,15,16,.938,84
8979,2015-12-23,GSW,,UTA,W 103-85,240,39,83,.470,30,60,.500,9,23,.391,16,16,1.000,103
8980,2015-12-23,UTA,@,GSW,L 85-103,240,33,80,.413,26,60,.433,7,20,.350,12,14,.857,85
8981,2015-12-23,IND,,SAC,L 106-108,240,41,89,.461,29,57,.509,12,32,.375,12,20,.600,106
8982,2015-12-23,SAC,@,IND,W 108-106,240,46,89,.517,42,66,.636,4,23,.174,12,16,.750,108
8983,2015-12-23,LAL,,OKC,L 85-120,240,32,89,.360,25,64,.391,7,25,.280,14,22,.636,85
8984,2015-12-23,OKC,@,LAL,W 120-85,240,51,95,.537,46,76,.605,5,19,.263,13,17,.765,120
8985,2015-12-23,MIL,,PHI,W 113-100,240,51,85,.600,46,73,.630,5,12,.417,6,8,.750,113
8986,2015-12-23,PHI,@,MIL,L 100-113,240,37,81,.457,30,61,.492,7,20,.350,19,29,.655,100
8987,2015-12-23,MIN,,SAS,L 83-108,240,30,72,.417,27,62,.435,3,10,.300,20,25,.800,83
8988,2015-12-23,SAS,@,MIN,W 108-83,240,44,82,.537,34,58,.586,10,24,.417,10,14,.714,108
8989,2015-12-23,NOP,,POR,W 115-89,240,41,85,.482,28,54,.519,13,31,.419,20,23,.870,115
8990,2015-12-23,POR,@,NOP,L 89-115,240,33,95,.347,26,67,.388,7,28,.250,16,24,.667,89
8991,2015-12-23,HOU,@,ORL,L 101-104,240,41,83,.494,34,54,.630,7,29,.241,12,17,.706,101
8992,2015-12-23,ORL,,HOU,W 104-101,240,44,84,.524,37,68,.544,7,16,.438,9,13,.692,104
8993,2015-12-23,DEN,@,PHO,W 104-96,240,42,91,.462,28,56,.500,14,35,.400,6,13,.462,104
8994,2015-12-23,PHO,,DEN,L 96-104,240,36,87,.414,23,62,.371,13,25,.520,11,17,.647,96
8995,2015-12-23,MEM,@,WAS,L 91-100,240,33,72,.458,30,55,.545,3,17,.176,22,32,.688,91
8996,2015-12-23,WAS,,MEM,W 100-91,240,37,82,.451,26,57,.456,11,25,.440,15,19,.789,100
8997,2015-12-22,DEN,,LAL,L 107-111,240,41,90,.456,32,65,.492,9,25,.360,16,19,.842,107
8998,2015-12-22,LAL,@,DEN,W 111-107,240,40,84,.476,33,58,.569,7,26,.269,24,32,.750,111
8999,2015-12-22,DET,@,MIA,W 93-92,240,35,78,.449,20,48,.417,15,30,.500,8,14,.571,93
9000,2015-12-22,MIA,,DET,L 92-93,240,39,88,.443,35,70,.500,4,18,.222,10,12,.833,92
9001,2015-12-22,MEM,@,PHI,W 104-90,240,40,85,.471,35,70,.500,5,15,.333,19,24,.792,104
9002,2015-12-22,PHI,,MEM,L 90-104,240,31,66,.470,24,43,.558,7,23,.304,21,32,.656,90
9003,2015-12-22,DAL,@,TOR,L 99-103,240,40,92,.435,29,63,.460,11,29,.379,8,11,.727,99
9004,2015-12-22,TOR,,DAL,W 103-99,240,35,74,.473,23,48,.479,12,26,.462,21,27,.778,103
9005,2015-12-21,ATL,,POR,W 106-97,240,37,77,.481,28,48,.583,9,29,.310,23,28,.821,106
9006,2015-12-21,POR,@,ATL,L 97-106,240,38,81,.469,33,57,.579,5,24,.208,16,22,.727,97
9007,2015-12-21,BOS,,MIN,W 113-99,240,46,89,.517,34,64,.531,12,25,.480,9,16,.563,113
9008,2015-12-21,MIN,@,BOS,L 99-113,240,36,79,.456,34,66,.515,2,13,.154,25,32,.781,99
9009,2015-12-21,BRK,@,CHI,W 105-102,240,43,94,.457,36,74,.486,7,20,.350,12,14,.857,105
9010,2015-12-21,CHI,,BRK,L 102-105,240,43,95,.453,34,69,.493,9,26,.346,7,13,.538,102
9011,2015-12-21,CHA,@,HOU,L 95-102,240,29,83,.349,17,42,.405,12,41,.293,25,31,.806,95
9012,2015-12-21,HOU,,CHO,W 102-95,240,33,71,.465,26,43,.605,7,28,.250,29,41,.707,102
9013,2015-12-21,LAC,,OKC,L 99-100,240,41,87,.471,34,65,.523,7,22,.318,10,14,.714,99
9014,2015-12-21,OKC,@,LAC,W 100-99,240,40,85,.471,36,68,.529,4,17,.235,16,20,.800,100
9015,2015-12-21,NYK,,ORL,L 99-107,240,39,76,.513,32,52,.615,7,24,.292,14,16,.875,99
9016,2015-12-21,ORL,@,NYK,W 107-99,240,44,86,.512,34,64,.531,10,22,.455,9,11,.818,107
9017,2015-12-21,IND,@,SAS,L 92-106,240,38,90,.422,31,71,.437,7,19,.368,9,15,.600,92
9018,2015-12-21,SAS,,IND,W 106-92,240,46,89,.517,40,69,.580,6,20,.300,8,9,.889,106
9019,2015-12-21,PHO,@,UTA,L 89-110,240,31,79,.392,24,55,.436,7,24,.292,20,22,.909,89
9020,2015-12-21,UTA,,PHO,W 110-89,240,36,79,.456,27,54,.500,9,25,.360,29,37,.784,110
9021,2015-12-21,SAC,@,WAS,L 99-113,240,37,91,.407,30,69,.435,7,22,.318,18,22,.818,99
9022,2015-12-21,WAS,,SAC,W 113-99,240,42,83,.506,28,59,.475,14,24,.583,15,17,.882,113
9023,2015-12-20,BRK,,MIN,L 85-100,240,32,78,.410,27,57,.474,5,21,.238,16,20,.800,85
9024,2015-12-20,MIN,@,BRK,W 100-85,240,38,80,.475,35,68,.515,3,12,.250,21,24,.875,100
9025,2015-12-20,CLE,,PHI,W 108-86,240,40,85,.471,29,60,.483,11,25,.440,17,21,.810,108
9026,2015-12-20,PHI,@,CLE,L 86-108,240,30,86,.349,25,62,.403,5,24,.208,21,30,.700,86
9027,2015-12-20,DEN,,NOP,L 125-130,240,45,96,.469,28,61,.459,17,35,.486,18,22,.818,125
9028,2015-12-20,NOP,@,DEN,W 130-125,240,44,78,.564,33,54,.611,11,24,.458,31,39,.795,130
9029,2015-12-20,MIA,,POR,W 116-109,240,43,75,.573,31,52,.596,12,23,.522,18,26,.692,116
9030,2015-12-20,POR,@,MIA,L 109-116,240,39,80,.488,26,46,.565,13,34,.382,18,22,.818,109
9031,2015-12-20,ATL,@,ORL,W 103-100,240,39,78,.500,28,56,.500,11,22,.500,14,20,.700,103
9032,2015-12-20,ORL,,ATL,L 100-103,240,38,81,.469,34,69,.493,4,12,.333,20,24,.833,100
9033,2015-12-20,MIL,@,PHO,W 101-95,240,41,79,.519,36,63,.571,5,16,.313,14,24,.583,101
9034,2015-12-20,PHO,,MIL,L 95-101,240,33,74,.446,25,56,.446,8,18,.444,21,24,.875,95
9035,2015-12-20,SAC,@,TOR,W 104-94,240,40,76,.526,31,55,.564,9,21,.429,15,24,.625,104
9036,2015-12-20,TOR,,SAC,L 94-104,240,35,94,.372,27,65,.415,8,29,.276,16,17,.941,94
9037,2015-12-19,HOU,,LAC,W 107-97,240,34,76,.447,26,51,.510,8,25,.320,31,49,.633,107
9038,2015-12-19,LAC,@,HOU,L 97-107,240,34,86,.395,23,48,.479,11,38,.289,18,29,.621,97
9039,2015-12-19,IND,@,MEM,L 84-96,240,30,77,.390,25,49,.510,5,28,.179,19,25,.760,84
9040,2015-12-19,MEM,,IND,W 96-84,240,37,83,.446,32,64,.500,5,19,.263,17,21,.810,96
9041,2015-12-19,CHI,@,NYK,L 91-107,240,37,94,.394,32,73,.438,5,21,.238,12,17,.706,91
9042,2015-12-19,NYK,,CHI,W 107-91,240,41,82,.500,36,62,.581,5,20,.250,20,24,.833,107
9043,2015-12-19,LAL,@,OKC,L 78-118,240,30,86,.349,22,58,.379,8,28,.286,10,17,.588,78
9044,2015-12-19,OKC,,LAL,W 118-78,240,46,84,.548,37,65,.569,9,19,.474,17,25,.680,118
9045,2015-12-19,CHA,@,WAS,L 101-109,240,39,93,.419,29,60,.483,10,33,.303,13,16,.813,101
9046,2015-12-19,WAS,,CHO,W 109-101,240,40,79,.506,31,59,.525,9,20,.450,20,23,.870,109
9047,2015-12-18,ATL,@,BOS,W 109-101,240,41,88,.466,37,68,.544,4,20,.200,23,29,.793,109
9048,2015-12-18,BOS,,ATL,L 101-109,240,34,77,.442,24,54,.444,10,23,.435,23,31,.742,101
9049,2015-12-18,CHI,,DET,L 144-147 (4OT),340,50,120,.417,45,98,.459,5,22,.227,39,44,.886,144
9050,2015-12-18,DET,@,CHI,W 147-144 (4OT),340,56,124,.452,48,95,.505,8,29,.276,27,46,.587,147
9051,2015-12-18,DAL,,MEM,W 97-88,240,34,78,.436,24,49,.490,10,29,.345,19,21,.905,97
9052,2015-12-18,MEM,@,DAL,L 88-97,240,30,80,.375,24,63,.381,6,17,.353,22,24,.917,88
9053,2015-12-18,GSW,,MIL,W 121-112,240,42,87,.483,33,61,.541,9,26,.346,28,37,.757,121
9054,2015-12-18,MIL,@,GSW,L 112-121,240,42,91,.462,38,73,.521,4,18,.222,24,28,.857,112
9055,2015-12-18,BRK,@,IND,L 97-104,240,36,86,.419,28,70,.400,8,16,.500,17,17,1.000,97
9056,2015-12-18,IND,,BRK,W 104-97,240,37,89,.416,30,61,.492,7,28,.250,23,26,.885,104
9057,2015-12-18,MIA,,TOR,L 94-108,240,35,74,.473,26,49,.531,9,25,.360,15,17,.882,94
9058,2015-12-18,TOR,@,MIA,W 108-94,240,41,80,.513,33,59,.559,8,21,.381,18,22,.818,108
9059,2015-12-18,MIN,,SAC,W 99-95,240,39,82,.476,33,64,.516,6,18,.333,15,16,.938,99
9060,2015-12-18,SAC,@,MIN,L 95-99,240,38,81,.469,31,58,.534,7,23,.304,12,17,.706,95
9061,2015-12-18,ORL,,POR,W 102-94,240,39,84,.464,37,69,.536,2,15,.133,22,31,.710,102
9062,2015-12-18,POR,@,ORL,L 94-102,240,32,73,.438,21,41,.512,11,32,.344,19,26,.731,94
9063,2015-12-18,NYK,@,PHI,W 107-97,240,40,85,.471,34,66,.515,6,19,.316,21,28,.750,107
9064,2015-12-18,PHI,,NYK,L 97-107,240,37,77,.481,31,53,.585,6,24,.250,17,30,.567,97
9065,2015-12-18,NOP,@,PHO,L 88-104,240,26,71,.366,22,49,.449,4,22,.182,32,38,.842,88
9066,2015-12-18,PHO,,NOP,W 104-88,240,44,84,.524,38,68,.559,6,16,.375,10,17,.588,104
9067,2015-12-18,LAC,@,SAS,L 107-115,240,36,72,.500,26,48,.542,10,24,.417,25,40,.625,107
9068,2015-12-18,SAS,,LAC,W 115-107,240,43,87,.494,33,68,.485,10,19,.526,19,24,.792,115
9069,2015-12-18,DEN,@,UTA,L 88-97,240,31,79,.392,25,51,.490,6,28,.214,20,25,.800,88
9070,2015-12-18,UTA,,DEN,W 97-88,240,34,73,.466,24,48,.500,10,25,.400,19,25,.760,97
9071,2015-12-17,CHA,,TOR,W 109-99 (OT),265,37,85,.435,27,56,.482,10,29,.345,25,31,.806,109
9072,2015-12-17,TOR,@,CHO,L 99-109 (OT),265,35,97,.361,26,58,.448,9,39,.231,20,28,.714,99
9073,2015-12-17,CLE,,OKC,W 104-100,240,41,88,.466,29,59,.492,12,29,.414,10,13,.769,104
9074,2015-12-17,OKC,@,CLE,L 100-104,240,35,74,.473,29,54,.537,6,20,.300,24,28,.857,100
9075,2015-12-17,HOU,@,LAL,W 107-87,240,34,88,.386,22,57,.386,12,31,.387,27,42,.643,107
9076,2015-12-17,LAL,,HOU,L 87-107,240,36,84,.429,31,60,.517,5,24,.208,10,18,.556,87
9077,2015-12-16,ATL,,PHI,W 127-106,240,48,78,.615,38,57,.667,10,21,.476,21,24,.875,127
9078,2015-12-16,PHI,@,ATL,L 106-127,240,39,75,.520,27,49,.551,12,26,.462,16,24,.667,106
9079,2015-12-16,BRK,,MIA,L 98-104,240,42,89,.472,38,73,.521,4,16,.250,10,14,.714,98
9080,2015-12-16,MIA,@,BRK,W 104-98,240,40,75,.533,33,54,.611,7,21,.333,17,24,.708,104
9081,2015-12-16,CHI,,MEM,W 98-85,240,38,86,.442,29,62,.468,9,24,.375,13,19,.684,98
9082,2015-12-16,MEM,@,CHI,L 85-98,240,32,76,.421,27,57,.474,5,19,.263,16,28,.571,85
9083,2015-12-16,BOS,@,DET,L 116-119,240,43,89,.483,33,64,.516,10,25,.400,20,24,.833,116
9084,2015-12-16,DET,,BOS,W 119-116,240,38,78,.487,27,57,.474,11,21,.524,32,43,.744,119
9085,2015-12-16,GSW,,PHO,W 128-103,240,46,88,.523,31,56,.554,15,32,.469,21,27,.778,128
9086,2015-12-16,PHO,@,GSW,L 103-128,240,41,91,.451,36,69,.522,5,22,.227,16,18,.889,103
9087,2015-12-16,DAL,@,IND,L 81-107,240,33,90,.367,25,57,.439,8,33,.242,7,10,.700,81
9088,2015-12-16,IND,,DAL,W 107-81,240,43,89,.483,32,60,.533,11,29,.379,10,17,.588,107
9089,2015-12-16,LAC,,MIL,W 103-90,240,36,75,.480,25,54,.463,11,21,.524,20,24,.833,103
9090,2015-12-16,MIL,@,LAC,L 90-103,240,38,88,.432,33,72,.458,5,16,.313,9,11,.818,90
9091,2015-12-16,MIN,@,NYK,L 102-107,240,42,101,.416,38,80,.475,4,21,.190,14,14,1.000,102
9092,2015-12-16,NYK,,MIN,W 107-102,240,37,85,.435,29,64,.453,8,21,.381,25,30,.833,107
9093,2015-12-16,OKC,,POR,W 106-90,240,38,79,.481,36,65,.554,2,14,.143,28,37,.757,106
9094,2015-12-16,POR,@,OKC,L 90-106,240,32,92,.348,21,66,.318,11,26,.423,15,18,.833,90
9095,2015-12-16,CHA,@,ORL,L 98-113,240,36,79,.456,22,45,.489,14,34,.412,12,15,.800,98
9096,2015-12-16,ORL,,CHO,W 113-98,240,43,77,.558,29,53,.547,14,24,.583,13,15,.867,113
9097,2015-12-16,SAS,,WAS,W 114-95,240,44,83,.530,36,61,.590,8,22,.364,18,23,.783,114
9098,2015-12-16,WAS,@,SAS,L 95-114,240,35,84,.417,32,69,.464,3,15,.200,22,25,.880,95
9099,2015-12-16,NOP,@,UTA,W 104-94,240,34,73,.466,24,52,.462,10,21,.476,26,28,.929,104
9100,2015-12-16,UTA,,NOP,L 94-104,240,32,67,.478,25,47,.532,7,20,.350,23,29,.793,94
9101,2015-12-15,BOS,,CLE,L 77-89,240,28,87,.322,19,55,.345,9,32,.281,12,14,.857,77
9102,2015-12-15,CLE,@,BOS,W 89-77,240,36,78,.462,28,55,.509,8,23,.348,9,10,.900,89
9103,2015-12-15,LAL,,MIL,W 113-95,240,41,89,.461,31,62,.500,10,27,.370,21,25,.840,113
9104,2015-12-15,MIL,@,LAL,L 95-113,240,40,85,.471,36,72,.500,4,13,.308,11,20,.550,95
9105,2015-12-15,DEN,@,MIN,W 112-100,240,41,73,.562,31,55,.564,10,18,.556,20,27,.741,112
9106,2015-12-15,MIN,,DEN,L 100-112,240,36,77,.468,32,67,.478,4,10,.400,24,31,.774,100
9107,2015-12-15,HOU,@,SAC,L 97-107,240,34,82,.415,22,43,.512,12,39,.308,17,23,.739,97
9108,2015-12-15,SAC,,HOU,W 107-97,240,38,75,.507,27,51,.529,11,24,.458,20,29,.690,107
9109,2015-12-14,ATL,,MIA,L 88-100,240,33,84,.393,25,51,.490,8,33,.242,14,15,.933,88
9110,2015-12-14,MIA,@,ATL,W 100-88,240,40,89,.449,33,73,.452,7,16,.438,13,15,.867,100
9111,2015-12-14,BRK,,ORL,L 82-105,240,31,80,.388,24,61,.393,7,19,.368,13,16,.813,82
9112,2015-12-14,ORL,@,BRK,W 105-82,240,41,76,.539,32,55,.582,9,21,.429,14,20,.700,105
9113,2015-12-14,CHI,,PHI,W 115-96,240,43,85,.506,35,63,.556,8,22,.364,21,26,.808,115
9114,2015-12-14,PHI,@,CHI,L 96-115,240,38,92,.413,27,61,.443,11,31,.355,9,13,.692,96
9115,2015-12-14,DAL,,PHO,W 104-94,240,38,77,.494,26,45,.578,12,32,.375,16,21,.762,104
9116,2015-12-14,PHO,@,DAL,L 94-104,240,33,80,.413,24,55,.436,9,25,.360,19,27,.704,94
9117,2015-12-14,DEN,,HOU,W 114-108,240,42,82,.512,34,57,.596,8,25,.320,22,25,.880,114
9118,2015-12-14,HOU,@,DEN,L 108-114,240,41,87,.471,23,47,.489,18,40,.450,8,11,.727,108
9119,2015-12-14,DET,,LAC,L 103-105 (OT),265,37,89,.416,31,70,.443,6,19,.316,23,31,.742,103
9120,2015-12-14,LAC,@,DET,W 105-103 (OT),265,44,97,.454,38,78,.487,6,19,.316,11,15,.733,105
9121,2015-12-14,IND,,TOR,W 106-90,240,41,86,.477,31,64,.484,10,22,.455,14,16,.875,106
9122,2015-12-14,TOR,@,IND,L 90-106,240,29,79,.367,19,51,.373,10,28,.357,22,26,.846,90
9123,2015-12-14,MEM,,WAS,W 112-95,240,44,78,.564,34,63,.540,10,15,.667,14,15,.933,112
9124,2015-12-14,WAS,@,MEM,L 95-112,240,37,86,.430,28,62,.452,9,24,.375,12,20,.600,95
9125,2015-12-14,NOP,@,POR,L 101-105,240,36,82,.439,28,57,.491,8,25,.320,21,27,.778,101
9126,2015-12-14,POR,,NOP,W 105-101,240,35,81,.432,22,49,.449,13,32,.406,22,29,.759,105
9127,2015-12-14,SAS,,UTA,W 118-81,240,42,75,.560,33,54,.611,9,21,.429,25,27,.926,118
9128,2015-12-14,UTA,@,SAS,L 81-118,240,32,79,.405,29,68,.426,3,11,.273,14,17,.824,81
9129,2015-12-13,MEM,@,MIA,L 97-100,240,40,77,.519,33,58,.569,7,19,.368,10,14,.714,97
9130,2015-12-13,MIA,,MEM,W 100-97,240,37,77,.481,30,55,.545,7,22,.318,19,23,.826,100
9131,2015-12-13,OKC,,UTA,W 104-98 (OT),265,35,79,.443,28,58,.483,7,21,.333,27,30,.900,104
9132,2015-12-13,UTA,@,OKC,L 98-104 (OT),265,39,94,.415,31,72,.431,8,22,.364,12,20,.600,98
9133,2015-12-13,MIN,@,PHO,L 101-108,240,33,73,.452,25,54,.463,8,19,.421,27,34,.794,101
9134,2015-12-13,PHO,,MIN,W 108-101,240,39,87,.448,29,57,.509,10,30,.333,20,24,.833,108
9135,2015-12-13,PHI,@,TOR,L 76-96,240,28,84,.333,18,56,.321,10,28,.357,10,14,.714,76
9136,2015-12-13,TOR,,PHI,W 96-76,240,32,78,.410,25,56,.446,7,22,.318,25,34,.735,96
9137,2015-12-12,ATL,,SAS,L 78-103,240,30,80,.375,25,56,.446,5,24,.208,13,16,.813,78
9138,2015-12-12,SAS,@,ATL,W 103-78,240,36,74,.486,26,54,.481,10,20,.500,21,22,.955,103
9139,2015-12-12,BRK,,LAC,L 100-105,240,35,79,.443,30,60,.500,5,19,.263,25,30,.833,100
9140,2015-12-12,LAC,@,BRK,W 105-100,240,43,86,.500,35,62,.565,8,24,.333,11,18,.611,105
9141,2015-12-12,CHI,,NOP,W 98-94,240,33,78,.423,25,58,.431,8,20,.400,24,29,.828,98
9142,2015-12-12,NOP,@,CHI,L 94-98,240,40,89,.449,34,73,.466,6,16,.375,8,11,.727,94
9143,2015-12-12,BOS,@,CHO,W 98-93,240,40,96,.417,31,71,.437,9,25,.360,9,10,.900,98
9144,2015-12-12,CHA,,BOS,L 93-98,240,36,88,.409,25,53,.472,11,35,.314,10,10,1.000,93
9145,2015-12-12,DAL,,WAS,L 111-114,240,38,89,.427,24,56,.429,14,33,.424,21,24,.875,111
9146,2015-12-12,WAS,@,DAL,W 114-111,240,44,85,.518,30,56,.536,14,29,.483,12,15,.800,114
9147,2015-12-12,DET,,IND,W 118-96,240,45,90,.500,32,61,.525,13,29,.448,15,19,.789,118
9148,2015-12-12,IND,@,DET,L 96-118,240,41,82,.500,38,66,.576,3,16,.188,11,18,.611,96
9149,2015-12-12,HOU,,LAL,W 126-97,240,47,90,.522,32,57,.561,15,33,.455,17,28,.607,126
9150,2015-12-12,LAL,@,HOU,L 97-126,240,35,88,.398,25,56,.446,10,32,.313,17,20,.850,97
9151,2015-12-12,GSW,@,MIL,L 95-108,240,36,89,.404,30,62,.484,6,27,.222,17,25,.680,95
9152,2015-12-12,MIL,,GSW,W 108-95,240,44,90,.489,38,76,.500,6,14,.429,14,18,.778,108
9153,2015-12-12,NYK,@,POR,W 112-110,240,39,75,.520,30,54,.556,9,21,.429,25,28,.893,112
9154,2015-12-12,POR,,NYK,L 110-112,240,41,89,.461,35,68,.515,6,21,.286,22,29,.759,110
9155,2015-12-11,BOS,,GSW,L 119-124 (2OT),290,49,114,.430,37,81,.457,12,33,.364,9,16,.563,119
9156,2015-12-11,GSW,@,BOS,W 124-119 (2OT),290,42,107,.393,33,76,.434,9,31,.290,31,39,.795,124
9157,2015-12-11,DEN,,MIN,W 111-108 (OT),265,38,86,.442,27,58,.466,11,28,.393,24,33,.727,111
9158,2015-12-11,MIN,@,DEN,L 108-111 (OT),265,38,87,.437,31,68,.456,7,19,.368,25,29,.862,108
9159,2015-12-11,IND,,MIA,W 96-83,240,36,86,.419,30,58,.517,6,28,.214,18,20,.900,96
9160,2015-12-11,MIA,@,IND,L 83-96,240,35,81,.432,30,61,.492,5,20,.250,8,13,.615,83
9161,2015-12-11,CHA,@,MEM,W 123-99,240,39,78,.500,21,41,.512,18,37,.486,27,30,.900,123
9162,2015-12-11,MEM,,CHO,L 99-123,240,32,80,.400,25,60,.417,7,20,.350,28,37,.757,99
9163,2015-12-11,NOP,,WAS,W 107-105,240,39,79,.494,23,52,.442,16,27,.593,13,18,.722,107
9164,2015-12-11,WAS,@,NOP,L 105-107,240,40,80,.500,28,53,.528,12,27,.444,13,21,.619,105
9165,2015-12-11,CLE,@,ORL,W 111-76,240,41,72,.569,30,51,.588,11,21,.524,18,27,.667,111
9166,2015-12-11,ORL,,CLE,L 76-111,240,28,72,.389,22,50,.440,6,22,.273,14,20,.700,76
9167,2015-12-11,DET,@,PHI,W 107-95,240,43,93,.462,33,66,.500,10,27,.370,11,16,.688,107
9168,2015-12-11,PHI,,DET,L 95-107,240,36,80,.450,30,62,.484,6,18,.333,17,24,.708,95
9169,2015-12-11,PHO,,POR,L 96-106,240,36,83,.434,23,48,.479,13,35,.371,11,18,.611,96
9170,2015-12-11,POR,@,PHO,W 106-96,240,45,96,.469,33,62,.532,12,34,.353,4,7,.571,106
9171,2015-12-11,LAL,@,SAS,L 87-109,240,36,88,.409,27,63,.429,9,25,.360,6,10,.600,87
9172,2015-12-11,SAS,,LAL,W 109-87,240,44,82,.537,38,68,.559,6,14,.429,15,25,.600,109
9173,2015-12-11,MIL,@,TOR,L 83-90,240,33,80,.413,29,69,.420,4,11,.364,13,16,.813,83
9174,2015-12-11,TOR,,MIL,W 90-83,240,34,70,.486,27,50,.540,7,20,.350,15,23,.652,90
9175,2015-12-11,OKC,@,UTA,W 94-90,240,37,79,.468,31,62,.500,6,17,.353,14,16,.875,94
9176,2015-12-11,UTA,,OKC,L 90-94,240,33,78,.423,25,50,.500,8,28,.286,16,24,.667,90
9177,2015-12-10,BRK,,PHI,W 100-91,240,37,74,.500,31,60,.517,6,14,.429,20,27,.741,100
9178,2015-12-10,PHI,@,BRK,L 91-100,240,34,87,.391,30,56,.536,4,31,.129,19,22,.864,91
9179,2015-12-10,CHI,,LAC,W 83-80,240,31,87,.356,24,64,.375,7,23,.304,14,16,.875,83
9180,2015-12-10,LAC,@,CHI,L 80-83,240,30,88,.341,20,66,.303,10,22,.455,10,12,.833,80
9181,2015-12-10,ATL,@,OKC,L 94-107,240,35,78,.449,25,50,.500,10,28,.357,14,23,.609,94
9182,2015-12-10,OKC,,ATL,W 107-94,240,39,80,.488,30,63,.476,9,17,.529,20,26,.769,107
9183,2015-12-10,NYK,@,SAC,L 97-99,240,33,83,.398,24,54,.444,9,29,.310,22,28,.786,97
9184,2015-12-10,SAC,,NYK,W 99-97,240,42,93,.452,39,77,.506,3,16,.188,12,16,.750,99
9185,2015-12-09,BOS,,CHI,W 105-100,240,38,92,.413,33,69,.478,5,23,.217,24,28,.857,105
9186,2015-12-09,CHI,@,BOS,L 100-105,240,39,91,.429,33,70,.471,6,21,.286,16,23,.696,100
9187,2015-12-09,CHA,,MIA,W 99-81,240,40,81,.494,29,54,.537,11,27,.407,8,17,.471,99
9188,2015-12-09,MIA,@,CHO,L 81-99,240,29,75,.387,23,54,.426,6,21,.286,17,24,.708,81
9189,2015-12-09,ATL,@,DAL,W 98-95,240,39,81,.481,33,61,.541,6,20,.300,14,18,.778,98
9190,2015-12-09,DAL,,ATL,L 95-98,240,36,100,.360,29,69,.420,7,31,.226,16,19,.842,95
9191,2015-12-09,DET,,MEM,L 92-93,240,37,87,.425,29,58,.500,8,29,.276,10,15,.667,92
9192,2015-12-09,MEM,@,DET,W 93-92,240,41,88,.466,37,73,.507,4,15,.267,7,13,.538,93
9193,2015-12-09,LAC,@,MIL,W 109-95,240,38,81,.469,26,53,.491,12,28,.429,21,36,.583,109
9194,2015-12-09,MIL,,LAC,L 95-109,240,42,90,.467,40,80,.500,2,10,.200,9,12,.750,95
9195,2015-12-09,LAL,@,MIN,L 122-123 (OT),265,48,93,.516,39,70,.557,9,23,.391,17,27,.630,122
9196,2015-12-09,MIN,,LAL,W 123-122 (OT),265,46,93,.495,39,74,.527,7,19,.368,24,31,.774,123
9197,2015-12-09,ORL,@,PHO,L 104-107,240,40,85,.471,28,60,.467,12,25,.480,12,16,.750,104
9198,2015-12-09,PHO,,ORL,W 107-104,240,41,80,.513,35,56,.625,6,24,.250,19,27,.704,107
9199,2015-12-09,SAS,@,TOR,L 94-97,240,34,76,.447,27,51,.529,7,25,.280,19,24,.792,94
9200,2015-12-09,TOR,,SAS,W 97-94,240,37,64,.578,34,54,.630,3,10,.300,20,22,.909,97
9201,2015-12-09,NYK,@,UTA,L 85-106,240,31,78,.397,23,57,.404,8,21,.381,15,27,.556,85
9202,2015-12-09,UTA,,NYK,W 106-85,240,39,80,.488,30,59,.508,9,21,.429,19,23,.826,106
9203,2015-12-09,HOU,@,WAS,W 109-103,240,40,83,.482,28,50,.560,12,33,.364,17,25,.680,109
9204,2015-12-09,WAS,,HOU,L 103-109,240,39,89,.438,34,64,.531,5,25,.200,20,24,.833,103
9205,2015-12-08,BRK,,HOU,W 110-105,240,45,81,.556,38,63,.603,7,18,.389,13,16,.813,110
9206,2015-12-08,HOU,@,BRK,L 105-110,240,39,82,.476,24,47,.511,15,35,.429,12,17,.706,105
9207,2015-12-08,CLE,,POR,W 105-100,240,40,79,.506,31,58,.534,9,21,.429,16,20,.800,105
9208,2015-12-08,POR,@,CLE,L 100-105,240,40,79,.506,29,53,.547,11,26,.423,9,16,.563,100
9209,2015-12-08,DEN,,ORL,L 74-85,240,28,84,.333,21,60,.350,7,24,.292,11,20,.550,74
9210,2015-12-08,ORL,@,DEN,W 85-74,240,38,88,.432,37,72,.514,1,16,.063,8,10,.800,85
9211,2015-12-08,GSW,@,IND,W 131-123,240,52,95,.547,36,60,.600,16,35,.457,11,15,.733,131
9212,2015-12-08,IND,,GSW,L 123-131,240,44,100,.440,30,67,.448,14,33,.424,21,26,.808,123
9213,2015-12-08,MEM,,OKC,L 88-125,240,33,81,.407,30,67,.448,3,14,.214,19,22,.864,88
9214,2015-12-08,OKC,@,MEM,W 125-88,240,47,84,.560,34,58,.586,13,26,.500,18,23,.783,125
9215,2015-12-08,SAC,,UTA,W 114-106,240,43,77,.558,33,49,.673,10,28,.357,18,24,.750,114
9216,2015-12-08,UTA,@,SAC,L 106-114,240,38,92,.413,23,56,.411,15,36,.417,15,22,.682,106
9217,2015-12-07,CHI,,PHO,L 101-103,240,41,90,.456,35,69,.507,6,21,.286,13,18,.722,101
9218,2015-12-07,PHO,@,CHI,W 103-101,240,41,92,.446,34,75,.453,7,17,.412,14,17,.824,103
9219,2015-12-07,CHA,,DET,W 104-84,240,36,84,.429,28,58,.483,8,26,.308,24,35,.686,104
9220,2015-12-07,DET,@,CHO,L 84-104,240,32,87,.368,22,53,.415,10,34,.294,10,22,.455,84
9221,2015-12-07,MIA,,WAS,L 103-114,240,41,69,.594,36,53,.679,5,16,.313,16,22,.727,103
9222,2015-12-07,WAS,@,MIA,W 114-103,240,46,92,.500,37,74,.500,9,18,.500,13,17,.765,114
9223,2015-12-07,MIL,,POR,W 90-88,240,30,73,.411,26,60,.433,4,13,.308,26,33,.788,90
9224,2015-12-07,POR,@,MIL,L 88-90,240,33,85,.388,25,52,.481,8,33,.242,14,18,.778,88
9225,2015-12-07,LAC,@,MIN,W 110-106,240,38,86,.442,30,61,.492,8,25,.320,26,29,.897,110
9226,2015-12-07,MIN,,LAC,L 106-110,240,36,82,.439,29,64,.453,7,18,.389,27,35,.771,106
9227,2015-12-07,BOS,@,NOP,W 111-93,240,40,81,.494,28,53,.528,12,28,.429,19,24,.792,111
9228,2015-12-07,NOP,,BOS,L 93-111,240,37,90,.411,33,77,.429,4,13,.308,15,18,.833,93
9229,2015-12-07,DAL,@,NYK,W 104-97,240,37,82,.451,24,51,.471,13,31,.419,17,20,.850,104
9230,2015-12-07,NYK,,DAL,L 97-104,240,40,84,.476,31,59,.525,9,25,.360,8,9,.889,97
9231,2015-12-07,PHI,,SAS,L 68-119,240,26,75,.347,22,51,.431,4,24,.167,12,21,.571,68
9232,2015-12-07,SAS,@,PHI,W 119-68,240,47,76,.618,43,65,.662,4,11,.364,21,25,.840,119
9233,2015-12-07,LAL,@,TOR,L 93-102,240,34,83,.410,27,64,.422,7,19,.368,18,20,.900,93
9234,2015-12-07,TOR,,LAL,W 102-93,240,34,74,.459,25,49,.510,9,25,.360,25,32,.781,102
9235,2015-12-06,BRK,,GSW,L 98-114,240,39,89,.438,34,72,.472,5,17,.294,15,23,.652,98
9236,2015-12-06,GSW,@,BRK,W 114-98,240,44,86,.512,30,53,.566,14,33,.424,12,23,.522,114
9237,2015-12-06,DET,,LAL,W 111-91,240,41,93,.441,32,69,.464,9,24,.375,20,26,.769,111
9238,2015-12-06,LAL,@,DET,L 91-111,240,32,80,.400,27,62,.435,5,18,.278,22,29,.759,91
9239,2015-12-06,MEM,,PHO,W 95-93,240,36,90,.400,31,75,.413,5,15,.333,18,24,.750,95
9240,2015-12-06,PHO,@,MEM,L 93-95,240,36,82,.439,27,51,.529,9,31,.290,12,17,.706,93
9241,2015-12-06,OKC,,SAC,W 98-95,240,35,86,.407,29,64,.453,6,22,.273,22,31,.710,98
9242,2015-12-06,SAC,@,OKC,L 95-98,240,35,88,.398,28,64,.438,7,24,.292,18,30,.600,95
9243,2015-12-06,DAL,@,WAS,W 116-104,240,38,76,.500,22,45,.489,16,31,.516,24,27,.889,116
9244,2015-12-06,WAS,,DAL,L 104-116,240,42,89,.472,34,62,.548,8,27,.296,12,21,.571,104
9245,2015-12-05,CHI,,CHO,L 96-102,240,37,89,.416,28,64,.438,9,25,.360,13,19,.684,96
9246,2015-12-05,CHA,@,CHI,W 102-96,240,37,89,.416,27,55,.491,10,34,.294,18,25,.720,102
9247,2015-12-05,HOU,,SAC,W 120-113,240,36,78,.462,20,44,.455,16,34,.471,32,43,.744,120
9248,2015-12-05,SAC,@,HOU,L 113-120,240,46,98,.469,36,72,.500,10,26,.385,11,13,.846,113
9249,2015-12-05,LAC,,ORL,W 103-101,240,37,82,.451,25,51,.490,12,31,.387,17,25,.680,103
9250,2015-12-05,ORL,@,LAC,L 101-103,240,40,90,.444,34,70,.486,6,20,.300,15,18,.833,101
9251,2015-12-05,CLE,@,MIA,L 84-99,240,31,85,.365,25,57,.439,6,28,.214,16,24,.667,84
9252,2015-12-05,MIA,,CLE,W 99-84,240,37,68,.544,30,52,.577,7,16,.438,18,29,.621,99
9253,2015-12-05,MIL,,NYK,W 106-91,240,44,89,.494,42,85,.494,2,4,.500,16,24,.667,106
9254,2015-12-05,NYK,@,MIL,L 91-106,240,32,76,.421,26,51,.510,6,25,.240,21,28,.750,91
9255,2015-12-05,MIN,,POR,L 103-109,240,38,83,.458,33,68,.485,5,15,.333,22,26,.846,103
9256,2015-12-05,POR,@,MIN,W 109-103,240,39,77,.506,29,57,.509,10,20,.500,21,30,.700,109
9257,2015-12-05,DEN,@,PHI,W 108-105,240,37,81,.457,26,50,.520,11,31,.355,23,38,.605,108
9258,2015-12-05,PHI,,DEN,L 105-108,240,37,74,.500,22,43,.512,15,31,.484,16,26,.615,105
9259,2015-12-05,BOS,@,SAS,L 105-108,240,39,86,.453,27,57,.474,12,29,.414,15,22,.682,105
9260,2015-12-05,SAS,,BOS,W 108-105,240,44,83,.530,39,66,.591,5,17,.294,15,22,.682,108
9261,2015-12-05,GSW,@,TOR,W 112-109,240,35,73,.479,19,43,.442,16,30,.533,26,36,.722,112
9262,2015-12-05,TOR,,GSW,L 109-112,240,40,91,.440,32,71,.451,8,20,.400,21,26,.808,109
9263,2015-12-05,IND,@,UTA,L 119-122 (OT),265,40,93,.430,28,64,.438,12,29,.414,27,34,.794,119
9264,2015-12-05,UTA,,IND,W 122-119 (OT),265,43,92,.467,35,69,.507,8,23,.348,28,37,.757,122
9265,2015-12-04,ATL,,LAL,W 100-87,240,37,74,.500,27,48,.563,10,26,.385,16,20,.800,100
9266,2015-12-04,LAL,@,ATL,L 87-100,240,32,86,.372,19,59,.322,13,27,.481,10,13,.769,87
9267,2015-12-04,DAL,,HOU,L 96-100,240,37,81,.457,29,52,.558,8,29,.276,14,20,.700,96
9268,2015-12-04,HOU,@,DAL,W 100-96,240,39,84,.464,27,58,.466,12,26,.462,10,18,.556,100
9269,2015-12-04,DET,,MIL,W 102-95,240,34,82,.415,27,59,.458,7,23,.304,27,39,.692,102
9270,2015-12-04,MIL,@,DET,L 95-102,240,39,87,.448,35,69,.507,4,18,.222,13,14,.929,95
9271,2015-12-04,CLE,@,NOP,L 108-114 (OT),265,39,89,.438,29,56,.518,10,33,.303,20,24,.833,108
9272,2015-12-04,NOP,,CLE,W 114-108 (OT),265,42,85,.494,33,60,.550,9,25,.360,21,31,.677,114
9273,2015-12-04,BRK,@,NYK,L 91-108,240,39,91,.429,36,80,.450,3,11,.273,10,15,.667,91
9274,2015-12-04,NYK,,BRK,W 108-91,240,39,87,.448,27,60,.450,12,27,.444,18,21,.857,108
9275,2015-12-04,PHO,@,WAS,L 106-109,240,43,84,.512,33,61,.541,10,23,.435,10,16,.625,106
9276,2015-12-04,WAS,,PHO,W 109-106,240,40,82,.488,30,56,.536,10,26,.385,19,25,.760,109
9277,2015-12-03,MEM,,SAS,L 83-103,240,30,80,.375,28,64,.438,2,16,.125,21,25,.840,83
9278,2015-12-03,SAS,@,MEM,W 103-83,240,40,80,.500,30,62,.484,10,18,.556,13,18,.722,103
9279,2015-12-03,MIA,,OKC,W 97-95,240,40,81,.494,37,68,.544,3,13,.231,14,24,.583,97
9280,2015-12-03,OKC,@,MIA,L 95-97,240,35,79,.443,31,63,.492,4,16,.250,21,24,.875,95
9281,2015-12-03,IND,@,POR,L 111-123,240,38,88,.432,25,58,.431,13,30,.433,22,24,.917,111
9282,2015-12-03,POR,,IND,W 123-111,240,44,85,.518,26,49,.531,18,36,.500,17,20,.850,123
9283,2015-12-03,BOS,@,SAC,W 114-97,240,40,84,.476,26,51,.510,14,33,.424,20,24,.833,114
9284,2015-12-03,SAC,,BOS,L 97-114,240,29,77,.377,22,56,.393,7,21,.333,32,41,.780,97
9285,2015-12-03,DEN,@,TOR,W 106-105,240,38,81,.469,26,54,.481,12,27,.444,18,18,1.000,106
9286,2015-12-03,TOR,,DEN,L 105-106,240,39,92,.424,31,65,.477,8,27,.296,19,22,.864,105
9287,2015-12-03,ORL,@,UTA,W 103-94,240,40,89,.449,32,66,.485,8,23,.348,15,15,1.000,103
9288,2015-12-03,UTA,,ORL,L 94-103,240,31,72,.431,17,39,.436,14,33,.424,18,24,.750,94
9289,2015-12-02,ATL,,TOR,L 86-96,240,33,90,.367,25,63,.397,8,27,.296,12,16,.750,86
9290,2015-12-02,TOR,@,ATL,W 96-86,240,36,79,.456,30,54,.556,6,25,.240,18,24,.750,96
9291,2015-12-02,CHI,,DEN,W 99-90,240,36,89,.404,30,72,.417,6,17,.353,21,27,.778,99
9292,2015-12-02,DEN,@,CHI,L 90-99,240,36,93,.387,31,78,.397,5,15,.333,13,22,.591,90
9293,2015-12-02,CHA,,GSW,L 99-116,240,35,94,.372,26,63,.413,9,31,.290,20,30,.667,99
9294,2015-12-02,GSW,@,CHO,W 116-99,240,46,88,.523,30,54,.556,16,34,.471,8,11,.727,116
9295,2015-12-02,DET,,PHO,W 127-122 (OT),265,44,87,.506,32,60,.533,12,27,.444,27,44,.614,127
9296,2015-12-02,PHO,@,DET,L 122-127 (OT),265,47,97,.485,33,64,.516,14,33,.424,14,15,.933,122
9297,2015-12-02,HOU,,NOP,W 108-101,240,36,87,.414,28,60,.467,8,27,.296,28,39,.718,108
9298,2015-12-02,NOP,@,HOU,L 101-108,240,36,88,.409,29,63,.460,7,25,.280,22,25,.880,101
9299,2015-12-02,IND,@,LAC,W 103-91,240,32,76,.421,25,56,.446,7,20,.350,32,39,.821,103
9300,2015-12-02,LAC,,IND,L 91-103,240,30,79,.380,24,52,.462,6,27,.222,25,39,.641,91
9301,2015-12-02,NYK,,PHI,W 99-87,240,38,88,.432,34,69,.493,4,19,.211,19,22,.864,99
9302,2015-12-02,PHI,@,NYK,L 87-99,240,32,86,.372,23,56,.411,9,30,.300,14,24,.583,87
9303,2015-12-02,MIL,@,SAS,L 70-95,240,26,78,.333,23,64,.359,3,14,.214,15,18,.833,70
9304,2015-12-02,SAS,,MIL,W 95-70,240,37,90,.411,30,69,.435,7,21,.333,14,20,.700,95
9305,2015-12-02,LAL,@,WAS,W 108-104,240,41,96,.427,33,71,.465,8,25,.320,18,20,.900,108
9306,2015-12-02,WAS,,LAL,L 104-108,240,37,79,.468,30,58,.517,7,21,.333,23,31,.742,104
9307,2015-12-01,BRK,,PHO,W 94-91,240,41,84,.488,37,71,.521,4,13,.308,8,12,.667,94
9308,2015-12-01,PHO,@,BRK,L 91-94,240,33,75,.440,23,47,.489,10,28,.357,15,22,.682,91
9309,2015-12-01,CLE,,WAS,L 85-97,240,28,83,.337,19,53,.358,9,30,.300,20,23,.870,85
9310,2015-12-01,WAS,@,CLE,W 97-85,240,39,83,.470,32,55,.582,7,28,.250,12,16,.750,97
9311,2015-12-01,MIN,,ORL,L 93-96,240,29,77,.377,25,58,.431,4,19,.211,31,38,.816,93
9312,2015-12-01,ORL,@,MIN,W 96-93,240,38,86,.442,33,69,.478,5,17,.294,15,20,.750,96
9313,2015-12-01,MEM,@,NOP,W 113-104,240,43,90,.478,41,80,.513,2,10,.200,25,26,.962,113
9314,2015-12-01,NOP,,MEM,L 104-113,240,35,81,.432,26,54,.481,9,27,.333,25,33,.758,104
9315,2015-12-01,LAL,@,PHI,L 91-103,240,33,89,.371,25,55,.455,8,34,.235,17,24,.708,91
9316,2015-12-01,PHI,,LAL,W 103-91,240,37,79,.468,23,47,.489,14,32,.438,15,23,.652,103
9317,2015-12-01,DAL,@,POR,W 115-112 (OT),265,43,94,.457,34,65,.523,9,29,.310,20,24,.833,115
9318,2015-12-01,POR,,DAL,L 112-115 (OT),265,41,100,.410,26,60,.433,15,40,.375,15,17,.882,112
9319,2015-11-30,ATL,,OKC,W 106-100,240,39,90,.433,29,62,.468,10,28,.357,18,20,.900,106
9320,2015-11-30,OKC,@,ATL,L 100-106,240,37,93,.398,30,74,.405,7,19,.368,19,22,.864,100
9321,2015-11-30,CHI,,SAS,W 92-89,240,37,86,.430,31,70,.443,6,16,.375,12,20,.600,92
9322,2015-11-30,SAS,@,CHI,L 89-92,240,37,90,.411,35,76,.461,2,14,.143,13,18,.722,89
9323,2015-11-30,DET,,HOU,W 116-105,240,45,85,.529,37,62,.597,8,23,.348,18,37,.486,116
9324,2015-11-30,HOU,@,DET,L 105-116,240,35,88,.398,24,61,.393,11,27,.407,24,28,.857,105
9325,2015-11-30,LAC,,POR,W 102-87,240,33,85,.388,25,66,.379,8,19,.421,28,56,.500,102
9326,2015-11-30,POR,@,LAC,L 87-102,240,33,87,.379,28,64,.438,5,23,.217,16,27,.593,87
9327,2015-11-30,BOS,@,MIA,W 105-95,240,38,80,.475,30,60,.500,8,20,.400,21,25,.840,105
9328,2015-11-30,MIA,,BOS,L 95-105,240,36,75,.480,31,58,.534,5,17,.294,18,24,.750,95
9329,2015-11-30,DEN,@,MIL,L 74-92,240,28,75,.373,22,56,.393,6,19,.316,12,16,.750,74
9330,2015-11-30,MIL,,DEN,W 92-74,240,35,77,.455,29,59,.492,6,18,.333,16,22,.727,92
9331,2015-11-30,DAL,@,SAC,L 98-112,240,36,84,.429,27,47,.574,9,37,.243,17,22,.773,98
9332,2015-11-30,SAC,,DAL,W 112-98,240,36,79,.456,27,48,.563,9,31,.290,31,44,.705,112
9333,2015-11-30,GSW,@,UTA,W 106-103,240,40,82,.488,26,53,.491,14,29,.483,12,15,.800,106
9334,2015-11-30,UTA,,GSW,L 103-106,240,40,89,.449,34,70,.486,6,19,.316,17,22,.773,103
9335,2015-11-29,BRK,,DET,W 87-83,240,35,81,.432,31,69,.449,4,12,.333,13,16,.813,87
9336,2015-11-29,DET,@,BRK,L 83-87,240,34,101,.337,28,77,.364,6,24,.250,9,21,.429,83
9337,2015-11-29,CHA,,MIL,W 87-82,240,27,70,.386,12,39,.308,15,31,.484,18,22,.818,87
9338,2015-11-29,MIL,@,CHO,L 82-87,240,33,82,.402,25,54,.463,8,28,.286,8,14,.571,82
9339,2015-11-29,LAC,,MIN,W 107-99,240,39,75,.520,31,53,.585,8,22,.364,21,33,.636,107
9340,2015-11-29,MIN,@,LAC,L 99-107,240,37,82,.451,29,66,.439,8,16,.500,17,21,.810,99
9341,2015-11-29,IND,@,LAL,W 107-103,240,34,83,.410,25,56,.446,9,27,.333,30,37,.811,107
9342,2015-11-29,LAL,,IND,L 103-107,240,38,99,.384,27,66,.409,11,33,.333,16,22,.727,103
9343,2015-11-29,MEM,,PHI,W 92-84,240,34,81,.420,30,68,.441,4,13,.308,20,27,.741,92
9344,2015-11-29,PHI,@,MEM,L 84-92,240,30,77,.390,18,41,.439,12,36,.333,12,16,.750,84
9345,2015-11-29,HOU,@,NYK,W 116-111 (OT),265,43,95,.453,36,70,.514,7,25,.280,23,36,.639,116
9346,2015-11-29,NYK,,HOU,L 111-116 (OT),265,45,78,.577,39,60,.650,6,18,.333,15,17,.882,111
9347,2015-11-29,BOS,@,ORL,L 91-110,240,36,88,.409,31,61,.508,5,27,.185,14,20,.700,91
9348,2015-11-29,ORL,,BOS,W 110-91,240,45,93,.484,36,68,.529,9,25,.360,11,16,.688,110
9349,2015-11-29,PHO,@,TOR,W 107-102,240,40,94,.426,29,67,.433,11,27,.407,16,20,.800,107
9350,2015-11-29,TOR,,PHO,L 102-107,240,38,86,.442,26,57,.456,12,29,.414,14,17,.824,102
9351,2015-11-28,BRK,@,CLE,L 88-90,240,33,81,.407,29,64,.453,4,17,.235,18,24,.750,88
9352,2015-11-28,CLE,,BRK,W 90-88,240,35,87,.402,26,60,.433,9,27,.333,11,17,.647,90
9353,2015-11-28,DAL,,DEN,W 92-81,240,33,77,.429,26,51,.510,7,26,.269,19,27,.704,92
9354,2015-11-28,DEN,@,DAL,L 81-92,240,30,75,.400,22,50,.440,8,25,.320,13,17,.765,81
9355,2015-11-28,GSW,,SAC,W 120-101,240,39,80,.488,23,50,.460,16,30,.533,26,31,.839,120
9356,2015-11-28,SAC,@,GSW,L 101-120,240,39,100,.390,29,75,.387,10,25,.400,13,15,.867,101
9357,2015-11-28,LAL,@,POR,L 96-108,240,36,82,.439,29,59,.492,7,23,.304,17,23,.739,96
9358,2015-11-28,POR,,LAL,W 108-96,240,38,78,.487,26,48,.542,12,30,.400,20,26,.769,108
9359,2015-11-28,ATL,@,SAS,L 88-108,240,37,87,.425,31,61,.508,6,26,.231,8,13,.615,88
9360,2015-11-28,SAS,,ATL,W 108-88,240,40,85,.471,31,68,.456,9,17,.529,19,20,.950,108
9361,2015-11-28,NOP,@,UTA,L 87-101,240,29,69,.420,24,52,.462,5,17,.294,24,30,.800,87
9362,2015-11-28,UTA,,NOP,W 101-87,240,38,82,.463,29,64,.453,9,18,.500,16,21,.762,101
9363,2015-11-28,TOR,@,WAS,W 84-82,240,31,72,.431,20,48,.417,11,24,.458,11,14,.786,84
9364,2015-11-28,WAS,,TOR,L 82-84,240,27,82,.329,20,59,.339,7,23,.304,21,27,.778,82
9365,2015-11-27,BOS,,WAS,W 111-78,240,42,97,.433,30,64,.469,12,33,.364,15,19,.789,111
9366,2015-11-27,WAS,@,BOS,L 78-111,240,27,84,.321,22,66,.333,5,18,.278,19,22,.864,78
9367,2015-11-27,CHA,,CLE,L 90-95,240,33,80,.413,28,55,.509,5,25,.200,19,25,.760,90
9368,2015-11-27,CLE,@,CHO,W 95-90,240,34,81,.420,26,56,.464,8,25,.320,19,25,.760,95
9369,2015-11-27,DEN,,SAS,L 80-91,240,31,77,.403,24,57,.421,7,20,.350,11,13,.846,80
9370,2015-11-27,SAS,@,DEN,W 91-80,240,36,75,.480,28,53,.528,8,22,.364,11,14,.786,91
9371,2015-11-27,HOU,,PHI,W 116-114,240,38,73,.521,27,53,.509,11,20,.550,29,37,.784,116
9372,2015-11-27,PHI,@,HOU,L 114-116,240,40,83,.482,24,48,.500,16,35,.457,18,26,.692,114
9373,2015-11-27,CHI,@,IND,L 92-104,240,32,92,.348,21,66,.318,11,26,.423,17,20,.850,92
9374,2015-11-27,IND,,CHI,W 104-92,240,37,87,.425,29,59,.492,8,28,.286,22,29,.759,104
9375,2015-11-27,LAC,,NOP,W 111-90,240,40,83,.482,33,64,.516,7,19,.368,24,30,.800,111
9376,2015-11-27,NOP,@,LAC,L 90-111,240,34,94,.362,29,74,.392,5,20,.250,17,23,.739,90
9377,2015-11-27,ATL,@,MEM,W 116-101,240,35,75,.467,21,36,.583,14,39,.359,32,36,.889,116
9378,2015-11-27,MEM,,ATL,L 101-116,240,35,80,.438,23,50,.460,12,30,.400,19,21,.905,101
9379,2015-11-27,MIA,@,NYK,W 97-78,240,33,76,.434,26,59,.441,7,17,.412,24,28,.857,97
9380,2015-11-27,NYK,,MIA,L 78-97,240,32,85,.376,29,71,.408,3,14,.214,11,15,.733,78
9381,2015-11-27,DET,@,OKC,L 87-103,240,31,90,.344,22,61,.361,9,29,.310,16,20,.800,87
9382,2015-11-27,OKC,,DET,W 103-87,240,37,79,.468,30,55,.545,7,24,.292,22,26,.846,103
9383,2015-11-27,MIL,@,ORL,L 90-114,240,31,74,.419,23,48,.479,8,26,.308,20,22,.909,90
9384,2015-11-27,ORL,,MIL,W 114-90,240,43,82,.524,31,55,.564,12,27,.444,16,22,.727,114
9385,2015-11-27,GSW,@,PHO,W 135-116,240,46,81,.568,24,43,.558,22,38,.579,21,31,.677,135
9386,2015-11-27,PHO,,GSW,L 116-135,240,45,92,.489,35,66,.530,10,26,.385,16,23,.696,116
9387,2015-11-27,MIN,@,SAC,W 101-91,240,37,77,.481,28,52,.538,9,25,.360,18,19,.947,101
9388,2015-11-27,SAC,,MIN,L 91-101,240,37,86,.430,29,64,.453,8,22,.364,9,15,.600,91
9389,2015-11-25,BOS,,PHI,W 84-80,240,31,91,.341,22,62,.355,9,29,.310,13,18,.722,84
9390,2015-11-25,PHI,@,BOS,L 80-84,240,31,83,.373,24,56,.429,7,27,.259,11,15,.733,80
9391,2015-11-25,CHA,,WAS,W 101-87,240,39,83,.470,31,57,.544,8,26,.308,15,15,1.000,101
9392,2015-11-25,WAS,@,CHO,L 87-101,240,31,87,.356,21,55,.382,10,32,.313,15,18,.833,87
9393,2015-11-25,DET,,MIA,W 104-81,240,41,98,.418,25,67,.373,16,31,.516,6,7,.857,104
9394,2015-11-25,MIA,@,DET,L 81-104,240,32,79,.405,26,59,.441,6,20,.300,11,16,.688,81
9395,2015-11-25,HOU,,MEM,L 93-102,240,30,71,.423,20,37,.541,10,34,.294,23,27,.852,93
9396,2015-11-25,MEM,@,HOU,W 102-93,240,39,80,.488,36,64,.563,3,16,.188,21,23,.913,102
9397,2015-11-25,LAC,,UTA,L 91-102,240,38,75,.507,34,63,.540,4,12,.333,11,17,.647,91
9398,2015-11-25,UTA,@,LAC,W 102-91,240,39,77,.506,33,64,.516,6,13,.462,18,25,.720,102
9399,2015-11-25,MIL,,SAC,L 118-129,240,42,88,.477,29,57,.509,13,31,.419,21,27,.778,118
9400,2015-11-25,SAC,@,MIL,W 129-118,240,44,77,.571,34,54,.630,10,23,.435,31,37,.838,129
9401,2015-11-25,ATL,@,MIN,L 95-99,240,31,82,.378,23,51,.451,8,31,.258,25,35,.714,95
9402,2015-11-25,MIN,,ATL,W 99-95,240,34,82,.415,25,61,.410,9,21,.429,22,29,.759,99
9403,2015-11-25,BRK,@,OKC,L 99-110,240,43,94,.457,40,81,.494,3,13,.231,10,12,.833,99
9404,2015-11-25,OKC,,BRK,W 110-99,240,41,78,.526,31,54,.574,10,24,.417,18,21,.857,110
9405,2015-11-25,NYK,@,ORL,L 91-100,240,31,83,.373,22,56,.393,9,27,.333,20,25,.800,91
9406,2015-11-25,ORL,,NYK,W 100-91,240,34,86,.395,29,70,.414,5,16,.313,27,32,.844,100
9407,2015-11-25,NOP,@,PHO,W 120-114,240,42,81,.519,32,59,.542,10,22,.455,26,34,.765,120
9408,2015-11-25,PHO,,NOP,L 114-120,240,44,96,.458,34,70,.486,10,26,.385,16,20,.800,114
9409,2015-11-25,DAL,@,SAS,L 83-88,240,34,83,.410,28,61,.459,6,22,.273,9,12,.750,83
9410,2015-11-25,SAS,,DAL,W 88-83,240,33,81,.407,25,53,.472,8,28,.286,14,19,.737,88
9411,2015-11-25,CLE,@,TOR,L 99-103,240,36,82,.439,22,53,.415,14,29,.483,13,16,.813,99
9412,2015-11-25,TOR,,CLE,W 103-99,240,40,79,.506,29,54,.537,11,25,.440,12,22,.545,103
9413,2015-11-24,ATL,,BOS,W 121-97,240,45,80,.563,33,56,.589,12,24,.500,19,22,.864,121
9414,2015-11-24,BOS,@,ATL,L 97-121,240,34,82,.415,25,61,.410,9,21,.429,20,26,.769,97
9415,2015-11-24,DEN,,LAC,L 94-111,240,31,78,.397,23,53,.434,8,25,.320,24,29,.828,94
9416,2015-11-24,LAC,@,DEN,W 111-94,240,37,79,.468,29,59,.492,8,20,.400,29,47,.617,111
9417,2015-11-24,GSW,,LAL,W 111-77,240,45,92,.489,33,57,.579,12,35,.343,9,15,.600,111
9418,2015-11-24,LAL,@,GSW,L 77-111,240,31,83,.373,28,62,.452,3,21,.143,12,16,.750,77
9419,2015-11-24,DAL,@,MEM,L 96-110,240,30,77,.390,19,43,.442,11,34,.324,25,28,.893,96
9420,2015-11-24,MEM,,DAL,W 110-96,240,37,86,.430,30,65,.462,7,21,.333,29,37,.784,110
9421,2015-11-24,CHI,@,POR,W 93-88,240,33,86,.384,26,68,.382,7,18,.389,20,23,.870,93
9422,2015-11-24,POR,,CHI,L 88-93,240,31,88,.352,25,66,.379,6,22,.273,20,27,.741,88
9423,2015-11-24,IND,@,WAS,W 123-106,240,44,80,.550,25,54,.463,19,26,.731,16,23,.696,123
9424,2015-11-24,WAS,,IND,L 106-123,240,38,83,.458,25,50,.500,13,33,.394,17,24,.708,106
9425,2015-11-23,CHA,,SAC,W 127-122 (OT),265,49,98,.500,40,69,.580,9,29,.310,20,26,.769,127
9426,2015-11-23,SAC,@,CHO,L 122-127 (OT),265,52,104,.500,44,73,.603,8,31,.258,10,16,.625,122
9427,2015-11-23,CLE,,ORL,W 117-103,240,43,81,.531,25,46,.543,18,35,.514,13,22,.591,117
9428,2015-11-23,ORL,@,CLE,L 103-117,240,40,81,.494,30,59,.508,10,22,.455,13,21,.619,103
9429,2015-11-23,MIA,,NYK,W 95-78,240,31,81,.383,26,62,.419,5,19,.263,28,36,.778,95
9430,2015-11-23,NYK,@,MIA,L 78-95,240,28,87,.322,24,63,.381,4,24,.167,18,21,.857,78
9431,2015-11-23,DET,@,MIL,L 88-109,240,31,91,.341,25,63,.397,6,28,.214,20,24,.833,88
9432,2015-11-23,MIL,,DET,W 109-88,240,43,83,.518,34,70,.486,9,13,.692,14,17,.824,109
9433,2015-11-23,MIN,,PHI,W 100-95,240,36,78,.462,33,66,.500,3,12,.250,25,27,.926,100
9434,2015-11-23,PHI,@,MIN,L 95-100,240,32,78,.410,22,47,.468,10,31,.323,21,27,.778,95
9435,2015-11-23,PHO,@,SAS,L 84-98,240,34,73,.466,27,54,.500,7,19,.368,9,10,.900,84
9436,2015-11-23,SAS,,PHO,W 98-84,240,42,82,.512,33,62,.532,9,20,.450,5,10,.500,98
9437,2015-11-23,OKC,@,UTA,W 111-89,240,42,77,.545,31,50,.620,11,27,.407,16,18,.889,111
9438,2015-11-23,UTA,,OKC,L 89-111,240,28,73,.384,23,54,.426,5,19,.263,28,40,.700,89
9439,2015-11-22,BOS,@,BRK,L 101-111,240,35,82,.427,21,45,.467,14,37,.378,17,21,.810,101
9440,2015-11-22,BRK,,BOS,W 111-101,240,40,79,.506,35,64,.547,5,15,.333,26,33,.788,111
9441,2015-11-22,DEN,,GSW,L 105-118,240,37,86,.430,33,71,.465,4,15,.267,27,35,.771,105
9442,2015-11-22,GSW,@,DEN,W 118-105,240,47,89,.528,32,60,.533,15,29,.517,9,13,.692,118
9443,2015-11-22,LAC,,TOR,L 80-91,240,29,74,.392,22,42,.524,7,32,.219,15,20,.750,80
9444,2015-11-22,TOR,@,LAC,W 91-80,240,29,78,.372,25,61,.410,4,17,.235,29,31,.935,91
9445,2015-11-22,LAL,,POR,L 93-107,240,32,88,.364,26,70,.371,6,18,.333,23,27,.852,93
9446,2015-11-22,POR,@,LAL,W 107-93,240,43,87,.494,35,62,.565,8,25,.320,13,17,.765,107
9447,2015-11-22,NOP,,PHO,W 122-116,240,39,85,.459,28,55,.509,11,30,.367,33,40,.825,122
9448,2015-11-22,PHO,@,NOP,L 116-122,240,35,90,.389,18,54,.333,17,36,.472,29,33,.879,116
9449,2015-11-22,DAL,@,OKC,L 114-117,240,44,83,.530,34,64,.531,10,19,.526,16,28,.571,114
9450,2015-11-22,OKC,,DAL,W 117-114,240,47,90,.522,38,68,.559,9,22,.409,14,18,.778,117
9451,2015-11-21,ATL,@,CLE,L 97-109,240,32,86,.372,21,58,.362,11,28,.393,22,25,.880,97
9452,2015-11-21,CLE,,ATL,W 109-97,240,41,85,.482,30,56,.536,11,29,.379,16,19,.842,109
9453,2015-11-21,DET,,WAS,L 95-97,240,36,79,.456,28,53,.528,8,26,.308,15,21,.714,95
9454,2015-11-21,WAS,@,DET,W 97-95,240,38,78,.487,31,59,.525,7,19,.368,14,20,.700,97
9455,2015-11-21,HOU,,NYK,L 102-107,240,35,81,.432,23,53,.434,12,28,.429,20,28,.714,102
9456,2015-11-21,NYK,@,HOU,W 107-102,240,34,80,.425,22,55,.400,12,25,.480,27,34,.794,107
9457,2015-11-21,IND,,MIL,W 123-86,240,47,91,.516,32,61,.525,15,30,.500,14,23,.609,123
9458,2015-11-21,MIL,@,IND,L 86-123,240,34,79,.430,29,62,.468,5,17,.294,13,19,.684,86
9459,2015-11-21,MIA,,PHI,W 96-91,240,30,69,.435,25,51,.490,5,18,.278,31,45,.689,96
9460,2015-11-21,PHI,@,MIA,L 91-96,240,31,82,.378,21,51,.412,10,31,.323,19,24,.792,91
9461,2015-11-21,ORL,,SAC,L 91-97,240,38,92,.413,29,61,.475,9,31,.290,6,8,.750,91
9462,2015-11-21,SAC,@,ORL,W 97-91,240,31,81,.383,24,61,.393,7,20,.350,28,31,.903,97
9463,2015-11-21,MEM,@,SAS,L 82-92,240,32,74,.432,31,65,.477,1,9,.111,17,17,1.000,82
9464,2015-11-21,SAS,,MEM,W 92-82,240,34,72,.472,27,51,.529,7,21,.333,17,22,.773,92
9465,2015-11-20,BOS,,BRK,W 120-95,240,51,87,.586,41,58,.707,10,29,.345,8,10,.800,120
9466,2015-11-20,BRK,@,BOS,L 95-120,240,35,89,.393,27,70,.386,8,19,.421,17,24,.708,95
9467,2015-11-20,CHA,,PHI,W 113-88,240,40,81,.494,28,56,.500,12,25,.480,21,22,.955,113
9468,2015-11-20,PHI,@,CHO,L 88-113,240,32,79,.405,24,53,.453,8,26,.308,16,22,.727,88
9469,2015-11-20,DAL,,UTA,W 102-93,240,39,83,.470,31,55,.564,8,28,.286,16,17,.941,102
9470,2015-11-20,UTA,@,DAL,L 93-102,240,35,80,.438,29,60,.483,6,20,.300,17,21,.810,93
9471,2015-11-20,DEN,,PHO,L 107-114,240,41,90,.456,36,66,.545,5,24,.208,20,26,.769,107
9472,2015-11-20,PHO,@,DEN,W 114-107,240,40,79,.506,25,52,.481,15,27,.556,19,25,.760,114
9473,2015-11-20,CHI,@,GSW,L 94-106,240,35,88,.398,28,66,.424,7,22,.318,17,23,.739,94
9474,2015-11-20,GSW,,CHI,W 106-94,240,39,79,.494,29,50,.580,10,29,.345,18,24,.750,106
9475,2015-11-20,LAL,,TOR,L 91-102,240,35,77,.455,27,52,.519,8,25,.320,13,17,.765,91
9476,2015-11-20,TOR,@,LAL,W 102-91,240,34,78,.436,19,45,.422,15,33,.455,19,24,.792,102
9477,2015-11-20,HOU,@,MEM,L 84-96,240,28,74,.378,22,45,.489,6,29,.207,22,37,.595,84
9478,2015-11-20,MEM,,HOU,W 96-84,240,36,85,.424,28,61,.459,8,24,.333,16,19,.842,96
9479,2015-11-20,DET,@,MIN,W 96-86,240,40,87,.460,34,59,.576,6,28,.214,10,13,.769,96
9480,2015-11-20,MIN,,DET,L 86-96,240,33,77,.429,30,64,.469,3,13,.231,17,25,.680,86
9481,2015-11-20,NOP,,SAS,W 104-90,240,40,88,.455,32,66,.485,8,22,.364,16,17,.941,104
9482,2015-11-20,SAS,@,NOP,L 90-104,240,34,84,.405,25,67,.373,9,17,.529,13,16,.813,90
9483,2015-11-20,NYK,@,OKC,W 93-90,240,33,72,.458,21,52,.404,12,20,.600,15,23,.652,93
9484,2015-11-20,OKC,,NYK,L 90-93,240,35,92,.380,32,63,.508,3,29,.103,17,23,.739,90
9485,2015-11-20,LAC,@,POR,L 91-102,240,38,86,.442,31,62,.500,7,24,.292,8,16,.500,91
9486,2015-11-20,POR,,LAC,W 102-91,240,38,90,.422,30,65,.462,8,25,.320,18,24,.750,102
9487,2015-11-19,CLE,,MIL,W 115-100,240,40,71,.563,29,47,.617,11,24,.458,24,30,.800,115
9488,2015-11-19,MIL,@,CLE,L 100-115,240,38,73,.521,35,65,.538,3,8,.375,21,26,.808,100
9489,2015-11-19,GSW,@,LAC,W 124-117,240,38,73,.521,21,43,.488,17,30,.567,31,36,.861,124
9490,2015-11-19,LAC,,GSW,L 117-124,240,44,88,.500,31,59,.525,13,29,.448,16,24,.667,117
9491,2015-11-19,MIA,,SAC,W 116-109,240,42,89,.472,35,65,.538,7,24,.292,25,33,.758,116
9492,2015-11-19,SAC,@,MIA,L 109-116,240,43,84,.512,31,61,.508,12,23,.522,11,20,.550,109
9493,2015-11-18,ATL,,SAC,W 103-97,240,38,89,.427,29,59,.492,9,30,.300,18,24,.750,103
9494,2015-11-18,SAC,@,ATL,L 97-103,240,38,86,.442,33,70,.471,5,16,.313,16,18,.889,97
9495,2015-11-18,BOS,,DAL,L 102-106,240,38,92,.413,30,66,.455,8,26,.308,18,24,.750,102
9496,2015-11-18,DAL,@,BOS,W 106-102,240,37,72,.514,30,52,.577,7,20,.350,25,35,.714,106
9497,2015-11-18,BRK,@,CHO,L 111-116,240,44,91,.484,39,76,.513,5,15,.333,18,22,.818,111
9498,2015-11-18,CHA,,BRK,W 116-111,240,39,80,.488,28,55,.509,11,25,.440,27,36,.750,116
9499,2015-11-18,HOU,,POR,W 108-103 (OT),265,32,92,.348,18,48,.375,14,44,.318,30,35,.857,108
9500,2015-11-18,POR,@,HOU,L 103-108 (OT),265,35,88,.398,26,58,.448,9,30,.300,24,29,.828,103
9501,2015-11-18,NOP,@,OKC,L 103-110,240,43,95,.453,35,63,.556,8,32,.250,9,9,1.000,103
9502,2015-11-18,OKC,,NOP,W 110-103,240,38,85,.447,31,68,.456,7,17,.412,27,40,.675,110
9503,2015-11-18,MIN,@,ORL,L 101-104 (OT),265,36,85,.424,32,67,.478,4,18,.222,25,30,.833,101
9504,2015-11-18,ORL,,MIN,W 104-101 (OT),265,41,110,.373,32,89,.360,9,21,.429,13,21,.619,104
9505,2015-11-18,IND,@,PHI,W 112-85,240,42,92,.457,30,65,.462,12,27,.444,16,20,.800,112
9506,2015-11-18,PHI,,IND,L 85-112,240,35,76,.461,30,51,.588,5,25,.200,10,16,.625,85
9507,2015-11-18,CHI,@,PHO,W 103-97,240,41,83,.494,32,64,.500,9,19,.474,12,14,.857,103
9508,2015-11-18,PHO,,CHI,L 97-103,240,37,91,.407,29,64,.453,8,27,.296,15,21,.714,97
9509,2015-11-18,DEN,@,SAS,L 98-109,240,38,98,.388,33,83,.398,5,15,.333,17,18,.944,98
9510,2015-11-18,SAS,,DEN,W 109-98,240,42,86,.488,33,68,.485,9,18,.500,16,20,.800,109
9511,2015-11-18,TOR,@,UTA,L 89-93,240,34,80,.425,29,60,.483,5,20,.250,16,18,.889,89
9512,2015-11-18,UTA,,TOR,W 93-89,240,35,72,.486,28,50,.560,7,22,.318,16,22,.727,93
9513,2015-11-17,ATL,@,BRK,L 88-90,240,33,76,.434,21,47,.447,12,29,.414,10,14,.714,88
9514,2015-11-17,BRK,,ATL,W 90-88,240,37,84,.440,28,64,.438,9,20,.450,7,13,.538,90
9515,2015-11-17,CLE,@,DET,L 99-104,240,38,80,.475,27,47,.574,11,33,.333,12,20,.600,99
9516,2015-11-17,DET,,CLE,W 104-99,240,36,84,.429,29,63,.460,7,21,.333,25,31,.806,104
9517,2015-11-17,GSW,,TOR,W 115-110,240,43,80,.538,32,51,.627,11,29,.379,18,27,.667,115
9518,2015-11-17,TOR,@,GSW,L 110-115,240,37,79,.468,31,61,.508,6,18,.333,30,39,.769,110
9519,2015-11-17,MIA,,MIN,L 91-103,240,36,79,.456,31,55,.564,5,24,.208,14,30,.467,91
9520,2015-11-17,MIN,@,MIA,W 103-91,240,36,97,.371,32,76,.421,4,21,.190,27,35,.771,103
9521,2015-11-17,DEN,@,NOP,W 115-98,240,45,85,.529,30,55,.545,15,30,.500,10,13,.769,115
9522,2015-11-17,NOP,,DEN,L 98-115,240,41,83,.494,34,60,.567,7,23,.304,9,11,.818,98
9523,2015-11-17,CHA,@,NYK,L 94-102,240,36,82,.439,31,62,.500,5,20,.250,17,25,.680,94
9524,2015-11-17,NYK,,CHO,W 102-94,240,36,89,.404,26,69,.377,10,20,.500,20,21,.952,102
9525,2015-11-17,MIL,@,WAS,L 86-115,240,31,72,.431,21,51,.412,10,21,.476,14,24,.583,86
9526,2015-11-17,WAS,,MIL,W 115-86,240,37,70,.529,25,48,.521,12,22,.545,29,41,.707,115
9527,2015-11-16,CHI,,IND,W 96-95,240,35,86,.407,29,71,.408,6,15,.400,20,32,.625,96
9528,2015-11-16,IND,@,CHI,L 95-96,240,35,87,.402,26,66,.394,9,21,.429,16,24,.667,95
9529,2015-11-16,BOS,@,HOU,W 111-95,240,44,93,.473,33,57,.579,11,36,.306,12,17,.706,111
9530,2015-11-16,HOU,,BOS,L 95-111,240,36,85,.424,25,53,.472,11,32,.344,12,23,.522,95
9531,2015-11-16,MEM,,OKC,W 122-114,240,37,84,.440,25,67,.373,12,17,.706,36,39,.923,122
9532,2015-11-16,OKC,@,MEM,L 114-122,240,41,81,.506,31,57,.544,10,24,.417,22,31,.710,114
9533,2015-11-16,DAL,@,PHI,W 92-86,240,30,76,.395,23,52,.442,7,24,.292,25,30,.833,92
9534,2015-11-16,PHI,,DAL,L 86-92,240,34,76,.447,29,54,.537,5,22,.227,13,20,.650,86
9535,2015-11-16,LAL,@,PHO,L 101-120,240,37,77,.481,28,57,.491,9,20,.450,18,20,.900,101
9536,2015-11-16,PHO,,LAL,W 120-101,240,45,93,.484,34,63,.540,11,30,.367,19,25,.760,120
9537,2015-11-16,POR,@,SAS,L 80-93,240,31,75,.413,24,56,.429,7,19,.368,11,13,.846,80
9538,2015-11-16,SAS,,POR,W 93-80,240,38,89,.427,31,66,.470,7,23,.304,10,13,.769,93
9539,2015-11-15,ATL,,UTA,L 96-97,240,37,76,.487,29,54,.537,8,22,.364,14,17,.824,96
9540,2015-11-15,UTA,@,ATL,W 97-96,240,39,76,.513,32,55,.582,7,21,.333,12,17,.706,97
9541,2015-11-15,CHA,,POR,W 106-94,240,41,83,.494,32,52,.615,9,31,.290,15,19,.789,106
9542,2015-11-15,POR,@,CHO,L 94-106,240,35,89,.393,30,68,.441,5,21,.238,19,21,.905,94
9543,2015-11-15,DET,@,LAL,L 85-97,240,35,96,.365,28,69,.406,7,27,.259,8,15,.533,85
9544,2015-11-15,LAL,,DET,W 97-85,240,31,75,.413,25,56,.446,6,19,.316,29,39,.744,97
9545,2015-11-15,MEM,@,MIN,W 114-106,240,40,71,.563,31,54,.574,9,17,.529,25,27,.926,114
9546,2015-11-15,MIN,,MEM,L 106-114,240,41,82,.500,36,66,.545,5,16,.313,19,21,.905,106
9547,2015-11-15,NOP,@,NYK,L 87-95,240,32,71,.451,26,50,.520,6,21,.286,17,19,.895,87
9548,2015-11-15,NYK,,NOP,W 95-87,240,38,88,.432,34,70,.486,4,18,.222,15,19,.789,95
9549,2015-11-15,BOS,@,OKC,W 100-85,240,39,82,.476,30,59,.508,9,23,.391,13,20,.650,100
9550,2015-11-15,OKC,,BOS,L 85-100,240,28,77,.364,22,52,.423,6,25,.240,23,29,.793,85
9551,2015-11-15,SAC,,TOR,W 107-101,240,39,76,.513,29,51,.569,10,25,.400,19,24,.792,107
9552,2015-11-15,TOR,@,SAC,L 101-107,240,38,87,.437,23,56,.411,15,31,.484,10,14,.714,101
9553,2015-11-14,BRK,@,GSW,L 99-107 (OT),265,41,98,.418,39,80,.488,2,18,.111,15,16,.938,99
9554,2015-11-14,GSW,,BRK,W 107-99 (OT),265,43,97,.443,31,63,.492,12,34,.353,9,10,.900,107
9555,2015-11-14,DAL,@,HOU,W 110-98,240,43,89,.483,35,61,.574,8,28,.286,16,21,.762,110
9556,2015-11-14,HOU,,DAL,L 98-110,240,32,84,.381,23,50,.460,9,34,.265,25,32,.781,98
9557,2015-11-14,DET,@,LAC,L 96-101,240,33,74,.446,26,47,.553,7,27,.259,23,35,.657,96
9558,2015-11-14,LAC,,DET,W 101-96,240,37,79,.468,30,60,.500,7,19,.368,20,26,.769,101
9559,2015-11-14,CLE,@,MIL,L 105-108 (2OT),290,37,91,.407,23,53,.434,14,38,.368,17,27,.630,105
9560,2015-11-14,MIL,,CLE,W 108-105 (2OT),290,43,102,.422,37,86,.430,6,16,.375,16,22,.727,108
9561,2015-11-14,DEN,@,PHO,L 81-105,240,34,98,.347,28,63,.444,6,35,.171,7,8,.875,81
9562,2015-11-14,PHO,,DEN,W 105-81,240,37,84,.440,26,60,.433,11,24,.458,20,26,.769,105
9563,2015-11-14,PHI,@,SAS,L 83-92,240,33,82,.402,25,60,.417,8,22,.364,9,11,.818,83
9564,2015-11-14,SAS,,PHI,W 92-83,240,33,85,.388,28,69,.406,5,16,.313,21,25,.840,92
9565,2015-11-14,ORL,@,WAS,L 99-108,240,38,87,.437,34,69,.493,4,18,.222,19,24,.792,99
9566,2015-11-14,WAS,,ORL,W 108-99,240,39,83,.470,27,54,.500,12,29,.414,18,26,.692,108
9567,2015-11-13,ATL,@,BOS,L 93-106,240,36,76,.474,30,56,.536,6,20,.300,15,20,.750,93
9568,2015-11-13,BOS,,ATL,W 106-93,240,42,103,.408,31,70,.443,11,33,.333,11,12,.917,106
9569,2015-11-13,CHI,,CHO,W 102-97,240,37,84,.440,33,68,.485,4,16,.250,24,31,.774,102
9570,2015-11-13,CHA,@,CHI,L 97-102,240,36,95,.379,21,62,.339,15,33,.455,10,12,.833,97
9571,2015-11-13,DAL,,LAL,W 90-82,240,30,82,.366,23,55,.418,7,27,.259,23,29,.793,90
9572,2015-11-13,LAL,@,DAL,L 82-90,240,29,88,.330,20,61,.328,9,27,.333,15,18,.833,82
9573,2015-11-13,DEN,,HOU,W 107-98,240,37,81,.457,28,61,.459,9,20,.450,24,32,.750,107
9574,2015-11-13,HOU,@,DEN,L 98-107,240,33,77,.429,24,48,.500,9,29,.310,23,31,.742,98
9575,2015-11-13,IND,,MIN,W 107-103,240,41,86,.477,31,61,.508,10,25,.400,15,23,.652,107
9576,2015-11-13,MIN,@,IND,L 103-107,240,42,83,.506,35,63,.556,7,20,.350,12,13,.923,103
9577,2015-11-13,MEM,,POR,W 101-100,240,36,86,.419,30,70,.429,6,16,.375,23,27,.852,101
9578,2015-11-13,POR,@,MEM,L 100-101,240,33,69,.478,25,47,.532,8,22,.364,26,29,.897,100
9579,2015-11-13,CLE,@,NYK,W 90-84,240,33,78,.423,27,50,.540,6,28,.214,18,31,.581,90
9580,2015-11-13,NYK,,CLE,L 84-90,240,29,79,.367,20,52,.385,9,27,.333,17,21,.810,84
9581,2015-11-13,OKC,,PHI,W 102-85,240,39,97,.402,31,72,.431,8,25,.320,16,21,.762,102
9582,2015-11-13,PHI,@,OKC,L 85-102,240,30,86,.349,25,69,.362,5,17,.294,20,28,.714,85
9583,2015-11-13,ORL,,UTA,W 102-93,240,32,76,.421,22,49,.449,10,27,.370,28,31,.903,102
9584,2015-11-13,UTA,@,ORL,L 93-102,240,34,87,.391,26,62,.419,8,25,.320,17,23,.739,93
9585,2015-11-13,BRK,@,SAC,L 109-111,240,42,89,.472,34,68,.500,8,21,.381,17,21,.810,109
9586,2015-11-13,SAC,,BRK,W 111-109,240,40,94,.426,29,67,.433,11,27,.407,20,26,.769,111
9587,2015-11-13,NOP,@,TOR,L 81-100,240,30,82,.366,23,59,.390,7,23,.304,14,20,.700,81
9588,2015-11-13,TOR,,NOP,W 100-81,240,34,77,.442,25,56,.446,9,21,.429,23,27,.852,100
9589,2015-11-12,MIA,,UTA,W 92-91,240,36,77,.468,32,64,.500,4,13,.308,16,25,.640,92
9590,2015-11-12,UTA,@,MIA,L 91-92,240,34,89,.382,30,72,.417,4,17,.235,19,25,.760,91
9591,2015-11-12,GSW,@,MIN,W 129-116,240,48,89,.539,30,51,.588,18,38,.474,15,16,.938,129
9592,2015-11-12,MIN,,GSW,L 116-129,240,43,87,.494,40,78,.513,3,9,.333,27,36,.750,116
9593,2015-11-12,LAC,@,PHO,L 104-118,240,40,90,.444,31,64,.484,9,26,.346,15,28,.536,104
9594,2015-11-12,PHO,,LAC,W 118-104,240,44,83,.530,30,53,.566,14,30,.467,16,21,.762,118
9595,2015-11-11,ATL,,NOP,W 106-98,240,42,86,.488,32,60,.533,10,26,.385,12,16,.750,106
9596,2015-11-11,NOP,@,ATL,L 98-106,240,37,83,.446,23,54,.426,14,29,.483,10,15,.667,98
9597,2015-11-11,BOS,,IND,L 91-102,240,32,77,.416,28,53,.528,4,24,.167,23,32,.719,91
9598,2015-11-11,IND,@,BOS,W 102-91,240,38,79,.481,32,62,.516,6,17,.353,20,31,.645,102
9599,2015-11-11,CHA,,NYK,W 95-93,240,35,84,.417,27,61,.443,8,23,.348,17,28,.607,95
9600,2015-11-11,NYK,@,CHO,L 93-95,240,42,86,.488,38,65,.585,4,21,.190,5,7,.714,93
9601,2015-11-11,DAL,,LAC,W 118-108,240,42,76,.553,31,52,.596,11,24,.458,23,30,.767,118
9602,2015-11-11,LAC,@,DAL,L 108-118,240,37,86,.430,25,59,.424,12,27,.444,22,33,.667,108
9603,2015-11-11,DEN,,MIL,W 103-102,240,39,79,.494,31,55,.564,8,24,.333,17,24,.708,103
9604,2015-11-11,MIL,@,DEN,L 102-103,240,42,79,.532,32,57,.561,10,22,.455,8,9,.889,102
9605,2015-11-11,BRK,@,HOU,W 106-98,240,42,98,.429,34,81,.420,8,17,.471,14,17,.824,106
9606,2015-11-11,HOU,,BRK,L 98-106,240,42,98,.429,34,64,.531,8,34,.235,6,12,.500,98
9607,2015-11-11,GSW,@,MEM,W 100-84,240,36,75,.480,25,48,.521,11,27,.407,17,23,.739,100
9608,2015-11-11,MEM,,GSW,L 84-100,240,24,70,.343,21,55,.382,3,15,.200,33,36,.917,84
9609,2015-11-11,LAL,@,ORL,L 99-101,240,39,79,.494,32,57,.561,7,22,.318,14,18,.778,99
9610,2015-11-11,ORL,,LAL,W 101-99,240,40,100,.400,27,72,.375,13,28,.464,8,12,.667,101
9611,2015-11-11,PHI,,TOR,L 103-119,240,40,87,.460,28,58,.483,12,29,.414,11,17,.647,103
9612,2015-11-11,TOR,@,PHI,W 119-103,240,43,89,.483,38,71,.535,5,18,.278,28,31,.903,119
9613,2015-11-11,POR,,SAS,L 101-113,240,39,88,.443,30,66,.455,9,22,.409,14,23,.609,101
9614,2015-11-11,SAS,@,POR,W 113-101,240,46,82,.561,39,67,.582,7,15,.467,14,18,.778,113
9615,2015-11-11,DET,@,SAC,L 92-101,240,34,89,.382,25,57,.439,9,32,.281,15,20,.750,92
9616,2015-11-11,SAC,,DET,W 101-92,240,37,74,.500,28,58,.483,9,16,.563,18,24,.750,101
9617,2015-11-10,CLE,,UTA,W 118-114,240,37,74,.500,26,50,.520,11,24,.458,33,43,.767,118
9618,2015-11-10,UTA,@,CLE,L 114-118,240,40,82,.488,30,60,.500,10,22,.455,24,28,.857,114
9619,2015-11-10,LAL,@,MIA,L 88-101,240,34,77,.442,23,55,.418,11,22,.500,9,12,.750,88
9620,2015-11-10,MIA,,LAL,W 101-88,240,38,84,.452,33,64,.516,5,20,.250,20,27,.741,101
9621,2015-11-10,BOS,@,MIL,W 99-83,240,38,86,.442,31,56,.554,7,30,.233,16,19,.842,99
9622,2015-11-10,MIL,,BOS,L 83-99,240,30,73,.411,24,56,.429,6,17,.353,17,23,.739,83
9623,2015-11-10,CHA,@,MIN,W 104-95,240,38,78,.487,30,52,.577,8,26,.308,20,27,.741,104
9624,2015-11-10,MIN,,CHO,L 95-104,240,36,80,.450,27,61,.443,9,19,.474,14,19,.737,95
9625,2015-11-10,DAL,@,NOP,L 105-120,240,39,88,.443,34,68,.500,5,20,.250,22,26,.846,105
9626,2015-11-10,NOP,,DAL,W 120-105,240,46,92,.500,32,59,.542,14,33,.424,14,18,.778,120
9627,2015-11-10,NYK,@,TOR,W 111-109,240,42,95,.442,31,72,.431,11,23,.478,16,18,.889,111
9628,2015-11-10,TOR,,NYK,L 109-111,240,37,84,.440,33,67,.493,4,17,.235,31,39,.795,109
9629,2015-11-10,OKC,@,WAS,W 125-101,240,44,86,.512,29,63,.460,15,23,.652,22,29,.759,125
9630,2015-11-10,WAS,,OKC,L 101-125,240,38,97,.392,33,73,.452,5,24,.208,20,26,.769,101
9631,2015-11-09,ATL,,MIN,L 107-117,240,44,86,.512,31,55,.564,13,31,.419,6,7,.857,107
9632,2015-11-09,MIN,@,ATL,W 117-107,240,46,80,.575,39,65,.600,7,15,.467,18,22,.818,117
9633,2015-11-09,DEN,,POR,W 108-104,240,40,77,.519,33,58,.569,7,19,.368,21,32,.656,108
9634,2015-11-09,POR,@,DEN,L 104-108,240,36,91,.396,26,62,.419,10,29,.345,22,27,.815,104
9635,2015-11-09,DET,@,GSW,L 95-109,240,40,85,.471,34,66,.515,6,19,.316,9,15,.600,95
9636,2015-11-09,GSW,,DET,W 109-95,240,43,91,.473,31,70,.443,12,21,.571,11,13,.846,109
9637,2015-11-09,IND,,ORL,W 97-84,240,34,77,.442,23,52,.442,11,25,.440,18,22,.818,97
9638,2015-11-09,ORL,@,IND,L 84-97,240,31,78,.397,21,45,.467,10,33,.303,12,17,.706,84
9639,2015-11-09,LAC,,MEM,W 94-92,240,28,68,.412,23,49,.469,5,19,.263,33,37,.892,94
9640,2015-11-09,MEM,@,LAC,L 92-94,240,35,80,.438,33,69,.478,2,11,.182,20,29,.690,92
9641,2015-11-09,CHI,@,PHI,W 111-88,240,41,96,.427,31,71,.437,10,25,.400,19,23,.826,111
9642,2015-11-09,PHI,,CHI,L 88-111,240,35,100,.350,30,75,.400,5,25,.200,13,23,.565,88
9643,2015-11-09,SAC,,SAS,L 88-106,240,34,84,.405,27,65,.415,7,19,.368,13,19,.684,88
9644,2015-11-09,SAS,@,SAC,W 106-88,240,46,87,.529,40,64,.625,6,23,.261,8,11,.727,106
9645,2015-11-08,CLE,,IND,W 101-97,240,38,83,.458,30,59,.508,8,24,.333,17,25,.680,101
9646,2015-11-08,IND,@,CLE,L 97-101,240,39,90,.433,33,72,.458,6,18,.333,13,19,.684,97
9647,2015-11-08,MIA,,TOR,W 96-76,240,35,83,.422,27,63,.429,8,20,.400,18,25,.720,96
9648,2015-11-08,TOR,@,MIA,L 76-96,240,28,71,.394,25,52,.481,3,19,.158,17,22,.773,76
9649,2015-11-08,LAL,@,NYK,L 95-99,240,36,94,.383,27,67,.403,9,27,.333,14,23,.609,95
9650,2015-11-08,NYK,,LAL,W 99-95,240,33,84,.393,24,57,.421,9,27,.333,24,29,.828,99
9651,2015-11-08,OKC,,PHO,W 124-103,240,49,94,.521,45,74,.608,4,20,.200,22,30,.733,124
9652,2015-11-08,PHO,@,OKC,L 103-124,240,38,84,.452,31,68,.456,7,16,.438,20,26,.769,103
9653,2015-11-08,DET,@,POR,W 120-103,240,47,96,.490,36,66,.545,11,30,.367,15,22,.682,120
9654,2015-11-08,POR,,DET,L 103-120,240,41,76,.539,32,51,.627,9,25,.360,12,18,.667,103
9655,2015-11-07,ATL,,WAS,W 114-99,240,43,92,.467,30,59,.508,13,33,.394,15,15,1.000,114
9656,2015-11-07,WAS,@,ATL,L 99-114,240,38,78,.487,30,54,.556,8,24,.333,15,17,.882,99
9657,2015-11-07,CHI,,MIN,L 93-102 (OT),265,33,93,.355,22,61,.361,11,32,.344,16,23,.696,93
9658,2015-11-07,MIN,@,CHI,W 102-93 (OT),265,39,96,.406,32,80,.400,7,16,.438,17,27,.630,102
9659,2015-11-07,DAL,,NOP,W 107-98,240,40,84,.476,31,60,.517,9,24,.375,18,22,.818,107
9660,2015-11-07,NOP,@,DAL,L 98-107,240,39,86,.453,30,58,.517,9,28,.321,11,13,.846,98
9661,2015-11-07,HOU,@,LAC,W 109-105,240,38,86,.442,31,56,.554,7,30,.233,26,29,.897,109
9662,2015-11-07,LAC,,HOU,L 105-109,240,42,88,.477,38,66,.576,4,22,.182,17,25,.680,105
9663,2015-11-07,BRK,@,MIL,L 86-94,240,34,82,.415,31,73,.425,3,9,.333,15,19,.789,86
9664,2015-11-07,MIL,,BRK,W 94-86,240,37,82,.451,29,62,.468,8,20,.400,12,16,.750,94
9665,2015-11-07,ORL,@,PHI,W 105-97,240,39,83,.470,33,70,.471,6,13,.462,21,24,.875,105
9666,2015-11-07,PHI,,ORL,L 97-105,240,36,80,.450,25,47,.532,11,33,.333,14,26,.538,97
9667,2015-11-07,GSW,@,SAC,W 103-94,240,38,92,.413,30,53,.566,8,39,.205,19,22,.864,103
9668,2015-11-07,SAC,,GSW,L 94-103,240,38,87,.437,32,68,.471,6,19,.316,12,16,.750,94
9669,2015-11-07,CHA,@,SAS,L 94-114,240,34,73,.466,28,54,.519,6,19,.316,20,31,.645,94
9670,2015-11-07,SAS,,CHO,W 114-94,240,45,81,.556,36,60,.600,9,21,.429,15,23,.652,114
9671,2015-11-07,MEM,@,UTA,L 79-89,240,30,91,.330,24,72,.333,6,19,.316,13,14,.929,79
9672,2015-11-07,UTA,,MEM,W 89-79,240,31,74,.419,19,47,.404,12,27,.444,15,18,.833,89
9673,2015-11-06,BOS,,WAS,W 118-98,240,44,97,.454,32,67,.478,12,30,.400,18,23,.783,118
9674,2015-11-06,WAS,@,BOS,L 98-118,240,36,88,.409,28,63,.444,8,25,.320,18,23,.783,98
9675,2015-11-06,BRK,,LAL,L 98-104,240,40,93,.430,37,74,.500,3,19,.158,15,20,.750,98
9676,2015-11-06,LAL,@,BRK,W 104-98,240,33,78,.423,26,55,.473,7,23,.304,31,40,.775,104
9677,2015-11-06,CLE,,PHI,W 108-102,240,45,88,.511,35,62,.565,10,26,.385,8,12,.667,108
9678,2015-11-06,PHI,@,CLE,L 102-108,240,41,79,.519,31,56,.554,10,23,.435,10,15,.667,102
9679,2015-11-06,DEN,@,GSW,L 104-119,240,39,92,.424,31,68,.456,8,24,.333,18,22,.818,104
9680,2015-11-06,GSW,,DEN,W 119-104,240,46,93,.495,29,56,.518,17,37,.459,10,18,.556,119
9681,2015-11-06,IND,,MIA,W 90-87,240,36,80,.450,31,65,.477,5,15,.333,13,24,.542,90
9682,2015-11-06,MIA,@,IND,L 87-90,240,36,81,.444,30,61,.492,6,20,.300,9,13,.692,87
9683,2015-11-06,ATL,@,NOP,W 121-115,240,41,77,.532,32,56,.571,9,21,.429,30,35,.857,121
9684,2015-11-06,NOP,,ATL,L 115-121,240,42,84,.500,32,54,.593,10,30,.333,21,24,.875,115
9685,2015-11-06,MIL,@,NYK,W 99-92,240,35,81,.432,32,67,.478,3,14,.214,26,29,.897,99
9686,2015-11-06,NYK,,MIL,L 92-99,240,33,81,.407,29,57,.509,4,24,.167,22,28,.786,92
9687,2015-11-06,ORL,,TOR,W 92-87,240,33,77,.429,24,52,.462,9,25,.360,17,22,.773,92
9688,2015-11-06,TOR,@,ORL,L 87-92,240,30,86,.349,25,63,.397,5,23,.217,22,29,.759,87
9689,2015-11-06,DET,@,PHO,W 100-92,240,37,74,.500,29,52,.558,8,22,.364,18,36,.500,100
9690,2015-11-06,PHO,,DET,L 92-100,240,37,92,.402,27,62,.435,10,30,.333,8,13,.615,92
9691,2015-11-06,HOU,@,SAC,W 116-110,240,40,82,.488,25,46,.543,15,36,.417,21,27,.778,116
9692,2015-11-06,SAC,,HOU,L 110-116,240,40,93,.430,31,65,.477,9,28,.321,21,29,.724,110
9693,2015-11-05,CHI,,OKC,W 104-98,240,40,90,.444,33,72,.458,7,18,.389,17,21,.810,104
9694,2015-11-05,OKC,@,CHI,L 98-104,240,38,84,.452,33,71,.465,5,13,.385,17,20,.850,98
9695,2015-11-05,CHA,@,DAL,W 108-94,240,44,89,.494,38,62,.613,6,27,.222,14,17,.824,108
9696,2015-11-05,DAL,,CHO,L 94-108,240,32,82,.390,26,53,.491,6,29,.207,24,27,.889,94
9697,2015-11-05,DEN,,UTA,L 84-96,240,28,72,.389,23,52,.442,5,20,.250,23,34,.676,84
9698,2015-11-05,UTA,@,DEN,W 96-84,240,37,85,.435,26,61,.426,11,24,.458,11,17,.647,96
9699,2015-11-05,MIA,@,MIN,W 96-84,240,37,76,.487,33,62,.532,4,14,.286,18,25,.720,96
9700,2015-11-05,MIN,,MIA,L 84-96,240,30,85,.353,26,73,.356,4,12,.333,20,22,.909,84
9701,2015-11-05,MEM,@,POR,L 96-115,240,37,77,.481,30,57,.526,7,20,.350,15,21,.714,96
9702,2015-11-05,POR,,MEM,W 115-96,240,44,87,.506,29,57,.509,15,30,.500,12,20,.600,115
9703,2015-11-04,ATL,,BRK,W 101-87,240,37,76,.487,29,54,.537,8,22,.364,19,24,.792,101
9704,2015-11-04,BRK,@,ATL,L 87-101,240,36,83,.434,31,62,.500,5,21,.238,10,13,.769,87
9705,2015-11-04,CLE,,NYK,W 96-86,240,33,83,.398,26,56,.464,7,27,.259,23,32,.719,96
9706,2015-11-04,NYK,@,CLE,L 86-96,240,33,84,.393,25,60,.417,8,24,.333,12,15,.800,86
9707,2015-11-04,GSW,,LAC,W 112-108,240,39,85,.459,29,59,.492,10,26,.385,24,31,.774,112
9708,2015-11-04,LAC,@,GSW,L 108-112,240,43,88,.489,35,66,.530,8,22,.364,14,22,.636,108
9709,2015-11-04,HOU,,ORL,W 119-114 (OT),265,42,88,.477,31,54,.574,11,34,.324,24,34,.706,119
9710,2015-11-04,ORL,@,HOU,L 114-119 (OT),265,46,91,.505,39,71,.549,7,20,.350,15,19,.789,114
9711,2015-11-04,BOS,@,IND,L 98-100,240,35,83,.422,25,56,.446,10,27,.370,18,22,.818,98
9712,2015-11-04,IND,,BOS,W 100-98,240,35,91,.385,27,68,.397,8,23,.348,22,29,.759,100
9713,2015-11-04,MIL,,PHI,W 91-87,240,35,86,.407,27,63,.429,8,23,.348,13,17,.765,91
9714,2015-11-04,PHI,@,MIL,L 87-91,240,34,81,.420,28,53,.528,6,28,.214,13,15,.867,87
9715,2015-11-04,OKC,,TOR,L 98-103,240,39,82,.476,31,59,.525,8,23,.348,12,14,.857,98
9716,2015-11-04,TOR,@,OKC,W 103-98,240,33,79,.418,28,65,.431,5,14,.357,32,39,.821,103
9717,2015-11-04,PHO,,SAC,W 118-97,240,45,83,.542,31,60,.517,14,23,.609,14,22,.636,118
9718,2015-11-04,SAC,@,PHO,L 97-118,240,40,84,.476,29,60,.483,11,24,.458,6,12,.500,97
9719,2015-11-04,POR,@,UTA,W 108-92,240,41,77,.532,30,52,.577,11,25,.440,15,32,.469,108
9720,2015-11-04,UTA,,POR,L 92-108,240,33,88,.375,28,64,.438,5,24,.208,21,33,.636,92
9721,2015-11-04,SAS,@,WAS,L 99-102,240,37,81,.457,30,59,.508,7,22,.318,18,20,.900,99
9722,2015-11-04,WAS,,SAS,W 102-99,240,42,87,.483,34,64,.531,8,23,.348,10,14,.714,102
9723,2015-11-03,CHI,@,CHO,L 105-130,240,44,90,.489,30,60,.500,14,30,.467,3,8,.375,105
9724,2015-11-03,CHA,,CHI,W 130-105,240,47,91,.516,33,68,.485,14,23,.609,22,23,.957,130
9725,2015-11-03,DAL,,TOR,L 91-102,240,33,86,.384,26,63,.413,7,23,.304,18,25,.720,91
9726,2015-11-03,TOR,@,DAL,W 102-91,240,37,82,.451,32,65,.492,5,17,.294,23,26,.885,102
9727,2015-11-03,DET,,IND,L 82-94,240,33,86,.384,28,64,.438,5,22,.227,11,17,.647,82
9728,2015-11-03,IND,@,DET,W 94-82,240,38,88,.432,31,65,.477,7,23,.304,11,12,.917,94
9729,2015-11-03,DEN,@,LAL,W 120-109,240,43,85,.506,36,65,.554,7,20,.350,27,31,.871,120
9730,2015-11-03,LAL,,DEN,L 109-120,240,36,86,.419,30,60,.500,6,26,.231,31,38,.816,109
9731,2015-11-03,ATL,@,MIA,W 98-92,240,37,90,.411,30,69,.435,7,21,.333,17,22,.773,98
9732,2015-11-03,MIA,,ATL,L 92-98,240,38,86,.442,33,58,.569,5,28,.179,11,16,.688,92
9733,2015-11-03,NOP,,ORL,L 94-103,240,32,90,.356,20,54,.370,12,36,.333,18,25,.720,94
9734,2015-11-03,ORL,@,NOP,W 103-94,240,42,90,.467,35,72,.486,7,18,.389,12,12,1.000,103
9735,2015-11-03,MEM,@,SAC,W 103-89,240,40,83,.482,37,63,.587,3,20,.150,20,25,.800,103
9736,2015-11-03,SAC,,MEM,L 89-103,240,29,74,.392,22,54,.407,7,20,.350,24,40,.600,89
9737,2015-11-02,BRK,,MIL,L 96-103,240,36,79,.456,30,60,.500,6,19,.316,18,22,.818,96
9738,2015-11-02,MIL,@,BRK,W 103-96,240,38,73,.521,29,50,.580,9,23,.391,18,26,.692,103
9739,2015-11-02,GSW,,MEM,W 119-69,240,43,84,.512,32,59,.542,11,25,.440,22,30,.733,119
9740,2015-11-02,MEM,@,GSW,L 69-119,240,26,96,.271,23,73,.315,3,23,.130,14,20,.700,69
9741,2015-11-02,HOU,,OKC,W 110-105,240,41,89,.461,32,60,.533,9,29,.310,19,29,.655,110
9742,2015-11-02,OKC,@,HOU,L 105-110,240,40,84,.476,30,61,.492,10,23,.435,15,22,.682,105
9743,2015-11-02,LAC,,PHO,W 102-96,240,37,81,.457,29,55,.527,8,26,.308,20,23,.870,102
9744,2015-11-02,PHO,@,LAC,L 96-102,240,36,98,.367,27,68,.397,9,30,.300,15,21,.714,96
9745,2015-11-02,MIN,,POR,L 101-106,240,34,79,.430,31,66,.470,3,13,.231,30,39,.769,101
9746,2015-11-02,POR,@,MIN,W 106-101,240,41,89,.461,32,59,.542,9,30,.300,15,20,.750,106
9747,2015-11-02,NYK,,SAS,L 84-94,240,32,89,.360,28,76,.368,4,13,.308,16,21,.762,84
9748,2015-11-02,SAS,@,NYK,W 94-84,240,39,79,.494,35,66,.530,4,13,.308,12,17,.706,94
9749,2015-11-02,CLE,@,PHI,W 107-100,240,42,81,.519,34,59,.576,8,22,.364,15,20,.750,107
9750,2015-11-02,PHI,,CLE,L 100-107,240,38,85,.447,31,61,.508,7,24,.292,17,23,.739,100
9751,2015-11-01,BOS,,SAS,L 87-95,240,35,98,.357,29,69,.420,6,29,.207,11,14,.786,87
9752,2015-11-01,SAS,@,BOS,W 95-87,240,36,83,.434,31,64,.484,5,19,.263,18,25,.720,95
9753,2015-11-01,CHI,,ORL,W 92-87,240,33,87,.379,26,59,.441,7,28,.250,19,22,.864,92
9754,2015-11-01,ORL,@,CHI,L 87-92,240,35,90,.389,28,67,.418,7,23,.304,10,17,.588,87
9755,2015-11-01,ATL,@,CHO,W 94-92,240,37,88,.420,30,59,.508,7,29,.241,13,14,.929,94
9756,2015-11-01,CHA,,ATL,L 92-94,240,32,86,.372,18,49,.367,14,37,.378,14,15,.933,92
9757,2015-11-01,DAL,@,LAL,W 103-93,240,40,87,.460,29,57,.509,11,30,.367,12,16,.750,103
9758,2015-11-01,LAL,,DAL,L 93-103,240,31,85,.365,21,51,.412,10,34,.294,21,28,.750,93
9759,2015-11-01,HOU,@,MIA,L 89-109,240,32,79,.405,22,43,.512,10,36,.278,15,18,.833,89
9760,2015-11-01,MIA,,HOU,W 109-89,240,42,86,.488,33,64,.516,9,22,.409,16,21,.762,109
9761,2015-11-01,DEN,@,OKC,L 93-117,240,35,92,.380,26,66,.394,9,26,.346,14,19,.737,93
9762,2015-11-01,OKC,,DEN,W 117-93,240,45,86,.523,32,61,.525,13,25,.520,14,18,.778,117
9763,2015-11-01,MIL,@,TOR,L 87-106,240,29,69,.420,24,50,.480,5,19,.263,24,24,1.000,87
9764,2015-11-01,TOR,,MIL,W 106-87,240,41,90,.456,30,65,.462,11,25,.440,13,20,.650,106
9765,2015-10-31,IND,,UTA,L 76-97,240,28,70,.400,24,53,.453,4,17,.235,16,21,.762,76
9766,2015-10-31,UTA,@,IND,W 97-76,240,39,88,.443,33,73,.452,6,15,.400,13,18,.722,97
9767,2015-10-31,LAC,,SAC,W 114-109,240,39,76,.513,35,59,.593,4,17,.235,32,46,.696,114
9768,2015-10-31,SAC,@,LAC,L 109-114,240,43,101,.426,37,83,.446,6,18,.333,17,25,.680,109
9769,2015-10-31,BRK,@,MEM,L 91-101,240,38,79,.481,35,66,.530,3,13,.231,12,18,.667,91
9770,2015-10-31,MEM,,BRK,W 101-91,240,34,80,.425,25,57,.439,9,23,.391,24,28,.857,101
9771,2015-10-31,GSW,@,NOP,W 134-120,240,46,84,.548,29,54,.537,17,30,.567,25,35,.714,134
9772,2015-10-31,NOP,,GSW,L 120-134,240,46,100,.460,38,78,.487,8,22,.364,20,23,.870,120
9773,2015-10-31,PHO,@,POR,W 101-90,240,39,94,.415,28,62,.452,11,32,.344,12,16,.750,101
9774,2015-10-31,POR,,PHO,L 90-101,240,33,79,.418,25,49,.510,8,30,.267,16,28,.571,90
9775,2015-10-31,NYK,@,WAS,W 117-110,240,41,86,.477,32,67,.478,9,19,.474,26,32,.813,117
9776,2015-10-31,WAS,,NYK,L 110-117,240,38,90,.422,32,68,.471,6,22,.273,28,33,.848,110
9777,2015-10-30,ATL,,CHO,W 97-94,240,36,83,.434,28,60,.467,8,23,.348,17,22,.773,97
9778,2015-10-30,CHA,@,ATL,L 94-97,240,36,88,.409,24,58,.414,12,30,.400,10,13,.769,94
9779,2015-10-30,BOS,,TOR,L 103-113,240,32,85,.376,25,59,.424,7,26,.269,32,41,.780,103
9780,2015-10-30,TOR,@,BOS,W 113-103,240,36,82,.439,25,56,.446,11,26,.423,30,35,.857,113
9781,2015-10-30,CLE,,MIA,W 102-92,240,39,86,.453,33,61,.541,6,25,.240,18,21,.857,102
9782,2015-10-30,MIA,@,CLE,L 92-102,240,33,77,.429,27,56,.482,6,21,.286,20,22,.909,92
9783,2015-10-30,DEN,,MIN,L 78-95,240,29,95,.305,24,70,.343,5,25,.200,15,20,.750,78
9784,2015-10-30,MIN,@,DEN,W 95-78,240,30,71,.423,28,60,.467,2,11,.182,33,41,.805,95
9785,2015-10-30,CHI,@,DET,L 94-98 (OT),265,34,84,.405,27,62,.435,7,22,.318,19,26,.731,94
9786,2015-10-30,DET,,CHI,W 98-94 (OT),265,39,104,.375,33,76,.434,6,28,.214,14,28,.500,98
9787,2015-10-30,GSW,@,HOU,W 112-92,240,43,93,.462,34,67,.507,9,26,.346,17,25,.680,112
9788,2015-10-30,HOU,,GSW,L 92-112,240,30,82,.366,25,59,.424,5,23,.217,27,36,.750,92
9789,2015-10-30,MIL,,WAS,L 113-118,240,42,82,.512,35,58,.603,7,24,.292,22,28,.786,113
9790,2015-10-30,WAS,@,MIL,W 118-113,240,35,68,.515,23,47,.489,12,21,.571,36,44,.818,118
9791,2015-10-30,OKC,@,ORL,W 139-136 (2OT),290,50,110,.455,42,83,.506,8,27,.296,31,38,.816,139
9792,2015-10-30,ORL,,OKC,L 136-139 (2OT),290,47,106,.443,35,73,.479,12,33,.364,30,38,.789,136
9793,2015-10-30,PHI,,UTA,L 71-99,240,19,63,.302,13,48,.271,6,15,.400,27,37,.730,71
9794,2015-10-30,UTA,@,PHI,W 99-71,240,36,88,.409,29,75,.387,7,13,.538,20,25,.800,99
9795,2015-10-30,PHO,,POR,W 110-92,240,37,83,.446,33,65,.508,4,18,.222,32,42,.762,110
9796,2015-10-30,POR,@,PHO,L 92-110,240,34,86,.395,25,62,.403,9,24,.375,15,19,.789,92
9797,2015-10-30,LAL,@,SAC,L 114-132,240,41,89,.461,30,55,.545,11,34,.324,21,27,.778,114
9798,2015-10-30,SAC,,LAL,W 132-114,240,52,101,.515,46,79,.582,6,22,.273,22,30,.733,132
9799,2015-10-30,BRK,@,SAS,L 75-102,240,31,77,.403,26,61,.426,5,16,.313,8,15,.533,75
9800,2015-10-30,SAS,,BRK,W 102-75,240,40,86,.465,31,64,.484,9,22,.409,13,13,1.000,102
9801,2015-10-29,IND,,MEM,L 103-112,240,37,78,.474,25,48,.521,12,30,.400,17,24,.708,103
9802,2015-10-29,MEM,@,IND,W 112-103,240,41,82,.500,34,66,.515,7,16,.438,23,29,.793,112
9803,2015-10-29,DAL,@,LAC,L 88-104,240,35,97,.361,29,67,.433,6,30,.200,12,15,.800,88
9804,2015-10-29,LAC,,DAL,W 104-88,240,38,87,.437,30,56,.536,8,31,.258,20,33,.606,104
9805,2015-10-29,ATL,@,NYK,W 112-101,240,42,83,.506,32,59,.542,10,24,.417,18,26,.692,112
9806,2015-10-29,NYK,,ATL,L 101-112,240,38,93,.409,32,64,.500,6,29,.207,19,21,.905,101
9807,2015-10-28,BOS,,PHI,W 112-95,240,39,85,.459,31,61,.508,8,24,.333,26,27,.963,112
9808,2015-10-28,PHI,@,BOS,L 95-112,240,34,83,.410,27,61,.443,7,22,.318,20,23,.870,95
9809,2015-10-28,BRK,,CHI,L 100-115,240,39,93,.419,39,84,.464,0,9,.000,22,28,.786,100
9810,2015-10-28,CHI,@,BRK,W 115-100,240,42,78,.538,28,50,.560,14,28,.500,17,20,.850,115
9811,2015-10-28,DET,,UTA,W 92-87,240,30,74,.405,23,55,.418,7,19,.368,25,34,.735,92
9812,2015-10-28,UTA,@,DET,L 87-92,240,35,75,.467,33,63,.524,2,12,.167,15,21,.714,87
9813,2015-10-28,DEN,@,HOU,W 105-85,240,40,79,.506,27,52,.519,13,27,.481,12,18,.667,105
9814,2015-10-28,HOU,,DEN,L 85-105,240,30,87,.345,22,52,.423,8,35,.229,17,26,.654,85
9815,2015-10-28,LAL,,MIN,L 111-112,240,35,90,.389,26,56,.464,9,34,.265,32,35,.914,111
9816,2015-10-28,MIN,@,LAL,W 112-111,240,38,83,.458,33,63,.524,5,20,.250,31,37,.838,112
9817,2015-10-28,CLE,@,MEM,W 106-76,240,41,84,.488,28,55,.509,13,29,.448,11,17,.647,106
9818,2015-10-28,MEM,,CLE,L 76-106,240,29,82,.354,27,66,.409,2,16,.125,16,22,.727,76
9819,2015-10-28,CHA,@,MIA,L 94-104,240,33,84,.393,27,60,.450,6,24,.250,22,29,.759,94
9820,2015-10-28,MIA,,CHO,W 104-94,240,36,73,.493,24,53,.453,12,20,.600,20,21,.952,104
9821,2015-10-28,MIL,,NYK,L 97-122,240,30,86,.349,21,68,.309,9,18,.500,28,31,.903,97
9822,2015-10-28,NYK,@,MIL,W 122-97,240,42,93,.452,33,70,.471,9,23,.391,29,35,.829,122
9823,2015-10-28,OKC,,SAS,W 112-106,240,42,86,.488,35,67,.522,7,19,.368,21,22,.955,112
9824,2015-10-28,SAS,@,OKC,L 106-112,240,45,93,.484,40,78,.513,5,15,.333,11,13,.846,106
9825,2015-10-28,ORL,,WAS,L 87-88,240,37,100,.370,32,74,.432,5,26,.192,8,12,.667,87
9826,2015-10-28,WAS,@,ORL,W 88-87,240,33,84,.393,26,56,.464,7,28,.250,15,25,.600,88
9827,2015-10-28,DAL,@,PHO,W 111-95,240,40,85,.471,30,64,.469,10,21,.476,21,31,.677,111
9828,2015-10-28,PHO,,DAL,L 95-111,240,34,87,.391,28,63,.444,6,24,.250,21,33,.636,95
9829,2015-10-28,NOP,@,POR,L 94-112,240,36,91,.396,25,58,.431,11,33,.333,11,18,.611,94
9830,2015-10-28,POR,,NOP,W 112-94,240,44,88,.500,32,56,.571,12,32,.375,12,14,.857,112
9831,2015-10-28,LAC,@,SAC,W 111-104,240,42,80,.525,36,61,.590,6,19,.316,21,31,.677,111
9832,2015-10-28,SAC,,LAC,L 104-111,240,41,94,.436,30,70,.429,11,24,.458,11,18,.611,104
9833,2015-10-28,IND,@,TOR,L 99-106,240,32,86,.372,23,63,.365,9,23,.391,26,31,.839,99
9834,2015-10-28,TOR,,IND,W 106-99,240,36,80,.450,29,62,.468,7,18,.389,27,39,.692,106
9835,2015-10-27,ATL,,DET,L 94-106,240,37,82,.451,29,55,.527,8,27,.296,12,15,.800,94
9836,2015-10-27,DET,@,ATL,W 106-94,240,37,96,.385,25,67,.373,12,29,.414,20,26,.769,106
9837,2015-10-27,CHI,,CLE,W 97-95,240,37,87,.425,30,68,.441,7,19,.368,16,23,.696,97
9838,2015-10-27,CLE,@,CHI,L 95-97,240,38,94,.404,29,65,.446,9,29,.310,10,17,.588,95
9839,2015-10-27,GSW,,NOP,W 111-95,240,41,96,.427,32,66,.485,9,30,.300,20,22,.909,111
9840,2015-10-27,NOP,@,GSW,L 95-111,240,35,83,.422,29,65,.446,6,18,.333,19,27,.704,95
9841,2015-04-15,BRK,,ORL,W 101-88,240,39,80,.488,30,56,.536,9,24,.375,14,23,.609,101
9842,2015-04-15,ORL,@,BRK,L 88-101,240,38,79,.481,31,59,.525,7,20,.350,5,13,.385,88
9843,2015-04-15,ATL,@,CHI,L 85-91,240,36,92,.391,28,63,.444,8,29,.276,5,7,.714,85
9844,2015-04-15,CHI,,ATL,W 91-85,240,31,77,.403,24,53,.453,7,24,.292,22,26,.846,91
9845,2015-04-15,CLE,,WAS,W 113-108 (OT),265,43,91,.473,27,61,.443,16,30,.533,11,17,.647,113
9846,2015-04-15,WAS,@,CLE,L 108-113 (OT),265,42,97,.433,34,75,.453,8,22,.364,16,21,.762,108
9847,2015-04-15,DAL,,POR,W 114-98,240,39,86,.453,30,61,.492,9,25,.360,27,34,.794,114
9848,2015-04-15,POR,@,DAL,L 98-114,240,38,91,.418,31,66,.470,7,25,.280,15,18,.833,98
9849,2015-04-15,DEN,@,GSW,L 126-133,240,45,83,.542,39,65,.600,6,18,.333,30,36,.833,126
9850,2015-04-15,GSW,,DEN,W 133-126,240,47,90,.522,34,62,.548,13,28,.464,26,34,.765,133
9851,2015-04-15,HOU,,UTA,W 117-91,240,41,76,.539,29,48,.604,12,28,.429,23,34,.676,117
9852,2015-04-15,UTA,@,HOU,L 91-117,240,38,101,.376,33,74,.446,5,27,.185,10,18,.556,91
9853,2015-04-15,LAL,,SAC,L 99-122,240,36,94,.383,29,70,.414,7,24,.292,20,25,.800,99
9854,2015-04-15,SAC,@,LAL,W 122-99,240,46,84,.548,38,67,.567,8,17,.471,22,41,.537,122
9855,2015-04-15,IND,@,MEM,L 83-95,240,32,78,.410,24,54,.444,8,24,.333,11,15,.733,83
9856,2015-04-15,MEM,,IND,W 95-83,240,36,76,.474,34,67,.507,2,9,.222,21,26,.808,95
9857,2015-04-15,BOS,@,MIL,W 105-100,240,42,85,.494,29,55,.527,13,30,.433,8,14,.571,105
9858,2015-04-15,MIL,,BOS,L 100-105,240,41,89,.461,34,68,.500,7,21,.333,11,16,.688,100
9859,2015-04-15,MIN,,OKC,L 113-138,240,39,84,.464,33,65,.508,6,19,.316,29,35,.829,113
9860,2015-04-15,OKC,@,MIN,W 138-113,240,52,95,.547,40,67,.597,12,28,.429,22,31,.710,138
9861,2015-04-15,NOP,,SAS,W 108-103,240,43,83,.518,38,73,.521,5,10,.500,17,25,.680,108
9862,2015-04-15,SAS,@,NOP,L 103-108,240,45,79,.570,42,69,.609,3,10,.300,10,13,.769,103
9863,2015-04-15,DET,@,NYK,W 112-90,240,41,81,.506,31,55,.564,10,26,.385,20,27,.741,112
9864,2015-04-15,NYK,,DET,L 90-112,240,33,77,.429,26,58,.448,7,19,.368,17,27,.630,90
9865,2015-04-15,MIA,@,PHI,W 105-101,240,39,89,.438,27,58,.466,12,31,.387,15,20,.750,105
9866,2015-04-15,PHI,,MIA,L 101-105,240,38,83,.458,33,54,.611,5,29,.172,20,25,.800,101
9867,2015-04-15,CHA,@,TOR,L 87-92,240,30,71,.423,18,38,.474,12,33,.364,15,16,.938,87
9868,2015-04-15,TOR,,CHO,W 92-87,240,38,77,.494,26,44,.591,12,33,.364,4,4,1.000,92
9869,2015-04-14,BOS,,TOR,W 95-93,240,38,99,.384,32,72,.444,6,27,.222,13,15,.867,95
9870,2015-04-14,TOR,@,BOS,L 93-95,240,35,80,.438,26,56,.464,9,24,.375,14,20,.700,93
9871,2015-04-14,IND,,WAS,W 99-95 (2OT),290,40,105,.381,31,75,.413,9,30,.300,10,17,.588,99
9872,2015-04-14,WAS,@,IND,L 95-99 (2OT),290,37,104,.356,30,80,.375,7,24,.292,14,17,.824,95
9873,2015-04-14,LAC,@,PHO,W 112-101,240,42,87,.483,27,49,.551,15,38,.395,13,18,.722,112
9874,2015-04-14,PHO,,LAC,L 101-112,240,39,80,.488,28,54,.519,11,26,.423,12,20,.600,101
9875,2015-04-13,ATL,,NYK,L 108-112,240,39,88,.443,28,56,.500,11,32,.344,19,23,.826,108
9876,2015-04-13,NYK,@,ATL,W 112-108,240,43,77,.558,30,52,.577,13,25,.520,13,19,.684,112
9877,2015-04-13,BRK,,CHI,L 86-113,240,32,87,.368,29,75,.387,3,12,.250,19,22,.864,86
9878,2015-04-13,CHI,@,BRK,W 113-86,240,44,88,.500,32,58,.552,12,30,.400,13,17,.765,113
9879,2015-04-13,CHA,,HOU,L 90-100,240,34,83,.410,21,51,.412,13,32,.406,9,17,.529,90
9880,2015-04-13,HOU,@,CHO,W 100-90,240,35,85,.412,26,50,.520,9,35,.257,21,26,.808,100
9881,2015-04-13,CLE,,DET,W 109-97,240,43,85,.506,26,53,.491,17,32,.531,6,12,.500,109
9882,2015-04-13,DET,@,CLE,L 97-109,240,38,83,.458,29,58,.500,9,25,.360,12,20,.600,97
9883,2015-04-13,GSW,,MEM,W 111-107,240,39,74,.527,26,50,.520,13,24,.542,20,27,.741,111
9884,2015-04-13,MEM,@,GSW,L 107-111,240,41,98,.418,36,83,.434,5,15,.333,20,25,.800,107
9885,2015-04-13,DEN,@,LAC,L 103-110,240,38,101,.376,26,68,.382,12,33,.364,15,22,.682,103
9886,2015-04-13,LAC,,DEN,W 110-103,240,37,82,.451,30,61,.492,7,21,.333,29,37,.784,110
9887,2015-04-13,MIA,,ORL,W 100-93,240,39,83,.470,36,73,.493,3,10,.300,19,23,.826,100
9888,2015-04-13,ORL,@,MIA,L 93-100,240,35,85,.412,29,64,.453,6,21,.286,17,28,.607,93
9889,2015-04-13,MIN,,NOP,L 88-100,240,31,78,.397,27,64,.422,4,14,.286,22,28,.786,88
9890,2015-04-13,NOP,@,MIN,W 100-88,240,37,84,.440,31,63,.492,6,21,.286,20,24,.833,100
9891,2015-04-13,OKC,,POR,W 101-90,240,39,96,.406,35,75,.467,4,21,.190,19,27,.704,101
9892,2015-04-13,POR,@,OKC,L 90-101,240,38,83,.458,30,60,.500,8,23,.348,6,9,.667,90
9893,2015-04-13,MIL,@,PHI,W 107-97,240,40,81,.494,36,72,.500,4,9,.444,23,36,.639,107
9894,2015-04-13,PHI,,MIL,L 97-107,240,32,81,.395,26,53,.491,6,28,.214,27,34,.794,97
9895,2015-04-13,LAL,@,SAC,L 92-102,240,40,96,.417,36,81,.444,4,15,.267,8,13,.615,92
9896,2015-04-13,SAC,,LAL,W 102-92,240,35,72,.486,31,56,.554,4,16,.250,28,36,.778,102
9897,2015-04-13,DAL,@,UTA,L 92-109,240,34,82,.415,25,62,.403,9,20,.450,15,23,.652,92
9898,2015-04-13,UTA,,DAL,W 109-92,240,41,82,.500,30,54,.556,11,28,.393,16,26,.615,109
9899,2015-04-12,BOS,,CLE,W 117-78,240,46,84,.548,36,60,.600,10,24,.417,15,22,.682,117
9900,2015-04-12,CLE,@,BOS,L 78-117,240,31,79,.392,28,57,.491,3,22,.136,13,19,.684,78
9901,2015-04-12,DEN,,SAC,W 122-111,240,45,82,.549,36,56,.643,9,26,.346,23,30,.767,122
9902,2015-04-12,SAC,@,DEN,L 111-122,240,38,74,.514,33,56,.589,5,18,.278,30,42,.714,111
9903,2015-04-12,CHA,@,DET,L 77-116,240,27,79,.342,23,64,.359,4,15,.267,19,29,.655,77
9904,2015-04-12,DET,,CHO,W 116-77,240,41,81,.506,25,53,.472,16,28,.571,18,23,.783,116
9905,2015-04-12,HOU,,NOP,W 121-114,240,39,73,.534,30,49,.612,9,24,.375,34,48,.708,121
9906,2015-04-12,NOP,@,HOU,L 114-121,240,44,91,.484,33,64,.516,11,27,.407,15,22,.682,114
9907,2015-04-12,IND,,OKC,W 116-104,240,42,79,.532,32,59,.542,10,20,.500,22,35,.629,116
9908,2015-04-12,OKC,@,IND,L 104-116,240,41,95,.432,30,67,.448,11,28,.393,11,28,.393,104
9909,2015-04-12,DAL,@,LAL,W 120-106,240,45,83,.542,35,62,.565,10,21,.476,20,26,.769,120
9910,2015-04-12,LAL,,DAL,L 106-120,240,34,78,.436,25,54,.463,9,24,.375,29,36,.806,106
9911,2015-04-12,BRK,@,MIL,L 73-96,240,27,83,.325,24,65,.369,3,18,.167,16,22,.727,73
9912,2015-04-12,MIL,,BRK,W 96-73,240,41,83,.494,35,63,.556,6,20,.300,8,12,.667,96
9913,2015-04-12,PHO,@,SAS,L 91-107,240,35,85,.412,31,69,.449,4,16,.250,17,23,.739,91
9914,2015-04-12,SAS,,PHO,W 107-91,240,35,69,.507,27,50,.540,8,19,.421,29,34,.853,107
9915,2015-04-12,ATL,@,WAS,L 99-108,240,36,87,.414,27,58,.466,9,29,.310,18,24,.750,99
9916,2015-04-12,WAS,,ATL,W 108-99,240,39,85,.459,30,64,.469,9,21,.429,21,27,.778,108
9917,2015-04-11,CHI,,PHI,W 114-107,240,40,90,.444,31,64,.484,9,26,.346,25,36,.694,114
9918,2015-04-11,PHI,@,CHI,L 107-114,240,37,89,.416,24,48,.500,13,41,.317,20,25,.800,107
9919,2015-04-11,GSW,,MIN,W 110-101,240,42,93,.452,31,62,.500,11,31,.355,15,21,.714,110
9920,2015-04-11,MIN,@,GSW,L 101-110,240,35,79,.443,24,55,.436,11,24,.458,20,26,.769,101
9921,2015-04-11,LAC,,MEM,W 94-86,240,35,88,.398,29,61,.475,6,27,.222,18,22,.818,94
9922,2015-04-11,MEM,@,LAC,L 86-94,240,34,77,.442,32,68,.471,2,9,.222,16,24,.667,86
9923,2015-04-11,MIA,,TOR,L 104-107,240,37,81,.457,31,61,.508,6,20,.300,24,44,.545,104
9924,2015-04-11,TOR,@,MIA,W 107-104,240,35,83,.422,26,57,.456,9,26,.346,28,37,.757,107
9925,2015-04-11,NYK,@,ORL,W 80-79,240,31,82,.378,25,62,.403,6,20,.300,12,13,.923,80
9926,2015-04-11,ORL,,NYK,L 79-80,240,30,84,.357,24,62,.387,6,22,.273,13,18,.722,79
9927,2015-04-11,POR,,UTA,L 105-111,240,41,87,.471,35,57,.614,6,30,.200,17,22,.773,105
9928,2015-04-11,UTA,@,POR,W 111-105,240,36,79,.456,30,62,.484,6,17,.353,33,42,.786,111
9929,2015-04-10,ATL,,CHO,W 104-80,240,41,82,.500,31,54,.574,10,28,.357,12,16,.750,104
9930,2015-04-10,CHA,@,ATL,L 80-104,240,30,83,.361,22,53,.415,8,30,.267,12,18,.667,80
9931,2015-04-10,BRK,,WAS,W 117-80,240,45,89,.506,33,69,.478,12,20,.600,15,23,.652,117
9932,2015-04-10,WAS,@,BRK,L 80-117,240,32,82,.390,27,67,.403,5,15,.333,11,17,.647,80
9933,2015-04-10,BOS,@,CLE,W 99-90,240,38,84,.452,30,62,.484,8,22,.364,15,21,.714,99
9934,2015-04-10,CLE,,BOS,L 90-99,240,32,77,.416,23,43,.535,9,34,.265,17,25,.680,90
9935,2015-04-10,DAL,@,DEN,W 144-143 (2OT),290,57,109,.523,46,80,.575,11,29,.379,19,24,.792,144
9936,2015-04-10,DEN,,DAL,L 143-144 (2OT),290,53,125,.424,38,82,.463,15,43,.349,22,25,.880,143
9937,2015-04-10,DET,,IND,L 103-107,240,40,89,.449,29,66,.439,11,23,.478,12,23,.522,103
9938,2015-04-10,IND,@,DET,W 107-103,240,38,79,.481,27,60,.450,11,19,.579,20,22,.909,107
9939,2015-04-10,HOU,,SAS,L 103-104,240,31,66,.470,22,45,.489,9,21,.429,32,53,.604,103
9940,2015-04-10,SAS,@,HOU,W 104-103,240,41,85,.482,37,68,.544,4,17,.235,18,24,.750,104
9941,2015-04-10,LAL,,MIN,W 106-98,240,41,83,.494,32,60,.533,9,23,.391,15,24,.625,106
9942,2015-04-10,MIN,@,LAL,L 98-106,240,32,74,.432,29,59,.492,3,15,.200,31,34,.912,98
9943,2015-04-10,NOP,,PHO,W 90-75,240,37,84,.440,32,65,.492,5,19,.263,11,19,.579,90
9944,2015-04-10,PHO,@,NOP,L 75-90,240,30,85,.353,23,60,.383,7,25,.280,8,10,.800,75
9945,2015-04-10,MIL,@,NYK,W 99-91,240,37,76,.487,31,59,.525,6,17,.353,19,29,.655,99
9946,2015-04-10,NYK,,MIL,L 91-99,240,34,72,.472,29,59,.492,5,13,.385,18,24,.750,91
9947,2015-04-10,OKC,,SAC,W 116-103,240,44,97,.454,34,66,.515,10,31,.323,18,24,.750,116
9948,2015-04-10,SAC,@,OKC,L 103-116,240,37,81,.457,28,57,.491,9,24,.375,20,28,.714,103
9949,2015-04-10,ORL,,TOR,L 99-101,240,41,89,.461,34,69,.493,7,20,.350,10,10,1.000,99
9950,2015-04-10,TOR,@,ORL,W 101-99,240,39,94,.415,30,64,.469,9,30,.300,14,15,.933,101
9951,2015-04-10,MEM,@,UTA,W 89-88,240,36,76,.474,31,61,.508,5,15,.333,12,19,.632,89
9952,2015-04-10,UTA,,MEM,L 88-89,240,31,71,.437,20,48,.417,11,23,.478,15,22,.682,88
9953,2015-04-09,GSW,,POR,W 116-105,240,48,90,.533,36,64,.563,12,26,.462,8,9,.889,116
9954,2015-04-09,POR,@,GSW,L 105-116,240,46,98,.469,39,74,.527,7,24,.292,6,8,.750,105
9955,2015-04-09,CHI,@,MIA,W 89-78,240,35,91,.385,29,68,.426,6,23,.261,13,17,.765,89
9956,2015-04-09,MIA,,CHI,L 78-89,240,34,88,.386,29,70,.414,5,18,.278,5,7,.714,78
9957,2015-04-08,ATL,@,BRK,W 114-111,240,43,86,.500,32,58,.552,11,28,.393,17,25,.680,114
9958,2015-04-08,BRK,,ATL,L 111-114,240,41,87,.471,34,61,.557,7,26,.269,22,25,.880,111
9959,2015-04-08,CHA,,TOR,L 74-92,240,28,81,.346,18,59,.305,10,22,.455,8,11,.727,74
9960,2015-04-08,TOR,@,CHO,W 92-74,240,33,77,.429,21,50,.420,12,27,.444,14,19,.737,92
9961,2015-04-08,DAL,,PHO,W 107-104,240,45,94,.479,41,76,.539,4,18,.222,13,16,.813,107
9962,2015-04-08,PHO,@,DAL,L 104-107,240,40,82,.488,32,57,.561,8,25,.320,16,19,.842,104
9963,2015-04-08,DEN,,LAL,W 119-101,240,44,88,.500,31,58,.534,13,30,.433,18,24,.750,119
9964,2015-04-08,LAL,@,DEN,L 101-119,240,36,75,.480,31,59,.525,5,16,.313,24,35,.686,101
9965,2015-04-08,BOS,@,DET,W 113-103,240,36,80,.450,28,52,.538,8,28,.286,33,34,.971,113
9966,2015-04-08,DET,,BOS,L 103-113,240,45,84,.536,38,66,.576,7,18,.389,6,10,.600,103
9967,2015-04-08,MEM,,NOP,W 110-74,240,45,88,.511,37,71,.521,8,17,.471,12,14,.857,110
9968,2015-04-08,NOP,@,MEM,L 74-110,240,28,80,.350,22,59,.373,6,21,.286,12,18,.667,74
9969,2015-04-08,CLE,@,MIL,W 104-99,240,36,74,.486,25,40,.625,11,34,.324,21,26,.808,104
9970,2015-04-08,MIL,,CLE,L 99-104,240,42,84,.500,36,66,.545,6,18,.333,9,13,.692,99
9971,2015-04-08,IND,@,NYK,W 102-86,240,38,77,.494,34,55,.618,4,22,.182,22,27,.815,102
9972,2015-04-08,NYK,,IND,L 86-102,240,29,84,.345,22,67,.328,7,17,.412,21,26,.808,86
9973,2015-04-08,CHI,@,ORL,L 103-105,240,34,79,.430,22,53,.415,12,26,.462,23,31,.742,103
9974,2015-04-08,ORL,,CHI,W 105-103,240,38,82,.463,30,59,.508,8,23,.348,21,24,.875,105
9975,2015-04-08,PHI,,WAS,L 90-119,240,31,89,.348,22,62,.355,9,27,.333,19,27,.704,90
9976,2015-04-08,WAS,@,PHI,W 119-90,240,47,72,.653,39,57,.684,8,15,.533,17,23,.739,119
9977,2015-04-08,MIN,@,POR,L 91-116,240,32,85,.376,29,74,.392,3,11,.273,24,29,.828,91
9978,2015-04-08,POR,,MIN,W 116-91,240,42,85,.494,30,52,.577,12,33,.364,20,23,.870,116
9979,2015-04-08,HOU,@,SAS,L 98-110,240,39,84,.464,29,59,.492,10,25,.400,10,16,.625,98
9980,2015-04-08,SAS,,HOU,W 110-98,240,48,95,.505,41,74,.554,7,21,.333,7,9,.778,110
9981,2015-04-08,SAC,@,UTA,L 91-103,240,33,75,.440,26,59,.441,7,16,.438,18,28,.643,91
9982,2015-04-08,UTA,,SAC,W 103-91,240,36,74,.486,23,43,.535,13,31,.419,18,25,.720,103
9983,2015-04-07,ATL,,PHO,W 96-69,240,41,83,.494,37,58,.638,4,25,.160,10,14,.714,96
9984,2015-04-07,PHO,@,ATL,L 69-96,240,26,83,.313,22,63,.349,4,20,.200,13,18,.722,69
9985,2015-04-07,LAC,,LAL,W 105-100,240,39,81,.481,32,57,.561,7,24,.292,20,30,.667,105
9986,2015-04-07,LAL,@,LAC,L 100-105,240,35,84,.417,26,59,.441,9,25,.360,21,27,.778,100
9987,2015-04-07,CHA,@,MIA,L 100-105,240,39,91,.429,34,73,.466,5,18,.278,17,21,.810,100
9988,2015-04-07,MIA,,CHO,W 105-100,240,40,81,.494,37,66,.561,3,15,.200,22,28,.786,105
9989,2015-04-07,GSW,@,NOP,L 100-103,240,42,95,.442,33,73,.452,9,22,.409,7,10,.700,100
9990,2015-04-07,NOP,,GSW,W 103-100,240,36,83,.434,27,64,.422,9,19,.474,22,30,.733,103
9991,2015-04-07,OKC,,SAS,L 88-113,240,34,84,.405,29,65,.446,5,19,.263,15,28,.536,88
9992,2015-04-07,SAS,@,OKC,W 113-88,240,47,89,.528,37,65,.569,10,24,.417,9,13,.692,113
9993,2015-04-07,MIN,@,SAC,L 111-116,240,45,93,.484,39,74,.527,6,19,.316,15,21,.714,111
9994,2015-04-07,SAC,,MIN,W 116-111,240,42,80,.525,33,56,.589,9,24,.375,23,34,.676,116
9995,2015-04-06,BRK,,POR,W 106-96,240,41,91,.451,35,77,.455,6,14,.429,18,23,.783,106
9996,2015-04-06,POR,@,BRK,L 96-106,240,39,87,.448,28,61,.459,11,26,.423,7,9,.778,96
9997,2015-04-05,CHI,@,CLE,L 94-99,240,34,76,.447,23,49,.469,11,27,.407,15,21,.714,94
9998,2015-04-05,CLE,,CHI,W 99-94,240,35,83,.422,19,46,.413,16,37,.432,13,22,.591,99
9999,2015-04-05,IND,,MIA,W 112-89,240,37,85,.435,23,55,.418,14,30,.467,24,36,.667,112
10000,2015-04-05,MIA,@,IND,L 89-112,240,37,82,.451,35,62,.565,2,20,.100,13,19,.684,89
10001,2015-04-05,LAC,@,LAL,W 106-78,240,40,75,.533,25,48,.521,15,27,.556,11,18,.611,106
10002,2015-04-05,LAL,,LAC,L 78-106,240,29,75,.387,22,58,.379,7,17,.412,13,22,.591,78
10003,2015-04-05,NYK,,PHI,W 101-91,240,37,72,.514,34,59,.576,3,13,.231,24,29,.828,101
10004,2015-04-05,PHI,@,NYK,L 91-101,240,38,99,.384,28,67,.418,10,32,.313,5,8,.625,91
10005,2015-04-05,HOU,@,OKC,W 115-112,240,38,81,.469,30,53,.566,8,28,.286,31,50,.620,115
10006,2015-04-05,OKC,,HOU,L 112-115,240,40,92,.435,26,62,.419,14,30,.467,18,26,.692,112
10007,2015-04-05,SAC,,UTA,L 95-101,240,38,79,.481,33,64,.516,5,15,.333,14,24,.583,95
10008,2015-04-05,UTA,@,SAC,W 101-95,240,40,87,.460,32,63,.508,8,24,.333,13,18,.722,101
10009,2015-04-05,GSW,@,SAS,L 92-107,240,39,91,.429,30,63,.476,9,28,.321,5,10,.500,92
10010,2015-04-05,SAS,,GSW,W 107-92,240,44,83,.530,37,62,.597,7,21,.333,12,15,.800,107
10011,2015-04-04,ATL,,BRK,W 131-99,240,49,82,.598,32,49,.653,17,33,.515,16,19,.842,131
10012,2015-04-04,BRK,@,ATL,L 99-131,240,39,80,.488,29,57,.509,10,23,.435,11,17,.647,99
10013,2015-04-04,CHA,,PHI,W 92-91,240,35,86,.407,34,73,.466,1,13,.077,21,23,.913,92
10014,2015-04-04,PHI,@,CHO,L 91-92,240,28,76,.368,17,50,.340,11,26,.423,24,33,.727,91
10015,2015-04-04,DAL,,GSW,L 110-123,240,34,80,.425,31,64,.484,3,16,.188,39,54,.722,110
10016,2015-04-04,GSW,@,DAL,W 123-110,240,43,95,.453,29,59,.492,14,36,.389,23,32,.719,123
10017,2015-04-04,DEN,,LAC,L 92-107,240,32,85,.376,26,63,.413,6,22,.273,22,31,.710,92
10018,2015-04-04,LAC,@,DEN,W 107-92,240,34,79,.430,21,45,.467,13,34,.382,26,42,.619,107
10019,2015-04-04,DET,,MIA,W 99-98,240,36,73,.493,24,47,.511,12,26,.462,15,23,.652,99
10020,2015-04-04,MIA,@,DET,L 98-99,240,37,77,.481,32,57,.561,5,20,.250,19,26,.731,98
10021,2015-04-04,MEM,,WAS,L 83-92,240,34,81,.420,33,66,.500,1,15,.067,14,18,.778,83
10022,2015-04-04,WAS,@,MEM,W 92-83,240,38,79,.481,30,57,.526,8,22,.364,8,10,.800,92
10023,2015-04-04,MIL,,ORL,L 90-97,240,39,89,.438,34,73,.466,5,16,.313,7,13,.538,90
10024,2015-04-04,ORL,@,MIL,W 97-90,240,40,86,.465,32,65,.492,8,21,.381,9,13,.692,97
10025,2015-04-04,PHO,,UTA,W 87-85,240,30,69,.435,25,55,.455,5,14,.357,22,29,.759,87
10026,2015-04-04,UTA,@,PHO,L 85-87,240,29,74,.392,22,53,.415,7,21,.333,20,24,.833,85
10027,2015-04-04,NOP,@,POR,L 90-99,240,39,85,.459,32,69,.464,7,16,.438,5,10,.500,90
10028,2015-04-04,POR,,NOP,W 99-90,240,36,84,.429,30,68,.441,6,16,.375,21,23,.913,99
10029,2015-04-04,BOS,@,TOR,W 117-116 (OT),265,47,97,.485,39,71,.549,8,26,.308,15,22,.682,117
10030,2015-04-04,TOR,,BOS,L 116-117 (OT),265,40,83,.482,34,60,.567,6,23,.261,30,38,.789,116
10031,2015-04-03,BOS,,MIL,L 101-110,240,39,88,.443,31,64,.484,8,24,.333,15,16,.938,101
10032,2015-04-03,MIL,@,BOS,W 110-101,240,45,85,.529,36,61,.590,9,24,.375,11,18,.611,110
10033,2015-04-03,BRK,,TOR,W 114-109,240,46,88,.523,41,72,.569,5,16,.313,17,23,.739,114
10034,2015-04-03,TOR,@,BRK,L 109-114,240,42,82,.512,34,56,.607,8,26,.308,17,23,.739,109
10035,2015-04-03,CHI,,DET,W 88-82,240,33,85,.388,29,68,.426,4,17,.235,18,21,.857,88
10036,2015-04-03,DET,@,CHI,L 82-88,240,32,74,.432,26,55,.473,6,19,.316,12,15,.800,82
10037,2015-04-03,CHA,@,IND,L 74-93,240,28,80,.350,24,62,.387,4,18,.222,14,20,.700,74
10038,2015-04-03,IND,,CHO,W 93-74,240,36,83,.434,28,67,.418,8,16,.500,13,18,.722,93
10039,2015-04-03,LAL,,POR,L 77-107,240,31,82,.378,26,68,.382,5,14,.357,10,17,.588,77
10040,2015-04-03,POR,@,LAL,W 107-77,240,43,88,.489,33,62,.532,10,26,.385,11,11,1.000,107
10041,2015-04-03,MEM,,OKC,W 100-92,240,38,80,.475,34,59,.576,4,21,.190,20,28,.714,100
10042,2015-04-03,OKC,@,MEM,L 92-100,240,36,88,.409,32,71,.451,4,17,.235,16,26,.615,92
10043,2015-04-03,MIN,,ORL,L 84-97,240,29,64,.453,28,53,.528,1,11,.091,25,32,.781,84
10044,2015-04-03,ORL,@,MIN,W 97-84,240,40,92,.435,34,71,.479,6,21,.286,11,17,.647,97
10045,2015-04-03,NOP,@,SAC,W 101-95,240,34,87,.391,20,58,.345,14,29,.483,19,28,.679,101
10046,2015-04-03,SAC,,NOP,L 95-101,240,37,78,.474,31,61,.508,6,17,.353,15,25,.600,95
10047,2015-04-03,DEN,@,SAS,L 93-123,240,40,87,.460,34,70,.486,6,17,.353,7,11,.636,93
10048,2015-04-03,SAS,,DEN,W 123-93,240,47,85,.553,33,51,.647,14,34,.412,15,17,.882,123
10049,2015-04-03,NYK,@,WAS,L 87-101,240,31,84,.369,24,63,.381,7,21,.333,18,20,.900,87
10050,2015-04-03,WAS,,NYK,W 101-87,240,43,93,.462,36,77,.468,7,16,.438,8,12,.667,101
10051,2015-04-02,CLE,,MIA,W 114-88,240,40,80,.500,25,45,.556,15,35,.429,19,25,.760,114
10052,2015-04-02,MIA,@,CLE,L 88-114,240,32,75,.427,25,54,.463,7,21,.333,17,21,.810,88
10053,2015-04-02,DAL,,HOU,L 101-108,240,37,84,.440,29,58,.500,8,26,.308,19,27,.704,101
10054,2015-04-02,HOU,@,DAL,W 108-101,240,34,77,.442,23,46,.500,11,31,.355,29,40,.725,108
10055,2015-04-02,GSW,,PHO,W 107-106,240,43,93,.462,33,67,.493,10,26,.385,11,17,.647,107
10056,2015-04-02,PHO,@,GSW,L 106-107,240,42,90,.467,37,71,.521,5,19,.263,17,26,.654,106
10057,2015-04-01,BOS,,IND,W 100-87,240,39,86,.453,33,59,.559,6,27,.222,16,18,.889,100
10058,2015-04-01,IND,@,BOS,L 87-100,240,34,81,.420,28,66,.424,6,15,.400,13,23,.565,87
10059,2015-04-01,CHA,,DET,W 102-78,240,38,90,.422,29,68,.426,9,22,.409,17,24,.708,102
10060,2015-04-01,DET,@,CHO,L 78-102,240,31,88,.352,26,66,.394,5,22,.227,11,18,.611,78
10061,2015-04-01,HOU,,SAC,W 115-111,240,41,89,.461,23,49,.469,18,40,.450,15,25,.600,115
10062,2015-04-01,SAC,@,HOU,L 111-115,240,48,96,.500,41,82,.500,7,14,.500,8,16,.500,111
10063,2015-04-01,LAL,,NOP,L 92-113,240,37,83,.446,32,67,.478,5,16,.313,13,21,.619,92
10064,2015-04-01,NOP,@,LAL,W 113-92,240,44,78,.564,35,62,.565,9,16,.563,16,21,.762,113
10065,2015-04-01,CHI,@,MIL,L 91-95,240,31,74,.419,26,48,.542,5,26,.192,24,37,.649,91
10066,2015-04-01,MIL,,CHI,W 95-91,240,37,89,.416,29,68,.426,8,21,.381,13,18,.722,95
10067,2015-04-01,MIN,,TOR,L 99-113,240,41,77,.532,36,63,.571,5,14,.357,12,19,.632,99
10068,2015-04-01,TOR,@,MIN,W 113-99,240,42,76,.553,29,46,.630,13,30,.433,16,23,.696,113
10069,2015-04-01,BRK,@,NYK,W 100-98,240,41,81,.506,32,65,.492,9,16,.563,9,12,.750,100
10070,2015-04-01,NYK,,BRK,L 98-100,240,37,81,.457,26,58,.448,11,23,.478,13,15,.867,98
10071,2015-04-01,DAL,@,OKC,W 135-131,240,56,91,.615,52,76,.684,4,15,.267,19,24,.792,135
10072,2015-04-01,OKC,,DAL,L 131-135,240,45,93,.484,31,62,.500,14,31,.452,27,33,.818,131
10073,2015-04-01,ORL,,SAS,L 91-103,240,39,93,.419,34,76,.447,5,17,.294,8,9,.889,91
10074,2015-04-01,SAS,@,ORL,W 103-91,240,35,86,.407,22,57,.386,13,29,.448,20,23,.870,103
10075,2015-04-01,LAC,@,POR,W 126-122,240,46,86,.535,31,58,.534,15,28,.536,19,24,.792,126
10076,2015-04-01,POR,,LAC,L 122-126,240,45,89,.506,32,64,.500,13,25,.520,19,25,.760,122
10077,2015-04-01,DEN,@,UTA,L 84-98,240,33,95,.347,26,62,.419,7,33,.212,11,12,.917,84
10078,2015-04-01,UTA,,DEN,W 98-84,240,37,77,.481,28,54,.519,9,23,.391,15,24,.625,98
10079,2015-04-01,PHI,@,WAS,L 93-106,240,36,91,.396,26,57,.456,10,34,.294,11,17,.647,93
10080,2015-04-01,WAS,,PHI,W 106-93,240,44,76,.579,40,64,.625,4,12,.333,14,22,.636,106
10081,2015-03-31,BRK,,IND,W 111-106,240,40,80,.500,31,62,.500,9,18,.500,22,28,.786,111
10082,2015-03-31,IND,@,BRK,L 106-111,240,37,82,.451,25,59,.424,12,23,.522,20,24,.833,106
10083,2015-03-31,ATL,@,DET,L 95-105,240,40,84,.476,32,59,.542,8,25,.320,7,10,.700,95
10084,2015-03-31,DET,,ATL,W 105-95,240,41,83,.494,30,54,.556,11,29,.379,12,17,.706,105
10085,2015-03-31,GSW,@,LAC,W 110-106,240,38,85,.447,30,64,.469,8,21,.381,26,34,.765,110
10086,2015-03-31,LAC,,GSW,L 106-110,240,36,82,.439,30,60,.500,6,22,.273,28,33,.848,106
10087,2015-03-31,MIA,,SAS,L 81-95,240,32,79,.405,27,64,.422,5,15,.333,12,12,1.000,81
10088,2015-03-31,SAS,@,MIA,W 95-81,240,37,74,.500,29,56,.518,8,18,.444,13,17,.765,95
10089,2015-03-30,ATL,,MIL,W 101-88,240,36,79,.456,27,50,.540,9,29,.310,20,24,.833,101
10090,2015-03-30,MIL,@,ATL,L 88-101,240,34,75,.453,30,58,.517,4,17,.235,16,23,.696,88
10091,2015-03-30,BOS,@,CHO,W 116-104,240,45,89,.506,36,63,.571,9,26,.346,17,23,.739,116
10092,2015-03-30,CHA,,BOS,L 104-116,240,40,85,.471,33,59,.559,7,26,.269,17,19,.895,104
10093,2015-03-30,MEM,,SAC,W 97-83,240,38,83,.458,30,60,.500,8,23,.348,13,17,.765,97
10094,2015-03-30,SAC,@,MEM,L 83-97,240,33,81,.407,28,65,.431,5,16,.313,12,20,.600,83
10095,2015-03-30,MIN,,UTA,L 84-104,240,28,76,.368,22,60,.367,6,16,.375,22,27,.815,84
10096,2015-03-30,UTA,@,MIN,W 104-84,240,39,82,.476,29,49,.592,10,33,.303,16,18,.889,104
10097,2015-03-30,LAL,@,PHI,W 113-111 (OT),265,40,82,.488,30,61,.492,10,21,.476,23,30,.767,113
10098,2015-03-30,PHI,,LAL,L 111-113 (OT),265,39,96,.406,29,66,.439,10,30,.333,23,38,.605,111
10099,2015-03-30,PHO,@,POR,L 86-109,240,38,87,.437,35,71,.493,3,16,.188,7,10,.700,86
10100,2015-03-30,POR,,PHO,W 109-86,240,44,86,.512,32,59,.542,12,27,.444,9,10,.900,109
10101,2015-03-30,HOU,@,TOR,L 96-99,240,35,84,.417,27,57,.474,8,27,.296,18,31,.581,96
10102,2015-03-30,TOR,,HOU,W 99-96,240,35,78,.449,27,56,.482,8,22,.364,21,27,.778,99
10103,2015-03-29,BOS,,LAC,L 106-119,240,39,93,.419,31,62,.500,8,31,.258,20,23,.870,106
10104,2015-03-29,LAC,@,BOS,W 119-106,240,41,84,.488,28,52,.538,13,32,.406,24,40,.600,119
10105,2015-03-29,BRK,,LAL,W 107-99,240,42,87,.483,34,59,.576,8,28,.286,15,21,.714,107
10106,2015-03-29,LAL,@,BRK,L 99-107,240,42,91,.462,36,73,.493,6,18,.333,9,11,.818,99
10107,2015-03-29,CLE,,PHI,W 87-86,240,33,85,.388,24,62,.387,9,23,.391,12,18,.667,87
10108,2015-03-29,PHI,@,CLE,L 86-87,240,34,84,.405,24,54,.444,10,30,.333,8,15,.533,86
10109,2015-03-29,DAL,@,IND,L 99-104,240,40,90,.444,34,75,.453,6,15,.400,13,19,.684,99
10110,2015-03-29,IND,,DAL,W 104-99,240,38,76,.500,28,59,.475,10,17,.588,18,26,.692,104
10111,2015-03-29,DET,@,MIA,L 102-109,240,40,83,.482,32,58,.552,8,25,.320,14,22,.636,102
10112,2015-03-29,MIA,,DET,W 109-102,240,39,82,.476,32,64,.500,7,18,.389,24,29,.828,109
10113,2015-03-29,MIN,@,NOP,L 88-110,240,32,75,.427,30,63,.476,2,12,.167,22,24,.917,88
10114,2015-03-29,NOP,,MIN,W 110-88,240,43,75,.573,37,62,.597,6,13,.462,18,24,.750,110
10115,2015-03-29,OKC,@,PHO,W 109-97,240,40,86,.465,30,60,.500,10,26,.385,19,26,.731,109
10116,2015-03-29,PHO,,OKC,L 97-109,240,37,82,.451,32,60,.533,5,22,.227,18,24,.750,97
10117,2015-03-29,MEM,@,SAS,L 89-103,240,36,82,.439,30,68,.441,6,14,.429,11,12,.917,89
10118,2015-03-29,SAS,,MEM,W 103-89,240,42,83,.506,38,66,.576,4,17,.235,15,18,.833,103
10119,2015-03-29,HOU,@,WAS,W 99-91,240,34,80,.425,25,51,.490,9,29,.310,22,33,.667,99
10120,2015-03-29,WAS,,HOU,L 91-99,240,29,75,.387,25,60,.417,4,15,.267,29,37,.784,91
10121,2015-03-28,CHI,,NYK,W 111-80,240,43,84,.512,37,67,.552,6,17,.353,19,22,.864,111
10122,2015-03-28,NYK,@,CHI,L 80-111,240,30,79,.380,26,62,.419,4,17,.235,16,19,.842,80
10123,2015-03-28,ATL,@,CHO,L 100-115,240,37,86,.430,22,56,.393,15,30,.500,11,14,.786,100
10124,2015-03-28,CHA,,ATL,W 115-100,240,42,80,.525,30,54,.556,12,26,.462,19,22,.864,115
10125,2015-03-28,GSW,@,MIL,W 108-95,240,42,82,.512,30,57,.526,12,25,.480,12,14,.857,108
10126,2015-03-28,MIL,,GSW,L 95-108,240,33,87,.379,31,72,.431,2,15,.133,27,32,.844,95
10127,2015-03-28,DEN,@,POR,L 114-120,240,43,92,.467,34,68,.500,9,24,.375,19,22,.864,114
10128,2015-03-28,POR,,DEN,W 120-114,240,48,85,.565,40,67,.597,8,18,.444,16,18,.889,120
10129,2015-03-28,OKC,@,UTA,L 89-94,240,31,73,.425,25,57,.439,6,16,.375,21,32,.656,89
10130,2015-03-28,UTA,,OKC,W 94-89,240,32,84,.381,26,55,.473,6,29,.207,24,35,.686,94
10131,2015-03-27,ATL,,MIA,W 99-86,240,37,72,.514,31,54,.574,6,18,.333,19,24,.792,99
10132,2015-03-27,MIA,@,ATL,L 86-99,240,32,82,.390,21,47,.447,11,35,.314,11,15,.733,86
10133,2015-03-27,BRK,,CLE,W 106-98,240,40,86,.465,31,63,.492,9,23,.391,17,19,.895,106
10134,2015-03-27,CLE,@,BRK,L 98-106,240,37,81,.457,29,51,.569,8,30,.267,16,20,.800,98
10135,2015-03-27,DEN,,UTA,W 107-91,240,39,76,.513,26,52,.500,13,24,.542,16,23,.696,107
10136,2015-03-27,UTA,@,DEN,L 91-107,240,32,81,.395,27,54,.500,5,27,.185,22,31,.710,91
10137,2015-03-27,HOU,,MIN,W 120-110,240,44,83,.530,24,39,.615,20,44,.455,12,17,.706,120
10138,2015-03-27,MIN,@,HOU,L 110-120,240,37,76,.487,31,62,.500,6,14,.429,30,34,.882,110
10139,2015-03-27,GSW,@,MEM,W 107-84,240,39,90,.433,23,59,.390,16,31,.516,13,17,.765,107
10140,2015-03-27,MEM,,GSW,L 84-107,240,34,76,.447,29,63,.460,5,13,.385,11,15,.733,84
10141,2015-03-27,NOP,,SAC,W 102-88,240,43,84,.512,34,64,.531,9,20,.450,7,12,.583,102
10142,2015-03-27,SAC,@,NOP,L 88-102,240,35,79,.443,28,64,.438,7,15,.467,11,18,.611,88
10143,2015-03-27,BOS,@,NYK,W 96-92,240,29,69,.420,25,49,.510,4,20,.200,34,43,.791,96
10144,2015-03-27,NYK,,BOS,L 92-96,240,38,87,.437,31,63,.492,7,24,.292,9,14,.643,92
10145,2015-03-27,DET,@,ORL,W 111-97,240,42,90,.467,35,72,.486,7,18,.389,20,27,.741,111
10146,2015-03-27,ORL,,DET,L 97-111,240,43,82,.524,40,67,.597,3,15,.200,8,8,1.000,97
10147,2015-03-27,LAC,@,PHI,W 119-98,240,44,82,.537,32,53,.604,12,29,.414,19,31,.613,119
10148,2015-03-27,PHI,,LAC,L 98-119,240,36,86,.419,25,55,.455,11,31,.355,15,27,.556,98
10149,2015-03-27,PHO,,POR,L 81-87,240,32,87,.368,26,67,.388,6,20,.300,11,12,.917,81
10150,2015-03-27,POR,@,PHO,W 87-81,240,36,89,.404,29,63,.460,7,26,.269,8,18,.444,87
10151,2015-03-27,DAL,@,SAS,L 76-94,240,31,82,.378,27,64,.422,4,18,.222,10,15,.667,76
10152,2015-03-27,SAS,,DAL,W 94-76,240,37,84,.440,28,58,.483,9,26,.346,11,14,.786,94
10153,2015-03-27,LAL,@,TOR,L 83-94,240,29,84,.345,25,67,.373,4,17,.235,21,29,.724,83
10154,2015-03-27,TOR,,LAL,W 94-83,240,36,75,.480,29,57,.509,7,18,.389,15,21,.714,94
10155,2015-03-27,CHA,@,WAS,L 107-110 (2OT),290,36,104,.346,28,79,.354,8,25,.320,27,35,.771,107
10156,2015-03-27,WAS,,CHO,W 110-107 (2OT),290,44,113,.389,35,88,.398,9,25,.360,13,22,.591,110
10157,2015-03-26,IND,@,MIL,L 107-111,240,30,71,.423,16,41,.390,14,30,.467,33,43,.767,107
10158,2015-03-26,MIL,,IND,W 111-107,240,39,73,.534,30,54,.556,9,19,.474,24,34,.706,111
10159,2015-03-25,BOS,,MIA,L 86-93,240,28,69,.406,23,50,.460,5,19,.263,25,37,.676,86
10160,2015-03-25,MIA,@,BOS,W 93-86,240,34,77,.442,25,53,.472,9,24,.375,16,23,.696,93
10161,2015-03-25,BRK,@,CHO,W 91-88,240,39,91,.429,36,77,.468,3,14,.214,10,11,.909,91
10162,2015-03-25,CHA,,BRK,L 88-91,240,36,91,.396,33,79,.418,3,12,.250,13,20,.650,88
10163,2015-03-25,DEN,,PHI,L 85-99,240,29,84,.345,21,55,.382,8,29,.276,19,27,.704,85
10164,2015-03-25,PHI,@,DEN,W 99-85,240,35,84,.417,21,50,.420,14,34,.412,15,22,.682,99
10165,2015-03-25,CLE,@,MEM,W 111-89,240,43,84,.512,29,50,.580,14,34,.412,11,13,.846,111
10166,2015-03-25,MEM,,CLE,L 89-111,240,37,85,.435,33,68,.485,4,17,.235,11,16,.688,89
10167,2015-03-25,LAL,@,MIN,W 101-99 (OT),265,39,92,.424,33,66,.500,6,26,.231,17,18,.944,101
10168,2015-03-25,MIN,,LAL,L 99-101 (OT),265,33,78,.423,27,56,.482,6,22,.273,27,30,.900,99
10169,2015-03-25,HOU,@,NOP,W 95-93,240,40,81,.494,34,59,.576,6,22,.273,9,12,.750,95
10170,2015-03-25,NOP,,HOU,L 93-95,240,34,75,.453,29,60,.483,5,15,.333,20,32,.625,93
10171,2015-03-25,LAC,@,NYK,W 111-80,240,44,78,.564,33,50,.660,11,28,.393,12,18,.667,111
10172,2015-03-25,NYK,,LAC,L 80-111,240,29,82,.354,24,59,.407,5,23,.217,17,19,.895,80
10173,2015-03-25,ATL,@,ORL,W 95-83,240,39,90,.433,29,59,.492,10,31,.323,7,10,.700,95
10174,2015-03-25,ORL,,ATL,L 83-95,240,32,78,.410,29,62,.468,3,16,.188,16,20,.800,83
10175,2015-03-25,PHO,,SAC,L 99-108,240,38,87,.437,32,62,.516,6,25,.240,17,26,.654,99
10176,2015-03-25,SAC,@,PHO,W 108-99,240,40,81,.494,32,60,.533,8,21,.381,20,23,.870,108
10177,2015-03-25,OKC,@,SAS,L 91-130,240,36,90,.400,30,72,.417,6,18,.333,13,14,.929,91
10178,2015-03-25,SAS,,OKC,W 130-91,240,51,88,.580,38,67,.567,13,21,.619,15,19,.789,130
10179,2015-03-25,CHI,@,TOR,W 116-103,240,45,74,.608,33,51,.647,12,23,.522,14,17,.824,116
10180,2015-03-25,TOR,,CHI,L 103-116,240,39,83,.470,30,62,.484,9,21,.429,16,19,.842,103
10181,2015-03-25,POR,@,UTA,W 92-89,240,34,81,.420,27,54,.500,7,27,.259,17,20,.850,92
10182,2015-03-25,UTA,,POR,L 89-92,240,35,80,.438,31,64,.484,4,16,.250,15,23,.652,89
10183,2015-03-25,IND,@,WAS,W 103-101,240,38,85,.447,29,59,.492,9,26,.346,18,28,.643,103
10184,2015-03-25,WAS,,IND,L 101-103,240,33,75,.440,28,61,.459,5,14,.357,30,38,.789,101
10185,2015-03-24,DAL,,SAS,W 101-94,240,42,87,.483,35,65,.538,7,22,.318,10,13,.769,101
10186,2015-03-24,SAS,@,DAL,L 94-101,240,36,85,.424,28,57,.491,8,28,.286,14,18,.778,94
10187,2015-03-24,DET,,TOR,W 108-104,240,40,93,.430,28,64,.438,12,29,.414,16,24,.667,108
10188,2015-03-24,TOR,@,DET,L 104-108,240,35,75,.467,28,52,.538,7,23,.304,27,29,.931,104
10189,2015-03-24,MIA,@,MIL,L 88-89,240,33,75,.440,25,56,.446,8,19,.421,14,18,.778,88
10190,2015-03-24,MIL,,MIA,W 89-88,240,36,87,.414,32,70,.457,4,17,.235,13,17,.765,89
10191,2015-03-24,LAL,@,OKC,L 117-127,240,44,85,.518,35,66,.530,9,19,.474,20,27,.741,117
10192,2015-03-24,OKC,,LAL,W 127-117,240,48,86,.558,37,65,.569,11,21,.524,20,23,.870,127
10193,2015-03-24,GSW,@,POR,W 122-108,240,50,83,.602,38,57,.667,12,26,.462,10,11,.909,122
10194,2015-03-24,POR,,GSW,L 108-122,240,39,92,.424,24,58,.414,15,34,.441,15,19,.789,108
10195,2015-03-24,PHI,@,SAC,L 106-107,240,40,81,.494,27,53,.509,13,28,.464,13,21,.619,106
10196,2015-03-24,SAC,,PHI,W 107-106,240,35,97,.361,28,77,.364,7,20,.350,30,38,.789,107
10197,2015-03-23,BOS,@,BRK,W 110-91,240,47,92,.511,41,70,.586,6,22,.273,10,14,.714,110
10198,2015-03-23,BRK,,BOS,L 91-110,240,32,89,.360,31,72,.431,1,17,.059,26,30,.867,91
10199,2015-03-23,CHI,,CHO,W 98-86,240,37,82,.451,34,66,.515,3,16,.188,21,29,.724,98
10200,2015-03-23,CHA,@,CHI,L 86-98,240,28,81,.346,20,61,.328,8,20,.400,22,28,.786,86
10201,2015-03-23,GSW,,WAS,W 107-76,240,39,95,.411,26,62,.419,13,33,.394,16,21,.762,107
10202,2015-03-23,WAS,@,GSW,L 76-107,240,27,81,.333,24,70,.343,3,11,.273,19,26,.731,76
10203,2015-03-23,HOU,@,IND,W 110-100,240,31,65,.477,18,41,.439,13,24,.542,35,37,.946,110
10204,2015-03-23,IND,,HOU,L 100-110,240,40,90,.444,32,66,.485,8,24,.333,12,19,.632,100
10205,2015-03-23,MEM,@,NYK,W 103-82,240,41,79,.519,34,67,.507,7,12,.583,14,19,.737,103
10206,2015-03-23,NYK,,MEM,L 82-103,240,32,76,.421,28,58,.483,4,18,.222,14,17,.824,82
10207,2015-03-23,MIN,@,UTA,W 106-104 (OT),265,37,78,.474,25,59,.424,12,19,.632,20,25,.800,106
10208,2015-03-23,UTA,,MIN,L 104-106 (OT),265,38,87,.437,29,59,.492,9,28,.321,19,31,.613,104
10209,2015-03-22,ATL,,SAS,L 95-114,240,38,80,.475,26,56,.464,12,24,.500,7,7,1.000,95
10210,2015-03-22,SAS,@,ATL,W 114-95,240,46,82,.561,39,65,.600,7,17,.412,15,17,.882,114
10211,2015-03-22,BOS,,DET,L 97-105 (OT),265,38,105,.362,30,78,.385,8,27,.296,13,17,.765,97
10212,2015-03-22,DET,@,BOS,W 105-97 (OT),265,39,89,.438,30,63,.476,9,26,.346,18,30,.600,105
10213,2015-03-22,LAC,,NOP,W 107-100,240,42,91,.462,35,68,.515,7,23,.304,16,23,.696,107
10214,2015-03-22,NOP,@,LAC,L 100-107,240,38,75,.507,26,53,.491,12,22,.545,12,16,.750,100
10215,2015-03-22,LAL,,PHI,W 101-87,240,39,81,.481,34,67,.507,5,14,.357,18,22,.818,101
10216,2015-03-22,PHI,@,LAL,L 87-101,240,32,89,.360,23,62,.371,9,27,.333,14,21,.667,87
10217,2015-03-22,CLE,@,MIL,W 108-90,240,42,84,.500,29,53,.547,13,31,.419,11,16,.688,108
10218,2015-03-22,MIL,,CLE,L 90-108,240,38,70,.543,35,58,.603,3,12,.250,11,14,.786,90
10219,2015-03-22,CHA,@,MIN,W 109-98,240,45,89,.506,39,71,.549,6,18,.333,13,16,.813,109
10220,2015-03-22,MIN,,CHO,L 98-109,240,41,74,.554,37,63,.587,4,11,.364,12,16,.750,98
10221,2015-03-22,MIA,@,OKC,L 75-93,240,32,81,.395,29,63,.460,3,18,.167,8,15,.533,75
10222,2015-03-22,OKC,,MIA,W 93-75,240,40,90,.444,34,72,.472,6,18,.333,7,13,.538,93
10223,2015-03-22,DEN,@,ORL,W 119-100,240,42,90,.467,30,62,.484,12,28,.429,23,30,.767,119
10224,2015-03-22,ORL,,DEN,L 100-119,240,41,85,.482,37,68,.544,4,17,.235,14,17,.824,100
10225,2015-03-22,DAL,@,PHO,L 92-98,240,37,96,.385,32,77,.416,5,19,.263,13,22,.591,92
10226,2015-03-22,PHO,,DAL,W 98-92,240,39,76,.513,33,55,.600,6,21,.286,14,23,.609,98
10227,2015-03-22,SAC,,WAS,W 109-86,240,40,79,.506,32,62,.516,8,17,.471,21,23,.913,109
10228,2015-03-22,WAS,@,SAC,L 86-109,240,35,87,.402,32,70,.457,3,17,.176,13,18,.722,86
10229,2015-03-22,NYK,@,TOR,L 89-106,240,35,84,.417,27,65,.415,8,19,.421,11,16,.688,89
10230,2015-03-22,TOR,,NYK,W 106-89,240,39,75,.520,35,64,.547,4,11,.364,24,29,.828,106
10231,2015-03-21,CHI,@,DET,L 91-107,240,33,77,.429,27,56,.482,6,21,.286,19,24,.792,91
10232,2015-03-21,DET,,CHI,W 107-91,240,44,90,.489,33,64,.516,11,26,.423,8,10,.800,107
10233,2015-03-21,GSW,,UTA,W 106-91,240,38,78,.487,30,60,.500,8,18,.444,22,26,.846,106
10234,2015-03-21,UTA,@,GSW,L 91-106,240,32,73,.438,22,51,.431,10,22,.455,17,21,.810,91
10235,2015-03-21,HOU,,PHO,L 102-117,240,41,87,.471,31,53,.585,10,34,.294,10,12,.833,102
10236,2015-03-21,PHO,@,HOU,W 117-102,240,46,92,.500,38,77,.494,8,15,.533,17,24,.708,117
10237,2015-03-21,BRK,@,IND,W 123-111,240,46,75,.613,40,63,.635,6,12,.500,25,31,.806,123
10238,2015-03-21,IND,,BRK,L 111-123,240,45,90,.500,37,67,.552,8,23,.348,13,18,.722,111
10239,2015-03-21,MEM,,POR,W 97-86,240,37,89,.416,26,71,.366,11,18,.611,12,16,.750,97
10240,2015-03-21,POR,@,MEM,L 86-97,240,33,76,.434,27,54,.500,6,22,.273,14,15,.933,86
10241,2015-03-20,BRK,,MIL,W 129-127 (3OT),315,46,107,.430,35,82,.427,11,25,.440,26,34,.765,129
10242,2015-03-20,MIL,@,BRK,L 127-129 (3OT),315,49,129,.380,41,113,.363,8,16,.500,21,29,.724,127
10243,2015-03-20,CHI,,TOR,W 108-92,240,42,79,.532,33,51,.647,9,28,.321,15,17,.882,108
10244,2015-03-20,TOR,@,CHI,L 92-108,240,30,79,.380,20,54,.370,10,25,.400,22,26,.846,92
10245,2015-03-20,CLE,,IND,W 95-92,240,35,82,.427,26,56,.464,9,26,.346,16,21,.762,95
10246,2015-03-20,IND,@,CLE,L 92-95,240,36,84,.429,28,64,.438,8,20,.400,12,13,.923,92
10247,2015-03-20,DAL,,MEM,L 101-112,240,34,76,.447,26,54,.481,8,22,.364,25,36,.694,101
10248,2015-03-20,MEM,@,DAL,W 112-101,240,41,77,.532,33,59,.559,8,18,.444,22,32,.688,112
10249,2015-03-20,GSW,,NOP,W 112-96,240,44,88,.500,39,69,.565,5,19,.263,19,23,.826,112
10250,2015-03-20,NOP,@,GSW,L 96-112,240,33,77,.429,22,55,.400,11,22,.500,19,22,.864,96
10251,2015-03-20,LAC,,WAS,W 113-99,240,45,86,.523,33,63,.524,12,23,.522,11,17,.647,113
10252,2015-03-20,WAS,@,LAC,L 99-113,240,37,86,.430,31,67,.463,6,19,.316,19,23,.826,99
10253,2015-03-20,DEN,@,MIA,L 91-108,240,37,79,.468,30,52,.577,7,27,.259,10,19,.526,91
10254,2015-03-20,MIA,,DEN,W 108-91,240,43,81,.531,36,65,.554,7,16,.438,15,19,.789,108
10255,2015-03-20,ATL,@,OKC,L 115-123,240,41,82,.500,28,53,.528,13,29,.448,20,25,.800,115
10256,2015-03-20,OKC,,ATL,W 123-115,240,43,84,.512,30,54,.556,13,30,.433,24,26,.923,123
10257,2015-03-20,ORL,,POR,W 111-104,240,43,94,.457,38,82,.463,5,12,.417,20,24,.833,111
10258,2015-03-20,POR,@,ORL,L 104-111,240,38,80,.475,31,56,.554,7,24,.292,21,24,.875,104
10259,2015-03-20,NYK,@,PHI,L 81-97,240,25,69,.362,17,53,.321,8,16,.500,23,26,.885,81
10260,2015-03-20,PHI,,NYK,W 97-81,240,37,88,.420,26,58,.448,11,30,.367,12,15,.800,97
10261,2015-03-20,CHA,@,SAC,L 91-101,240,36,91,.396,30,73,.411,6,18,.333,13,16,.813,91
10262,2015-03-20,SAC,,CHO,W 101-91,240,37,78,.474,28,57,.491,9,21,.429,18,25,.720,101
10263,2015-03-20,BOS,@,SAS,L 89-101,240,35,88,.398,30,68,.441,5,20,.250,14,20,.700,89
10264,2015-03-20,SAS,,BOS,W 101-89,240,38,81,.469,33,58,.569,5,23,.217,20,23,.870,101
10265,2015-03-19,DEN,@,HOU,L 108-118,240,42,93,.452,29,57,.509,13,36,.361,11,19,.579,108
10266,2015-03-19,HOU,,DEN,W 118-108,240,37,83,.446,25,53,.472,12,30,.400,32,40,.800,118
10267,2015-03-19,LAL,,UTA,L 73-80,240,31,77,.403,28,66,.424,3,11,.273,8,17,.471,73
10268,2015-03-19,UTA,@,LAL,W 80-73,240,25,62,.403,16,37,.432,9,25,.360,21,31,.677,80
10269,2015-03-19,MIN,@,NYK,W 95-92 (OT),265,34,83,.410,32,71,.451,2,12,.167,25,30,.833,95
10270,2015-03-19,NYK,,MIN,L 92-95 (OT),265,40,97,.412,36,77,.468,4,20,.200,8,10,.800,92
10271,2015-03-19,NOP,@,PHO,L 72-74,240,31,83,.373,26,65,.400,5,18,.278,5,10,.500,72
10272,2015-03-19,PHO,,NOP,W 74-72,240,29,83,.349,27,61,.443,2,22,.091,14,21,.667,74
10273,2015-03-18,CHI,,IND,W 103-86,240,34,82,.415,24,58,.414,10,24,.417,25,28,.893,103
10274,2015-03-18,IND,@,CHI,L 86-103,240,32,81,.395,26,62,.419,6,19,.316,16,21,.762,86
10275,2015-03-18,BRK,@,CLE,L 92-117,240,36,80,.450,31,60,.517,5,20,.250,15,21,.714,92
10276,2015-03-18,CLE,,BRK,W 117-92,240,45,82,.549,30,53,.566,15,29,.517,12,20,.600,117
10277,2015-03-18,DAL,,ORL,W 107-102,240,39,80,.488,26,49,.531,13,31,.419,16,24,.667,107
10278,2015-03-18,ORL,@,DAL,L 102-107,240,40,87,.460,31,59,.525,9,28,.321,13,14,.929,102
10279,2015-03-18,ATL,@,GSW,L 95-114,240,31,87,.356,23,65,.354,8,22,.364,25,30,.833,95
10280,2015-03-18,GSW,,ATL,W 114-95,240,44,84,.524,30,54,.556,14,30,.467,12,20,.600,114
10281,2015-03-18,MIA,,POR,W 108-104,240,46,87,.529,39,77,.506,7,10,.700,9,14,.643,108
10282,2015-03-18,POR,@,MIA,L 104-108,240,41,81,.506,31,55,.564,10,26,.385,12,21,.571,104
10283,2015-03-18,MIL,,SAS,L 103-114,240,39,80,.488,32,66,.485,7,14,.500,18,24,.750,103
10284,2015-03-18,SAS,@,MIL,W 114-103,240,38,76,.500,30,56,.536,8,20,.400,30,38,.789,114
10285,2015-03-18,BOS,@,OKC,L 118-122,240,44,84,.524,31,50,.620,13,34,.382,17,28,.607,118
10286,2015-03-18,OKC,,BOS,W 122-118,240,42,88,.477,37,69,.536,5,19,.263,33,39,.846,122
10287,2015-03-18,DET,@,PHI,L 83-94,240,29,88,.330,21,62,.339,8,26,.308,17,19,.895,83
10288,2015-03-18,PHI,,DET,W 94-83,240,36,84,.429,25,57,.439,11,27,.407,11,18,.611,94
10289,2015-03-18,LAC,@,SAC,W 116-105,240,45,88,.511,28,51,.549,17,37,.459,9,13,.692,116
10290,2015-03-18,SAC,,LAC,L 105-116,240,38,79,.481,35,62,.565,3,17,.176,26,32,.813,105
10291,2015-03-18,MIN,@,TOR,L 100-105,240,42,87,.483,36,70,.514,6,17,.353,10,15,.667,100
10292,2015-03-18,TOR,,MIN,W 105-100,240,35,79,.443,23,50,.460,12,29,.414,23,27,.852,105
10293,2015-03-18,UTA,,WAS,L 84-88,240,34,82,.415,30,60,.500,4,22,.182,12,24,.500,84
10294,2015-03-18,WAS,@,UTA,W 88-84,240,33,63,.524,27,52,.519,6,11,.545,16,23,.696,88
10295,2015-03-17,DET,,MEM,W 105-95,240,39,83,.470,27,50,.540,12,33,.364,15,22,.682,105
10296,2015-03-17,MEM,@,DET,L 95-105,240,35,80,.438,25,62,.403,10,18,.556,15,17,.882,95
10297,2015-03-17,HOU,,ORL,W 107-94,240,39,78,.500,28,51,.549,11,27,.407,18,27,.667,107
10298,2015-03-17,ORL,@,HOU,L 94-107,240,38,89,.427,32,67,.478,6,22,.273,12,17,.706,94
10299,2015-03-17,CHA,@,LAC,L 92-99,240,32,79,.405,27,65,.415,5,14,.357,23,29,.793,92
10300,2015-03-17,LAC,,CHO,W 99-92,240,35,77,.455,26,53,.491,9,24,.375,20,28,.714,99
10301,2015-03-17,MIL,@,NOP,L 84-85,240,32,86,.372,28,66,.424,4,20,.200,16,21,.762,84
10302,2015-03-17,NOP,,MIL,W 85-84,240,29,83,.349,21,58,.362,8,25,.320,19,26,.731,85
10303,2015-03-17,NYK,,SAS,W 104-100 (OT),265,41,91,.451,38,77,.494,3,14,.214,19,27,.704,104
10304,2015-03-17,SAS,@,NYK,L 100-104 (OT),265,36,94,.383,33,80,.413,3,14,.214,25,30,.833,100
10305,2015-03-16,BOS,,PHI,W 108-89,240,44,88,.500,36,68,.529,8,20,.400,12,15,.800,108
10306,2015-03-16,PHI,@,BOS,L 89-108,240,34,84,.405,26,60,.433,8,24,.333,13,24,.542,89
10307,2015-03-16,DAL,,OKC,W 119-115,240,42,89,.472,32,64,.500,10,25,.400,25,35,.714,119
10308,2015-03-16,OKC,@,DAL,L 115-119,240,40,90,.444,33,64,.516,7,26,.269,28,35,.800,115
10309,2015-03-16,GSW,,LAL,W 108-105,240,40,84,.476,33,57,.579,7,27,.259,21,23,.913,108
10310,2015-03-16,LAL,@,GSW,L 105-108,240,39,85,.459,31,70,.443,8,15,.533,19,21,.905,105
10311,2015-03-16,IND,,TOR,L 98-117,240,38,88,.432,36,69,.522,2,19,.105,20,25,.800,98
10312,2015-03-16,TOR,@,IND,W 117-98,240,39,82,.476,27,59,.458,12,23,.522,27,33,.818,117
10313,2015-03-16,DEN,@,MEM,L 81-92,240,30,81,.370,22,63,.349,8,18,.444,13,21,.619,81
10314,2015-03-16,MEM,,DEN,W 92-81,240,33,80,.413,31,71,.437,2,9,.222,24,28,.857,92
10315,2015-03-16,CLE,@,MIA,L 92-106,240,30,79,.380,19,46,.413,11,33,.333,21,27,.778,92
10316,2015-03-16,MIA,,CLE,W 106-92,240,42,76,.553,38,61,.623,4,15,.267,18,22,.818,106
10317,2015-03-16,BRK,@,MIN,W 122-106,240,52,90,.578,47,77,.610,5,13,.385,13,17,.765,122
10318,2015-03-16,MIN,,BRK,L 106-122,240,41,88,.466,32,73,.438,9,15,.600,15,17,.882,106
10319,2015-03-16,ATL,@,SAC,W 110-103,240,38,84,.452,26,53,.491,12,31,.387,22,30,.733,110
10320,2015-03-16,SAC,,ATL,L 103-110,240,38,81,.469,31,61,.508,7,20,.350,20,25,.800,103
10321,2015-03-16,CHA,@,UTA,L 66-94,240,23,78,.295,18,59,.305,5,19,.263,15,18,.833,66
10322,2015-03-16,UTA,,CHO,W 94-66,240,33,78,.423,18,54,.333,15,24,.625,13,19,.684,94
10323,2015-03-16,POR,@,WAS,L 97-105,240,36,89,.404,28,61,.459,8,28,.286,17,20,.850,97
10324,2015-03-16,WAS,,POR,W 105-97,240,41,82,.500,34,70,.486,7,12,.583,16,26,.615,105
10325,2015-03-15,HOU,@,LAC,W 100-98,240,32,86,.372,25,56,.446,7,30,.233,29,36,.806,100
10326,2015-03-15,LAC,,HOU,L 98-100,240,36,82,.439,24,56,.429,12,26,.462,14,24,.583,98
10327,2015-03-15,ATL,@,LAL,W 91-86,240,34,76,.447,29,53,.547,5,23,.217,18,27,.667,91
10328,2015-03-15,LAL,,ATL,L 86-91,240,34,85,.400,27,67,.403,7,18,.389,11,15,.733,86
10329,2015-03-15,DEN,@,NOP,W 118-111 (2OT),290,46,104,.442,36,73,.493,10,31,.323,16,20,.800,118
10330,2015-03-15,NOP,,DEN,L 111-118 (2OT),290,46,99,.465,40,77,.519,6,22,.273,13,21,.619,111
10331,2015-03-15,CHI,@,OKC,L 100-109,240,37,83,.446,28,54,.519,9,29,.310,17,24,.708,100
10332,2015-03-15,OKC,,CHI,W 109-100,240,40,87,.460,32,66,.485,8,21,.381,21,30,.700,109
10333,2015-03-15,CLE,@,ORL,W 123-108,240,45,76,.592,27,41,.659,18,35,.514,15,19,.789,123
10334,2015-03-15,ORL,,CLE,L 108-123,240,42,88,.477,33,69,.478,9,19,.474,15,27,.556,108
10335,2015-03-15,NYK,@,PHO,L 89-102,240,32,73,.438,27,59,.458,5,14,.357,20,30,.667,89
10336,2015-03-15,PHO,,NYK,W 102-89,240,41,83,.494,35,65,.538,6,18,.333,14,23,.609,102
10337,2015-03-15,MIN,@,SAS,L 97-123,240,38,86,.442,31,71,.437,7,15,.467,14,18,.778,97
10338,2015-03-15,SAS,,MIN,W 123-97,240,49,84,.583,37,62,.597,12,22,.545,13,15,.867,123
10339,2015-03-15,POR,@,TOR,W 113-97,240,45,86,.523,32,57,.561,13,29,.448,10,16,.625,113
10340,2015-03-15,TOR,,POR,L 97-113,240,37,78,.474,32,60,.533,5,18,.278,18,23,.783,97
10341,2015-03-14,GSW,,NYK,W 125-94,240,45,90,.500,26,56,.464,19,34,.559,16,17,.941,125
10342,2015-03-14,NYK,@,GSW,L 94-125,240,38,96,.396,29,71,.408,9,25,.360,9,16,.563,94
10343,2015-03-14,BOS,@,IND,W 93-89,240,35,83,.422,27,55,.491,8,28,.286,15,21,.714,93
10344,2015-03-14,IND,,BOS,L 89-93,240,34,85,.400,25,61,.410,9,24,.375,12,15,.800,89
10345,2015-03-14,MEM,,MIL,W 96-83,240,37,78,.474,29,64,.453,8,14,.571,14,16,.875,96
10346,2015-03-14,MIL,@,MEM,L 83-96,240,30,72,.417,25,53,.472,5,19,.263,18,27,.667,83
10347,2015-03-14,BRK,@,PHI,W 94-87,240,37,84,.440,35,67,.522,2,17,.118,18,26,.692,94
10348,2015-03-14,PHI,,BRK,L 87-94,240,35,94,.372,27,57,.474,8,37,.216,9,14,.643,87
10349,2015-03-14,DET,@,UTA,L 85-88,240,32,84,.381,24,61,.393,8,23,.348,13,22,.591,85
10350,2015-03-14,UTA,,DET,W 88-85,240,33,69,.478,27,55,.491,6,14,.429,16,24,.667,88
10351,2015-03-14,SAC,@,WAS,L 97-113,240,35,77,.455,29,58,.500,6,19,.316,21,28,.750,97
10352,2015-03-14,WAS,,SAC,W 113-97,240,43,81,.531,30,55,.545,13,26,.500,14,17,.824,113
10353,2015-03-13,BOS,,ORL,W 95-88,240,37,86,.430,27,60,.450,10,26,.385,11,20,.550,95
10354,2015-03-13,ORL,@,BOS,L 88-95,240,34,80,.425,28,60,.467,6,20,.300,14,28,.500,88
10355,2015-03-13,CHI,@,CHO,L 91-101,240,31,82,.378,16,50,.320,15,32,.469,14,19,.737,91
10356,2015-03-13,CHA,,CHI,W 101-91,240,33,89,.371,26,70,.371,7,19,.368,28,33,.848,101
10357,2015-03-13,DAL,,LAC,W 129-99,240,51,84,.607,35,56,.625,16,28,.571,11,16,.688,129
10358,2015-03-13,LAC,@,DAL,L 99-129,240,41,82,.500,29,50,.580,12,32,.375,5,12,.417,99
10359,2015-03-13,DEN,,GSW,W 114-103,240,41,82,.500,33,65,.508,8,17,.471,24,37,.649,114
10360,2015-03-13,GSW,@,DEN,L 103-114,240,39,92,.424,31,73,.425,8,19,.421,17,22,.773,103
10361,2015-03-13,MIN,@,OKC,L 99-113,240,34,78,.436,31,66,.470,3,12,.250,28,31,.903,99
10362,2015-03-13,OKC,,MIN,W 113-99,240,44,101,.436,33,77,.429,11,24,.458,14,14,1.000,113
10363,2015-03-13,PHI,,SAC,W 114-107,240,45,95,.474,36,63,.571,9,32,.281,15,23,.652,114
10364,2015-03-13,SAC,@,PHI,L 107-114,240,35,87,.402,31,73,.425,4,14,.286,33,40,.825,107
10365,2015-03-13,ATL,@,PHO,W 96-87,240,39,83,.470,31,65,.477,8,18,.444,10,12,.833,96
10366,2015-03-13,PHO,,ATL,L 87-96,240,32,78,.410,22,52,.423,10,26,.385,13,21,.619,87
10367,2015-03-13,DET,@,POR,L 99-118,240,41,91,.451,34,66,.515,7,25,.280,10,12,.833,99
10368,2015-03-13,POR,,DET,W 118-99,240,46,80,.575,35,59,.593,11,21,.524,15,17,.882,118
10369,2015-03-13,MIA,@,TOR,L 92-102,240,35,79,.443,30,56,.536,5,23,.217,17,24,.708,92
10370,2015-03-13,TOR,,MIA,W 102-92,240,34,79,.430,22,46,.478,12,33,.364,22,31,.710,102
10371,2015-03-12,IND,,MIL,W 109-103 (OT),265,39,79,.494,30,57,.526,9,22,.409,22,28,.786,109
10372,2015-03-12,MIL,@,IND,L 103-109 (OT),265,35,91,.385,31,77,.403,4,14,.286,29,36,.806,103
10373,2015-03-12,LAL,,NYK,L 94-101,240,38,90,.422,33,72,.458,5,18,.278,13,21,.619,94
10374,2015-03-12,NYK,@,LAL,W 101-94,240,36,77,.468,27,59,.458,9,18,.500,20,26,.769,101
10375,2015-03-12,CLE,@,SAS,W 128-125 (OT),265,44,91,.484,30,65,.462,14,26,.538,26,30,.867,128
10376,2015-03-12,SAS,,CLE,L 125-128 (OT),265,49,87,.563,41,61,.672,8,26,.308,19,27,.704,125
10377,2015-03-12,HOU,@,UTA,L 91-109,240,34,79,.430,27,47,.574,7,32,.219,16,24,.667,91
10378,2015-03-12,UTA,,HOU,W 109-91,240,44,92,.478,33,59,.559,11,33,.333,10,17,.588,109
10379,2015-03-12,MEM,@,WAS,L 87-107,240,31,80,.388,28,61,.459,3,19,.158,22,30,.733,87
10380,2015-03-12,WAS,,MEM,W 107-87,240,40,80,.500,35,63,.556,5,17,.294,22,31,.710,107
10381,2015-03-11,BOS,,MEM,W 95-92,240,37,85,.435,29,58,.500,8,27,.296,13,17,.765,95
10382,2015-03-11,MEM,@,BOS,L 92-95,240,37,78,.474,32,66,.485,5,12,.417,13,13,1.000,92
10383,2015-03-11,CHA,,SAC,L 106-113,240,42,93,.452,36,75,.480,6,18,.333,16,26,.615,106
10384,2015-03-11,SAC,@,CHO,W 113-106,240,40,85,.471,32,65,.492,8,20,.400,25,30,.833,113
10385,2015-03-11,ATL,@,DEN,L 102-115,240,34,81,.420,25,54,.463,9,27,.333,25,27,.926,102
10386,2015-03-11,DEN,,ATL,W 115-102,240,42,84,.500,29,53,.547,13,31,.419,18,20,.900,115
10387,2015-03-11,DET,@,GSW,L 98-105,240,42,98,.429,38,86,.442,4,12,.333,10,12,.833,98
10388,2015-03-11,GSW,,DET,W 105-98,240,44,84,.524,37,64,.578,7,20,.350,10,13,.769,105
10389,2015-03-11,BRK,@,MIA,L 98-104,240,32,73,.438,26,56,.464,6,17,.353,28,39,.718,98
10390,2015-03-11,MIA,,BRK,W 104-98,240,37,81,.457,31,60,.517,6,21,.286,24,38,.632,104
10391,2015-03-11,MIL,,ORL,W 97-91,240,39,79,.494,31,61,.508,8,18,.444,11,16,.688,97
10392,2015-03-11,ORL,@,MIL,L 91-97,240,34,85,.400,24,67,.358,10,18,.556,13,13,1.000,91
10393,2015-03-11,LAC,@,OKC,W 120-108,240,35,76,.461,20,46,.435,15,30,.500,35,47,.745,120
10394,2015-03-11,OKC,,LAC,L 108-120,240,33,76,.434,21,51,.412,12,25,.480,30,36,.833,108
10395,2015-03-11,CHI,@,PHI,W 104-95 (OT),265,40,87,.460,30,63,.476,10,24,.417,14,20,.700,104
10396,2015-03-11,PHI,,CHI,L 95-104 (OT),265,36,104,.346,25,63,.397,11,41,.268,12,25,.480,95
10397,2015-03-11,MIN,@,PHO,L 97-106,240,36,81,.444,35,68,.515,1,13,.077,24,26,.923,97
10398,2015-03-11,PHO,,MIN,W 106-97,240,45,90,.500,39,66,.591,6,24,.250,10,13,.769,106
10399,2015-03-11,HOU,@,POR,L 100-105,240,38,91,.418,27,60,.450,11,31,.355,13,23,.565,100
10400,2015-03-11,POR,,HOU,W 105-100,240,42,92,.457,32,59,.542,10,33,.303,11,14,.786,105
10401,2015-03-10,BRK,,NOP,L 91-111,240,35,84,.417,29,68,.426,6,16,.375,15,23,.652,91
10402,2015-03-10,NOP,@,BRK,W 111-91,240,45,87,.517,33,66,.500,12,21,.571,9,11,.818,111
10403,2015-03-10,CLE,@,DAL,W 127-94,240,44,87,.506,29,55,.527,15,32,.469,24,29,.828,127
10404,2015-03-10,DAL,,CLE,L 94-127,240,33,81,.407,28,61,.459,5,20,.250,23,33,.697,94
10405,2015-03-10,IND,,ORL,W 118-86,240,45,85,.529,28,51,.549,17,34,.500,11,12,.917,118
10406,2015-03-10,ORL,@,IND,L 86-118,240,34,92,.370,30,75,.400,4,17,.235,14,20,.700,86
10407,2015-03-10,DET,@,LAL,L 85-93,240,32,84,.381,24,49,.490,8,35,.229,13,19,.684,85
10408,2015-03-10,LAL,,DET,W 93-85,240,32,75,.427,29,62,.468,3,13,.231,26,30,.867,93
10409,2015-03-10,SAS,,TOR,W 117-107,240,41,85,.482,30,67,.448,11,18,.611,24,30,.800,117
10410,2015-03-10,TOR,@,SAS,L 107-117,240,43,97,.443,35,71,.493,8,26,.308,13,18,.722,107
10411,2015-03-10,NYK,@,UTA,L 82-87,240,31,79,.392,26,66,.394,5,13,.385,15,17,.882,82
10412,2015-03-10,UTA,,NYK,W 87-82,240,30,70,.429,24,52,.462,6,18,.333,21,29,.724,87
10413,2015-03-09,ATL,,SAC,W 130-105,240,53,88,.602,33,52,.635,20,36,.556,4,7,.571,130
10414,2015-03-09,SAC,@,ATL,L 105-130,240,39,81,.481,31,61,.508,8,20,.400,19,20,.950,105
10415,2015-03-09,CHI,,MEM,L 91-101,240,35,80,.438,25,58,.431,10,22,.455,11,14,.786,91
10416,2015-03-09,MEM,@,CHI,W 101-91,240,42,84,.500,37,70,.529,5,14,.357,12,17,.706,101
10417,2015-03-09,CHA,,WAS,L 69-95,240,25,77,.325,21,55,.382,4,22,.182,15,20,.750,69
10418,2015-03-09,WAS,@,CHO,W 95-69,240,44,85,.518,42,71,.592,2,14,.143,5,5,1.000,95
10419,2015-03-09,DEN,,NYK,W 106-78,240,38,87,.437,30,63,.476,8,24,.333,22,29,.759,106
10420,2015-03-09,NYK,@,DEN,L 78-106,240,29,75,.387,24,62,.387,5,13,.385,15,25,.600,78
10421,2015-03-09,LAC,,MIN,W 89-76,240,35,79,.443,24,48,.500,11,31,.355,8,15,.533,89
10422,2015-03-09,MIN,@,LAC,L 76-89,240,31,83,.373,29,75,.387,2,8,.250,12,21,.571,76
10423,2015-03-09,BOS,@,MIA,W 100-90,240,39,87,.448,33,62,.532,6,25,.240,16,17,.941,100
10424,2015-03-09,MIA,,BOS,L 90-100,240,29,69,.420,25,52,.481,4,17,.235,28,34,.824,90
10425,2015-03-09,MIL,,NOP,L 103-114,240,37,71,.521,33,56,.589,4,15,.267,25,31,.806,103
10426,2015-03-09,NOP,@,MIL,W 114-103,240,44,75,.587,35,60,.583,9,15,.600,17,21,.810,114
10427,2015-03-09,GSW,@,PHO,W 98-80,240,35,83,.422,22,52,.423,13,31,.419,15,19,.789,98
10428,2015-03-09,PHO,,GSW,L 80-98,240,29,77,.377,25,66,.379,4,11,.364,18,23,.783,80
10429,2015-03-08,BRK,,UTA,L 88-95,240,38,76,.500,30,61,.492,8,15,.533,4,11,.364,88
10430,2015-03-08,UTA,@,BRK,W 95-88,240,34,72,.472,24,50,.480,10,22,.455,17,21,.810,95
10431,2015-03-08,CHA,@,DET,W 108-101,240,41,79,.519,35,62,.565,6,17,.353,20,23,.870,108
10432,2015-03-08,DET,,CHO,L 101-108,240,39,89,.438,36,75,.480,3,14,.214,20,25,.800,101
10433,2015-03-08,GSW,,LAC,W 106-98,240,40,80,.500,30,58,.517,10,22,.455,16,23,.696,106
10434,2015-03-08,LAC,@,GSW,L 98-106,240,40,83,.482,32,58,.552,8,25,.320,10,14,.714,98
10435,2015-03-08,DAL,@,LAL,W 100-93,240,38,78,.487,29,52,.558,9,26,.346,15,22,.682,100
10436,2015-03-08,LAL,,DAL,L 93-100,240,38,82,.463,36,68,.529,2,14,.143,15,21,.714,93
10437,2015-03-08,OKC,,TOR,W 108-104,240,42,82,.512,36,61,.590,6,21,.286,18,25,.720,108
10438,2015-03-08,TOR,@,OKC,L 104-108,240,42,98,.429,31,71,.437,11,27,.407,9,9,1.000,104
10439,2015-03-08,BOS,@,ORL,L 98-103,240,35,89,.393,20,55,.364,15,34,.441,13,16,.813,98
10440,2015-03-08,ORL,,BOS,W 103-98,240,38,87,.437,31,65,.477,7,22,.318,20,30,.667,103
10441,2015-03-08,CHI,@,SAS,L 105-116,240,37,73,.507,32,58,.552,5,15,.333,26,29,.897,105
10442,2015-03-08,SAS,,CHI,W 116-105,240,44,90,.489,35,68,.515,9,22,.409,19,24,.792,116
10443,2015-03-07,CLE,,PHO,W 89-79,240,31,75,.413,23,55,.418,8,20,.400,19,23,.826,89
10444,2015-03-07,PHO,@,CLE,L 79-89,240,30,84,.357,21,59,.356,9,25,.360,10,14,.714,79
10445,2015-03-07,DEN,,HOU,L 100-114,240,38,92,.413,29,62,.468,9,30,.300,15,19,.789,100
10446,2015-03-07,HOU,@,DEN,W 114-100,240,40,86,.465,30,58,.517,10,28,.357,24,32,.750,114
10447,2015-03-07,MIA,,SAC,W 114-109 (OT),265,41,80,.513,34,56,.607,7,24,.292,25,33,.758,114
10448,2015-03-07,SAC,@,MIA,L 109-114 (OT),265,40,88,.455,30,63,.476,10,25,.400,19,24,.792,109
10449,2015-03-07,MIL,,WAS,W 91-85,240,36,78,.462,26,58,.448,10,20,.500,9,15,.600,91
10450,2015-03-07,WAS,@,MIL,L 85-91,240,31,81,.383,22,53,.415,9,28,.321,14,22,.636,85
10451,2015-03-07,MIN,,POR,W 121-113,240,46,85,.541,42,78,.538,4,7,.571,25,31,.806,121
10452,2015-03-07,POR,@,MIN,L 113-121,240,43,88,.489,29,61,.475,14,27,.519,13,17,.765,113
10453,2015-03-07,MEM,@,NOP,L 89-95,240,32,74,.432,26,58,.448,6,16,.375,19,29,.655,89
10454,2015-03-07,NOP,,MEM,W 95-89,240,38,80,.475,30,57,.526,8,23,.348,11,13,.846,95
10455,2015-03-07,IND,@,NYK,W 92-86,240,30,79,.380,23,61,.377,7,18,.389,25,30,.833,92
10456,2015-03-07,NYK,,IND,L 86-92,240,30,78,.385,27,63,.429,3,15,.200,23,30,.767,86
10457,2015-03-07,ATL,@,PHI,L 84-92,240,30,77,.390,19,52,.365,11,25,.440,13,16,.813,84
10458,2015-03-07,PHI,,ATL,W 92-84,240,35,95,.368,22,58,.379,13,37,.351,9,17,.529,92
10459,2015-03-06,ATL,,CLE,W 106-97,240,43,84,.512,37,63,.587,6,21,.286,14,17,.824,106
10460,2015-03-06,CLE,@,ATL,L 97-106,240,29,69,.420,16,31,.516,13,38,.342,26,33,.788,97
10461,2015-03-06,BRK,,PHO,L 100-108 (OT),265,34,97,.351,26,75,.347,8,22,.364,24,29,.828,100
10462,2015-03-06,PHO,@,BRK,W 108-100 (OT),265,39,91,.429,36,65,.554,3,26,.115,27,35,.771,108
10463,2015-03-06,CHA,,TOR,W 103-94,240,40,85,.471,35,65,.538,5,20,.250,18,20,.900,103
10464,2015-03-06,TOR,@,CHO,L 94-103,240,37,91,.407,30,69,.435,7,22,.318,13,15,.867,94
10465,2015-03-06,DAL,@,GSW,L 89-104,240,32,87,.368,26,67,.388,6,20,.300,19,26,.731,89
10466,2015-03-06,GSW,,DAL,W 104-89,240,38,81,.469,27,58,.466,11,23,.478,17,19,.895,104
10467,2015-03-06,DET,@,HOU,L 93-103,240,37,102,.363,31,73,.425,6,29,.207,13,17,.765,93
10468,2015-03-06,HOU,,DET,W 103-93,240,38,91,.418,32,63,.508,6,28,.214,21,25,.840,103
10469,2015-03-06,CHI,@,IND,L 84-98,240,31,86,.360,26,63,.413,5,23,.217,17,19,.895,84
10470,2015-03-06,IND,,CHI,W 98-84,240,34,80,.425,28,60,.467,6,20,.300,24,33,.727,98
10471,2015-03-06,LAL,@,MEM,L 90-97,240,39,84,.464,34,72,.472,5,12,.417,7,9,.778,90
10472,2015-03-06,MEM,,LAL,W 97-90,240,34,77,.442,33,66,.500,1,11,.091,28,33,.848,97
10473,2015-03-06,BOS,@,NOP,W 104-98,240,36,79,.456,26,56,.464,10,23,.435,22,25,.880,104
10474,2015-03-06,NOP,,BOS,L 98-104,240,38,80,.475,30,59,.508,8,21,.381,14,15,.933,98
10475,2015-03-06,ORL,,SAC,W 119-114,240,48,85,.565,35,61,.574,13,24,.542,10,12,.833,119
10476,2015-03-06,SAC,@,ORL,L 114-119,240,38,85,.447,28,58,.483,10,27,.370,28,38,.737,114
10477,2015-03-06,PHI,,UTA,L 83-89,240,32,88,.364,22,56,.393,10,32,.313,9,18,.500,83
10478,2015-03-06,UTA,@,PHI,W 89-83,240,27,71,.380,21,59,.356,6,12,.500,29,41,.707,89
10479,2015-03-06,DEN,@,SAS,L 111-120,240,45,86,.523,39,69,.565,6,17,.353,15,23,.652,111
10480,2015-03-06,SAS,,DEN,W 120-111,240,43,79,.544,34,55,.618,9,24,.375,25,33,.758,120
10481,2015-03-06,MIA,@,WAS,L 97-99,240,37,79,.468,27,52,.519,10,27,.370,13,19,.684,97
10482,2015-03-06,WAS,,MIA,W 99-97,240,38,82,.463,31,59,.525,7,23,.304,16,18,.889,99
10483,2015-03-05,CHI,,OKC,W 108-105,240,40,87,.460,33,62,.532,7,25,.280,21,26,.808,108
10484,2015-03-05,OKC,@,CHI,L 105-108,240,41,88,.466,33,68,.485,8,20,.400,15,19,.789,105
10485,2015-03-05,DAL,@,POR,L 75-94,240,33,88,.375,31,72,.431,2,16,.125,7,8,.875,75
10486,2015-03-05,POR,,DAL,W 94-75,240,34,82,.415,27,60,.450,7,22,.318,19,21,.905,94
10487,2015-03-04,BOS,,UTA,W 85-84,240,33,88,.375,25,61,.410,8,27,.296,11,20,.550,85
10488,2015-03-04,UTA,@,BOS,L 84-85,240,34,75,.453,31,56,.554,3,19,.158,13,21,.619,84
10489,2015-03-04,BRK,,CHO,L 91-115,240,35,88,.398,32,72,.444,3,16,.188,18,24,.750,91
10490,2015-03-04,CHA,@,BRK,W 115-91,240,42,85,.494,34,66,.515,8,19,.421,23,28,.821,115
10491,2015-03-04,GSW,,MIL,W 102-93,240,37,73,.507,23,39,.590,14,34,.412,14,25,.560,102
10492,2015-03-04,MIL,@,GSW,L 93-102,240,34,80,.425,29,66,.439,5,14,.357,20,25,.800,93
10493,2015-03-04,HOU,,MEM,L 100-102,240,42,86,.488,31,58,.534,11,28,.393,5,5,1.000,100
10494,2015-03-04,MEM,@,HOU,W 102-100,240,42,83,.506,38,67,.567,4,16,.250,14,17,.824,102
10495,2015-03-04,IND,,NYK,W 105-82,240,38,80,.475,28,58,.483,10,22,.455,19,24,.792,105
10496,2015-03-04,NYK,@,IND,L 82-105,240,30,76,.395,24,60,.400,6,16,.375,16,23,.696,82
10497,2015-03-04,LAC,,POR,L 93-98 (OT),265,37,96,.385,26,65,.400,11,31,.355,8,18,.444,93
10498,2015-03-04,POR,@,LAC,W 98-93 (OT),265,34,87,.391,26,55,.473,8,32,.250,22,29,.759,98
10499,2015-03-04,LAL,@,MIA,L 94-100,240,38,88,.432,31,70,.443,7,18,.389,11,17,.647,94
10500,2015-03-04,MIA,,LAL,W 100-94,240,32,79,.405,29,63,.460,3,16,.188,33,43,.767,100
10501,2015-03-04,DEN,@,MIN,W 100-85,240,42,92,.457,34,72,.472,8,20,.400,8,10,.800,100
10502,2015-03-04,MIN,,DEN,L 85-100,240,32,82,.390,29,64,.453,3,18,.167,18,25,.720,85
10503,2015-03-04,DET,@,NOP,L 85-88,240,38,93,.409,36,79,.456,2,14,.143,7,9,.778,85
10504,2015-03-04,NOP,,DET,W 88-85,240,37,90,.411,35,78,.449,2,12,.167,12,16,.750,88
10505,2015-03-04,OKC,,PHI,W 123-118 (OT),265,44,96,.458,37,75,.493,7,21,.333,28,34,.824,123
10506,2015-03-04,PHI,@,OKC,L 118-123 (OT),265,34,96,.354,19,61,.311,15,35,.429,35,44,.795,118
10507,2015-03-04,ORL,,PHO,L 100-105,240,41,87,.471,36,67,.537,5,20,.250,13,15,.867,100
10508,2015-03-04,PHO,@,ORL,W 105-100,240,37,79,.468,29,58,.500,8,21,.381,23,27,.852,105
10509,2015-03-04,SAC,@,SAS,L 85-112,240,29,78,.372,26,69,.377,3,9,.333,24,34,.706,85
10510,2015-03-04,SAS,,SAC,W 112-85,240,45,85,.529,35,62,.565,10,23,.435,12,16,.750,112
10511,2015-03-04,CLE,@,TOR,W 120-112,240,40,78,.513,25,42,.595,15,36,.417,25,34,.735,120
10512,2015-03-04,TOR,,CLE,L 112-120,240,43,79,.544,33,58,.569,10,21,.476,16,17,.941,112
10513,2015-03-03,ATL,,HOU,W 104-96,240,39,86,.453,31,57,.544,8,29,.276,18,21,.857,104
10514,2015-03-03,HOU,@,ATL,L 96-104,240,39,90,.433,25,49,.510,14,41,.341,4,9,.444,96
10515,2015-03-03,CHI,,WAS,W 97-92,240,33,78,.423,24,49,.490,9,29,.310,22,30,.733,97
10516,2015-03-03,WAS,@,CHI,L 92-97,240,35,84,.417,27,62,.435,8,22,.364,14,19,.737,92
10517,2015-03-03,CHA,,LAL,W 104-103,240,39,79,.494,34,66,.515,5,13,.385,21,31,.677,104
10518,2015-03-03,LAL,@,CHO,L 103-104,240,39,86,.453,33,69,.478,6,17,.353,19,21,.905,103
10519,2015-03-03,BOS,@,CLE,L 79-110,240,31,88,.352,24,60,.400,7,28,.250,10,13,.769,79
10520,2015-03-03,CLE,,BOS,W 110-79,240,43,89,.483,33,61,.541,10,28,.357,14,14,1.000,110
10521,2015-03-03,DEN,,MIL,W 106-95,240,39,86,.453,27,52,.519,12,34,.353,16,20,.800,106
10522,2015-03-03,MIL,@,DEN,L 95-106,240,35,86,.407,25,62,.403,10,24,.417,15,22,.682,95
10523,2015-03-03,MEM,,UTA,L 82-93,240,33,82,.402,30,71,.423,3,11,.273,13,19,.684,82
10524,2015-03-03,UTA,@,MEM,W 93-82,240,36,80,.450,31,55,.564,5,25,.200,16,19,.842,93
10525,2015-03-03,NYK,,SAC,L 86-124,240,30,82,.366,26,60,.433,4,22,.182,22,30,.733,86
10526,2015-03-03,SAC,@,NYK,W 124-86,240,41,83,.494,31,65,.477,10,18,.556,32,37,.865,124
10527,2015-03-02,BRK,,GSW,W 110-108,240,44,89,.494,34,68,.500,10,21,.476,12,16,.750,110
10528,2015-03-02,GSW,@,BRK,L 108-110,240,42,90,.467,31,60,.517,11,30,.367,13,18,.722,108
10529,2015-03-02,DAL,,NOP,W 102-93,240,38,79,.481,32,63,.508,6,16,.375,20,22,.909,102
10530,2015-03-02,NOP,@,DAL,L 93-102,240,35,74,.473,25,53,.472,10,21,.476,13,16,.813,93
10531,2015-03-02,MIA,,PHO,W 115-98,240,43,82,.524,36,68,.529,7,14,.500,22,30,.733,115
10532,2015-03-02,PHO,@,MIA,L 98-115,240,33,78,.423,26,47,.553,7,31,.226,25,38,.658,98
10533,2015-03-02,LAC,@,MIN,W 110-105,240,44,92,.478,32,59,.542,12,33,.364,10,19,.526,110
10534,2015-03-02,MIN,,LAC,L 105-110,240,36,82,.439,32,67,.478,4,15,.267,29,35,.829,105
10535,2015-03-02,PHI,,TOR,L 103-114,240,41,78,.526,33,58,.569,8,20,.400,13,19,.684,103
10536,2015-03-02,TOR,@,PHI,W 114-103,240,41,80,.513,30,53,.566,11,27,.407,21,24,.875,114
10537,2015-03-01,BOS,,GSW,L 101-106,240,40,109,.367,32,78,.410,8,31,.258,13,17,.765,101
10538,2015-03-01,GSW,@,BOS,W 106-101,240,40,95,.421,28,61,.459,12,34,.353,14,17,.824,106
10539,2015-03-01,CHI,,LAC,L 86-96,240,27,87,.310,17,61,.279,10,26,.385,22,30,.733,86
10540,2015-03-01,LAC,@,CHI,W 96-86,240,38,87,.437,31,60,.517,7,27,.259,13,24,.542,96
10541,2015-03-01,DEN,,NOP,L 92-99,240,37,92,.402,28,59,.475,9,33,.273,9,17,.529,92
10542,2015-03-01,NOP,@,DEN,W 99-92,240,36,74,.486,31,52,.596,5,22,.227,22,30,.733,99
10543,2015-03-01,CLE,@,HOU,L 103-105 (OT),265,40,98,.408,28,58,.483,12,40,.300,11,21,.524,103
10544,2015-03-01,HOU,,CLE,W 105-103 (OT),265,34,74,.459,23,44,.523,11,30,.367,26,33,.788,105
10545,2015-03-01,IND,,PHI,W 94-74,240,36,88,.409,33,70,.471,3,18,.167,19,25,.760,94
10546,2015-03-01,PHI,@,IND,L 74-94,240,29,84,.345,24,60,.400,5,24,.208,11,17,.647,74
10547,2015-03-01,LAL,,OKC,L 101-108,240,40,90,.444,31,65,.477,9,25,.360,12,18,.667,101
10548,2015-03-01,OKC,@,LAL,W 108-101,240,40,97,.412,29,65,.446,11,32,.344,17,23,.739,108
10549,2015-03-01,CHA,@,ORL,W 98-83,240,40,80,.500,32,62,.516,8,18,.444,10,14,.714,98
10550,2015-03-01,ORL,,CHO,L 83-98,240,31,85,.365,25,70,.357,6,15,.400,15,20,.750,83
10551,2015-03-01,POR,@,SAC,W 110-99,240,41,83,.494,31,59,.525,10,24,.417,18,20,.900,110
10552,2015-03-01,SAC,,POR,L 99-110,240,39,86,.453,36,74,.486,3,12,.250,18,23,.783,99
10553,2015-02-28,BRK,@,DAL,W 104-94,240,40,77,.519,30,54,.556,10,23,.435,14,23,.609,104
10554,2015-02-28,DAL,,BRK,L 94-104,240,35,82,.427,26,54,.481,9,28,.321,15,18,.833,94
10555,2015-02-28,ATL,@,MIA,W 93-91,240,34,79,.430,24,54,.444,10,25,.400,15,20,.750,93
10556,2015-02-28,MIA,,ATL,L 91-93,240,32,81,.395,25,55,.455,7,26,.269,20,21,.952,91
10557,2015-02-28,MEM,@,MIN,W 101-97,240,38,64,.594,34,53,.642,4,11,.364,21,29,.724,101
10558,2015-02-28,MIN,,MEM,L 97-101,240,34,88,.386,27,69,.391,7,19,.368,22,27,.815,97
10559,2015-02-28,NYK,,TOR,W 103-98,240,33,75,.440,26,56,.464,7,19,.368,30,38,.789,103
10560,2015-02-28,TOR,@,NYK,L 98-103,240,34,81,.420,26,52,.500,8,29,.276,22,28,.786,98
10561,2015-02-28,PHO,,SAS,L 74-101,240,25,84,.298,20,68,.294,5,16,.313,19,24,.792,74
10562,2015-02-28,SAS,@,PHO,W 101-74,240,41,92,.446,37,73,.507,4,19,.211,15,17,.882,101
10563,2015-02-28,MIL,@,UTA,L 75-82,240,29,74,.392,24,59,.407,5,15,.333,12,14,.857,75
10564,2015-02-28,UTA,,MIL,W 82-75,240,29,76,.382,23,54,.426,6,22,.273,18,23,.783,82
10565,2015-02-28,DET,@,WAS,L 95-99,240,38,79,.481,30,53,.566,8,26,.308,11,21,.524,95
10566,2015-02-28,WAS,,DET,W 99-95,240,37,78,.474,30,58,.517,7,20,.350,18,25,.720,99
10567,2015-02-27,ATL,,ORL,W 95-88,240,36,81,.444,22,50,.440,14,31,.452,9,12,.750,95
10568,2015-02-27,ORL,@,ATL,L 88-95,240,36,80,.450,27,54,.500,9,26,.346,7,13,.538,88
10569,2015-02-27,BOS,,CHO,W 106-98,240,40,96,.417,26,61,.426,14,35,.400,12,15,.800,106
10570,2015-02-27,CHA,@,BOS,L 98-106,240,37,82,.451,27,61,.443,10,21,.476,14,17,.824,98
10571,2015-02-27,CHI,,MIN,W 96-89,240,37,96,.385,28,65,.431,9,31,.290,13,16,.813,96
10572,2015-02-27,MIN,@,CHI,L 89-96,240,33,77,.429,31,63,.492,2,14,.143,21,31,.677,89
10573,2015-02-27,DEN,,UTA,L 82-104,240,28,84,.333,20,52,.385,8,32,.250,18,29,.621,82
10574,2015-02-27,UTA,@,DEN,W 104-82,240,39,68,.574,30,47,.638,9,21,.429,17,21,.810,104
10575,2015-02-27,DET,,NYK,L 115-121 (2OT),290,39,97,.402,31,66,.470,8,31,.258,29,40,.725,115
10576,2015-02-27,NYK,@,DET,W 121-115 (2OT),290,45,109,.413,39,91,.429,6,18,.333,25,26,.962,121
10577,2015-02-27,BRK,@,HOU,L 98-102,240,38,85,.447,34,68,.500,4,17,.235,18,20,.900,98
10578,2015-02-27,HOU,,BRK,W 102-98,240,39,84,.464,30,52,.577,9,32,.281,15,17,.882,102
10579,2015-02-27,CLE,@,IND,L 86-93,240,33,92,.359,24,63,.381,9,29,.310,11,14,.786,86
10580,2015-02-27,IND,,CLE,W 93-86,240,34,80,.425,28,63,.444,6,17,.353,19,29,.655,93
10581,2015-02-27,LAL,,MIL,W 101-93,240,40,85,.471,34,67,.507,6,18,.333,15,22,.682,101
10582,2015-02-27,MIL,@,LAL,L 93-101,240,34,87,.391,30,70,.429,4,17,.235,21,29,.724,93
10583,2015-02-27,LAC,@,MEM,W 97-79,240,36,78,.462,27,52,.519,9,26,.346,16,28,.571,97
10584,2015-02-27,MEM,,LAC,L 79-97,240,33,87,.379,30,75,.400,3,12,.250,10,15,.667,79
10585,2015-02-27,MIA,@,NOP,L 102-104,240,41,84,.488,33,63,.524,8,21,.381,12,16,.750,102
10586,2015-02-27,NOP,,MIA,W 104-102,240,39,76,.513,33,60,.550,6,16,.375,20,27,.741,104
10587,2015-02-27,PHI,,WAS,W 89-81,240,28,80,.350,16,47,.340,12,33,.364,21,34,.618,89
10588,2015-02-27,WAS,@,PHI,L 81-89,240,30,93,.323,26,76,.342,4,17,.235,17,22,.773,81
10589,2015-02-27,OKC,@,POR,L 112-115,240,45,94,.479,41,80,.513,4,14,.286,18,22,.818,112
10590,2015-02-27,POR,,OKC,W 115-112,240,39,89,.438,29,63,.460,10,26,.385,27,31,.871,115
10591,2015-02-27,SAC,,SAS,L 96-107,240,38,79,.481,37,75,.493,1,4,.250,19,23,.826,96
10592,2015-02-27,SAS,@,SAC,W 107-96,240,35,88,.398,27,65,.415,8,23,.348,29,32,.906,107
10593,2015-02-27,GSW,@,TOR,W 113-89,240,42,87,.483,29,59,.492,13,28,.464,16,19,.842,113
10594,2015-02-27,TOR,,GSW,L 89-113,240,31,77,.403,27,55,.491,4,22,.182,23,28,.821,89
10595,2015-02-26,CLE,,GSW,W 110-99,240,36,77,.468,27,49,.551,9,28,.321,29,35,.829,110
10596,2015-02-26,GSW,@,CLE,L 99-110,240,39,92,.424,28,63,.444,11,29,.379,10,19,.526,99
10597,2015-02-26,OKC,@,PHO,L 113-117 (OT),265,39,101,.386,31,77,.403,8,24,.333,27,30,.900,113
10598,2015-02-26,PHO,,OKC,W 117-113 (OT),265,48,97,.495,39,71,.549,9,26,.346,12,21,.571,117
10599,2015-02-25,ATL,,DAL,W 104-87,240,39,85,.459,26,50,.520,13,35,.371,13,16,.813,104
10600,2015-02-25,DAL,@,ATL,L 87-104,240,34,80,.425,29,49,.592,5,31,.161,14,18,.778,87
10601,2015-02-25,BOS,,NYK,W 115-94,240,42,83,.506,28,52,.538,14,31,.452,17,20,.850,115
10602,2015-02-25,NYK,@,BOS,L 94-115,240,34,82,.415,32,61,.525,2,21,.095,24,31,.774,94
10603,2015-02-25,CHI,,CHO,L 86-98,240,34,77,.442,31,60,.517,3,17,.176,15,23,.652,86
10604,2015-02-25,CHA,@,CHI,W 98-86,240,39,84,.464,35,70,.500,4,14,.286,16,21,.762,98
10605,2015-02-25,DEN,,PHO,L 96-110,240,31,81,.383,19,47,.404,12,34,.353,22,33,.667,96
10606,2015-02-25,PHO,@,DEN,W 110-96,240,39,91,.429,31,67,.463,8,24,.333,24,32,.750,110
10607,2015-02-25,HOU,,LAC,W 110-105,240,36,88,.409,19,44,.432,17,44,.386,21,30,.700,110
10608,2015-02-25,LAC,@,HOU,L 105-110,240,40,91,.440,29,59,.492,11,32,.344,14,19,.737,105
10609,2015-02-25,MIL,,PHI,W 104-88,240,44,82,.537,39,67,.582,5,15,.333,11,16,.688,104
10610,2015-02-25,PHI,@,MIL,L 88-104,240,31,75,.413,20,50,.400,11,25,.440,15,19,.789,88
10611,2015-02-25,MIN,,WAS,W 97-77,240,35,81,.432,31,68,.456,4,13,.308,23,28,.821,97
10612,2015-02-25,WAS,@,MIN,L 77-97,240,33,87,.379,29,69,.420,4,18,.222,7,8,.875,77
10613,2015-02-25,BRK,@,NOP,L 96-102,240,39,92,.424,32,71,.451,7,21,.333,11,15,.733,96
10614,2015-02-25,NOP,,BRK,W 102-96,240,38,74,.514,27,49,.551,11,25,.440,15,19,.789,102
10615,2015-02-25,MIA,@,ORL,W 93-90 (OT),265,32,84,.381,26,53,.491,6,31,.194,23,32,.719,93
10616,2015-02-25,ORL,,MIA,L 90-93 (OT),265,33,78,.423,27,56,.482,6,22,.273,18,31,.581,90
10617,2015-02-25,POR,,SAS,W 111-95,240,43,85,.506,30,59,.508,13,26,.500,12,15,.800,111
10618,2015-02-25,SAS,@,POR,L 95-111,240,37,85,.435,29,64,.453,8,21,.381,13,14,.929,95
10619,2015-02-25,MEM,@,SAC,L 90-102,240,34,84,.405,30,68,.441,4,16,.250,18,23,.783,90
10620,2015-02-25,SAC,,MEM,W 102-90,240,39,80,.488,33,64,.516,6,16,.375,18,25,.720,102
10621,2015-02-25,LAL,@,UTA,W 100-97,240,40,89,.449,38,78,.487,2,11,.182,18,21,.857,100
10622,2015-02-25,UTA,,LAL,L 97-100,240,34,73,.466,27,61,.443,7,12,.583,22,34,.647,97
10623,2015-02-24,DAL,,TOR,W 99-92,240,38,79,.481,30,60,.500,8,19,.421,15,18,.833,99
10624,2015-02-24,TOR,@,DAL,L 92-99,240,38,84,.452,29,58,.500,9,26,.346,7,11,.636,92
10625,2015-02-24,CLE,@,DET,W 102-93,240,34,77,.442,20,40,.500,14,37,.378,20,24,.833,102
10626,2015-02-24,DET,,CLE,L 93-102,240,33,82,.402,24,58,.414,9,24,.375,18,30,.600,93
10627,2015-02-24,IND,@,OKC,L 92-105,240,38,88,.432,29,62,.468,9,26,.346,7,11,.636,92
10628,2015-02-24,OKC,,IND,W 105-92,240,40,96,.417,31,72,.431,9,24,.375,16,18,.889,105
10629,2015-02-24,GSW,@,WAS,W 114-107,240,45,90,.500,33,67,.493,12,23,.522,12,17,.706,114
10630,2015-02-24,WAS,,GSW,L 107-114,240,42,79,.532,37,61,.607,5,18,.278,18,21,.857,107
10631,2015-02-23,CHI,,MIL,W 87-71,240,27,76,.355,19,50,.380,8,26,.308,25,32,.781,87
10632,2015-02-23,MIL,@,CHI,L 71-87,240,30,89,.337,26,71,.366,4,18,.222,7,13,.538,71
10633,2015-02-23,BRK,@,DEN,W 110-82,240,43,92,.467,39,71,.549,4,21,.190,20,23,.870,110
10634,2015-02-23,DEN,,BRK,L 82-110,240,31,94,.330,24,67,.358,7,27,.259,13,22,.591,82
10635,2015-02-23,HOU,,MIN,W 113-102,240,39,94,.415,27,56,.482,12,38,.316,23,34,.676,113
10636,2015-02-23,MIN,@,HOU,L 102-113,240,31,93,.333,26,75,.347,5,18,.278,35,39,.897,102
10637,2015-02-23,LAC,,MEM,L 87-90,240,35,79,.443,26,52,.500,9,27,.333,8,12,.667,87
10638,2015-02-23,MEM,@,LAC,W 90-87,240,33,81,.407,28,66,.424,5,15,.333,19,26,.731,90
10639,2015-02-23,MIA,,PHI,W 119-108,240,46,83,.554,35,62,.565,11,21,.524,16,22,.727,119
10640,2015-02-23,PHI,@,MIA,L 108-119,240,40,84,.476,27,53,.509,13,31,.419,15,28,.536,108
10641,2015-02-23,NOP,,TOR,W 100-97,240,40,78,.513,30,56,.536,10,22,.455,10,16,.625,100
10642,2015-02-23,TOR,@,NOP,L 97-100,240,35,84,.417,30,61,.492,5,23,.217,22,31,.710,97
10643,2015-02-23,BOS,@,PHO,W 115-110,240,39,89,.438,25,60,.417,14,29,.483,23,30,.767,115
10644,2015-02-23,PHO,,BOS,L 110-115,240,44,97,.454,35,65,.538,9,32,.281,13,16,.813,110
10645,2015-02-23,SAS,@,UTA,L 81-90,240,32,79,.405,27,60,.450,5,19,.263,12,21,.571,81
10646,2015-02-23,UTA,,SAS,W 90-81,240,34,83,.410,30,68,.441,4,15,.267,18,23,.783,90
10647,2015-02-22,CHA,@,DAL,L 81-92,240,33,90,.367,27,71,.380,6,19,.316,9,13,.692,81
10648,2015-02-22,DAL,,CHO,W 92-81,240,36,78,.462,31,60,.517,5,18,.278,15,19,.789,92
10649,2015-02-22,DET,,WAS,W 106-89,240,37,89,.416,24,57,.421,13,32,.406,19,25,.760,106
10650,2015-02-22,WAS,@,DET,L 89-106,240,37,85,.435,31,68,.456,6,17,.353,9,14,.643,89
10651,2015-02-22,GSW,@,IND,L 98-104,240,34,89,.382,25,63,.397,9,26,.346,21,22,.955,98
10652,2015-02-22,IND,,GSW,W 104-98,240,39,81,.481,31,62,.500,8,19,.421,18,23,.783,104
10653,2015-02-22,BOS,@,LAL,L 111-118 (OT),265,42,98,.429,34,65,.523,8,33,.242,19,27,.704,111
10654,2015-02-22,LAL,,BOS,W 118-111 (OT),265,43,84,.512,36,66,.545,7,18,.389,25,38,.658,118
10655,2015-02-22,ATL,@,MIL,W 97-86,240,35,87,.402,26,57,.456,9,30,.300,18,21,.857,97
10656,2015-02-22,MIL,,ATL,L 86-97,240,32,72,.444,28,56,.500,4,16,.250,18,18,1.000,86
10657,2015-02-22,CLE,@,NYK,W 101-83,240,40,79,.506,28,46,.609,12,33,.364,9,15,.600,101
10658,2015-02-22,NYK,,CLE,L 83-101,240,37,99,.374,34,80,.425,3,19,.158,6,7,.857,83
10659,2015-02-22,DEN,@,OKC,L 94-119,240,35,97,.361,28,70,.400,7,27,.259,17,20,.850,94
10660,2015-02-22,OKC,,DEN,W 119-94,240,48,92,.522,40,72,.556,8,20,.400,15,23,.652,119
10661,2015-02-22,ORL,,PHI,W 103-98,240,39,82,.476,33,59,.559,6,23,.261,19,26,.731,103
10662,2015-02-22,PHI,@,ORL,L 98-103,240,36,78,.462,23,44,.523,13,34,.382,13,17,.765,98
10663,2015-02-22,MEM,@,POR,W 98-92,240,42,89,.472,39,80,.488,3,9,.333,11,13,.846,98
10664,2015-02-22,POR,,MEM,L 92-98,240,33,82,.402,20,49,.408,13,33,.394,13,16,.813,92
10665,2015-02-21,CHI,,PHO,W 112-107,240,43,89,.483,31,65,.477,12,24,.500,14,16,.875,112
10666,2015-02-21,PHO,@,CHI,L 107-112,240,47,88,.534,37,63,.587,10,25,.400,3,8,.375,107
10667,2015-02-21,CHA,,OKC,L 103-110,240,40,93,.430,33,69,.478,7,24,.292,16,20,.800,103
10668,2015-02-21,OKC,@,CHO,W 110-103,240,42,95,.442,37,77,.481,5,18,.278,21,26,.808,110
10669,2015-02-21,HOU,,TOR,W 98-76,240,35,84,.417,29,55,.527,6,29,.207,22,31,.710,98
10670,2015-02-21,TOR,@,HOU,L 76-98,240,25,77,.325,21,59,.356,4,18,.222,22,28,.786,76
10671,2015-02-21,LAC,,SAC,W 126-99,240,46,95,.484,32,60,.533,14,35,.400,20,28,.714,126
10672,2015-02-21,SAC,@,LAC,L 99-126,240,30,88,.341,26,72,.361,4,16,.250,35,46,.761,99
10673,2015-02-21,MIA,,NOP,L 91-105,240,33,79,.418,28,62,.452,5,17,.294,20,27,.741,91
10674,2015-02-21,NOP,@,MIA,W 105-91,240,35,83,.422,27,62,.435,8,21,.381,27,31,.871,105
10675,2015-02-20,ATL,,TOR,L 80-105,240,29,88,.330,21,50,.420,8,38,.211,14,21,.667,80
10676,2015-02-20,TOR,@,ATL,W 105-80,240,43,96,.448,30,66,.455,13,30,.433,6,8,.750,105
10677,2015-02-20,DAL,,HOU,W 111-100,240,44,93,.473,35,69,.507,9,24,.375,14,18,.778,111
10678,2015-02-20,HOU,@,DAL,L 100-111,240,36,87,.414,24,50,.480,12,37,.324,16,26,.615,100
10679,2015-02-20,CHI,@,DET,L 91-100,240,33,78,.423,28,62,.452,5,16,.313,20,22,.909,91
10680,2015-02-20,DET,,CHI,W 100-91,240,38,84,.452,32,62,.516,6,22,.273,18,33,.545,100
10681,2015-02-20,GSW,,SAS,W 110-99,240,41,84,.488,24,51,.471,17,33,.515,11,18,.611,110
10682,2015-02-20,SAS,@,GSW,L 99-110,240,39,81,.481,33,62,.532,6,19,.316,15,20,.750,99
10683,2015-02-20,BRK,@,LAL,W 114-105,240,42,89,.472,32,68,.471,10,21,.476,20,24,.833,114
10684,2015-02-20,LAL,,BRK,L 105-114,240,41,89,.461,37,66,.561,4,23,.174,19,29,.655,105
10685,2015-02-20,DEN,@,MIL,L 81-89,240,30,84,.357,23,58,.397,7,26,.269,14,21,.667,81
10686,2015-02-20,MIL,,DEN,W 89-81,240,33,78,.423,28,63,.444,5,15,.333,18,22,.818,89
10687,2015-02-20,MIN,,PHO,W 111-109,240,40,86,.465,36,71,.507,4,15,.267,27,38,.711,111
10688,2015-02-20,PHO,@,MIN,L 109-111,240,40,89,.449,33,72,.458,7,17,.412,22,31,.710,109
10689,2015-02-20,MIA,@,NYK,W 111-87,240,38,79,.481,29,59,.492,9,20,.450,26,35,.743,111
10690,2015-02-20,NYK,,MIA,L 87-111,240,35,82,.427,29,64,.453,6,18,.333,11,16,.688,87
10691,2015-02-20,NOP,@,ORL,L 84-95,240,29,69,.420,24,50,.480,5,19,.263,21,28,.750,84
10692,2015-02-20,ORL,,NOP,W 95-84,240,44,88,.500,40,70,.571,4,18,.222,3,6,.500,95
10693,2015-02-20,IND,@,PHI,W 106-95,240,40,83,.482,32,61,.525,8,22,.364,18,22,.818,106
10694,2015-02-20,PHI,,IND,L 95-106,240,34,84,.405,26,59,.441,8,25,.320,19,29,.655,95
10695,2015-02-20,BOS,@,SAC,L 101-109,240,40,100,.400,34,78,.436,6,22,.273,15,26,.577,101
10696,2015-02-20,SAC,,BOS,W 109-101,240,40,83,.482,32,61,.525,8,22,.364,21,26,.808,109
10697,2015-02-20,POR,@,UTA,L 76-92,240,26,72,.361,22,50,.440,4,22,.182,20,22,.909,76
10698,2015-02-20,UTA,,POR,W 92-76,240,37,83,.446,27,58,.466,10,25,.400,8,17,.471,92
10699,2015-02-20,CLE,@,WAS,W 127-89,240,46,90,.511,32,57,.561,14,33,.424,21,28,.750,127
10700,2015-02-20,WAS,,CLE,L 89-127,240,38,86,.442,37,70,.529,1,16,.063,12,16,.750,89
10701,2015-02-19,LAC,,SAS,W 119-115,240,42,77,.545,34,58,.586,8,19,.421,27,52,.519,119
10702,2015-02-19,SAS,@,LAC,L 115-119,240,43,84,.512,33,56,.589,10,28,.357,19,23,.826,115
10703,2015-02-19,DAL,@,OKC,L 89-104,240,33,91,.363,24,64,.375,9,27,.333,14,17,.824,89
10704,2015-02-19,OKC,,DAL,W 104-89,240,38,91,.418,31,69,.449,7,22,.318,21,26,.808,104
10705,2015-02-12,CHI,,CLE,W 113-98,240,42,92,.457,33,69,.478,9,23,.391,20,26,.769,113
10706,2015-02-12,CLE,@,CHI,L 98-113,240,37,85,.435,29,54,.537,8,31,.258,16,22,.727,98
10707,2015-02-11,ATL,@,BOS,L 88-89,240,33,78,.423,26,49,.531,7,29,.241,15,23,.652,88
10708,2015-02-11,BOS,,ATL,W 89-88,240,30,93,.323,20,62,.323,10,31,.323,19,20,.950,89
10709,2015-02-11,CLE,,MIA,W 113-93,240,44,78,.564,34,53,.642,10,25,.400,15,19,.789,113
10710,2015-02-11,MIA,@,CLE,L 93-113,240,34,84,.405,25,60,.417,9,24,.375,16,20,.800,93
10711,2015-02-11,DAL,,UTA,W 87-82,240,28,75,.373,18,47,.383,10,28,.357,21,26,.808,87
10712,2015-02-11,UTA,@,DAL,L 82-87,240,30,80,.375,19,51,.373,11,29,.379,11,21,.524,82
10713,2015-02-11,DET,,SAS,L 87-104,240,33,81,.407,24,60,.400,9,21,.429,12,17,.706,87
10714,2015-02-11,SAS,@,DET,W 104-87,240,42,88,.477,32,61,.525,10,27,.370,10,11,.909,104
10715,2015-02-11,HOU,@,LAC,L 95-110,240,34,87,.391,25,42,.595,9,45,.200,18,22,.818,95
10716,2015-02-11,LAC,,HOU,W 110-95,240,39,81,.481,35,59,.593,4,22,.182,28,45,.622,110
10717,2015-02-11,MIL,,SAC,W 111-103,240,39,80,.488,32,65,.492,7,15,.467,26,32,.813,111
10718,2015-02-11,SAC,@,MIL,L 103-111,240,36,84,.429,28,62,.452,8,22,.364,23,30,.767,103
10719,2015-02-11,GSW,@,MIN,W 94-91,240,40,90,.444,33,63,.524,7,27,.259,7,9,.778,94
10720,2015-02-11,MIN,,GSW,L 91-94,240,33,86,.384,28,72,.389,5,14,.357,20,27,.741,91
10721,2015-02-11,IND,@,NOP,W 106-93,240,40,75,.533,31,55,.564,9,20,.450,17,18,.944,106
10722,2015-02-11,NOP,,IND,L 93-106,240,34,74,.459,27,59,.458,7,15,.467,18,25,.720,93
10723,2015-02-11,MEM,@,OKC,L 89-105,240,32,86,.372,30,74,.405,2,12,.167,23,30,.767,89
10724,2015-02-11,OKC,,MEM,W 105-89,240,37,83,.446,30,63,.476,7,20,.350,24,25,.960,105
10725,2015-02-11,NYK,@,ORL,L 83-89,240,25,73,.342,20,58,.345,5,15,.333,28,36,.778,83
10726,2015-02-11,ORL,,NYK,W 89-83,240,31,67,.463,27,56,.482,4,11,.364,23,28,.821,89
10727,2015-02-11,LAL,@,POR,L 86-102,240,34,93,.366,27,77,.351,7,16,.438,11,11,1.000,86
10728,2015-02-11,POR,,LAL,W 102-86,240,35,86,.407,25,56,.446,10,30,.333,22,23,.957,102
10729,2015-02-11,TOR,,WAS,W 95-93,240,31,76,.408,20,50,.400,11,26,.423,22,26,.846,95
10730,2015-02-11,WAS,@,TOR,L 93-95,240,39,85,.459,34,64,.531,5,21,.238,10,16,.625,93
10731,2015-02-10,CHI,,SAC,W 104-86,240,42,80,.525,35,60,.583,7,20,.350,13,15,.867,104
10732,2015-02-10,SAC,@,CHI,L 86-104,240,35,75,.467,33,63,.524,2,12,.167,14,27,.519,86
10733,2015-02-10,CHA,,DET,L 78-106,240,29,81,.358,20,57,.351,9,24,.375,11,14,.786,78
10734,2015-02-10,DET,@,CHO,W 106-78,240,37,83,.446,32,64,.500,5,19,.263,27,30,.900,106
10735,2015-02-10,DEN,@,LAL,W 106-96,240,43,79,.544,39,63,.619,4,16,.250,16,23,.696,106
10736,2015-02-10,LAL,,DEN,L 96-106,240,37,85,.435,31,67,.463,6,18,.333,16,27,.593,96
10737,2015-02-10,BRK,@,MEM,L 86-95,240,35,81,.432,32,69,.464,3,12,.250,13,17,.765,86
10738,2015-02-10,MEM,,BRK,W 95-86,240,36,81,.444,30,62,.484,6,19,.316,17,25,.680,95
10739,2015-02-10,HOU,@,PHO,W 127-118,240,48,95,.505,33,58,.569,15,37,.405,16,23,.696,127
10740,2015-02-10,PHO,,HOU,L 118-127,240,41,87,.471,29,61,.475,12,26,.462,24,30,.800,118
10741,2015-02-09,DAL,,LAC,L 98-115,240,33,81,.407,23,47,.489,10,34,.294,22,30,.733,98
10742,2015-02-09,LAC,@,DAL,W 115-98,240,41,92,.446,32,65,.492,9,27,.333,24,29,.828,115
10743,2015-02-09,DEN,,OKC,L 114-124,240,42,87,.483,33,59,.559,9,28,.321,21,29,.724,114
10744,2015-02-09,OKC,@,DEN,W 124-114,240,43,80,.538,31,56,.554,12,24,.500,26,35,.743,124
10745,2015-02-09,IND,,SAS,L 93-95,240,36,88,.409,28,67,.418,8,21,.381,13,13,1.000,93
10746,2015-02-09,SAS,@,IND,W 95-93,240,37,89,.416,31,64,.484,6,25,.240,15,17,.882,95
10747,2015-02-09,MIA,,NYK,W 109-95,240,36,74,.486,24,52,.462,12,22,.545,25,29,.862,109
10748,2015-02-09,NYK,@,MIA,L 95-109,240,36,84,.429,29,64,.453,7,20,.350,16,19,.842,95
10749,2015-02-09,BRK,@,MIL,L 97-103,240,38,76,.500,29,51,.569,9,25,.360,12,19,.632,97
10750,2015-02-09,MIL,,BRK,W 103-97,240,37,89,.416,30,71,.423,7,18,.389,22,25,.880,103
10751,2015-02-09,ATL,@,MIN,W 117-105,240,44,86,.512,34,65,.523,10,21,.476,19,20,.950,117
10752,2015-02-09,MIN,,ATL,L 105-117,240,42,93,.452,37,77,.481,5,16,.313,16,22,.727,105
10753,2015-02-09,NOP,,UTA,L 96-100,240,33,79,.418,20,57,.351,13,22,.591,17,20,.850,96
10754,2015-02-09,UTA,@,NOP,W 100-96,240,39,93,.419,30,72,.417,9,21,.429,13,19,.684,100
10755,2015-02-09,GSW,@,PHI,W 89-84,240,34,85,.400,27,56,.482,7,29,.241,14,19,.737,89
10756,2015-02-09,PHI,,GSW,L 84-89,240,33,79,.418,26,55,.473,7,24,.292,11,14,.786,84
10757,2015-02-09,ORL,@,WAS,L 80-96,240,33,83,.398,29,61,.475,4,22,.182,10,15,.667,80
10758,2015-02-09,WAS,,ORL,W 96-80,240,33,77,.429,26,52,.500,7,25,.280,23,27,.852,96
10759,2015-02-08,CHA,,IND,L 102-103,240,36,77,.468,28,63,.444,8,14,.571,22,28,.786,102
10760,2015-02-08,IND,@,CHO,W 103-102,240,37,84,.440,30,65,.462,7,19,.368,22,25,.880,103
10761,2015-02-08,CLE,,LAL,W 120-105,240,45,82,.549,27,49,.551,18,33,.545,12,20,.600,120
10762,2015-02-08,LAL,@,CLE,L 105-120,240,41,100,.410,34,77,.442,7,23,.304,16,19,.842,105
10763,2015-02-08,DET,,MIN,L 101-112,240,37,79,.468,27,48,.563,10,31,.323,17,22,.773,101
10764,2015-02-08,MIN,@,DET,W 112-101,240,39,76,.513,34,64,.531,5,12,.417,29,34,.853,112
10765,2015-02-08,HOU,,POR,L 98-109,240,31,82,.378,18,47,.383,13,35,.371,23,34,.676,98
10766,2015-02-08,POR,@,HOU,W 109-98,240,40,76,.526,31,47,.660,9,29,.310,20,23,.870,109
10767,2015-02-08,ATL,@,MEM,L 88-94,240,33,80,.413,21,50,.420,12,30,.400,10,11,.909,88
10768,2015-02-08,MEM,,ATL,W 94-88,240,36,92,.391,33,79,.418,3,13,.231,19,21,.905,94
10769,2015-02-08,LAC,@,OKC,L 108-131,240,42,90,.467,30,58,.517,12,32,.375,12,17,.706,108
10770,2015-02-08,OKC,,LAC,W 131-108,240,46,88,.523,38,68,.559,8,20,.400,31,38,.816,131
10771,2015-02-08,CHI,@,ORL,W 98-97,240,37,77,.481,29,55,.527,8,22,.364,16,18,.889,98
10772,2015-02-08,ORL,,CHI,L 97-98,240,39,83,.470,30,58,.517,9,25,.360,10,13,.769,97
10773,2015-02-08,PHO,@,SAC,L 83-85,240,33,91,.363,28,63,.444,5,28,.179,12,17,.706,83
10774,2015-02-08,SAC,,PHO,W 85-83,240,34,75,.453,30,63,.476,4,12,.333,13,21,.619,85
10775,2015-02-08,SAS,@,TOR,L 82-87,240,31,93,.333,24,65,.369,7,28,.250,13,16,.813,82
10776,2015-02-08,TOR,,SAS,W 87-82,240,32,74,.432,28,61,.459,4,13,.308,19,24,.792,87
10777,2015-02-07,DAL,,POR,W 111-101 (OT),265,43,105,.410,29,69,.420,14,36,.389,11,16,.688,111
10778,2015-02-07,POR,@,DAL,L 101-111 (OT),265,37,89,.416,27,57,.474,10,32,.313,17,24,.708,101
10779,2015-02-07,BOS,@,MIL,L 93-96,240,36,86,.419,29,57,.509,7,29,.241,14,20,.700,93
10780,2015-02-07,MIL,,BOS,W 96-93,240,37,75,.493,29,55,.527,8,20,.400,14,19,.737,96
10781,2015-02-07,CHI,@,NOP,W 107-72,240,43,84,.512,33,62,.532,10,22,.455,11,13,.846,107
10782,2015-02-07,NOP,,CHI,L 72-107,240,32,86,.372,28,69,.406,4,17,.235,4,7,.571,72
10783,2015-02-07,GSW,@,NYK,W 106-92,240,37,81,.457,25,56,.446,12,25,.480,20,24,.833,106
10784,2015-02-07,NYK,,GSW,L 92-106,240,35,87,.402,27,69,.391,8,18,.444,14,17,.824,92
10785,2015-02-07,CHA,@,PHI,L 81-89,240,29,84,.345,23,61,.377,6,23,.261,17,20,.850,81
10786,2015-02-07,PHI,,CHO,W 89-81,240,29,74,.392,20,51,.392,9,23,.391,22,30,.733,89
10787,2015-02-07,SAC,@,UTA,L 90-102,240,32,82,.390,29,69,.420,3,13,.231,23,33,.697,90
10788,2015-02-07,UTA,,SAC,W 102-90,240,43,86,.500,38,67,.567,5,19,.263,11,17,.647,102
10789,2015-02-07,BRK,@,WAS,L 77-114,240,26,77,.338,22,59,.373,4,18,.222,21,31,.677,77
10790,2015-02-07,WAS,,BRK,W 114-77,240,44,87,.506,35,67,.522,9,20,.450,17,23,.739,114
10791,2015-02-06,ATL,,GSW,W 124-116,240,38,77,.494,23,50,.460,15,27,.556,33,37,.892,124
10792,2015-02-06,GSW,@,ATL,L 116-124,240,47,103,.456,35,70,.500,12,33,.364,10,15,.667,116
10793,2015-02-06,BOS,,PHI,W 107-96,240,39,86,.453,29,59,.492,10,27,.370,19,25,.760,107
10794,2015-02-06,PHI,@,BOS,L 96-107,240,35,79,.443,24,54,.444,11,25,.440,15,31,.484,96
10795,2015-02-06,BRK,,NYK,W 92-88,240,37,74,.500,34,63,.540,3,11,.273,15,22,.682,92
10796,2015-02-06,NYK,@,BRK,L 88-92,240,34,89,.382,28,65,.431,6,24,.250,14,17,.824,88
10797,2015-02-06,DEN,@,DET,L 88-98,240,33,85,.388,28,63,.444,5,22,.227,17,22,.773,88
10798,2015-02-06,DET,,DEN,W 98-88,240,37,82,.451,33,58,.569,4,24,.167,20,26,.769,98
10799,2015-02-06,HOU,,MIL,W 117-111,240,41,81,.506,26,49,.531,15,32,.469,20,29,.690,117
10800,2015-02-06,MIL,@,HOU,L 111-117,240,48,95,.505,44,78,.564,4,17,.235,11,15,.733,111
10801,2015-02-06,CLE,@,IND,L 99-103,240,40,89,.449,29,54,.537,11,35,.314,8,12,.667,99
10802,2015-02-06,IND,,CLE,W 103-99,240,37,79,.468,29,58,.500,8,21,.381,21,26,.808,103
10803,2015-02-06,MEM,@,MIN,L 89-90,240,36,69,.522,34,57,.596,2,12,.167,15,20,.750,89
10804,2015-02-06,MIN,,MEM,W 90-89,240,35,81,.432,30,64,.469,5,17,.294,15,17,.882,90
10805,2015-02-06,NOP,@,OKC,W 116-113,240,40,83,.482,29,63,.460,11,20,.550,25,30,.833,116
10806,2015-02-06,OKC,,NOP,L 113-116,240,40,89,.449,32,65,.492,8,24,.333,25,28,.893,113
10807,2015-02-06,LAL,@,ORL,L 97-103 (OT),265,39,97,.402,28,71,.394,11,26,.423,8,13,.615,97
10808,2015-02-06,ORL,,LAL,W 103-97 (OT),265,43,83,.518,38,68,.559,5,15,.333,12,14,.857,103
10809,2015-02-06,PHO,,UTA,W 100-93,240,38,84,.452,24,57,.421,14,27,.519,10,14,.714,100
10810,2015-02-06,UTA,@,PHO,L 93-100,240,37,80,.463,30,60,.500,7,20,.350,12,18,.667,93
10811,2015-02-06,MIA,@,SAS,L 85-98,240,36,80,.450,31,64,.484,5,16,.313,8,9,.889,85
10812,2015-02-06,SAS,,MIA,W 98-85,240,40,83,.482,29,54,.537,11,29,.379,7,9,.778,98
10813,2015-02-06,LAC,@,TOR,L 107-123,240,38,78,.487,32,55,.582,6,23,.261,25,31,.806,107
10814,2015-02-06,TOR,,LAC,W 123-107,240,40,75,.533,27,45,.600,13,30,.433,30,37,.811,123
10815,2015-02-05,CHA,,WAS,W 94-87,240,33,76,.434,27,51,.529,6,25,.240,22,27,.815,94
10816,2015-02-05,WAS,@,CHO,L 87-94,240,35,84,.417,30,74,.405,5,10,.500,12,17,.706,87
10817,2015-02-05,CLE,,LAC,W 105-94,240,31,72,.431,23,42,.548,8,30,.267,35,44,.795,105
10818,2015-02-05,LAC,@,CLE,L 94-105,240,38,91,.418,33,69,.478,5,22,.227,13,20,.650,94
10819,2015-02-05,PHO,@,POR,L 87-108,240,34,88,.386,28,65,.431,6,23,.261,13,17,.765,87
10820,2015-02-05,POR,,PHO,W 108-87,240,40,90,.444,32,59,.542,8,31,.258,20,23,.870,108
10821,2015-02-05,DAL,@,SAC,W 101-78,240,41,96,.427,29,62,.468,12,34,.353,7,10,.700,101
10822,2015-02-05,SAC,,DAL,L 78-101,240,29,79,.367,26,58,.448,3,21,.143,17,22,.773,78
10823,2015-02-04,ATL,,WAS,W 105-96,240,38,80,.475,27,55,.491,11,25,.440,18,27,.667,105
10824,2015-02-04,WAS,@,ATL,L 96-105,240,34,77,.442,30,61,.492,4,16,.250,24,30,.800,96
10825,2015-02-04,BOS,,DEN,W 104-100,240,40,99,.404,28,71,.394,12,28,.429,12,17,.706,104
10826,2015-02-04,DEN,@,BOS,L 100-104,240,33,80,.413,29,56,.518,4,24,.167,30,33,.909,100
10827,2015-02-04,DAL,@,GSW,L 114-128,240,41,98,.418,31,68,.456,10,30,.333,22,28,.786,114
10828,2015-02-04,GSW,,DAL,W 128-114,240,45,86,.523,26,48,.542,19,38,.500,19,25,.760,128
10829,2015-02-04,CHI,@,HOU,L 90-101,240,31,89,.348,23,64,.359,8,25,.320,20,26,.769,90
10830,2015-02-04,HOU,,CHI,W 101-90,240,38,92,.413,30,65,.462,8,27,.296,17,23,.739,101
10831,2015-02-04,DET,@,IND,L 109-114,240,43,87,.494,31,63,.492,12,24,.500,11,15,.733,109
10832,2015-02-04,IND,,DET,W 114-109,240,46,77,.597,34,56,.607,12,21,.571,10,18,.556,114
10833,2015-02-04,LAL,@,MIL,L 105-113 (OT),265,39,93,.419,30,65,.462,9,28,.321,18,25,.720,105
10834,2015-02-04,MIL,,LAL,W 113-105 (OT),265,41,82,.500,30,56,.536,11,26,.423,20,22,.909,113
10835,2015-02-04,MIA,@,MIN,L 101-102,240,39,80,.488,32,64,.500,7,16,.438,16,24,.667,101
10836,2015-02-04,MIN,,MIA,W 102-101,240,37,72,.514,31,61,.508,6,11,.545,22,27,.815,102
10837,2015-02-04,NOP,,OKC,L 91-102,240,37,97,.381,30,72,.417,7,25,.280,10,13,.769,91
10838,2015-02-04,OKC,@,NOP,W 102-91,240,45,85,.529,40,70,.571,5,15,.333,7,11,.636,102
10839,2015-02-04,ORL,@,SAS,L 103-110,240,42,84,.500,32,63,.508,10,21,.476,9,14,.643,103
10840,2015-02-04,SAS,,ORL,W 110-103,240,44,84,.524,30,52,.577,14,32,.438,8,14,.571,110
10841,2015-02-04,BRK,@,TOR,W 109-93,240,40,81,.494,31,62,.500,9,19,.474,20,23,.870,109
10842,2015-02-04,TOR,,BRK,L 93-109,240,35,79,.443,25,46,.543,10,33,.303,13,18,.722,93
10843,2015-02-04,MEM,@,UTA,W 100-90,240,38,80,.475,32,67,.478,6,13,.462,18,22,.818,100
10844,2015-02-04,UTA,,MEM,L 90-100,240,33,73,.452,26,50,.520,7,23,.304,17,26,.654,90
10845,2015-02-03,DET,,MIA,W 108-91,240,42,88,.477,33,68,.485,9,20,.450,15,18,.833,108
10846,2015-02-03,MIA,@,DET,L 91-108,240,35,74,.473,29,60,.483,6,14,.429,15,23,.652,91
10847,2015-02-03,BOS,@,NYK,W 108-97,240,42,77,.545,36,53,.679,6,24,.250,18,23,.783,108
10848,2015-02-03,NYK,,BOS,L 97-108,240,41,83,.494,34,63,.540,7,20,.350,8,11,.727,97
10849,2015-02-03,DEN,@,PHI,L 98-105,240,33,85,.388,21,54,.389,12,31,.387,20,28,.714,98
10850,2015-02-03,PHI,,DEN,W 105-98,240,31,70,.443,20,43,.465,11,27,.407,32,42,.762,105
10851,2015-02-03,POR,,UTA,W 103-102,240,36,76,.474,29,53,.547,7,23,.304,24,34,.706,103
10852,2015-02-03,UTA,@,POR,L 102-103,240,39,85,.459,33,72,.458,6,13,.462,18,26,.692,102
10853,2015-02-03,GSW,@,SAC,W 121-96,240,46,91,.505,36,68,.529,10,23,.435,19,26,.731,121
10854,2015-02-03,SAC,,GSW,L 96-121,240,35,79,.443,28,63,.444,7,16,.438,19,24,.792,96
10855,2015-02-02,BRK,,LAC,W 102-100,240,41,83,.494,29,56,.518,12,27,.444,8,18,.444,102
10856,2015-02-02,LAC,@,BRK,L 100-102,240,42,89,.472,34,66,.515,8,23,.348,8,25,.320,100
10857,2015-02-02,CLE,,PHI,W 97-84,240,35,78,.449,23,51,.451,12,27,.444,15,22,.682,97
10858,2015-02-02,PHI,@,CLE,L 84-97,240,31,78,.397,19,45,.422,12,33,.364,10,14,.714,84
10859,2015-02-02,DAL,,MIN,W 100-94,240,39,84,.464,29,53,.547,10,31,.323,12,18,.667,100
10860,2015-02-02,MIN,@,DAL,L 94-100,240,34,82,.415,31,69,.449,3,13,.231,23,26,.885,94
10861,2015-02-02,ATL,@,NOP,L 100-115,240,40,89,.449,33,67,.493,7,22,.318,13,17,.765,100
10862,2015-02-02,NOP,,ATL,W 115-100,240,43,86,.500,34,63,.540,9,23,.391,20,23,.870,115
10863,2015-02-02,OKC,,ORL,W 104-97,240,37,75,.493,29,55,.527,8,20,.400,22,26,.846,104
10864,2015-02-02,ORL,@,OKC,L 97-104,240,38,90,.422,32,67,.478,6,23,.261,15,18,.833,97
10865,2015-02-02,MEM,@,PHO,W 102-101,240,36,83,.434,33,72,.458,3,11,.273,27,34,.794,102
10866,2015-02-02,PHO,,MEM,L 101-102,240,42,84,.500,36,68,.529,6,16,.375,11,18,.611,101
10867,2015-02-02,MIL,@,TOR,W 82-75,240,33,80,.413,26,64,.406,7,16,.438,9,17,.529,82
10868,2015-02-02,TOR,,MIL,L 75-82,240,25,78,.321,18,51,.353,7,27,.259,18,22,.818,75
10869,2015-02-02,CHA,@,WAS,W 92-88,240,37,79,.468,33,64,.516,4,15,.267,14,19,.737,92
10870,2015-02-02,WAS,,CHO,L 88-92,240,33,81,.407,27,66,.409,6,15,.400,16,19,.842,88
10871,2015-02-01,BOS,,MIA,L 75-83,240,30,81,.370,26,62,.419,4,19,.211,11,18,.611,75
10872,2015-02-01,MIA,@,BOS,W 83-75,240,32,77,.416,28,56,.500,4,21,.190,15,21,.714,83
10873,2015-02-01,LAL,@,NYK,L 80-92,240,27,76,.355,20,60,.333,7,16,.438,19,23,.826,80
10874,2015-02-01,NYK,,LAL,W 92-80,240,37,84,.440,27,62,.435,10,22,.455,8,13,.615,92
10875,2015-01-31,ATL,,PHI,W 91-85,240,34,78,.436,24,50,.480,10,28,.357,13,18,.722,91
10876,2015-01-31,PHI,@,ATL,L 85-91,240,31,81,.383,17,46,.370,14,35,.400,9,15,.600,85
10877,2015-01-31,CHA,@,DEN,W 104-86,240,44,93,.473,44,82,.537,0,11,.000,16,25,.640,104
10878,2015-01-31,DEN,,CHO,L 86-104,240,33,92,.359,28,68,.412,5,24,.208,15,20,.750,86
10879,2015-01-31,DET,,HOU,W 114-101,240,41,82,.500,31,57,.544,10,25,.400,22,35,.629,114
10880,2015-01-31,HOU,@,DET,L 101-114,240,39,87,.448,28,55,.509,11,32,.344,12,19,.632,101
10881,2015-01-31,GSW,,PHO,W 106-87,240,40,87,.460,28,55,.509,12,32,.375,14,18,.778,106
10882,2015-01-31,PHO,@,GSW,L 87-106,240,33,91,.363,24,65,.369,9,26,.346,12,17,.706,87
10883,2015-01-31,IND,,SAC,L 94-99,240,33,80,.413,28,55,.509,5,25,.200,23,25,.920,94
10884,2015-01-31,SAC,@,IND,W 99-94,240,34,80,.425,29,65,.446,5,15,.333,26,29,.897,99
10885,2015-01-31,MEM,,OKC,W 85-74,240,34,91,.374,31,80,.388,3,11,.273,14,17,.824,85
10886,2015-01-31,OKC,@,MEM,L 74-85,240,27,78,.346,21,58,.362,6,20,.300,14,18,.778,74
10887,2015-01-31,MIL,,POR,W 95-88,240,37,82,.451,29,61,.475,8,21,.381,13,14,.929,95
10888,2015-01-31,POR,@,MIL,L 88-95,240,33,89,.371,24,58,.414,9,31,.290,13,18,.722,88
10889,2015-01-31,CLE,@,MIN,W 106-90,240,42,87,.483,32,55,.582,10,32,.313,12,19,.632,106
10890,2015-01-31,MIN,,CLE,L 90-106,240,34,82,.415,28,69,.406,6,13,.462,16,21,.762,90
10891,2015-01-31,DAL,@,ORL,W 108-93,240,42,74,.568,31,53,.585,11,21,.524,13,22,.591,108
10892,2015-01-31,ORL,,DAL,L 93-108,240,33,78,.423,25,54,.463,8,24,.333,19,24,.792,93
10893,2015-01-31,LAC,@,SAS,W 105-85,240,40,91,.440,32,69,.464,8,22,.364,17,18,.944,105
10894,2015-01-31,SAS,,LAC,L 85-105,240,28,75,.373,18,45,.400,10,30,.333,19,28,.679,85
10895,2015-01-31,TOR,@,WAS,W 120-116 (OT),265,44,88,.500,33,62,.532,11,26,.423,21,30,.700,120
10896,2015-01-31,WAS,,TOR,L 116-120 (OT),265,37,79,.468,27,55,.491,10,24,.417,32,41,.780,116
10897,2015-01-30,ATL,,POR,W 105-99,240,40,84,.476,29,61,.475,11,23,.478,14,22,.636,105
10898,2015-01-30,POR,@,ATL,L 99-105,240,39,87,.448,28,57,.491,11,30,.367,10,11,.909,99
10899,2015-01-30,BOS,,HOU,L 87-93,240,32,90,.356,25,66,.379,7,24,.292,16,23,.696,87
10900,2015-01-30,HOU,@,BOS,W 93-87,240,35,84,.417,27,54,.500,8,30,.267,15,20,.750,93
10901,2015-01-30,BRK,,TOR,L 122-127 (OT),265,49,101,.485,45,82,.549,4,19,.211,20,26,.769,122
10902,2015-01-30,TOR,@,BRK,W 127-122 (OT),265,47,92,.511,40,66,.606,7,26,.269,26,30,.867,127
10903,2015-01-30,CLE,,SAC,W 101-90,240,38,80,.475,27,49,.551,11,31,.355,14,22,.636,101
10904,2015-01-30,SAC,@,CLE,L 90-101,240,30,84,.357,27,66,.409,3,18,.167,27,32,.844,90
10905,2015-01-30,DAL,@,MIA,W 93-72,240,34,82,.415,21,53,.396,13,29,.448,12,20,.600,93
10906,2015-01-30,MIA,,DAL,L 72-93,240,29,88,.330,20,59,.339,9,29,.310,5,10,.500,72
10907,2015-01-30,LAC,@,NOP,L 103-108,240,42,92,.457,35,64,.547,7,28,.250,12,17,.706,103
10908,2015-01-30,NOP,,LAC,W 108-103,240,36,86,.419,23,61,.377,13,25,.520,23,26,.885,108
10909,2015-01-30,MIN,@,PHI,L 94-103,240,34,76,.447,29,62,.468,5,14,.357,21,25,.840,94
10910,2015-01-30,PHI,,MIN,W 103-94,240,37,74,.500,29,51,.569,8,23,.348,21,25,.840,103
10911,2015-01-30,CHI,@,PHO,L 93-99,240,36,87,.414,32,69,.464,4,18,.222,17,27,.630,93
10912,2015-01-30,PHO,,CHI,W 99-93,240,39,90,.433,33,68,.485,6,22,.273,15,17,.882,99
10913,2015-01-30,GSW,@,UTA,L 100-110,240,37,86,.430,29,59,.492,8,27,.296,18,25,.720,100
10914,2015-01-30,UTA,,GSW,W 110-100,240,42,94,.447,33,69,.478,9,25,.360,17,28,.607,110
10915,2015-01-29,IND,,NYK,W 103-82,240,42,79,.532,36,61,.590,6,18,.333,13,18,.722,103
10916,2015-01-29,NYK,@,IND,L 82-103,240,34,81,.420,29,65,.446,5,16,.313,9,13,.692,82
10917,2015-01-29,CHI,@,LAL,L 118-123 (2OT),290,43,104,.413,37,79,.468,6,25,.240,26,32,.813,118
10918,2015-01-29,LAL,,CHI,W 123-118 (2OT),290,50,106,.472,47,97,.485,3,9,.333,20,25,.800,123
10919,2015-01-29,DEN,@,MEM,L 69-99,240,29,87,.333,27,61,.443,2,26,.077,9,10,.900,69
10920,2015-01-29,MEM,,DEN,W 99-69,240,39,88,.443,36,72,.500,3,16,.188,18,27,.667,99
10921,2015-01-29,MIL,@,ORL,W 115-100,240,45,87,.517,33,62,.532,12,25,.480,13,18,.722,115
10922,2015-01-29,ORL,,MIL,L 100-115,240,37,82,.451,32,64,.500,5,18,.278,21,30,.700,100
10923,2015-01-28,ATL,,BRK,W 113-102,240,38,82,.463,26,49,.531,12,33,.364,25,26,.962,113
10924,2015-01-28,BRK,@,ATL,L 102-113,240,39,87,.448,30,63,.476,9,24,.375,15,18,.833,102
10925,2015-01-28,CLE,,POR,W 99-94,240,34,85,.400,19,48,.396,15,37,.405,16,18,.889,99
10926,2015-01-28,POR,@,CLE,L 94-99,240,35,80,.438,25,49,.510,10,31,.323,14,17,.824,94
10927,2015-01-28,DAL,@,HOU,L 94-99,240,35,82,.427,25,57,.439,10,25,.400,14,16,.875,94
10928,2015-01-28,HOU,,DAL,W 99-94,240,36,88,.409,22,53,.415,14,35,.400,13,15,.867,99
10929,2015-01-28,BOS,@,MIN,L 98-110,240,42,91,.462,35,68,.515,7,23,.304,7,9,.778,98
10930,2015-01-28,MIN,,BOS,W 110-98,240,38,77,.494,32,61,.525,6,16,.375,28,32,.875,110
10931,2015-01-28,DEN,@,NOP,W 93-85,240,39,85,.459,29,68,.426,10,17,.588,5,7,.714,93
10932,2015-01-28,NOP,,DEN,L 85-93,240,32,82,.390,29,67,.433,3,15,.200,18,24,.750,85
10933,2015-01-28,NYK,,OKC,W 100-92,240,40,91,.440,32,74,.432,8,17,.471,12,17,.706,100
10934,2015-01-28,OKC,@,NYK,L 92-100,240,34,85,.400,29,63,.460,5,22,.227,19,22,.864,92
10935,2015-01-28,DET,@,PHI,L 69-89,240,23,75,.307,21,55,.382,2,20,.100,21,23,.913,69
10936,2015-01-28,PHI,,DET,W 89-69,240,37,78,.474,30,57,.526,7,21,.333,8,12,.667,89
10937,2015-01-28,PHO,,WAS,W 106-98,240,40,88,.455,29,59,.492,11,29,.379,15,18,.833,106
10938,2015-01-28,WAS,@,PHO,L 98-106,240,37,88,.420,29,70,.414,8,18,.444,16,23,.696,98
10939,2015-01-28,CHA,@,SAS,L 86-95,240,34,83,.410,28,65,.431,6,18,.333,12,14,.857,86
10940,2015-01-28,SAS,,CHO,W 95-86,240,35,83,.422,25,54,.463,10,29,.345,15,18,.833,95
10941,2015-01-28,SAC,@,TOR,L 102-119,240,35,73,.479,28,56,.500,7,17,.412,25,29,.862,102
10942,2015-01-28,TOR,,SAC,W 119-102,240,43,84,.512,26,50,.520,17,34,.500,16,19,.842,119
10943,2015-01-28,LAC,@,UTA,W 94-89,240,34,76,.447,25,50,.500,9,26,.346,17,25,.680,94
10944,2015-01-28,UTA,,LAC,L 89-94,240,35,81,.432,30,57,.526,5,24,.208,14,20,.700,89
10945,2015-01-27,DAL,,MEM,L 90-109,240,38,78,.487,31,52,.596,7,26,.269,7,10,.700,90
10946,2015-01-27,MEM,@,DAL,W 109-90,240,42,79,.532,32,58,.552,10,21,.476,15,20,.750,109
10947,2015-01-27,CLE,@,DET,W 103-95,240,39,93,.419,30,59,.508,9,34,.265,16,17,.941,103
10948,2015-01-27,DET,,CLE,L 95-103,240,35,83,.422,27,59,.458,8,24,.333,17,23,.739,95
10949,2015-01-27,CHI,@,GSW,W 113-111 (OT),265,42,98,.429,34,69,.493,8,29,.276,21,23,.913,113
10950,2015-01-27,GSW,,CHI,L 111-113 (OT),265,48,113,.425,39,80,.488,9,33,.273,6,12,.500,111
10951,2015-01-27,IND,,TOR,L 91-104,240,34,82,.415,27,64,.422,7,18,.389,16,23,.696,91
10952,2015-01-27,TOR,@,IND,W 104-91,240,34,73,.466,25,47,.532,9,26,.346,27,34,.794,104
10953,2015-01-27,LAL,,WAS,L 92-98,240,37,87,.425,32,67,.478,5,20,.250,13,16,.813,92
10954,2015-01-27,WAS,@,LAL,W 98-92,240,38,78,.487,34,62,.548,4,16,.250,18,27,.667,98
10955,2015-01-27,MIA,,MIL,L 102-109,240,38,75,.507,31,55,.564,7,20,.350,19,26,.731,102
10956,2015-01-27,MIL,@,MIA,W 109-102,240,39,71,.549,30,55,.545,9,16,.563,22,30,.733,109
10957,2015-01-26,DEN,@,LAC,L 98-102,240,40,83,.482,32,62,.516,8,21,.381,10,15,.667,98
10958,2015-01-26,LAC,,DEN,W 102-98,240,38,80,.475,31,61,.508,7,19,.368,19,22,.864,102
10959,2015-01-26,MEM,,ORL,W 103-94,240,36,76,.474,29,58,.500,7,18,.389,24,26,.923,103
10960,2015-01-26,ORL,@,MEM,L 94-103,240,37,78,.474,33,66,.500,4,12,.333,16,25,.640,94
10961,2015-01-26,NOP,,PHI,W 99-74,240,39,86,.453,32,70,.457,7,16,.438,14,19,.737,99
10962,2015-01-26,PHI,@,NOP,L 74-99,240,28,81,.346,26,66,.394,2,15,.133,16,21,.762,74
10963,2015-01-26,MIN,@,OKC,L 84-92,240,29,85,.341,27,72,.375,2,13,.154,24,32,.750,84
10964,2015-01-26,OKC,,MIN,W 92-84,240,36,86,.419,32,66,.485,4,20,.200,16,24,.667,92
10965,2015-01-26,BOS,@,UTA,W 99-90,240,35,74,.473,27,55,.491,8,19,.421,21,23,.913,99
10966,2015-01-26,UTA,,BOS,L 90-99,240,35,82,.427,26,58,.448,9,24,.375,11,19,.579,90
10967,2015-01-25,ATL,,MIN,W 112-100,240,45,80,.563,35,52,.673,10,28,.357,12,18,.667,112
10968,2015-01-25,MIN,@,ATL,L 100-112,240,37,71,.521,31,55,.564,6,16,.375,20,25,.800,100
10969,2015-01-25,CHI,,MIA,L 84-96,240,31,87,.356,24,63,.381,7,24,.292,15,19,.789,84
10970,2015-01-25,MIA,@,CHI,W 96-84,240,38,84,.452,37,71,.521,1,13,.077,19,23,.826,96
10971,2015-01-25,CLE,,OKC,W 108-98,240,36,82,.439,20,46,.435,16,36,.444,20,29,.690,108
10972,2015-01-25,OKC,@,CLE,L 98-108,240,37,94,.394,27,64,.422,10,30,.333,14,18,.778,98
10973,2015-01-25,DEN,,WAS,L 115-117 (OT),265,41,101,.406,29,72,.403,12,29,.414,21,28,.750,115
10974,2015-01-25,WAS,@,DEN,W 117-115 (OT),265,48,90,.533,44,76,.579,4,14,.286,17,23,.739,117
10975,2015-01-25,BOS,@,GSW,L 111-114,240,41,95,.432,31,67,.463,10,28,.357,19,27,.704,111
10976,2015-01-25,GSW,,BOS,W 114-111,240,42,89,.472,34,66,.515,8,23,.348,22,25,.880,114
10977,2015-01-25,HOU,@,LAL,W 99-87,240,35,87,.402,22,43,.512,13,44,.295,16,21,.762,99
10978,2015-01-25,LAL,,HOU,L 87-99,240,34,79,.430,33,66,.500,1,13,.077,18,25,.720,87
10979,2015-01-25,DAL,@,NOP,L 106-109,240,39,81,.481,30,57,.526,9,24,.375,19,25,.760,106
10980,2015-01-25,NOP,,DAL,W 109-106,240,40,79,.506,32,62,.516,8,17,.471,21,25,.840,109
10981,2015-01-25,IND,@,ORL,W 106-99,240,43,83,.518,35,63,.556,8,20,.400,12,18,.667,106
10982,2015-01-25,ORL,,IND,L 99-106,240,38,78,.487,32,61,.525,6,17,.353,17,23,.739,99
10983,2015-01-25,LAC,@,PHO,W 120-100,240,43,87,.494,33,64,.516,10,23,.435,24,36,.667,120
10984,2015-01-25,PHO,,LAC,L 100-120,240,34,80,.425,24,51,.471,10,29,.345,22,27,.815,100
10985,2015-01-25,MIL,@,SAS,L 95-101,240,39,82,.476,31,65,.477,8,17,.471,9,13,.692,95
10986,2015-01-25,SAS,,MIL,W 101-95,240,35,83,.422,30,61,.492,5,22,.227,26,30,.867,101
10987,2015-01-25,DET,@,TOR,L 110-114,240,41,90,.456,29,56,.518,12,34,.353,16,23,.696,110
10988,2015-01-25,TOR,,DET,W 114-110,240,43,81,.531,38,66,.576,5,15,.333,23,29,.793,114
10989,2015-01-24,CHA,,NYK,W 76-71,240,25,76,.329,23,69,.333,2,7,.286,24,37,.649,76
10990,2015-01-24,NYK,@,CHO,L 71-76,240,28,79,.354,22,64,.344,6,15,.400,9,18,.500,71
10991,2015-01-24,MEM,,PHI,W 101-83,240,37,79,.468,31,65,.477,6,14,.429,21,25,.840,101
10992,2015-01-24,PHI,@,MEM,L 83-101,240,31,81,.383,22,57,.386,9,24,.375,12,22,.545,83
10993,2015-01-24,DET,@,MIL,L 86-101,240,31,86,.360,25,61,.410,6,25,.240,18,25,.720,86
10994,2015-01-24,MIL,,DET,W 101-86,240,41,81,.506,30,64,.469,11,17,.647,8,10,.800,101
10995,2015-01-24,POR,,WAS,W 103-96,240,35,87,.402,22,56,.393,13,31,.419,20,20,1.000,103
10996,2015-01-24,WAS,@,POR,L 96-103,240,40,82,.488,35,67,.522,5,15,.333,11,14,.786,96
10997,2015-01-24,BRK,@,UTA,L 73-108,240,29,75,.387,24,60,.400,5,15,.333,10,16,.625,73
10998,2015-01-24,UTA,,BRK,W 108-73,240,42,79,.532,29,50,.580,13,29,.448,11,14,.786,108
10999,2015-01-23,ATL,,OKC,W 103-93,240,40,83,.482,30,58,.517,10,25,.400,13,13,1.000,103
11000,2015-01-23,OKC,@,ATL,L 93-103,240,36,87,.414,26,61,.426,10,26,.385,11,18,.611,93
11001,2015-01-23,CHA,@,CLE,L 90-129,240,36,89,.404,34,73,.466,2,16,.125,16,24,.667,90
11002,2015-01-23,CLE,,CHO,W 129-90,240,46,89,.517,31,61,.508,15,28,.536,22,28,.786,129
11003,2015-01-23,CHI,@,DAL,W 102-98,240,38,78,.487,29,62,.468,9,16,.563,17,20,.850,102
11004,2015-01-23,DAL,,CHI,L 98-102,240,37,82,.451,31,64,.484,6,18,.333,18,18,1.000,98
11005,2015-01-23,BOS,@,DEN,W 100-99,240,37,75,.493,28,54,.519,9,21,.429,17,27,.630,100
11006,2015-01-23,DEN,,BOS,L 99-100,240,37,89,.416,31,68,.456,6,21,.286,19,26,.731,99
11007,2015-01-23,GSW,,SAC,W 126-101,240,45,94,.479,28,54,.519,17,40,.425,19,22,.864,126
11008,2015-01-23,SAC,@,GSW,L 101-126,240,34,82,.415,30,65,.462,4,17,.235,29,34,.853,101
11009,2015-01-23,IND,@,MIA,L 87-89,240,32,78,.410,29,63,.460,3,15,.200,20,23,.870,87
11010,2015-01-23,MIA,,IND,W 89-87,240,36,75,.480,32,58,.552,4,17,.235,13,15,.867,89
11011,2015-01-23,MIN,,NOP,L 84-92,240,35,84,.417,33,75,.440,2,9,.222,12,17,.706,84
11012,2015-01-23,NOP,@,MIN,W 92-84,240,40,80,.500,37,76,.487,3,4,.750,9,14,.643,92
11013,2015-01-23,NYK,,ORL,W 113-106,240,43,91,.473,33,66,.500,10,25,.400,17,21,.810,113
11014,2015-01-23,ORL,@,NYK,L 106-113,240,44,87,.506,37,60,.617,7,27,.259,11,19,.579,106
11015,2015-01-23,PHI,,TOR,L 86-91,240,31,81,.383,22,52,.423,9,29,.310,15,18,.833,86
11016,2015-01-23,TOR,@,PHI,W 91-86,240,33,80,.413,27,56,.482,6,24,.250,19,24,.792,91
11017,2015-01-23,HOU,@,PHO,W 113-111,240,44,84,.524,34,57,.596,10,27,.370,15,20,.750,113
11018,2015-01-23,PHO,,HOU,L 111-113,240,42,91,.462,32,61,.525,10,30,.333,17,24,.708,111
11019,2015-01-23,LAL,@,SAS,L 85-99,240,33,83,.398,28,70,.400,5,13,.385,14,20,.700,85
11020,2015-01-23,SAS,,LAL,W 99-85,240,36,84,.429,29,60,.483,7,24,.292,20,27,.741,99
11021,2015-01-22,CHI,,SAS,W 104-81,240,36,76,.474,30,57,.526,6,19,.316,26,32,.813,104
11022,2015-01-22,SAS,@,CHI,L 81-104,240,30,81,.370,24,60,.400,6,21,.286,15,18,.833,81
11023,2015-01-22,BRK,@,LAC,L 84-123,240,33,88,.375,29,67,.433,4,21,.190,14,25,.560,84
11024,2015-01-22,LAC,,BRK,W 123-84,240,49,83,.590,38,58,.655,11,25,.440,14,21,.667,123
11025,2015-01-22,MIL,,UTA,L 99-101,240,42,92,.457,37,79,.468,5,13,.385,10,12,.833,99
11026,2015-01-22,UTA,@,MIL,W 101-99,240,32,71,.451,18,40,.450,14,31,.452,23,28,.821,101
11027,2015-01-22,BOS,@,POR,W 90-89,240,39,87,.448,32,68,.471,7,19,.368,5,7,.714,90
11028,2015-01-22,POR,,BOS,L 89-90,240,33,89,.371,24,61,.393,9,28,.321,14,19,.737,89
11029,2015-01-21,ATL,,IND,W 110-91,240,39,78,.500,26,49,.531,13,29,.448,19,26,.731,110
11030,2015-01-21,IND,@,ATL,L 91-110,240,31,78,.397,26,53,.491,5,25,.200,24,26,.923,91
11031,2015-01-21,CHA,,MIA,W 78-76,240,27,80,.338,23,61,.377,4,19,.211,20,30,.667,78
11032,2015-01-21,MIA,@,CHO,L 76-78,240,29,84,.345,24,66,.364,5,18,.278,13,15,.867,76
11033,2015-01-21,CLE,,UTA,W 106-92,240,42,81,.519,37,57,.649,5,24,.208,17,25,.680,106
11034,2015-01-21,UTA,@,CLE,L 92-106,240,35,84,.417,27,62,.435,8,22,.364,14,18,.778,92
11035,2015-01-21,DET,,ORL,W 128-118,240,49,94,.521,39,70,.557,10,24,.417,20,24,.833,128
11036,2015-01-21,ORL,@,DET,L 118-128,240,48,97,.495,42,82,.512,6,15,.400,16,16,1.000,118
11037,2015-01-21,GSW,,HOU,W 126-113,240,49,98,.500,36,69,.522,13,29,.448,15,18,.833,126
11038,2015-01-21,HOU,@,GSW,L 113-126,240,37,87,.425,24,55,.436,13,32,.406,26,31,.839,113
11039,2015-01-21,MEM,,TOR,W 92-86,240,34,74,.459,33,67,.493,1,7,.143,23,29,.793,92
11040,2015-01-21,TOR,@,MEM,L 86-92,240,27,85,.318,22,57,.386,5,28,.179,27,32,.844,86
11041,2015-01-21,DAL,@,MIN,W 98-75,240,39,76,.513,28,49,.571,11,27,.407,9,14,.643,98
11042,2015-01-21,MIN,,DAL,L 75-98,240,31,89,.348,29,74,.392,2,15,.133,11,15,.733,75
11043,2015-01-21,LAL,@,NOP,L 80-96,240,28,77,.364,22,57,.386,6,20,.300,18,21,.857,80
11044,2015-01-21,NOP,,LAL,W 96-80,240,38,83,.458,35,67,.522,3,16,.188,17,21,.810,96
11045,2015-01-21,NYK,@,PHI,W 98-91,240,37,91,.407,30,71,.423,7,20,.350,17,20,.850,98
11046,2015-01-21,PHI,,NYK,L 91-98,240,29,79,.367,21,56,.375,8,23,.348,25,32,.781,91
11047,2015-01-21,PHO,,POR,W 118-113,240,47,92,.511,38,65,.585,9,27,.333,15,24,.625,118
11048,2015-01-21,POR,@,PHO,L 113-118,240,39,87,.448,26,55,.473,13,32,.406,22,28,.786,113
11049,2015-01-21,BRK,@,SAC,W 103-100,240,37,79,.468,32,59,.542,5,20,.250,24,30,.800,103
11050,2015-01-21,SAC,,BRK,L 100-103,240,39,84,.464,34,66,.515,5,18,.278,17,24,.708,100
11051,2015-01-21,OKC,@,WAS,W 105-103 (OT),265,40,102,.392,34,73,.466,6,29,.207,19,23,.826,105
11052,2015-01-21,WAS,,OKC,L 103-105 (OT),265,38,100,.380,31,70,.443,7,30,.233,20,26,.769,103
11053,2015-01-20,DEN,,SAS,L 99-109,240,37,79,.468,32,65,.492,5,14,.357,20,29,.690,99
11054,2015-01-20,SAS,@,DEN,W 109-99,240,38,84,.452,27,57,.474,11,27,.407,22,27,.815,109
11055,2015-01-20,MIA,,OKC,L 86-94,240,32,68,.471,24,46,.522,8,22,.364,14,19,.737,86
11056,2015-01-20,OKC,@,MIA,W 94-86,240,41,92,.446,35,66,.530,6,26,.231,6,10,.600,94
11057,2015-01-19,ATL,,DET,W 93-82,240,37,84,.440,28,54,.519,9,30,.300,10,14,.714,93
11058,2015-01-19,DET,@,ATL,L 82-93,240,29,82,.354,20,47,.426,9,35,.257,15,26,.577,82
11059,2015-01-19,CHA,,MIN,W 105-80,240,40,89,.449,28,67,.418,12,22,.545,13,19,.684,105
11060,2015-01-19,MIN,@,CHO,L 80-105,240,29,80,.363,23,61,.377,6,19,.316,16,20,.800,80
11061,2015-01-19,CHI,@,CLE,L 94-108,240,30,80,.375,22,64,.344,8,16,.500,26,32,.813,94
11062,2015-01-19,CLE,,CHI,W 108-94,240,41,90,.456,33,72,.458,8,18,.444,18,25,.720,108
11063,2015-01-19,DEN,@,GSW,L 79-122,240,30,87,.345,23,63,.365,7,24,.292,12,19,.632,79
11064,2015-01-19,GSW,,DEN,W 122-79,240,44,81,.543,31,54,.574,13,27,.481,21,27,.778,122
11065,2015-01-19,HOU,,IND,W 110-98,240,37,72,.514,25,41,.610,12,31,.387,24,33,.727,110
11066,2015-01-19,IND,@,HOU,L 98-110,240,39,85,.459,33,58,.569,6,27,.222,14,18,.778,98
11067,2015-01-19,BOS,@,LAC,L 93-102,240,33,84,.393,21,55,.382,12,29,.414,15,21,.714,93
11068,2015-01-19,LAC,,BOS,W 102-93,240,39,82,.476,30,61,.492,9,21,.429,15,19,.789,102
11069,2015-01-19,DAL,@,MEM,W 103-95,240,34,76,.447,24,51,.471,10,25,.400,25,33,.758,103
11070,2015-01-19,MEM,,DAL,L 95-103,240,36,85,.424,33,63,.524,3,22,.136,20,22,.909,95
11071,2015-01-19,MIL,,TOR,L 89-92,240,34,76,.447,29,58,.500,5,18,.278,16,25,.640,89
11072,2015-01-19,TOR,@,MIL,W 92-89,240,36,90,.400,30,66,.455,6,24,.250,14,24,.583,92
11073,2015-01-19,NOP,@,NYK,L 92-99,240,35,84,.417,27,57,.474,8,27,.296,14,20,.700,92
11074,2015-01-19,NYK,,NOP,W 99-92,240,38,78,.487,28,55,.509,10,23,.435,13,17,.765,99
11075,2015-01-19,LAL,@,PHO,L 100-115,240,34,75,.453,26,58,.448,8,17,.471,24,35,.686,100
11076,2015-01-19,PHO,,LAL,W 115-100,240,43,86,.500,30,54,.556,13,32,.406,16,22,.727,115
11077,2015-01-19,POR,,SAC,W 98-94,240,35,88,.398,24,52,.462,11,36,.306,17,26,.654,98
11078,2015-01-19,SAC,@,POR,L 94-98,240,34,76,.447,30,64,.469,4,12,.333,22,30,.733,94
11079,2015-01-19,PHI,@,WAS,L 76-111,240,28,85,.329,22,61,.361,6,24,.250,14,23,.609,76
11080,2015-01-19,WAS,,PHI,W 111-76,240,45,81,.556,38,68,.559,7,13,.538,14,18,.778,111
11081,2015-01-18,OKC,@,ORL,W 127-99,240,48,83,.578,39,58,.672,9,25,.360,22,32,.688,127
11082,2015-01-18,ORL,,OKC,L 99-127,240,35,88,.398,27,65,.415,8,23,.348,21,27,.778,99
11083,2015-01-18,SAS,,UTA,W 89-69,240,31,80,.388,23,63,.365,8,17,.471,19,23,.826,89
11084,2015-01-18,UTA,@,SAS,L 69-89,240,28,84,.333,25,74,.338,3,10,.300,10,16,.625,69
11085,2015-01-18,NOP,@,TOR,W 95-93,240,39,82,.476,34,65,.523,5,17,.294,12,20,.600,95
11086,2015-01-18,TOR,,NOP,L 93-95,240,31,72,.431,24,47,.511,7,25,.280,24,29,.828,93
11087,2015-01-17,BRK,,WAS,L 90-99,240,36,82,.439,32,65,.492,4,17,.235,14,18,.778,90
11088,2015-01-17,WAS,@,BRK,W 99-90,240,40,77,.519,35,61,.574,5,16,.313,14,27,.519,99
11089,2015-01-17,ATL,@,CHI,W 107-99,240,40,84,.476,29,58,.500,11,26,.423,16,21,.762,107
11090,2015-01-17,CHI,,ATL,L 99-107,240,37,80,.463,28,54,.519,9,26,.346,16,20,.800,99
11091,2015-01-17,CHA,,IND,W 80-71 (OT),265,31,101,.307,29,86,.337,2,15,.133,16,25,.640,80
11092,2015-01-17,IND,@,CHO,L 71-80 (OT),265,30,84,.357,28,63,.444,2,21,.095,9,13,.692,71
11093,2015-01-17,DEN,,MIN,L 105-113,240,38,92,.413,28,61,.459,10,31,.323,19,22,.864,105
11094,2015-01-17,MIN,@,DEN,W 113-105,240,43,80,.538,35,61,.574,8,19,.421,19,21,.905,113
11095,2015-01-17,DET,,PHI,W 107-89,240,38,88,.432,23,53,.434,15,35,.429,16,19,.842,107
11096,2015-01-17,PHI,@,DET,L 89-107,240,38,82,.463,31,54,.574,7,28,.250,6,7,.857,89
11097,2015-01-17,GSW,@,HOU,W 131-106,240,50,91,.549,41,69,.594,9,22,.409,22,33,.667,131
11098,2015-01-17,HOU,,GSW,L 106-131,240,37,88,.420,30,65,.462,7,23,.304,25,34,.735,106
11099,2015-01-17,MEM,,POR,W 102-98,240,39,77,.506,31,62,.500,8,15,.533,16,24,.667,102
11100,2015-01-17,POR,@,MEM,L 98-102,240,36,93,.387,23,57,.404,13,36,.361,13,15,.867,98
11101,2015-01-17,LAC,@,SAC,W 117-108,240,44,92,.478,35,64,.547,9,28,.321,20,31,.645,117
11102,2015-01-17,SAC,,LAC,L 108-117,240,41,89,.461,36,71,.507,5,18,.278,21,26,.808,108
11103,2015-01-16,BOS,,CHI,L 103-119,240,42,85,.494,37,69,.536,5,16,.313,14,16,.875,103
11104,2015-01-16,CHI,@,BOS,W 119-103,240,48,89,.539,35,64,.547,13,25,.520,10,12,.833,119
11105,2015-01-16,DAL,,DEN,W 97-89,240,33,79,.418,25,54,.463,8,25,.320,23,29,.793,97
11106,2015-01-16,DEN,@,DAL,L 89-97,240,34,83,.410,25,58,.431,9,25,.360,12,25,.480,89
11107,2015-01-16,DET,@,IND,W 98-96,240,32,85,.376,19,54,.352,13,31,.419,21,24,.875,98
11108,2015-01-16,IND,,DET,L 96-98,240,40,89,.449,34,71,.479,6,18,.333,10,12,.833,96
11109,2015-01-16,CLE,@,LAC,W 126-121,240,46,83,.554,36,60,.600,10,23,.435,24,31,.774,126
11110,2015-01-16,LAC,,CLE,L 121-126,240,43,91,.473,33,62,.532,10,29,.345,25,36,.694,121
11111,2015-01-16,GSW,@,OKC,L 115-127,240,42,92,.457,33,68,.485,9,24,.375,22,28,.786,115
11112,2015-01-16,OKC,,GSW,W 127-115,240,51,97,.526,41,75,.547,10,22,.455,15,19,.789,127
11113,2015-01-16,MEM,@,ORL,W 106-96,240,40,87,.460,37,73,.507,3,14,.214,23,29,.793,106
11114,2015-01-16,ORL,,MEM,L 96-106,240,36,79,.456,27,55,.491,9,24,.375,15,20,.750,96
11115,2015-01-16,NOP,@,PHI,L 81-96,240,29,75,.387,25,58,.431,4,17,.235,19,29,.655,81
11116,2015-01-16,PHI,,NOP,W 96-81,240,36,80,.450,29,58,.500,7,22,.318,17,27,.630,96
11117,2015-01-16,MIN,@,PHO,L 99-110,240,42,91,.462,34,69,.493,8,22,.364,7,12,.583,99
11118,2015-01-16,PHO,,MIN,W 110-99,240,48,87,.552,43,72,.597,5,15,.333,9,11,.818,110
11119,2015-01-16,MIA,@,SAC,W 95-83,240,35,74,.473,27,57,.474,8,17,.471,17,21,.810,95
11120,2015-01-16,SAC,,MIA,L 83-95,240,32,75,.427,25,59,.424,7,16,.438,12,14,.857,83
11121,2015-01-16,POR,@,SAS,L 96-110,240,37,74,.500,31,55,.564,6,19,.316,16,20,.800,96
11122,2015-01-16,SAS,,POR,W 110-96,240,42,94,.447,31,65,.477,11,29,.379,15,17,.882,110
11123,2015-01-16,ATL,@,TOR,W 110-89,240,42,69,.609,30,46,.652,12,23,.522,14,16,.875,110
11124,2015-01-16,TOR,,ATL,L 89-110,240,35,82,.427,29,57,.509,6,25,.240,13,17,.765,89
11125,2015-01-16,LAL,@,UTA,L 85-94,240,31,65,.477,28,58,.483,3,7,.429,20,27,.741,85
11126,2015-01-16,UTA,,LAL,W 94-85,240,36,85,.424,24,54,.444,12,31,.387,10,10,1.000,94
11127,2015-01-16,BRK,@,WAS,W 102-80,240,37,81,.457,33,69,.478,4,12,.333,24,31,.774,102
11128,2015-01-16,WAS,,BRK,L 80-102,240,31,73,.425,27,56,.482,4,17,.235,14,16,.875,80
11129,2015-01-15,HOU,,OKC,W 112-101,240,41,86,.477,25,50,.500,16,36,.444,14,19,.737,112
11130,2015-01-15,OKC,@,HOU,L 101-112,240,35,81,.432,24,52,.462,11,29,.379,20,28,.714,101
11131,2015-01-15,CLE,@,LAL,W 109-102,240,37,78,.474,28,48,.583,9,30,.300,26,36,.722,109
11132,2015-01-15,LAL,,CLE,L 102-109,240,39,76,.513,31,52,.596,8,24,.333,16,23,.696,102
11133,2015-01-15,MIL,,NYK,W 95-79,240,28,72,.389,20,54,.370,8,18,.444,31,42,.738,95
11134,2015-01-15,NYK,@,MIL,L 79-95,240,28,68,.412,20,46,.435,8,22,.364,15,20,.750,79
11135,2015-01-14,ATL,@,BOS,W 105-91,240,36,73,.493,26,44,.591,10,29,.345,23,27,.852,105
11136,2015-01-14,BOS,,ATL,L 91-105,240,34,83,.410,23,50,.460,11,33,.333,12,14,.857,91
11137,2015-01-14,BRK,,MEM,L 92-103,240,36,75,.480,26,49,.531,10,26,.385,10,12,.833,92
11138,2015-01-14,MEM,@,BRK,W 103-92,240,39,83,.470,36,66,.545,3,17,.176,22,29,.759,103
11139,2015-01-14,CHI,,WAS,L 99-105,240,34,79,.430,21,52,.404,13,27,.481,18,24,.750,99
11140,2015-01-14,WAS,@,CHI,W 105-99,240,40,78,.513,35,63,.556,5,15,.333,20,25,.800,105
11141,2015-01-14,CHA,,SAS,L 93-98,240,33,86,.384,29,73,.397,4,13,.308,23,35,.657,93
11142,2015-01-14,SAS,@,CHO,W 98-93,240,37,85,.435,29,64,.453,8,21,.381,16,20,.800,98
11143,2015-01-14,DAL,@,DEN,L 107-114,240,41,100,.410,32,63,.508,9,37,.243,16,20,.800,107
11144,2015-01-14,DEN,,DAL,W 114-107,240,41,82,.500,37,63,.587,4,19,.211,28,35,.800,114
11145,2015-01-14,DET,,NOP,L 94-105,240,34,73,.466,26,51,.510,8,22,.364,18,23,.783,94
11146,2015-01-14,NOP,@,DET,W 105-94,240,39,80,.488,31,59,.525,8,21,.381,19,23,.826,105
11147,2015-01-14,GSW,,MIA,W 104-89,240,38,81,.469,25,52,.481,13,29,.448,15,19,.789,104
11148,2015-01-14,MIA,@,GSW,L 89-104,240,30,71,.423,24,53,.453,6,18,.333,23,27,.852,89
11149,2015-01-14,HOU,@,ORL,L 113-120,240,42,83,.506,33,57,.579,9,26,.346,20,23,.870,113
11150,2015-01-14,ORL,,HOU,W 120-113,240,44,90,.489,35,64,.547,9,26,.346,23,26,.885,120
11151,2015-01-14,LAC,@,POR,W 100-94,240,37,88,.420,29,65,.446,8,23,.348,18,19,.947,100
11152,2015-01-14,POR,,LAC,L 94-100,240,35,87,.402,29,61,.475,6,26,.231,18,20,.900,94
11153,2015-01-14,PHI,@,TOR,L 84-100,240,31,80,.388,28,61,.459,3,19,.158,19,31,.613,84
11154,2015-01-14,TOR,,PHI,W 100-84,240,38,82,.463,28,53,.528,10,29,.345,14,22,.636,100
11155,2015-01-13,IND,,MIN,L 101-110,240,39,80,.488,34,62,.548,5,18,.278,18,30,.600,101
11156,2015-01-13,MIN,@,IND,W 110-101,240,41,87,.471,31,67,.463,10,20,.500,18,19,.947,110
11157,2015-01-13,LAL,,MIA,L 75-78,240,29,92,.315,25,69,.362,4,23,.174,13,18,.722,75
11158,2015-01-13,MIA,@,LAL,W 78-75,240,33,78,.423,31,62,.500,2,16,.125,10,15,.667,78
11159,2015-01-13,ATL,@,PHI,W 105-87,240,42,87,.483,30,64,.469,12,23,.522,9,16,.563,105
11160,2015-01-13,PHI,,ATL,L 87-105,240,31,76,.408,22,51,.431,9,25,.360,16,25,.640,87
11161,2015-01-13,CLE,@,PHO,L 100-107,240,36,82,.439,23,47,.489,13,35,.371,15,20,.750,100
11162,2015-01-13,PHO,,CLE,W 107-100,240,40,76,.526,33,56,.589,7,20,.350,20,27,.741,107
11163,2015-01-13,DAL,@,SAC,W 108-104 (OT),265,43,100,.430,37,76,.487,6,24,.250,16,23,.696,108
11164,2015-01-13,SAC,,DAL,L 104-108 (OT),265,38,86,.442,37,68,.544,1,18,.056,27,34,.794,104
11165,2015-01-13,GSW,@,UTA,W 116-105,240,46,91,.505,33,66,.500,13,25,.520,11,13,.846,116
11166,2015-01-13,UTA,,GSW,L 105-116,240,39,81,.481,32,60,.533,7,21,.333,20,24,.833,105
11167,2015-01-13,SAS,@,WAS,L 93-101,240,38,96,.396,29,67,.433,9,29,.310,8,12,.667,93
11168,2015-01-13,WAS,,SAS,W 101-93,240,37,75,.493,31,63,.492,6,12,.500,21,24,.875,101
11169,2015-01-12,BOS,,NOP,W 108-100,240,37,88,.420,29,64,.453,8,24,.333,26,31,.839,108
11170,2015-01-12,NOP,@,BOS,L 100-108,240,31,75,.413,25,60,.417,6,15,.400,32,37,.865,100
11171,2015-01-12,BRK,,HOU,L 99-113,240,39,84,.464,34,63,.540,5,21,.238,16,18,.889,99
11172,2015-01-12,HOU,@,BRK,W 113-99,240,41,86,.477,25,46,.543,16,40,.400,15,20,.750,113
11173,2015-01-12,CHI,,ORL,L 114-121,240,41,84,.488,33,57,.579,8,27,.296,24,33,.727,114
11174,2015-01-12,ORL,@,CHI,W 121-114,240,48,81,.593,41,63,.651,7,18,.389,18,29,.621,121
11175,2015-01-12,DET,@,TOR,W 114-111,240,41,96,.427,34,75,.453,7,21,.333,25,31,.806,114
11176,2015-01-12,TOR,,DET,L 111-114,240,47,87,.540,40,60,.667,7,27,.259,10,14,.714,111
11177,2015-01-11,ATL,,WAS,W 120-89,240,42,89,.472,26,58,.448,16,31,.516,20,24,.833,120
11178,2015-01-11,WAS,@,ATL,L 89-120,240,36,76,.474,31,56,.554,5,20,.250,12,15,.800,89
11179,2015-01-11,LAC,,MIA,L 90-104,240,34,75,.453,25,49,.510,9,26,.346,13,18,.722,90
11180,2015-01-11,MIA,@,LAC,W 104-90,240,39,81,.481,33,60,.550,6,21,.286,20,24,.833,104
11181,2015-01-11,LAL,,POR,L 94-106,240,36,81,.444,29,59,.492,7,22,.318,15,19,.789,94
11182,2015-01-11,POR,@,LAL,W 106-94,240,41,86,.477,28,55,.509,13,31,.419,11,17,.647,106
11183,2015-01-11,MEM,,PHO,W 122-110 (2OT),290,48,100,.480,39,79,.494,9,21,.429,17,24,.708,122
11184,2015-01-11,PHO,@,MEM,L 110-122 (2OT),290,42,100,.420,34,65,.523,8,35,.229,18,23,.783,110
11185,2015-01-11,CLE,@,SAC,L 84-103,240,33,78,.423,22,46,.478,11,32,.344,7,12,.583,84
11186,2015-01-11,SAC,,CLE,W 103-84,240,42,86,.488,36,69,.522,6,17,.353,13,17,.765,103
11187,2015-01-10,CHI,,MIL,W 95-87,240,35,88,.398,31,71,.437,4,17,.235,21,24,.875,95
11188,2015-01-10,MIL,@,CHI,L 87-95,240,36,81,.444,33,70,.471,3,11,.273,12,16,.750,87
11189,2015-01-10,BRK,@,DET,L 93-98,240,37,88,.420,28,57,.491,9,31,.290,10,10,1.000,93
11190,2015-01-10,DET,,BRK,W 98-93,240,34,80,.425,23,47,.489,11,33,.333,19,26,.731,98
11191,2015-01-10,HOU,,UTA,W 97-82,240,33,77,.429,20,43,.465,13,34,.382,18,21,.857,97
11192,2015-01-10,UTA,@,HOU,L 82-97,240,29,70,.414,24,53,.453,5,17,.294,19,21,.905,82
11193,2015-01-10,DAL,@,LAC,L 100-120,240,38,86,.442,26,56,.464,12,30,.400,12,17,.706,100
11194,2015-01-10,LAC,,DAL,W 120-100,240,46,88,.523,33,57,.579,13,31,.419,15,21,.714,120
11195,2015-01-10,MIN,,SAS,L 93-108,240,32,81,.395,29,66,.439,3,15,.200,26,26,1.000,93
11196,2015-01-10,SAS,@,MIN,W 108-93,240,41,84,.488,32,60,.533,9,24,.375,17,20,.850,108
11197,2015-01-10,CHA,@,NYK,W 110-82,240,39,78,.500,32,62,.516,7,16,.438,25,33,.758,110
11198,2015-01-10,NYK,,CHO,L 82-110,240,33,85,.388,25,56,.446,8,29,.276,8,9,.889,82
11199,2015-01-10,IND,@,PHI,L 92-93,240,29,87,.333,25,69,.362,4,18,.222,30,42,.714,92
11200,2015-01-10,PHI,,IND,W 93-92,240,32,80,.400,21,56,.375,11,24,.458,18,25,.720,93
11201,2015-01-10,ORL,@,POR,L 92-103,240,37,92,.402,34,71,.479,3,21,.143,15,20,.750,92
11202,2015-01-10,POR,,ORL,W 103-92,240,36,76,.474,26,50,.520,10,26,.385,21,26,.808,103
11203,2015-01-10,BOS,@,TOR,L 96-109,240,39,83,.470,33,65,.508,6,18,.333,12,20,.600,96
11204,2015-01-10,TOR,,BOS,W 109-96,240,41,91,.451,28,61,.459,13,30,.433,14,19,.737,109
11205,2015-01-09,BRK,,PHI,L 88-90,240,33,73,.452,30,57,.526,3,16,.188,19,27,.704,88
11206,2015-01-09,PHI,@,BRK,W 90-88,240,36,79,.456,28,62,.452,8,17,.471,10,17,.588,90
11207,2015-01-09,ATL,@,DET,W 106-103,240,40,82,.488,30,59,.508,10,23,.435,16,24,.667,106
11208,2015-01-09,DET,,ATL,L 103-106,240,38,96,.396,25,53,.472,13,43,.302,14,18,.778,103
11209,2015-01-09,CLE,@,GSW,L 94-112,240,35,86,.407,28,63,.444,7,23,.304,17,23,.739,94
11210,2015-01-09,GSW,,CLE,W 112-94,240,43,86,.500,33,56,.589,10,30,.333,16,17,.941,112
11211,2015-01-09,BOS,@,IND,L 103-107 (OT),265,41,103,.398,31,69,.449,10,34,.294,11,16,.688,103
11212,2015-01-09,IND,,BOS,W 107-103 (OT),265,34,92,.370,25,69,.362,9,23,.391,30,34,.882,107
11213,2015-01-09,LAL,,ORL,W 101-84,240,36,90,.400,29,69,.420,7,21,.333,22,31,.710,101
11214,2015-01-09,ORL,@,LAL,L 84-101,240,30,76,.395,24,62,.387,6,14,.429,18,23,.783,84
11215,2015-01-09,MIL,,MIN,W 98-84,240,39,75,.520,27,56,.482,12,19,.632,8,10,.800,98
11216,2015-01-09,MIN,@,MIL,L 84-98,240,32,79,.405,26,57,.456,6,22,.273,14,17,.824,84
11217,2015-01-09,MEM,@,NOP,L 95-106,240,36,82,.439,30,65,.462,6,17,.353,17,22,.773,95
11218,2015-01-09,NOP,,MEM,W 106-95,240,37,81,.457,27,61,.443,10,20,.500,22,26,.846,106
11219,2015-01-09,OKC,,UTA,W 99-94,240,42,91,.462,35,70,.500,7,21,.333,8,9,.889,99
11220,2015-01-09,UTA,@,OKC,L 94-99,240,36,74,.486,29,53,.547,7,21,.333,15,22,.682,94
11221,2015-01-09,DEN,@,SAC,W 118-108,240,47,85,.553,42,68,.618,5,17,.294,19,28,.679,118
11222,2015-01-09,SAC,,DEN,L 108-118,240,42,86,.488,36,67,.537,6,19,.316,18,24,.750,108
11223,2015-01-09,PHO,@,SAS,L 95-100,240,37,83,.446,30,57,.526,7,26,.269,14,21,.667,95
11224,2015-01-09,SAS,,PHO,W 100-95,240,38,89,.427,27,66,.409,11,23,.478,13,18,.722,100
11225,2015-01-09,CHI,@,WAS,L 86-102,240,32,83,.386,22,57,.386,10,26,.385,12,19,.632,86
11226,2015-01-09,WAS,,CHI,W 102-86,240,41,86,.477,33,71,.465,8,15,.533,12,19,.632,102
11227,2015-01-08,HOU,@,NYK,W 120-96,240,41,77,.532,25,41,.610,16,36,.444,22,32,.688,120
11228,2015-01-08,NYK,,HOU,L 96-120,240,37,80,.463,26,54,.481,11,26,.423,11,21,.524,96
11229,2015-01-08,MIA,@,POR,L 83-99,240,29,77,.377,26,63,.413,3,14,.214,22,30,.733,83
11230,2015-01-08,POR,,MIA,W 99-83,240,40,95,.421,32,68,.471,8,27,.296,11,15,.733,99
11231,2015-01-08,CHA,@,TOR,W 103-95,240,42,88,.477,38,72,.528,4,16,.250,15,22,.682,103
11232,2015-01-08,TOR,,CHO,L 95-103,240,33,83,.398,23,52,.442,10,31,.323,19,25,.760,95
11233,2015-01-07,ATL,,MEM,W 96-86,240,32,72,.444,19,47,.404,13,25,.520,19,23,.826,96
11234,2015-01-07,MEM,@,ATL,L 86-96,240,35,79,.443,30,62,.484,5,17,.294,11,11,1.000,86
11235,2015-01-07,BOS,@,BRK,W 89-81,240,35,88,.398,30,70,.429,5,18,.278,14,17,.824,89
11236,2015-01-07,BRK,,BOS,L 81-89,240,30,74,.405,27,60,.450,3,14,.214,18,26,.692,81
11237,2015-01-07,CHI,,UTA,L 77-97,240,28,84,.333,22,64,.344,6,20,.300,15,20,.750,77
11238,2015-01-07,UTA,@,CHI,W 97-77,240,37,78,.474,32,62,.516,5,16,.313,18,24,.750,97
11239,2015-01-07,CHA,,NOP,W 98-94,240,37,86,.430,33,72,.458,4,14,.286,20,26,.769,98
11240,2015-01-07,NOP,@,CHO,L 94-98,240,36,80,.450,30,62,.484,6,18,.333,16,24,.667,94
11241,2015-01-07,CLE,,HOU,L 93-105,240,34,82,.415,24,53,.453,10,29,.345,15,19,.789,93
11242,2015-01-07,HOU,@,CLE,W 105-93,240,39,86,.453,27,52,.519,12,34,.353,15,24,.625,105
11243,2015-01-07,DAL,,DET,L 95-108,240,38,87,.437,32,65,.492,6,22,.273,13,18,.722,95
11244,2015-01-07,DET,@,DAL,W 108-95,240,43,97,.443,33,76,.434,10,21,.476,12,14,.857,108
11245,2015-01-07,DEN,,ORL,W 93-90,240,33,74,.446,26,57,.456,7,17,.412,20,26,.769,93
11246,2015-01-07,ORL,@,DEN,L 90-93,240,35,88,.398,27,66,.409,8,22,.364,12,16,.750,90
11247,2015-01-07,GSW,,IND,W 117-102,240,45,91,.495,33,63,.524,12,28,.429,15,20,.750,117
11248,2015-01-07,IND,@,GSW,L 102-117,240,37,81,.457,31,55,.564,6,26,.231,22,23,.957,102
11249,2015-01-07,LAC,,LAL,W 114-89,240,40,85,.471,28,52,.538,12,33,.364,22,30,.733,114
11250,2015-01-07,LAL,@,LAC,L 89-114,240,37,85,.435,32,65,.492,5,20,.250,10,17,.588,89
11251,2015-01-07,MIN,,PHO,L 111-113,240,44,92,.478,37,75,.493,7,17,.412,16,19,.842,111
11252,2015-01-07,PHO,@,MIN,W 113-111,240,46,96,.479,41,70,.586,5,26,.192,16,19,.842,113
11253,2015-01-07,MIL,@,PHI,W 97-77,240,41,76,.539,33,59,.559,8,17,.471,7,11,.636,97
11254,2015-01-07,PHI,,MIL,L 77-97,240,25,83,.301,23,58,.397,2,25,.080,25,29,.862,77
11255,2015-01-07,OKC,@,SAC,L 83-104,240,29,89,.326,20,59,.339,9,30,.300,16,23,.696,83
11256,2015-01-07,SAC,,OKC,W 104-83,240,36,92,.391,26,73,.356,10,19,.526,22,28,.786,104
11257,2015-01-07,NYK,@,WAS,L 91-101,240,34,82,.415,23,56,.411,11,26,.423,12,16,.750,91
11258,2015-01-07,WAS,,NYK,W 101-91,240,39,76,.513,31,60,.517,8,16,.500,15,21,.714,101
11259,2015-01-06,MIL,,PHO,L 96-102,240,37,88,.420,34,68,.500,3,20,.150,19,22,.864,96
11260,2015-01-06,PHO,@,MIL,W 102-96,240,37,81,.457,30,56,.536,7,25,.280,21,27,.778,102
11261,2015-01-06,DET,@,SAS,W 105-104,240,41,87,.471,38,68,.559,3,19,.158,20,28,.714,105
11262,2015-01-06,SAS,,DET,L 104-105,240,36,79,.456,27,58,.466,9,21,.429,23,34,.676,104
11263,2015-01-05,BOS,,CHO,L 95-104,240,36,91,.396,29,73,.397,7,18,.389,16,23,.696,95
11264,2015-01-05,CHA,@,BOS,W 104-95,240,38,78,.487,32,59,.542,6,19,.316,22,23,.957,104
11265,2015-01-05,BRK,,DAL,L 88-96 (OT),265,33,84,.393,30,59,.508,3,25,.120,19,23,.826,88
11266,2015-01-05,DAL,@,BRK,W 96-88 (OT),265,37,94,.394,27,67,.403,10,27,.370,12,19,.632,96
11267,2015-01-05,CHI,,HOU,W 114-105,240,41,85,.482,36,68,.529,5,17,.294,27,30,.900,114
11268,2015-01-05,HOU,@,CHI,L 105-114,240,47,102,.461,39,77,.506,8,25,.320,3,5,.600,105
11269,2015-01-05,GSW,,OKC,W 117-91,240,41,88,.466,26,60,.433,15,28,.536,20,32,.625,117
11270,2015-01-05,OKC,@,GSW,L 91-117,240,30,98,.306,25,70,.357,5,28,.179,26,34,.765,91
11271,2015-01-05,ATL,@,LAC,W 107-98,240,36,81,.444,23,54,.426,13,27,.481,22,33,.667,107
11272,2015-01-05,LAC,,ATL,L 98-107,240,33,74,.446,26,49,.531,7,25,.280,25,33,.758,98
11273,2015-01-05,MEM,,NYK,W 105-83,240,43,82,.524,36,67,.537,7,15,.467,12,19,.632,105
11274,2015-01-05,NYK,@,MEM,L 83-105,240,33,76,.434,25,50,.500,8,26,.308,9,13,.692,83
11275,2015-01-05,DEN,@,MIN,W 110-101,240,46,84,.548,39,65,.600,7,19,.368,11,16,.688,110
11276,2015-01-05,MIN,,DEN,L 101-110,240,38,89,.427,28,65,.431,10,24,.417,15,18,.833,101
11277,2015-01-05,NOP,,WAS,L 85-92,240,33,74,.446,27,55,.491,6,19,.316,13,17,.765,85
11278,2015-01-05,WAS,@,NOP,W 92-85,240,38,79,.481,36,69,.522,2,10,.200,14,17,.824,92
11279,2015-01-05,CLE,@,PHI,L 92-95,240,33,85,.388,22,55,.400,11,30,.367,15,22,.682,92
11280,2015-01-05,PHI,,CLE,W 95-92,240,38,79,.481,31,56,.554,7,23,.304,12,15,.800,95
11281,2015-01-05,LAL,@,POR,L 94-98,240,37,88,.420,33,74,.446,4,14,.286,16,20,.800,94
11282,2015-01-05,POR,,LAL,W 98-94,240,33,83,.398,22,57,.386,11,26,.423,21,24,.875,98
11283,2015-01-05,IND,@,UTA,W 105-101,240,35,74,.473,28,61,.459,7,13,.538,28,30,.933,105
11284,2015-01-05,UTA,,IND,L 101-105,240,35,81,.432,31,58,.534,4,23,.174,27,34,.794,101
11285,2015-01-04,CLE,,DAL,L 90-109,240,35,86,.407,27,61,.443,8,25,.320,12,17,.706,90
11286,2015-01-04,DAL,@,CLE,W 109-90,240,44,78,.564,32,52,.615,12,26,.462,9,11,.818,109
11287,2015-01-04,DET,,SAC,W 114-95,240,45,91,.495,33,60,.550,12,31,.387,12,16,.750,114
11288,2015-01-04,SAC,@,DET,L 95-114,240,32,75,.427,29,60,.483,3,15,.200,28,36,.778,95
11289,2015-01-04,IND,@,LAL,L 87-88,240,33,90,.367,25,62,.403,8,28,.286,13,18,.722,87
11290,2015-01-04,LAL,,IND,W 88-87,240,27,71,.380,21,53,.396,6,18,.333,28,30,.933,88
11291,2015-01-04,BRK,@,MIA,L 84-88,240,34,86,.395,27,62,.435,7,24,.292,9,13,.692,84
11292,2015-01-04,MIA,,BRK,W 88-84,240,31,67,.463,26,53,.491,5,14,.357,21,28,.750,88
11293,2015-01-04,MIL,@,NYK,W 95-82,240,35,77,.455,31,61,.508,4,16,.250,21,27,.778,95
11294,2015-01-04,NYK,,MIL,L 82-95,240,31,76,.408,22,51,.431,9,25,.360,11,14,.786,82
11295,2015-01-04,PHO,,TOR,W 125-109,240,48,89,.539,40,66,.606,8,23,.348,21,28,.750,125
11296,2015-01-04,TOR,@,PHO,L 109-125,240,38,83,.458,29,57,.509,9,26,.346,24,29,.828,109
11297,2015-01-03,BOS,@,CHI,L 104-109 (OT),265,45,100,.450,40,83,.482,5,17,.294,9,11,.818,104
11298,2015-01-03,CHI,,BOS,W 109-104 (OT),265,37,100,.370,31,72,.431,6,28,.214,29,40,.725,109
11299,2015-01-03,DEN,,MEM,W 114-85,240,41,79,.519,34,64,.531,7,15,.467,25,31,.806,114
11300,2015-01-03,MEM,@,DEN,L 85-114,240,37,86,.430,35,72,.486,2,14,.143,9,13,.692,85
11301,2015-01-03,HOU,,MIA,W 115-79,240,41,83,.494,28,52,.538,13,31,.419,20,28,.714,115
11302,2015-01-03,MIA,@,HOU,L 79-115,240,30,68,.441,26,51,.510,4,17,.235,15,25,.600,79
11303,2015-01-03,LAC,,PHI,W 127-91,240,46,85,.541,31,48,.646,15,37,.405,20,26,.769,127
11304,2015-01-03,PHI,@,LAC,L 91-127,240,32,79,.405,23,54,.426,9,25,.360,18,26,.692,91
11305,2015-01-03,MIN,,UTA,L 89-101,240,34,86,.395,28,67,.418,6,19,.316,15,18,.833,89
11306,2015-01-03,UTA,@,MIN,W 101-89,240,38,75,.507,27,55,.491,11,20,.550,14,21,.667,101
11307,2015-01-03,CHA,@,ORL,W 98-90,240,35,78,.449,31,62,.500,4,16,.250,24,32,.750,98
11308,2015-01-03,ORL,,CHO,L 90-98,240,33,87,.379,29,68,.426,4,19,.211,20,21,.952,90
11309,2015-01-03,ATL,@,POR,W 115-107,240,43,84,.512,37,67,.552,6,17,.353,23,31,.742,115
11310,2015-01-03,POR,,ATL,L 107-115,240,42,93,.452,29,60,.483,13,33,.394,10,12,.833,107
11311,2015-01-03,SAS,,WAS,W 101-92,240,43,78,.551,39,62,.629,4,16,.250,11,18,.611,101
11312,2015-01-03,WAS,@,SAS,L 92-101,240,40,82,.488,36,68,.529,4,14,.286,8,13,.615,92
11313,2015-01-02,BOS,,DAL,L 101-119,240,38,89,.427,26,55,.473,12,34,.353,13,19,.684,101
11314,2015-01-02,DAL,@,BOS,W 119-101,240,45,96,.469,32,69,.464,13,27,.481,16,17,.941,119
11315,2015-01-02,CHA,,CLE,L 87-91,240,32,87,.368,26,59,.441,6,28,.214,17,26,.654,87
11316,2015-01-02,CLE,@,CHO,W 91-87,240,33,87,.379,29,72,.403,4,15,.267,21,30,.700,91
11317,2015-01-02,GSW,,TOR,W 126-105,240,49,92,.533,37,64,.578,12,28,.429,16,20,.800,126
11318,2015-01-02,TOR,@,GSW,L 105-126,240,40,86,.465,30,61,.492,10,25,.400,15,20,.750,105
11319,2015-01-02,LAL,,MEM,L 106-109,240,43,81,.531,37,62,.597,6,19,.316,14,19,.737,106
11320,2015-01-02,MEM,@,LAL,W 109-106,240,41,84,.488,35,70,.500,6,14,.429,21,31,.677,109
11321,2015-01-02,IND,@,MIL,W 94-91,240,35,81,.432,27,61,.443,8,20,.400,16,20,.800,94
11322,2015-01-02,MIL,,IND,L 91-94,240,38,89,.427,31,65,.477,7,24,.292,8,10,.800,91
11323,2015-01-02,HOU,@,NOP,L 83-111,240,35,88,.398,29,59,.492,6,29,.207,7,11,.636,83
11324,2015-01-02,NOP,,HOU,W 111-83,240,44,83,.530,37,68,.544,7,15,.467,16,20,.800,111
11325,2015-01-02,DET,@,NYK,W 97-81,240,38,76,.500,25,43,.581,13,33,.394,8,14,.571,97
11326,2015-01-02,NYK,,DET,L 81-97,240,32,91,.352,22,67,.328,10,24,.417,7,14,.500,81
11327,2015-01-02,OKC,,WAS,W 109-102,240,44,83,.530,36,64,.563,8,19,.421,13,19,.684,109
11328,2015-01-02,WAS,@,OKC,L 102-109,240,39,84,.464,28,63,.444,11,21,.524,13,15,.867,102
11329,2015-01-02,BRK,@,ORL,W 100-98,240,41,72,.569,34,52,.654,7,20,.350,11,18,.611,100
11330,2015-01-02,ORL,,BRK,L 98-100,240,37,88,.420,26,66,.394,11,22,.500,13,20,.650,98
11331,2015-01-02,PHI,@,PHO,L 96-112,240,37,87,.425,30,61,.492,7,26,.269,15,25,.600,96
11332,2015-01-02,PHO,,PHI,W 112-96,240,42,84,.500,28,52,.538,14,32,.438,14,16,.875,112
11333,2015-01-02,ATL,@,UTA,W 98-92,240,33,81,.407,27,58,.466,6,23,.261,26,30,.867,98
11334,2015-01-02,UTA,,ATL,L 92-98,240,32,86,.372,22,55,.400,10,31,.323,18,24,.750,92
11335,2015-01-01,CHI,,DEN,W 106-101,240,38,91,.418,30,76,.395,8,15,.533,22,25,.880,106
11336,2015-01-01,DEN,@,CHI,L 101-106,240,37,92,.402,32,78,.410,5,14,.357,22,27,.815,101
11337,2015-01-01,MIN,,SAC,L 107-110,240,42,91,.462,35,67,.522,7,24,.292,16,22,.727,107
11338,2015-01-01,SAC,@,MIN,W 110-107,240,40,74,.541,35,62,.565,5,12,.417,25,29,.862,110
11339,2014-12-31,BOS,,SAC,W 106-84,240,44,94,.468,39,73,.534,5,21,.238,13,15,.867,106
11340,2014-12-31,SAC,@,BOS,L 84-106,240,32,87,.368,30,72,.417,2,15,.133,18,28,.643,84
11341,2014-12-31,CLE,,MIL,L 80-96,240,29,85,.341,21,54,.389,8,31,.258,14,16,.875,80
11342,2014-12-31,MIL,@,CLE,W 96-80,240,40,90,.444,29,65,.446,11,25,.440,5,10,.500,96
11343,2014-12-31,CHA,@,HOU,L 83-102,240,29,76,.382,26,58,.448,3,18,.167,22,26,.846,83
11344,2014-12-31,HOU,,CHO,W 102-83,240,38,88,.432,21,45,.467,17,43,.395,9,14,.643,102
11345,2014-12-31,IND,,MIA,W 106-95,240,35,79,.443,25,61,.410,10,18,.556,26,30,.867,106
11346,2014-12-31,MIA,@,IND,L 95-106,240,38,77,.494,33,61,.541,5,16,.313,14,18,.778,95
11347,2014-12-31,LAC,,NYK,W 99-78,240,36,82,.439,21,48,.438,15,34,.441,12,20,.600,99
11348,2014-12-31,NYK,@,LAC,L 78-99,240,32,84,.381,28,67,.418,4,17,.235,10,15,.667,78
11349,2014-12-31,OKC,,PHO,W 137-134 (OT),265,41,99,.414,30,64,.469,11,35,.314,44,49,.898,137
11350,2014-12-31,PHO,@,OKC,L 134-137 (OT),265,46,90,.511,33,63,.524,13,27,.481,29,35,.829,134
11351,2014-12-31,NOP,@,SAS,L 93-95 (OT),265,34,89,.382,26,61,.426,8,28,.286,17,20,.850,93
11352,2014-12-31,SAS,,NOP,W 95-93 (OT),265,39,89,.438,33,65,.508,6,24,.250,11,18,.611,95
11353,2014-12-30,ATL,,CLE,W 109-101,240,40,79,.506,30,50,.600,10,29,.345,19,26,.731,109
11354,2014-12-30,CLE,@,ATL,L 101-109,240,37,84,.440,24,53,.453,13,31,.419,14,21,.667,101
11355,2014-12-30,BRK,@,CHI,W 96-82,240,36,83,.434,30,69,.435,6,14,.429,18,21,.857,96
11356,2014-12-30,CHI,,BRK,L 82-96,240,33,86,.384,25,61,.410,8,25,.320,8,15,.533,82
11357,2014-12-30,DAL,,WAS,W 114-87,240,43,82,.524,35,67,.522,8,15,.533,20,29,.690,114
11358,2014-12-30,WAS,@,DAL,L 87-114,240,33,74,.446,29,62,.468,4,12,.333,17,27,.630,87
11359,2014-12-30,DEN,,LAL,L 103-111,240,39,87,.448,31,61,.508,8,26,.308,17,27,.630,103
11360,2014-12-30,LAL,@,DEN,W 111-103,240,40,76,.526,26,51,.510,14,25,.560,17,26,.654,111
11361,2014-12-30,GSW,,PHI,W 126-86,240,46,82,.561,34,54,.630,12,28,.429,22,27,.815,126
11362,2014-12-30,PHI,@,GSW,L 86-126,240,33,86,.384,27,66,.409,6,20,.300,14,23,.609,86
11363,2014-12-30,MEM,,SAS,W 95-87,240,35,72,.486,28,57,.491,7,15,.467,18,22,.818,95
11364,2014-12-30,SAS,@,MEM,L 87-95,240,35,78,.449,30,56,.536,5,22,.227,12,17,.706,87
11365,2014-12-30,NOP,,PHO,W 110-106,240,42,81,.519,34,63,.540,8,18,.444,18,29,.621,110
11366,2014-12-30,PHO,@,NOP,L 106-110,240,41,86,.477,32,65,.492,9,21,.429,15,19,.789,106
11367,2014-12-30,DET,@,ORL,W 109-86,240,40,86,.465,26,53,.491,14,33,.424,15,29,.517,109
11368,2014-12-30,ORL,,DET,L 86-109,240,38,85,.447,34,65,.523,4,20,.200,6,10,.600,86
11369,2014-12-30,POR,,TOR,W 102-97 (OT),265,38,95,.400,26,59,.441,12,36,.333,14,18,.778,102
11370,2014-12-30,TOR,@,POR,L 97-102 (OT),265,40,99,.404,36,77,.468,4,22,.182,13,15,.867,97
11371,2014-12-30,MIN,@,UTA,L 94-100,240,38,82,.463,30,65,.462,8,17,.471,10,14,.714,94
11372,2014-12-30,UTA,,MIN,W 100-94,240,38,79,.481,31,60,.517,7,19,.368,17,22,.773,100
11373,2014-12-29,BRK,,SAC,W 107-99,240,36,80,.450,28,59,.475,8,21,.381,27,39,.692,107
11374,2014-12-29,SAC,@,BRK,L 99-107,240,37,76,.487,28,56,.500,9,20,.450,16,20,.800,99
11375,2014-12-29,CHA,,MIL,L 94-104 (OT),265,33,90,.367,26,65,.400,7,25,.280,21,26,.808,94
11376,2014-12-29,MIL,@,CHO,W 104-94 (OT),265,40,85,.471,34,64,.531,6,21,.286,18,21,.857,104
11377,2014-12-29,HOU,,WAS,L 103-104,240,40,86,.465,31,57,.544,9,29,.310,14,23,.609,103
11378,2014-12-29,WAS,@,HOU,W 104-103,240,35,73,.479,27,55,.491,8,18,.444,26,28,.929,104
11379,2014-12-29,CHI,@,IND,W 92-90,240,29,84,.345,24,71,.338,5,13,.385,29,33,.879,92
11380,2014-12-29,IND,,CHI,L 90-92,240,36,83,.434,31,70,.443,5,13,.385,13,21,.619,90
11381,2014-12-29,LAC,,UTA,W 101-97,240,37,81,.457,27,58,.466,10,23,.435,17,22,.773,101
11382,2014-12-29,UTA,@,LAC,L 97-101,240,38,92,.413,30,73,.411,8,19,.421,13,22,.591,97
11383,2014-12-29,MIA,,ORL,L 101-102,240,33,63,.524,26,49,.531,7,14,.500,28,40,.700,101
11384,2014-12-29,ORL,@,MIA,W 102-101,240,41,77,.532,30,52,.577,11,25,.440,9,13,.692,102
11385,2014-12-28,CLE,,DET,L 80-103,240,31,82,.378,26,53,.491,5,29,.172,13,17,.765,80
11386,2014-12-28,DET,@,CLE,W 103-80,240,41,91,.451,24,60,.400,17,31,.548,4,9,.444,103
11387,2014-12-28,DAL,,OKC,W 112-107,240,39,88,.443,29,57,.509,10,31,.323,24,28,.857,112
11388,2014-12-28,OKC,@,DAL,L 107-112,240,45,90,.500,40,76,.526,5,14,.357,12,21,.571,107
11389,2014-12-28,DEN,,TOR,L 102-116,240,37,87,.425,33,70,.471,4,17,.235,24,34,.706,102
11390,2014-12-28,TOR,@,DEN,W 116-102,240,43,88,.489,33,65,.508,10,23,.435,20,32,.625,116
11391,2014-12-28,LAL,,PHO,L 107-116,240,42,81,.519,30,61,.492,12,20,.600,11,20,.550,107
11392,2014-12-28,PHO,@,LAL,W 116-107,240,44,87,.506,35,65,.538,9,22,.409,19,24,.792,116
11393,2014-12-28,NYK,@,POR,L 79-101,240,31,93,.333,24,66,.364,7,27,.259,10,15,.667,79
11394,2014-12-28,POR,,NYK,W 101-79,240,38,81,.469,22,45,.489,16,36,.444,9,12,.750,101
11395,2014-12-28,HOU,@,SAS,L 106-110,240,38,77,.494,26,44,.591,12,33,.364,18,31,.581,106
11396,2014-12-28,SAS,,HOU,W 110-106,240,39,83,.470,28,53,.528,11,30,.367,21,24,.875,110
11397,2014-12-27,BRK,,IND,L 85-110,240,28,77,.364,21,52,.404,7,25,.280,22,27,.815,85
11398,2014-12-27,IND,@,BRK,W 110-85,240,44,86,.512,35,68,.515,9,18,.500,13,18,.722,110
11399,2014-12-27,CHI,,NOP,W 107-100,240,41,89,.461,35,69,.507,6,20,.300,19,22,.864,107
11400,2014-12-27,NOP,@,CHI,L 100-107,240,41,88,.466,37,74,.500,4,14,.286,14,16,.875,100
11401,2014-12-27,CHA,,ORL,L 94-102,240,36,86,.419,28,62,.452,8,24,.333,14,18,.778,94
11402,2014-12-27,ORL,@,CHO,W 102-94,240,38,83,.458,30,63,.476,8,20,.400,18,24,.750,102
11403,2014-12-27,GSW,,MIN,W 110-97,240,41,88,.466,30,60,.500,11,28,.393,17,21,.810,110
11404,2014-12-27,MIN,@,GSW,L 97-110,240,34,77,.442,26,58,.448,8,19,.421,21,36,.583,97
11405,2014-12-27,LAC,,TOR,L 98-110,240,37,81,.457,25,56,.446,12,25,.480,12,15,.800,98
11406,2014-12-27,TOR,@,LAC,W 110-98,240,41,86,.477,28,52,.538,13,34,.382,15,19,.789,110
11407,2014-12-27,MEM,@,MIA,W 103-95,240,34,73,.466,27,57,.474,7,16,.438,28,37,.757,103
11408,2014-12-27,MIA,,MEM,L 95-103,240,37,72,.514,31,52,.596,6,20,.300,15,21,.714,95
11409,2014-12-27,ATL,@,MIL,W 90-85,240,33,90,.367,24,61,.393,9,29,.310,15,19,.789,90
11410,2014-12-27,MIL,,ATL,L 85-90,240,31,80,.388,19,50,.380,12,30,.400,11,14,.786,85
11411,2014-12-27,NYK,@,SAC,L 129-135 (OT),265,48,97,.495,42,77,.545,6,20,.300,27,32,.844,129
11412,2014-12-27,SAC,,NYK,W 135-129 (OT),265,49,89,.551,41,73,.562,8,16,.500,29,33,.879,135
11413,2014-12-27,PHI,@,UTA,L 71-88,240,24,74,.324,19,48,.396,5,26,.192,18,28,.643,71
11414,2014-12-27,UTA,,PHI,W 88-71,240,30,84,.357,26,61,.426,4,23,.174,24,28,.857,88
11415,2014-12-27,BOS,@,WAS,L 88-101,240,32,79,.405,26,55,.473,6,24,.250,18,24,.750,88
11416,2014-12-27,WAS,,BOS,W 101-88,240,45,90,.500,40,77,.519,5,13,.385,6,10,.600,101
11417,2014-12-26,ATL,,MIL,L 77-107,240,31,76,.408,27,53,.509,4,23,.174,11,14,.786,77
11418,2014-12-26,MIL,@,ATL,W 107-77,240,40,79,.506,32,60,.533,8,19,.421,19,23,.826,107
11419,2014-12-26,BOS,,BRK,L 107-109,240,45,87,.517,36,63,.571,9,24,.375,8,11,.727,107
11420,2014-12-26,BRK,@,BOS,W 109-107,240,41,83,.494,34,62,.548,7,21,.333,20,28,.714,109
11421,2014-12-26,DAL,,LAL,W 102-98,240,42,83,.506,37,65,.569,5,18,.278,13,24,.542,102
11422,2014-12-26,LAL,@,DAL,L 98-102,240,36,99,.364,25,70,.357,11,29,.379,15,20,.750,98
11423,2014-12-26,DEN,,MIN,W 106-102,240,39,95,.411,36,76,.474,3,19,.158,25,32,.781,106
11424,2014-12-26,MIN,@,DEN,L 102-106,240,41,103,.398,38,88,.432,3,15,.200,17,24,.708,102
11425,2014-12-26,DET,,IND,W 119-109,240,47,86,.547,37,60,.617,10,26,.385,15,29,.517,119
11426,2014-12-26,IND,@,DET,L 109-119,240,42,83,.506,33,63,.524,9,20,.450,16,22,.727,109
11427,2014-12-26,HOU,@,MEM,W 117-111 (OT),265,41,91,.451,27,57,.474,14,34,.412,21,28,.750,117
11428,2014-12-26,MEM,,HOU,L 111-117 (OT),265,43,104,.413,36,80,.450,7,24,.292,18,23,.783,111
11429,2014-12-26,NOP,,SAS,W 97-90,240,35,84,.417,29,67,.433,6,17,.353,21,24,.875,97
11430,2014-12-26,SAS,@,NOP,L 90-97,240,37,75,.493,31,61,.508,6,14,.429,10,14,.714,90
11431,2014-12-26,CHA,@,OKC,L 75-98,240,25,87,.287,20,63,.317,5,24,.208,20,26,.769,75
11432,2014-12-26,OKC,,CHO,W 98-75,240,36,88,.409,28,61,.459,8,27,.296,18,21,.857,98
11433,2014-12-26,CLE,@,ORL,W 98-89,240,33,80,.413,25,50,.500,8,30,.267,24,26,.923,98
11434,2014-12-26,ORL,,CLE,L 89-98,240,36,73,.493,27,52,.519,9,21,.429,8,12,.667,89
11435,2014-12-26,PHI,@,POR,L 93-114,240,36,81,.444,33,67,.493,3,14,.214,18,33,.545,93
11436,2014-12-26,POR,,PHI,W 114-93,240,42,88,.477,24,45,.533,18,43,.419,12,14,.857,114
11437,2014-12-26,PHO,@,SAC,W 115-106,240,46,94,.489,32,61,.525,14,33,.424,9,12,.750,115
11438,2014-12-26,SAC,,PHO,L 106-115,240,41,93,.441,34,73,.466,7,20,.350,17,24,.708,106
11439,2014-12-25,CHI,,LAL,W 113-93,240,42,86,.488,32,62,.516,10,24,.417,19,25,.760,113
11440,2014-12-25,LAL,@,CHI,L 93-113,240,36,92,.391,31,76,.408,5,16,.313,16,21,.762,93
11441,2014-12-25,GSW,@,LAC,L 86-100,240,34,80,.425,28,52,.538,6,28,.214,12,22,.545,86
11442,2014-12-25,LAC,,GSW,W 100-86,240,34,87,.391,25,55,.455,9,32,.281,23,31,.742,100
11443,2014-12-25,CLE,@,MIA,L 91-101,240,32,72,.444,26,46,.565,6,26,.231,21,33,.636,91
11444,2014-12-25,MIA,,CLE,W 101-91,240,40,84,.476,33,63,.524,7,21,.333,14,17,.824,101
11445,2014-12-25,NYK,,WAS,L 91-102,240,36,80,.450,32,58,.552,4,22,.182,15,19,.789,91
11446,2014-12-25,WAS,@,NYK,W 102-91,240,44,86,.512,37,70,.529,7,16,.438,7,10,.700,102
11447,2014-12-25,OKC,@,SAS,W 114-106,240,42,81,.519,33,66,.500,9,15,.600,21,38,.553,114
11448,2014-12-25,SAS,,OKC,L 106-114,240,42,81,.519,35,58,.603,7,23,.304,15,21,.714,106
11449,2014-12-23,ATL,,LAC,W 107-104,240,34,76,.447,22,53,.415,12,23,.522,27,35,.771,107
11450,2014-12-23,LAC,@,ATL,L 104-107,240,37,92,.402,26,63,.413,11,29,.379,19,28,.679,104
11451,2014-12-23,BRK,,DEN,W 102-96,240,43,91,.473,37,68,.544,6,23,.261,10,14,.714,102
11452,2014-12-23,DEN,@,BRK,L 96-102,240,36,82,.439,29,57,.509,7,25,.280,17,22,.773,96
11453,2014-12-23,CLE,,MIN,W 125-104,240,44,84,.524,32,60,.533,12,24,.500,25,31,.806,125
11454,2014-12-23,MIN,@,CLE,L 104-125,240,39,88,.443,35,75,.467,4,13,.308,22,29,.759,104
11455,2014-12-23,IND,,NOP,W 96-84,240,39,78,.500,34,63,.540,5,15,.333,13,18,.722,96
11456,2014-12-23,NOP,@,IND,L 84-96,240,33,83,.398,29,63,.460,4,20,.200,14,19,.737,84
11457,2014-12-23,GSW,@,LAL,L 105-115,240,39,84,.464,27,58,.466,12,26,.462,15,17,.882,105
11458,2014-12-23,LAL,,GSW,W 115-105,240,46,89,.517,34,63,.540,12,26,.462,11,17,.647,115
11459,2014-12-23,MIA,,PHI,L 87-91,240,33,80,.413,25,54,.463,8,26,.308,13,18,.722,87
11460,2014-12-23,PHI,@,MIA,W 91-87,240,33,77,.429,28,58,.483,5,19,.263,20,27,.741,91
11461,2014-12-23,CHA,@,MIL,W 108-101,240,36,82,.439,28,61,.459,8,21,.381,28,36,.778,108
11462,2014-12-23,MIL,,CHO,L 101-108,240,39,82,.476,31,61,.508,8,21,.381,15,20,.750,101
11463,2014-12-23,OKC,,POR,L 111-115 (OT),265,46,101,.455,40,82,.488,6,19,.316,13,15,.867,111
11464,2014-12-23,POR,@,OKC,W 115-111 (OT),265,38,91,.418,21,60,.350,17,31,.548,22,24,.917,115
11465,2014-12-23,BOS,@,ORL,L 95-100,240,33,85,.388,26,62,.419,7,23,.304,22,29,.759,95
11466,2014-12-23,ORL,,BOS,W 100-95,240,39,83,.470,32,65,.492,7,18,.389,15,23,.652,100
11467,2014-12-23,DAL,@,PHO,L 115-124,240,41,88,.466,32,63,.508,9,25,.360,24,29,.828,115
11468,2014-12-23,PHO,,DAL,W 124-115,240,44,97,.454,31,64,.484,13,33,.394,23,32,.719,124
11469,2014-12-23,CHI,@,WAS,W 99-91,240,39,85,.459,34,68,.500,5,17,.294,16,24,.667,99
11470,2014-12-23,WAS,,CHI,L 91-99,240,38,89,.427,33,80,.413,5,9,.556,10,16,.625,91
11471,2014-12-22,CHI,,TOR,W 129-120,240,40,74,.541,34,62,.548,6,12,.500,43,47,.915,129
11472,2014-12-22,TOR,@,CHI,L 120-129,240,44,100,.440,35,70,.500,9,30,.300,23,32,.719,120
11473,2014-12-22,CHA,,DEN,W 110-82,240,43,80,.538,35,61,.574,8,19,.421,16,24,.667,110
11474,2014-12-22,DEN,@,CHO,L 82-110,240,31,82,.378,29,64,.453,2,18,.111,18,24,.750,82
11475,2014-12-22,ATL,@,DAL,W 105-102,240,40,81,.494,33,62,.532,7,19,.368,18,27,.667,105
11476,2014-12-22,DAL,,ATL,L 102-105,240,39,90,.433,28,62,.452,11,28,.393,13,20,.650,102
11477,2014-12-22,GSW,,SAC,W 128-108,240,49,91,.538,40,66,.606,9,25,.360,21,24,.875,128
11478,2014-12-22,SAC,@,GSW,L 108-128,240,43,90,.478,35,73,.479,8,17,.471,14,21,.667,108
11479,2014-12-22,HOU,,POR,W 110-95,240,41,87,.471,28,51,.549,13,36,.361,15,20,.750,110
11480,2014-12-22,POR,@,HOU,L 95-110,240,34,76,.447,24,49,.490,10,27,.370,17,18,.944,95
11481,2014-12-22,MEM,,UTA,L 91-97,240,38,86,.442,31,63,.492,7,23,.304,8,9,.889,91
11482,2014-12-22,UTA,@,MEM,W 97-91,240,34,75,.453,25,56,.446,9,19,.474,20,27,.741,97
11483,2014-12-22,LAC,@,SAS,L 118-125,240,43,86,.500,33,62,.532,10,24,.417,22,29,.759,118
11484,2014-12-22,SAS,,LAC,W 125-118,240,49,77,.636,36,54,.667,13,23,.565,14,22,.636,125
11485,2014-12-21,BRK,,DET,W 110-105,240,40,76,.526,32,56,.571,8,20,.400,22,29,.759,110
11486,2014-12-21,DET,@,BRK,L 105-110,240,40,91,.440,31,64,.484,9,27,.333,16,26,.615,105
11487,2014-12-21,CLE,,MEM,W 105-91,240,46,76,.605,39,62,.629,7,14,.500,6,10,.600,105
11488,2014-12-21,MEM,@,CLE,L 91-105,240,39,86,.453,38,70,.543,1,16,.063,12,15,.800,91
11489,2014-12-21,BOS,@,MIA,L 84-100,240,33,83,.398,27,60,.450,6,23,.261,12,15,.800,84
11490,2014-12-21,MIA,,BOS,W 100-84,240,37,78,.474,31,57,.544,6,21,.286,20,26,.769,100
11491,2014-12-21,IND,@,MIN,W 100-96,240,42,84,.500,36,65,.554,6,19,.316,10,14,.714,100
11492,2014-12-21,MIN,,IND,L 96-100,240,36,77,.468,31,66,.470,5,11,.455,19,24,.792,96
11493,2014-12-21,NOP,@,OKC,W 101-99,240,43,90,.478,36,70,.514,7,20,.350,8,10,.800,101
11494,2014-12-21,OKC,,NOP,L 99-101,240,38,83,.458,33,63,.524,5,20,.250,18,24,.750,99
11495,2014-12-21,ORL,,PHI,L 88-96,240,35,84,.417,28,61,.459,7,23,.304,11,20,.550,88
11496,2014-12-21,PHI,@,ORL,W 96-88,240,35,82,.427,29,59,.492,6,23,.261,20,25,.800,96
11497,2014-12-21,LAL,@,SAC,L 101-108,240,33,87,.379,23,61,.377,10,26,.385,25,30,.833,101
11498,2014-12-21,SAC,,LAL,W 108-101,240,38,79,.481,31,56,.554,7,23,.304,25,36,.694,108
11499,2014-12-21,NYK,@,TOR,L 108-118,240,40,82,.488,35,68,.515,5,14,.357,23,26,.885,108
11500,2014-12-21,TOR,,NYK,W 118-108,240,42,86,.488,28,53,.528,14,33,.424,20,27,.741,118
11501,2014-12-21,PHO,@,WAS,W 104-92,240,40,78,.513,34,61,.557,6,17,.353,18,25,.720,104
11502,2014-12-21,WAS,,PHO,L 92-104,240,34,83,.410,31,69,.449,3,14,.214,21,29,.724,92
11503,2014-12-20,CHA,,UTA,W 104-86,240,42,87,.483,33,65,.508,9,22,.409,11,16,.688,104
11504,2014-12-20,UTA,@,CHO,L 86-104,240,33,85,.388,25,54,.463,8,31,.258,12,15,.800,86
11505,2014-12-20,DAL,,SAS,W 99-93,240,37,86,.430,28,60,.467,9,26,.346,16,20,.800,99
11506,2014-12-20,SAS,@,DAL,L 93-99,240,32,77,.416,29,64,.453,3,13,.231,26,26,1.000,93
11507,2014-12-20,DEN,,IND,W 76-73,240,30,82,.366,28,66,.424,2,16,.125,14,19,.737,76
11508,2014-12-20,IND,@,DEN,L 73-76,240,27,88,.307,20,65,.308,7,23,.304,12,17,.706,73
11509,2014-12-20,ATL,@,HOU,W 104-97,240,38,74,.514,28,48,.583,10,26,.385,18,24,.750,104
11510,2014-12-20,HOU,,ATL,L 97-104,240,34,86,.395,19,43,.442,15,43,.349,14,18,.778,97
11511,2014-12-20,LAC,,MIL,W 106-102,240,37,81,.457,25,55,.455,12,26,.462,20,27,.741,106
11512,2014-12-20,MIL,@,LAC,L 102-106,240,43,81,.531,35,57,.614,8,24,.333,8,15,.533,102
11513,2014-12-20,NOP,,POR,L 88-114,240,30,85,.353,27,70,.386,3,15,.200,25,28,.893,88
11514,2014-12-20,POR,@,NOP,W 114-88,240,48,90,.533,39,65,.600,9,25,.360,9,15,.600,114
11515,2014-12-20,NYK,,PHO,L 90-99,240,35,88,.398,28,66,.424,7,22,.318,13,16,.813,90
11516,2014-12-20,PHO,@,NYK,W 99-90,240,35,78,.449,25,53,.472,10,25,.400,19,23,.826,99
11517,2014-12-19,BOS,,MIN,W 114-98,240,48,85,.565,40,62,.645,8,23,.348,10,14,.714,114
11518,2014-12-19,MIN,@,BOS,L 98-114,240,42,93,.452,36,81,.444,6,12,.500,8,16,.500,98
11519,2014-12-19,BRK,@,CLE,L 91-95,240,37,78,.474,28,54,.519,9,24,.375,8,12,.667,91
11520,2014-12-19,CLE,,BRK,W 95-91,240,31,77,.403,22,53,.415,9,24,.375,24,29,.828,95
11521,2014-12-19,DEN,,LAC,W 109-106,240,38,80,.475,27,51,.529,11,29,.379,22,30,.733,109
11522,2014-12-19,LAC,@,DEN,L 106-109,240,39,85,.459,36,67,.537,3,18,.167,25,33,.758,106
11523,2014-12-19,DET,,TOR,L 100-110,240,41,94,.436,33,69,.478,8,25,.320,10,15,.667,100
11524,2014-12-19,TOR,@,DET,W 110-100,240,42,88,.477,34,61,.557,8,27,.296,18,24,.750,110
11525,2014-12-19,LAL,,OKC,L 103-104,240,41,85,.482,31,60,.517,10,25,.400,11,15,.733,103
11526,2014-12-19,OKC,@,LAL,W 104-103,240,37,86,.430,29,65,.446,8,21,.381,22,29,.759,104
11527,2014-12-19,CHI,@,MEM,W 103-97,240,32,73,.438,22,47,.468,10,26,.385,29,33,.879,103
11528,2014-12-19,MEM,,CHI,L 97-103,240,37,94,.394,35,81,.432,2,13,.154,21,24,.875,97
11529,2014-12-19,MIA,,WAS,L 103-105,240,40,75,.533,31,56,.554,9,19,.474,14,19,.737,103
11530,2014-12-19,WAS,@,MIA,W 105-103,240,39,79,.494,36,65,.554,3,14,.214,24,33,.727,105
11531,2014-12-19,ORL,,UTA,L 94-101,240,37,83,.446,25,61,.410,12,22,.545,8,12,.667,94
11532,2014-12-19,UTA,@,ORL,W 101-94,240,39,73,.534,35,62,.565,4,11,.364,19,24,.792,101
11533,2014-12-19,CHA,@,PHI,W 109-91,240,43,98,.439,33,74,.446,10,24,.417,13,17,.765,109
11534,2014-12-19,PHI,,CHO,L 91-109,240,32,71,.451,20,45,.444,12,26,.462,15,17,.882,91
11535,2014-12-19,POR,@,SAS,W 129-119 (3OT),315,47,110,.427,34,75,.453,13,35,.371,22,23,.957,129
11536,2014-12-19,SAS,,POR,L 119-129 (3OT),315,45,109,.413,37,89,.416,8,20,.400,21,26,.808,119
11537,2014-12-18,CHI,,NYK,W 103-97,240,34,75,.453,22,52,.423,12,23,.522,23,30,.767,103
11538,2014-12-18,NYK,@,CHI,L 97-103,240,38,82,.463,32,73,.438,6,9,.667,15,19,.789,97
11539,2014-12-18,GSW,,OKC,W 114-109,240,48,94,.511,36,63,.571,12,31,.387,6,10,.600,114
11540,2014-12-18,OKC,@,GSW,L 109-114,240,41,86,.477,30,61,.492,11,25,.440,16,24,.667,109
11541,2014-12-18,HOU,,NOP,L 90-99,240,33,86,.384,27,61,.443,6,25,.240,18,23,.783,90
11542,2014-12-18,NOP,@,HOU,W 99-90,240,38,82,.463,33,64,.516,5,18,.278,18,22,.818,99
11543,2014-12-18,MIL,@,SAC,W 108-107,240,37,75,.493,24,52,.462,13,23,.565,21,27,.778,108
11544,2014-12-18,SAC,,MIL,L 107-108,240,38,67,.567,32,53,.604,6,14,.429,25,33,.758,107
11545,2014-12-17,BOS,,ORL,W 109-92,240,44,80,.550,37,61,.607,7,19,.368,14,18,.778,109
11546,2014-12-17,ORL,@,BOS,L 92-109,240,37,85,.435,32,66,.485,5,19,.263,13,15,.867,92
11547,2014-12-17,CHA,,PHO,L 106-111,240,40,86,.465,30,62,.484,10,24,.417,16,22,.727,106
11548,2014-12-17,PHO,@,CHO,W 111-106,240,43,82,.524,34,57,.596,9,25,.360,16,21,.762,111
11549,2014-12-17,ATL,@,CLE,W 127-98,240,49,76,.645,33,48,.688,16,28,.571,13,16,.813,127
11550,2014-12-17,CLE,,ATL,L 98-127,240,37,82,.451,29,52,.558,8,30,.267,16,21,.762,98
11551,2014-12-17,DEN,,HOU,L 111-115 (OT),265,40,99,.404,27,69,.391,13,30,.433,18,23,.783,111
11552,2014-12-17,HOU,@,DEN,W 115-111 (OT),265,35,85,.412,27,57,.474,8,28,.286,37,48,.771,115
11553,2014-12-17,DAL,@,DET,W 117-106,240,40,79,.506,30,57,.526,10,22,.455,27,35,.771,117
11554,2014-12-17,DET,,DAL,L 106-117,240,40,89,.449,27,56,.482,13,33,.394,13,19,.684,106
11555,2014-12-17,IND,@,LAC,L 100-102,240,40,90,.444,36,71,.507,4,19,.211,16,23,.696,100
11556,2014-12-17,LAC,,IND,W 102-100,240,34,78,.436,28,60,.467,6,18,.333,28,45,.622,102
11557,2014-12-17,MIA,,UTA,L 87-105,240,27,70,.386,23,53,.434,4,17,.235,29,40,.725,87
11558,2014-12-17,UTA,@,MIA,W 105-87,240,35,66,.530,21,41,.512,14,25,.560,21,24,.875,105
11559,2014-12-17,MIL,@,POR,L 97-104,240,37,77,.481,30,58,.517,7,19,.368,16,22,.727,97
11560,2014-12-17,POR,,MIL,W 104-97,240,41,87,.471,34,64,.531,7,23,.304,15,29,.517,104
11561,2014-12-17,MEM,@,SAS,W 117-116 (3OT),315,48,107,.449,38,80,.475,10,27,.370,11,14,.786,117
11562,2014-12-17,SAS,,MEM,L 116-117 (3OT),315,43,105,.410,26,70,.371,17,35,.486,13,27,.481,116
11563,2014-12-17,BRK,@,TOR,L 89-105,240,35,81,.432,26,54,.481,9,27,.333,10,22,.455,89
11564,2014-12-17,TOR,,BRK,W 105-89,240,41,80,.513,31,60,.517,10,20,.500,13,19,.684,105
11565,2014-12-16,BRK,,MIA,L 91-95,240,30,77,.390,22,49,.449,8,28,.286,23,32,.719,91
11566,2014-12-16,MIA,@,BRK,W 95-91,240,33,72,.458,24,48,.500,9,24,.375,20,26,.769,95
11567,2014-12-16,GSW,@,MEM,L 98-105,240,39,95,.411,30,64,.469,9,31,.290,11,12,.917,98
11568,2014-12-16,MEM,,GSW,W 105-98,240,42,92,.457,37,78,.474,5,14,.357,16,19,.842,105
11569,2014-12-16,NOP,,UTA,W 119-111,240,47,79,.595,39,63,.619,8,16,.500,17,18,.944,119
11570,2014-12-16,UTA,@,NOP,L 111-119,240,45,90,.500,40,75,.533,5,15,.333,16,19,.842,111
11571,2014-12-16,DAL,@,NYK,W 107-87,240,42,83,.506,27,50,.540,15,33,.455,8,8,1.000,107
11572,2014-12-16,NYK,,DAL,L 87-107,240,37,84,.440,32,63,.508,5,21,.238,8,10,.800,87
11573,2014-12-16,OKC,@,SAC,W 104-92,240,41,87,.471,35,67,.522,6,20,.300,16,24,.667,104
11574,2014-12-16,SAC,,OKC,L 92-104,240,36,84,.429,31,66,.470,5,18,.278,15,17,.882,92
11575,2014-12-16,MIN,@,WAS,L 95-109,240,36,81,.444,33,73,.452,3,8,.375,20,35,.571,95
11576,2014-12-16,WAS,,MIN,W 109-95,240,43,86,.500,33,69,.478,10,17,.588,13,18,.722,109
11577,2014-12-15,ATL,,CHI,W 93-86,240,36,83,.434,29,62,.468,7,21,.333,14,17,.824,93
11578,2014-12-15,CHI,@,ATL,L 86-93,240,35,93,.376,29,64,.453,6,29,.207,10,14,.714,86
11579,2014-12-15,CHA,@,CLE,L 88-97,240,38,83,.458,33,67,.493,5,16,.313,7,14,.500,88
11580,2014-12-15,CLE,,CHO,W 97-88,240,38,83,.458,29,59,.492,9,24,.375,12,17,.706,97
11581,2014-12-15,IND,,LAL,W 110-91,240,40,83,.482,33,66,.500,7,17,.412,23,27,.852,110
11582,2014-12-15,LAL,@,IND,L 91-110,240,29,88,.330,19,62,.306,10,26,.385,23,29,.793,91
11583,2014-12-15,DET,@,LAC,L 91-113,240,35,83,.422,27,56,.482,8,27,.296,13,22,.591,91
11584,2014-12-15,LAC,,DET,W 113-91,240,43,80,.538,31,56,.554,12,24,.500,15,20,.750,113
11585,2014-12-15,BOS,@,PHI,W 105-87,240,38,86,.442,32,61,.525,6,25,.240,23,35,.657,105
11586,2014-12-15,PHI,,BOS,L 87-105,240,33,93,.355,29,65,.446,4,28,.143,17,21,.810,87
11587,2014-12-15,MIL,@,PHO,W 96-94,240,35,73,.479,27,57,.474,8,16,.500,18,22,.818,96
11588,2014-12-15,PHO,,MIL,L 94-96,240,30,75,.400,18,37,.486,12,38,.316,22,27,.815,94
11589,2014-12-15,POR,,SAS,W 108-95,240,41,89,.461,34,71,.479,7,18,.389,19,22,.864,108
11590,2014-12-15,SAS,@,POR,L 95-108,240,38,78,.487,34,67,.507,4,11,.364,15,22,.682,95
11591,2014-12-15,ORL,@,TOR,L 82-95,240,36,74,.486,32,59,.542,4,15,.267,6,8,.750,82
11592,2014-12-15,TOR,,ORL,W 95-82,240,37,83,.446,26,53,.491,11,30,.367,10,15,.667,95
11593,2014-12-14,DEN,,SAS,L 91-99,240,34,83,.410,26,67,.388,8,16,.500,15,21,.714,91
11594,2014-12-14,SAS,@,DEN,W 99-91,240,34,74,.459,29,58,.500,5,16,.313,26,35,.743,99
11595,2014-12-14,CHI,@,MIA,W 93-75,240,33,71,.465,24,53,.453,9,18,.500,18,21,.857,93
11596,2014-12-14,MIA,,CHI,L 75-93,240,28,80,.350,24,58,.414,4,22,.182,15,18,.833,75
11597,2014-12-14,LAL,@,MIN,W 100-94,240,34,81,.420,29,64,.453,5,17,.294,27,34,.794,100
11598,2014-12-14,MIN,,LAL,L 94-100,240,38,90,.422,35,80,.438,3,10,.300,15,20,.750,94
11599,2014-12-14,GSW,@,NOP,W 128-122 (OT),265,44,86,.512,33,62,.532,11,24,.458,29,35,.829,128
11600,2014-12-14,NOP,,GSW,L 122-128 (OT),265,47,101,.465,39,74,.527,8,27,.296,20,25,.800,122
11601,2014-12-14,NYK,,TOR,L 90-95 (OT),265,29,78,.372,20,49,.408,9,29,.310,23,28,.821,90
11602,2014-12-14,TOR,@,NYK,W 95-90 (OT),265,36,78,.462,27,54,.500,9,24,.375,14,18,.778,95
11603,2014-12-14,OKC,,PHO,W 112-88,240,39,80,.488,35,62,.565,4,18,.222,30,34,.882,112
11604,2014-12-14,PHO,@,OKC,L 88-112,240,34,99,.343,27,68,.397,7,31,.226,13,18,.722,88
11605,2014-12-14,UTA,@,WAS,L 84-93,240,30,78,.385,25,61,.410,5,17,.294,19,28,.679,84
11606,2014-12-14,WAS,,UTA,W 93-84,240,41,84,.488,37,71,.521,4,13,.308,7,12,.583,93
11607,2014-12-13,BRK,@,CHO,W 114-87,240,42,72,.583,26,49,.531,16,23,.696,14,20,.700,114
11608,2014-12-13,CHA,,BRK,L 87-114,240,31,79,.392,23,57,.404,8,22,.364,17,27,.630,87
11609,2014-12-13,DAL,,GSW,L 98-105,240,36,89,.404,31,64,.484,5,25,.200,21,30,.700,98
11610,2014-12-13,GSW,@,DAL,W 105-98,240,37,83,.446,27,51,.529,10,32,.313,21,27,.778,105
11611,2014-12-13,DEN,@,HOU,L 96-108,240,36,96,.375,29,68,.426,7,28,.250,17,26,.654,96
11612,2014-12-13,HOU,,DEN,W 108-96,240,39,88,.443,29,54,.537,10,34,.294,20,34,.588,108
11613,2014-12-13,IND,,POR,L 85-95,240,34,88,.386,30,73,.411,4,15,.267,13,16,.813,85
11614,2014-12-13,POR,@,IND,W 95-85,240,40,90,.444,35,73,.479,5,17,.294,10,12,.833,95
11615,2014-12-13,LAC,@,MIL,L 106-111,240,39,91,.429,25,62,.403,14,29,.483,14,19,.737,106
11616,2014-12-13,MIL,,LAC,W 111-106,240,43,76,.566,36,65,.554,7,11,.636,18,24,.750,111
11617,2014-12-13,ATL,@,ORL,L 99-100,240,35,84,.417,27,57,.474,8,27,.296,21,24,.875,99
11618,2014-12-13,ORL,,ATL,W 100-99,240,37,74,.500,27,53,.509,10,21,.476,16,21,.762,100
11619,2014-12-13,MEM,@,PHI,W 120-115 (OT),265,45,93,.484,34,67,.507,11,26,.423,19,27,.704,120
11620,2014-12-13,PHI,,MEM,L 115-120 (OT),265,40,82,.488,29,54,.537,11,28,.393,24,34,.706,115
11621,2014-12-13,DET,@,SAC,W 95-90,240,35,79,.443,29,59,.492,6,20,.300,19,23,.826,95
11622,2014-12-13,SAC,,DET,L 90-95,240,33,93,.355,22,64,.344,11,29,.379,13,19,.684,90
11623,2014-12-12,ATL,,ORL,W 87-81,240,29,78,.372,20,49,.408,9,29,.310,20,27,.741,87
11624,2014-12-12,ORL,@,ATL,L 81-87,240,30,77,.390,21,51,.412,9,26,.346,12,16,.750,81
11625,2014-12-12,BOS,,NYK,L 95-101,240,37,85,.435,30,63,.476,7,22,.318,14,18,.778,95
11626,2014-12-12,NYK,@,BOS,W 101-95,240,40,81,.494,34,65,.523,6,16,.375,15,18,.833,101
11627,2014-12-12,BRK,,PHI,W 88-70,240,36,81,.444,31,61,.508,5,20,.250,11,17,.647,88
11628,2014-12-12,PHI,@,BRK,L 70-88,240,22,69,.319,11,41,.268,11,28,.393,15,20,.750,70
11629,2014-12-12,CHI,,POR,W 115-106,240,44,88,.500,39,73,.534,5,15,.333,22,28,.786,115
11630,2014-12-12,POR,@,CHI,L 106-115,240,43,88,.489,31,64,.484,12,24,.500,8,11,.727,106
11631,2014-12-12,CHA,@,MEM,L 107-113 (2OT),290,41,98,.418,35,81,.432,6,17,.353,19,27,.704,107
11632,2014-12-12,MEM,,CHO,W 113-107 (2OT),290,39,85,.459,33,72,.458,6,13,.462,29,38,.763,113
11633,2014-12-12,MIN,,OKC,L 92-111,240,36,78,.462,35,71,.493,1,7,.143,19,29,.655,92
11634,2014-12-12,OKC,@,MIN,W 111-92,240,45,88,.511,39,64,.609,6,24,.250,15,20,.750,111
11635,2014-12-12,CLE,@,NOP,L 114-119,240,44,89,.494,36,67,.537,8,22,.364,18,23,.783,114
11636,2014-12-12,NOP,,CLE,W 119-114,240,44,79,.557,32,51,.627,12,28,.429,19,25,.760,119
11637,2014-12-12,DET,@,PHO,W 105-103,240,40,84,.476,36,69,.522,4,15,.267,21,27,.778,105
11638,2014-12-12,PHO,,DET,L 103-105,240,39,83,.470,29,52,.558,10,31,.323,15,19,.789,103
11639,2014-12-12,LAL,@,SAS,W 112-110 (OT),265,44,96,.458,32,72,.444,12,24,.500,12,15,.800,112
11640,2014-12-12,SAS,,LAL,L 110-112 (OT),265,42,90,.467,30,59,.508,12,31,.387,14,21,.667,110
11641,2014-12-12,IND,@,TOR,L 94-106,240,33,80,.413,25,58,.431,8,22,.364,20,23,.870,94
11642,2014-12-12,TOR,,IND,W 106-94,240,38,91,.418,28,65,.431,10,26,.385,20,22,.909,106
11643,2014-12-12,MIA,@,UTA,W 100-95,240,36,72,.500,29,52,.558,7,20,.350,21,31,.677,100
11644,2014-12-12,UTA,,MIA,L 95-100,240,34,77,.442,26,49,.531,8,28,.286,19,22,.864,95
11645,2014-12-12,LAC,@,WAS,L 96-104,240,32,75,.427,26,55,.473,6,20,.300,26,31,.839,96
11646,2014-12-12,WAS,,LAC,W 104-96,240,39,80,.488,30,64,.469,9,16,.563,17,21,.810,104
11647,2014-12-11,CLE,@,OKC,L 94-103,240,31,85,.365,22,57,.386,9,28,.321,23,30,.767,94
11648,2014-12-11,OKC,,CLE,W 103-94,240,38,87,.437,31,61,.508,7,26,.269,20,22,.909,103
11649,2014-12-11,HOU,@,SAC,W 113-109 (OT),265,38,95,.400,23,51,.451,15,44,.341,22,31,.710,113
11650,2014-12-11,SAC,,HOU,L 109-113 (OT),265,39,84,.464,31,66,.470,8,18,.444,23,34,.676,109
11651,2014-12-10,ATL,,PHI,W 95-79,240,38,91,.418,28,61,.459,10,30,.333,9,13,.692,95
11652,2014-12-10,PHI,@,ATL,L 79-95,240,30,72,.417,24,47,.511,6,25,.240,13,22,.591,79
11653,2014-12-10,BRK,@,CHI,L 80-105,240,29,88,.330,26,74,.351,3,14,.214,19,24,.792,80
11654,2014-12-10,CHI,,BRK,W 105-80,240,37,79,.468,29,57,.509,8,22,.364,23,32,.719,105
11655,2014-12-10,BOS,@,CHO,L 87-96,240,38,87,.437,33,64,.516,5,23,.217,6,10,.600,87
11656,2014-12-10,CHA,,BOS,W 96-87,240,35,84,.417,32,70,.457,3,14,.214,23,29,.793,96
11657,2014-12-10,DAL,,NOP,W 112-107,240,44,83,.530,35,62,.565,9,21,.429,15,17,.882,112
11658,2014-12-10,NOP,@,DAL,L 107-112,240,40,88,.455,33,70,.471,7,18,.389,20,24,.833,107
11659,2014-12-10,DEN,,MIA,W 102-82,240,38,85,.447,30,62,.484,8,23,.348,18,27,.667,102
11660,2014-12-10,MIA,@,DEN,L 82-102,240,30,82,.366,23,60,.383,7,22,.318,15,21,.714,82
11661,2014-12-10,GSW,,HOU,W 105-93,240,40,81,.494,32,58,.552,8,23,.348,17,20,.850,105
11662,2014-12-10,HOU,@,GSW,L 93-105,240,37,90,.411,28,55,.509,9,35,.257,10,15,.667,93
11663,2014-12-10,IND,,LAC,L 96-103,240,35,89,.393,26,62,.419,9,27,.333,17,22,.773,96
11664,2014-12-10,LAC,@,IND,W 103-96,240,42,88,.477,35,64,.547,7,24,.292,12,14,.857,103
11665,2014-12-10,MIN,,POR,W 90-82,240,32,81,.395,31,69,.449,1,12,.083,25,33,.758,90
11666,2014-12-10,POR,@,MIN,L 82-90,240,31,80,.388,21,45,.467,10,35,.286,10,12,.833,82
11667,2014-12-10,ORL,,WAS,L 89-91,240,38,84,.452,31,69,.449,7,15,.467,6,9,.667,89
11668,2014-12-10,WAS,@,ORL,W 91-89,240,41,81,.506,36,69,.522,5,12,.417,4,9,.444,91
11669,2014-12-10,NYK,@,SAS,L 95-109,240,37,76,.487,31,61,.508,6,15,.400,15,17,.882,95
11670,2014-12-10,SAS,,NYK,W 109-95,240,37,73,.507,27,54,.500,10,19,.526,25,30,.833,109
11671,2014-12-09,CLE,,TOR,W 105-101,240,39,79,.494,30,53,.566,9,26,.346,18,21,.857,105
11672,2014-12-09,TOR,@,CLE,L 101-105,240,42,82,.512,35,59,.593,7,23,.304,10,10,1.000,101
11673,2014-12-09,DET,,POR,L 86-98,240,34,97,.351,29,75,.387,5,22,.227,13,16,.813,86
11674,2014-12-09,POR,@,DET,W 98-86,240,41,84,.488,32,63,.508,9,21,.429,7,8,.875,98
11675,2014-12-09,LAL,,SAC,W 98-95,240,38,96,.396,33,71,.465,5,25,.200,17,25,.680,98
11676,2014-12-09,SAC,@,LAL,L 95-98,240,32,70,.457,25,55,.455,7,15,.467,24,37,.649,95
11677,2014-12-09,DAL,@,MEM,L 105-114,240,38,85,.447,20,45,.444,18,40,.450,11,14,.786,105
11678,2014-12-09,MEM,,DAL,W 114-105,240,41,85,.482,34,71,.479,7,14,.500,25,29,.862,114
11679,2014-12-09,NOP,,NYK,W 104-93,240,40,80,.500,36,65,.554,4,15,.267,20,26,.769,104
11680,2014-12-09,NYK,@,NOP,L 93-104,240,37,78,.474,28,59,.475,9,19,.474,10,13,.769,93
11681,2014-12-09,MIL,@,OKC,L 101-114,240,34,84,.405,30,63,.476,4,21,.190,29,35,.829,101
11682,2014-12-09,OKC,,MIL,W 114-101,240,41,82,.500,37,61,.607,4,21,.190,28,34,.824,114
11683,2014-12-09,MIA,@,PHO,W 103-97,240,43,80,.538,34,63,.540,9,17,.529,8,12,.667,103
11684,2014-12-09,PHO,,MIA,L 97-103,240,37,77,.481,20,42,.476,17,35,.486,6,9,.667,97
11685,2014-12-09,SAS,@,UTA,L 96-100,240,39,84,.464,35,64,.547,4,20,.200,14,23,.609,96
11686,2014-12-09,UTA,,SAS,W 100-96,240,40,80,.500,36,66,.545,4,14,.286,16,22,.727,100
11687,2014-12-08,BRK,,CLE,L 88-110,240,36,81,.444,32,62,.516,4,19,.211,12,19,.632,88
11688,2014-12-08,CLE,@,BRK,W 110-88,240,43,90,.478,34,65,.523,9,25,.360,15,22,.682,110
11689,2014-12-08,ATL,@,IND,W 108-92,240,40,77,.519,31,56,.554,9,21,.429,19,27,.704,108
11690,2014-12-08,IND,,ATL,L 92-108,240,37,84,.440,28,57,.491,9,27,.333,9,17,.529,92
11691,2014-12-08,LAC,,PHO,W 121-120 (OT),265,44,96,.458,35,65,.538,9,31,.290,24,30,.800,121
11692,2014-12-08,PHO,@,LAC,L 120-121 (OT),265,44,91,.484,28,54,.519,16,37,.432,16,20,.800,120
11693,2014-12-08,GSW,@,MIN,W 102-86,240,42,91,.462,37,69,.536,5,22,.227,13,14,.929,102
11694,2014-12-08,MIN,,GSW,L 86-102,240,32,88,.364,30,77,.390,2,11,.182,20,29,.690,86
11695,2014-12-08,SAC,,UTA,W 101-92,240,35,74,.473,32,66,.485,3,8,.375,28,36,.778,101
11696,2014-12-08,UTA,@,SAC,L 92-101,240,32,79,.405,29,62,.468,3,17,.176,25,37,.676,92
11697,2014-12-08,DEN,@,TOR,L 107-112 (OT),265,43,104,.413,33,74,.446,10,30,.333,11,15,.733,107
11698,2014-12-08,TOR,,DEN,W 112-107 (OT),265,41,81,.506,32,48,.667,9,33,.273,21,29,.724,112
11699,2014-12-08,BOS,@,WAS,L 132-133 (2OT),290,47,102,.461,38,80,.475,9,22,.409,29,32,.906,132
11700,2014-12-08,WAS,,BOS,W 133-132 (2OT),290,49,94,.521,42,78,.538,7,16,.438,28,34,.824,133
11701,2014-12-07,ATL,,DEN,W 96-84,240,36,87,.414,26,60,.433,10,27,.370,14,19,.737,96
11702,2014-12-07,DEN,@,ATL,L 84-96,240,34,93,.366,28,58,.483,6,35,.171,10,13,.769,84
11703,2014-12-07,BOS,,WAS,W 101-93,240,36,88,.409,28,71,.394,8,17,.471,21,26,.808,101
11704,2014-12-07,WAS,@,BOS,L 93-101,240,34,93,.366,23,66,.348,11,27,.407,14,21,.667,93
11705,2014-12-07,DAL,,MIL,W 125-102,240,49,84,.583,37,53,.698,12,31,.387,15,19,.789,125
11706,2014-12-07,MIL,@,DAL,L 102-125,240,42,84,.500,38,69,.551,4,15,.267,14,17,.824,102
11707,2014-12-07,DET,,OKC,L 94-96,240,34,76,.447,27,53,.509,7,23,.304,19,28,.679,94
11708,2014-12-07,OKC,@,DET,W 96-94,240,39,87,.448,33,66,.500,6,21,.286,12,17,.706,96
11709,2014-12-07,LAL,,NOP,L 87-104,240,36,90,.400,31,71,.437,5,19,.263,10,15,.667,87
11710,2014-12-07,NOP,@,LAL,W 104-87,240,43,83,.518,35,65,.538,8,18,.444,10,15,.667,104
11711,2014-12-07,MEM,,MIA,W 103-87,240,43,73,.589,35,60,.583,8,13,.615,9,11,.818,103
11712,2014-12-07,MIA,@,MEM,L 87-103,240,39,80,.488,34,64,.531,5,16,.313,4,8,.500,87
11713,2014-12-07,NYK,,POR,L 99-103,240,41,79,.519,36,60,.600,5,19,.263,12,14,.857,99
11714,2014-12-07,POR,@,NYK,W 103-99,240,36,85,.424,26,57,.456,10,28,.357,21,29,.724,103
11715,2014-12-06,CHI,,GSW,L 102-112,240,36,83,.434,29,62,.468,7,21,.333,23,27,.852,102
11716,2014-12-06,GSW,@,CHI,W 112-102,240,40,89,.449,28,59,.475,12,30,.400,20,25,.800,112
11717,2014-12-06,DET,,PHI,L 101-108 (OT),265,34,87,.391,28,64,.438,6,23,.261,27,35,.771,101
11718,2014-12-06,PHI,@,DET,W 108-101 (OT),265,40,87,.460,33,64,.516,7,23,.304,21,30,.700,108
11719,2014-12-06,HOU,,PHO,W 100-95,240,33,81,.407,22,54,.407,11,27,.407,23,31,.742,100
11720,2014-12-06,PHO,@,HOU,L 95-100,240,34,93,.366,27,65,.415,7,28,.250,20,26,.769,95
11721,2014-12-06,LAC,,NOP,W 120-100,240,43,78,.551,26,46,.565,17,32,.531,17,24,.708,120
11722,2014-12-06,NOP,@,LAC,L 100-120,240,38,80,.475,30,57,.526,8,23,.348,16,25,.640,100
11723,2014-12-06,ORL,@,SAC,W 105-96,240,42,83,.506,33,57,.579,9,26,.346,12,14,.857,105
11724,2014-12-06,SAC,,ORL,L 96-105,240,35,79,.443,31,64,.484,4,15,.267,22,28,.786,96
11725,2014-12-06,MIN,@,SAS,L 101-123,240,35,83,.422,29,67,.433,6,16,.375,25,32,.781,101
11726,2014-12-06,SAS,,MIN,W 123-101,240,47,82,.573,40,64,.625,7,18,.389,22,25,.880,123
11727,2014-12-05,BOS,,LAL,W 113-96,240,46,90,.511,38,70,.543,8,20,.400,13,22,.591,113
11728,2014-12-05,LAL,@,BOS,L 96-113,240,38,92,.413,32,76,.421,6,16,.375,14,19,.737,96
11729,2014-12-05,ATL,@,BRK,W 98-75,240,35,81,.432,22,47,.468,13,34,.382,15,24,.625,98
11730,2014-12-05,BRK,,ATL,L 75-98,240,30,80,.375,27,62,.435,3,18,.167,12,19,.632,75
11731,2014-12-05,CHA,,NYK,W 103-102,240,42,88,.477,38,70,.543,4,18,.222,15,18,.833,103
11732,2014-12-05,NYK,@,CHO,L 102-103,240,37,79,.468,27,57,.474,10,22,.455,18,22,.818,102
11733,2014-12-05,DAL,,PHO,L 106-118,240,40,88,.455,36,69,.522,4,19,.211,22,30,.733,106
11734,2014-12-05,PHO,@,DAL,W 118-106,240,45,80,.563,32,54,.593,13,26,.500,15,17,.882,118
11735,2014-12-05,MEM,,SAS,L 101-107,240,37,80,.463,32,68,.471,5,12,.417,22,26,.846,101
11736,2014-12-05,SAS,@,MEM,W 107-101,240,40,84,.476,26,59,.441,14,25,.560,13,16,.813,107
11737,2014-12-05,MIA,@,MIL,L 85-109,240,30,68,.441,23,50,.460,7,18,.389,18,27,.667,85
11738,2014-12-05,MIL,,MIA,W 109-85,240,39,69,.565,30,53,.566,9,16,.563,22,26,.846,109
11739,2014-12-05,HOU,@,MIN,W 114-112 (OT),265,38,78,.487,26,46,.565,12,32,.375,26,31,.839,114
11740,2014-12-05,MIN,,HOU,L 112-114 (OT),265,45,97,.464,42,87,.483,3,10,.300,19,27,.704,112
11741,2014-12-05,OKC,@,PHI,W 103-91,240,35,71,.493,26,48,.542,9,23,.391,24,31,.774,103
11742,2014-12-05,PHI,,OKC,L 91-103,240,32,84,.381,24,56,.429,8,28,.286,19,30,.633,91
11743,2014-12-05,IND,@,SAC,L 101-102 (OT),265,36,96,.375,30,70,.429,6,26,.231,23,29,.793,101
11744,2014-12-05,SAC,,IND,W 102-101 (OT),265,36,83,.434,34,73,.466,2,10,.200,28,40,.700,102
11745,2014-12-05,CLE,@,TOR,W 105-91,240,41,84,.488,32,64,.500,9,20,.450,14,21,.667,105
11746,2014-12-05,TOR,,CLE,L 91-105,240,35,86,.407,27,62,.435,8,24,.333,13,20,.650,91
11747,2014-12-05,ORL,@,UTA,W 98-93,240,37,74,.500,30,57,.526,7,17,.412,17,20,.850,98
11748,2014-12-05,UTA,,ORL,L 93-98,240,36,79,.456,28,63,.444,8,16,.500,13,21,.619,93
11749,2014-12-05,DEN,@,WAS,L 89-119,240,31,82,.378,26,60,.433,5,22,.227,22,30,.733,89
11750,2014-12-05,WAS,,DEN,W 119-89,240,45,85,.529,38,65,.585,7,20,.350,22,27,.815,119
11751,2014-12-04,GSW,,NOP,W 112-85,240,47,100,.470,37,78,.474,10,22,.455,8,17,.471,112
11752,2014-12-04,NOP,@,GSW,L 85-112,240,37,89,.416,34,74,.459,3,15,.200,8,13,.615,85
11753,2014-12-04,CLE,@,NYK,W 90-87,240,32,70,.457,27,52,.519,5,18,.278,21,26,.808,90
11754,2014-12-04,NYK,,CLE,L 87-90,240,37,88,.420,29,62,.468,8,26,.308,5,6,.833,87
11755,2014-12-04,IND,@,POR,L 82-88,240,36,91,.396,31,73,.425,5,18,.278,5,8,.625,82
11756,2014-12-04,POR,,IND,W 88-82,240,33,83,.398,29,62,.468,4,21,.190,18,23,.783,88
11757,2014-12-03,BOS,,DET,W 109-102 (OT),265,37,93,.398,24,63,.381,13,30,.433,22,27,.815,109
11758,2014-12-03,DET,@,BOS,L 102-109 (OT),265,37,102,.363,29,75,.387,8,27,.296,20,29,.690,102
11759,2014-12-03,BRK,,SAS,W 95-93 (OT),265,37,90,.411,28,71,.394,9,19,.474,12,18,.667,95
11760,2014-12-03,SAS,@,BRK,L 93-95 (OT),265,36,101,.356,24,69,.348,12,32,.375,9,12,.750,93
11761,2014-12-03,CHI,@,CHO,W 102-95,240,37,80,.463,25,52,.481,12,28,.429,16,21,.762,102
11762,2014-12-03,CHA,,CHI,L 95-102,240,36,90,.400,34,75,.453,2,15,.133,21,23,.913,95
11763,2014-12-03,HOU,,MEM,W 105-96,240,41,93,.441,31,65,.477,10,28,.357,13,20,.650,105
11764,2014-12-03,MEM,@,HOU,L 96-105,240,39,76,.513,37,63,.587,2,13,.154,16,27,.593,96
11765,2014-12-03,LAC,,ORL,W 114-86,240,42,78,.538,30,47,.638,12,31,.387,18,25,.720,114
11766,2014-12-03,ORL,@,LAC,L 86-114,240,33,79,.418,26,59,.441,7,20,.350,13,25,.520,86
11767,2014-12-03,ATL,@,MIA,W 112-102,240,40,74,.541,28,49,.571,12,25,.480,20,23,.870,112
11768,2014-12-03,MIA,,ATL,L 102-112,240,36,64,.563,30,48,.625,6,16,.375,24,32,.750,102
11769,2014-12-03,DAL,@,MIL,W 107-105,240,42,92,.457,34,65,.523,8,27,.296,15,22,.682,107
11770,2014-12-03,MIL,,DAL,L 105-107,240,38,73,.521,31,62,.500,7,11,.636,22,32,.688,105
11771,2014-12-03,MIN,,PHI,L 77-85,240,30,84,.357,27,67,.403,3,17,.176,14,17,.824,77
11772,2014-12-03,PHI,@,MIN,W 85-77,240,32,82,.390,27,58,.466,5,24,.208,16,25,.640,85
11773,2014-12-03,TOR,@,UTA,W 123-104,240,45,79,.570,33,58,.569,12,21,.571,21,24,.875,123
11774,2014-12-03,UTA,,TOR,L 104-123,240,42,87,.483,34,59,.576,8,28,.286,12,15,.800,104
11775,2014-12-03,LAL,@,WAS,L 95-111,240,33,85,.388,21,56,.375,12,29,.414,17,21,.810,95
11776,2014-12-03,WAS,,LAL,W 111-95,240,45,93,.484,39,74,.527,6,19,.316,15,19,.789,111
11777,2014-12-02,ATL,,BOS,W 109-105,240,43,82,.524,32,58,.552,11,24,.458,12,14,.857,109
11778,2014-12-02,BOS,@,ATL,L 105-109,240,41,84,.488,29,61,.475,12,23,.522,11,13,.846,105
11779,2014-12-02,CHI,,DAL,L 129-132 (2OT),290,47,103,.456,39,77,.506,8,26,.308,27,34,.794,129
11780,2014-12-02,DAL,@,CHI,W 132-129 (2OT),290,47,102,.461,32,72,.444,15,30,.500,23,27,.852,132
11781,2014-12-02,CLE,,MIL,W 111-108,240,39,73,.534,33,52,.635,6,21,.286,27,38,.711,111
11782,2014-12-02,MIL,@,CLE,L 108-111,240,45,92,.489,38,72,.528,7,20,.350,11,13,.846,108
11783,2014-12-02,DEN,,POR,L 103-105,240,41,81,.506,34,61,.557,7,20,.350,14,19,.737,103
11784,2014-12-02,POR,@,DEN,W 105-103,240,43,86,.500,38,64,.594,5,22,.227,14,17,.824,105
11785,2014-12-02,DET,,LAL,L 96-106,240,33,90,.367,27,69,.391,6,21,.286,24,31,.774,96
11786,2014-12-02,LAL,@,DET,W 106-96,240,39,81,.481,29,64,.453,10,17,.588,18,24,.750,106
11787,2014-12-02,GSW,,ORL,W 98-97,240,38,82,.463,30,55,.545,8,27,.296,14,18,.778,98
11788,2014-12-02,ORL,@,GSW,L 97-98,240,39,87,.448,33,70,.471,6,17,.353,13,14,.929,97
11789,2014-12-02,NOP,,OKC,W 112-104,240,39,88,.443,34,71,.479,5,17,.294,29,45,.644,112
11790,2014-12-02,OKC,@,NOP,L 104-112,240,37,84,.440,30,60,.500,7,24,.292,23,27,.852,104
11791,2014-12-02,BRK,@,NYK,W 98-93,240,39,89,.438,33,72,.458,6,17,.353,14,20,.700,98
11792,2014-12-02,NYK,,BRK,L 93-98,240,35,81,.432,24,53,.453,11,28,.393,12,14,.857,93
11793,2014-12-02,IND,@,PHO,L 99-116,240,41,85,.482,37,72,.514,4,13,.308,13,17,.765,99
11794,2014-12-02,PHO,,IND,W 116-99,240,43,86,.500,31,61,.508,12,25,.480,18,26,.692,116
11795,2014-12-02,SAC,,TOR,L 109-117,240,39,75,.520,36,65,.554,3,10,.300,28,37,.757,109
11796,2014-12-02,TOR,@,SAC,W 117-109,240,44,88,.500,34,65,.523,10,23,.435,19,21,.905,117
11797,2014-12-01,LAC,,MIN,W 127-101,240,41,80,.513,26,46,.565,15,34,.441,30,36,.833,127
11798,2014-12-01,MIN,@,LAC,L 101-127,240,35,82,.427,33,70,.471,2,12,.167,29,40,.725,101
11799,2014-12-01,PHI,,SAS,L 103-109,240,38,89,.427,26,60,.433,12,29,.414,15,25,.600,103
11800,2014-12-01,SAS,@,PHI,W 109-103,240,36,83,.434,27,57,.474,9,26,.346,28,35,.800,109
11801,2014-12-01,DEN,@,UTA,W 103-101,240,41,87,.471,32,61,.525,9,26,.346,12,17,.706,103
11802,2014-12-01,UTA,,DEN,L 101-103,240,36,84,.429,29,66,.439,7,18,.389,22,30,.733,101
11803,2014-12-01,MIA,@,WAS,L 86-107,240,33,72,.458,31,50,.620,2,22,.091,18,30,.600,86
11804,2014-12-01,WAS,,MIA,W 107-86,240,39,72,.542,29,53,.547,10,19,.526,19,24,.792,107
11805,2014-11-30,BOS,,SAS,L 89-111,240,36,87,.414,30,69,.435,6,18,.333,11,15,.733,89
11806,2014-11-30,SAS,@,BOS,W 111-89,240,41,85,.482,30,59,.508,11,26,.423,18,20,.900,111
11807,2014-11-30,BRK,,CHI,L 84-102,240,32,86,.372,30,72,.417,2,14,.143,18,24,.750,84
11808,2014-11-30,CHI,@,BRK,W 102-84,240,34,69,.493,27,45,.600,7,24,.292,27,34,.794,102
11809,2014-11-30,DET,,GSW,L 93-104,240,33,91,.363,22,68,.324,11,23,.478,16,24,.667,93
11810,2014-11-30,GSW,@,DET,W 104-93,240,37,79,.468,28,58,.483,9,21,.429,21,27,.778,104
11811,2014-11-30,LAL,,TOR,W 129-122 (OT),265,47,96,.490,37,72,.514,10,24,.417,25,34,.735,129
11812,2014-11-30,TOR,@,LAL,L 122-129 (OT),265,45,104,.433,36,70,.514,9,34,.265,23,31,.742,122
11813,2014-11-30,MIA,@,NYK,W 86-79,240,30,72,.417,23,49,.469,7,23,.304,19,31,.613,86
11814,2014-11-30,NYK,,MIA,L 79-86,240,31,88,.352,28,64,.438,3,24,.125,14,20,.700,79
11815,2014-11-30,ORL,@,PHO,W 93-90,240,35,76,.461,30,61,.492,5,15,.333,18,25,.720,93
11816,2014-11-30,PHO,,ORL,L 90-93,240,34,85,.400,27,59,.458,7,26,.269,15,18,.833,90
11817,2014-11-30,MIN,@,POR,L 93-107,240,39,90,.433,37,81,.457,2,9,.222,13,20,.650,93
11818,2014-11-30,POR,,MIN,W 107-93,240,39,86,.453,27,53,.509,12,33,.364,17,25,.680,107
11819,2014-11-30,MEM,@,SAC,W 97-85,240,38,79,.481,35,66,.530,3,13,.231,18,28,.643,97
11820,2014-11-30,SAC,,MEM,L 85-97,240,33,70,.471,32,59,.542,1,11,.091,18,27,.667,85
11821,2014-11-29,ATL,,CHO,W 105-75,240,40,75,.533,28,52,.538,12,23,.522,13,16,.813,105
11822,2014-11-29,CHA,@,ATL,L 75-105,240,29,88,.330,24,65,.369,5,23,.217,12,16,.750,75
11823,2014-11-29,CLE,,IND,W 109-97,240,41,78,.526,34,62,.548,7,16,.438,20,32,.625,109
11824,2014-11-29,IND,@,CLE,L 97-109,240,35,89,.393,28,67,.418,7,22,.318,20,26,.769,97
11825,2014-11-29,HOU,@,MIL,W 117-103,240,44,87,.506,29,49,.592,15,38,.395,14,16,.875,117
11826,2014-11-29,MIL,,HOU,L 103-117,240,33,74,.446,27,55,.491,6,19,.316,31,35,.886,103
11827,2014-11-29,DAL,@,PHI,W 110-103,240,40,89,.449,32,59,.542,8,30,.267,22,30,.733,110
11828,2014-11-29,PHI,,DAL,L 103-110,240,36,85,.424,30,64,.469,6,21,.286,25,31,.806,103
11829,2014-11-29,LAC,@,UTA,W 112-96,240,45,80,.563,34,52,.654,11,28,.393,11,15,.733,112
11830,2014-11-29,UTA,,LAC,L 96-112,240,34,75,.453,27,54,.500,7,21,.333,21,33,.636,96
11831,2014-11-29,NOP,@,WAS,L 80-83,240,30,81,.370,24,64,.375,6,17,.353,14,21,.667,80
11832,2014-11-29,WAS,,NOP,W 83-80,240,35,76,.461,30,64,.469,5,12,.417,8,12,.667,83
11833,2014-11-28,ATL,,NOP,W 100-91,240,38,76,.500,33,59,.559,5,17,.294,19,22,.864,100
11834,2014-11-28,NOP,@,ATL,L 91-100,240,36,89,.404,29,65,.446,7,24,.292,12,16,.750,91
11835,2014-11-28,BOS,,CHI,L 102-109,240,37,92,.402,31,70,.443,6,22,.273,22,29,.759,102
11836,2014-11-28,CHI,@,BOS,W 109-102,240,37,90,.411,32,73,.438,5,17,.294,30,37,.811,109
11837,2014-11-28,CHA,,GSW,L 101-106,240,38,87,.437,32,68,.471,6,19,.316,19,23,.826,101
11838,2014-11-28,GSW,@,CHO,W 106-101,240,42,99,.424,35,73,.479,7,26,.269,15,16,.938,106
11839,2014-11-28,DEN,,PHO,W 122-97,240,41,88,.466,33,67,.493,8,21,.381,32,36,.889,122
11840,2014-11-28,PHO,@,DEN,L 97-122,240,33,85,.388,25,62,.403,8,23,.348,23,29,.793,97
11841,2014-11-28,DET,,MIL,L 88-104,240,34,83,.410,28,60,.467,6,23,.261,14,25,.560,88
11842,2014-11-28,MIL,@,DET,W 104-88,240,39,77,.506,26,48,.542,13,29,.448,13,16,.813,104
11843,2014-11-28,HOU,,LAC,L 85-102,240,32,82,.390,22,45,.489,10,37,.270,11,15,.733,85
11844,2014-11-28,LAC,@,HOU,W 102-85,240,38,81,.469,29,56,.518,9,25,.360,17,22,.773,102
11845,2014-11-28,IND,,ORL,W 98-83,240,41,94,.436,37,78,.474,4,16,.250,12,14,.857,98
11846,2014-11-28,ORL,@,IND,L 83-98,240,31,70,.443,24,52,.462,7,18,.389,14,16,.875,83
11847,2014-11-28,LAL,,MIN,L 119-120,240,48,89,.539,40,68,.588,8,21,.381,15,22,.682,119
11848,2014-11-28,MIN,@,LAL,W 120-119,240,45,79,.570,35,61,.574,10,18,.556,20,24,.833,120
11849,2014-11-28,NYK,@,OKC,L 78-105,240,29,75,.387,27,56,.482,2,19,.105,18,24,.750,78
11850,2014-11-28,OKC,,NYK,W 105-78,240,38,86,.442,28,62,.452,10,24,.417,19,23,.826,105
11851,2014-11-28,MEM,@,POR,W 112-99,240,45,84,.536,39,71,.549,6,13,.462,16,26,.615,112
11852,2014-11-28,POR,,MEM,L 99-112,240,39,97,.402,31,69,.449,8,28,.286,13,18,.722,99
11853,2014-11-28,SAC,@,SAS,L 104-112,240,38,75,.507,32,65,.492,6,10,.600,22,26,.846,104
11854,2014-11-28,SAS,,SAC,W 112-104,240,42,82,.512,30,58,.517,12,24,.500,16,20,.800,112
11855,2014-11-28,DAL,@,TOR,W 106-102,240,40,86,.465,29,60,.483,11,26,.423,15,22,.682,106
11856,2014-11-28,TOR,,DAL,L 102-106,240,38,91,.418,24,58,.414,14,33,.424,12,16,.750,102
11857,2014-11-26,ATL,,TOR,L 115-126,240,42,82,.512,32,58,.552,10,24,.417,21,24,.875,115
11858,2014-11-26,TOR,@,ATL,W 126-115,240,42,82,.512,28,53,.528,14,29,.483,28,33,.848,126
11859,2014-11-26,CHA,,POR,L 97-105,240,41,94,.436,36,79,.456,5,15,.333,10,15,.667,97
11860,2014-11-26,POR,@,CHO,W 105-97,240,39,92,.424,27,65,.415,12,27,.444,15,20,.750,105
11861,2014-11-26,CLE,,WAS,W 113-87,240,38,74,.514,32,54,.593,6,20,.300,31,38,.816,113
11862,2014-11-26,WAS,@,CLE,L 87-113,240,33,71,.465,28,58,.483,5,13,.385,16,22,.727,87
11863,2014-11-26,DAL,,NYK,W 109-102 (OT),265,38,95,.400,34,64,.531,4,31,.129,29,38,.763,109
11864,2014-11-26,NYK,@,DAL,L 102-109 (OT),265,39,92,.424,25,64,.391,14,28,.500,10,16,.625,102
11865,2014-11-26,DET,,LAC,L 98-104,240,35,78,.449,25,51,.490,10,27,.370,18,24,.750,98
11866,2014-11-26,LAC,@,DET,W 104-98,240,37,78,.474,25,50,.500,12,28,.429,18,19,.947,104
11867,2014-11-26,HOU,,SAC,W 102-89,240,42,94,.447,30,59,.508,12,35,.343,6,15,.400,102
11868,2014-11-26,SAC,@,HOU,L 89-102,240,31,71,.437,26,55,.473,5,16,.313,22,28,.786,89
11869,2014-11-26,LAL,,MEM,L 93-99,240,33,81,.407,25,62,.403,8,19,.421,19,24,.792,93
11870,2014-11-26,MEM,@,LAL,W 99-93,240,36,80,.450,31,58,.534,5,22,.227,22,25,.880,99
11871,2014-11-26,MIL,@,MIN,W 103-86,240,40,85,.471,35,69,.507,5,16,.313,18,19,.947,103
11872,2014-11-26,MIN,,MIL,L 86-103,240,31,81,.383,28,67,.418,3,14,.214,21,34,.618,86
11873,2014-11-26,OKC,,UTA,W 97-82,240,40,83,.482,28,57,.491,12,26,.462,5,10,.500,97
11874,2014-11-26,UTA,@,OKC,L 82-97,240,31,70,.443,28,54,.519,3,16,.188,17,28,.607,82
11875,2014-11-26,GSW,@,ORL,W 111-96,240,44,85,.518,32,59,.542,12,26,.462,11,19,.579,111
11876,2014-11-26,ORL,,GSW,L 96-111,240,36,87,.414,30,67,.448,6,20,.300,18,24,.750,96
11877,2014-11-26,BRK,@,PHI,W 99-91,240,35,71,.493,27,47,.574,8,24,.333,21,28,.750,99
11878,2014-11-26,PHI,,BRK,L 91-99,240,34,85,.400,25,61,.410,9,24,.375,14,17,.824,91
11879,2014-11-26,DEN,@,PHO,L 112-120,240,39,90,.433,31,65,.477,8,25,.320,26,34,.765,112
11880,2014-11-26,PHO,,DEN,W 120-112,240,45,88,.511,32,63,.508,13,25,.520,17,21,.810,120
11881,2014-11-26,IND,@,SAS,L 100-106,240,40,87,.460,30,66,.455,10,21,.476,10,18,.556,100
11882,2014-11-26,SAS,,IND,W 106-100,240,41,74,.554,36,59,.610,5,15,.333,19,29,.655,106
11883,2014-11-25,CHI,@,DEN,L 109-114,240,35,82,.427,28,61,.459,7,21,.333,32,37,.865,109
11884,2014-11-25,DEN,,CHI,W 114-109,240,43,85,.506,35,69,.507,8,16,.500,20,27,.741,114
11885,2014-11-25,GSW,@,MIA,W 114-97,240,43,75,.573,30,47,.638,13,28,.464,15,23,.652,114
11886,2014-11-25,MIA,,GSW,L 97-114,240,33,85,.388,23,62,.371,10,23,.435,21,27,.778,97
11887,2014-11-25,DET,@,MIL,L 86-98,240,36,78,.462,29,58,.500,7,20,.350,7,17,.412,86
11888,2014-11-25,MIL,,DET,W 98-86,240,39,90,.433,29,68,.426,10,22,.455,10,13,.769,98
11889,2014-11-25,NOP,,SAC,L 89-99,240,33,79,.418,30,62,.484,3,17,.176,20,29,.690,89
11890,2014-11-25,SAC,@,NOP,W 99-89,240,37,77,.481,32,63,.508,5,14,.357,20,24,.833,99
11891,2014-11-25,ATL,@,WAS,W 106-102,240,36,85,.424,29,60,.483,7,25,.280,27,34,.794,106
11892,2014-11-25,WAS,,ATL,L 102-106,240,36,84,.429,27,64,.422,9,20,.450,21,29,.724,102
11893,2014-11-24,CHA,,LAC,L 92-113,240,31,75,.413,29,55,.527,2,20,.100,28,35,.800,92
11894,2014-11-24,LAC,@,CHO,W 113-92,240,45,88,.511,30,56,.536,15,32,.469,8,10,.800,113
11895,2014-11-24,CLE,,ORL,W 106-74,240,42,81,.519,36,65,.554,6,16,.375,16,22,.727,106
11896,2014-11-24,ORL,@,CLE,L 74-106,240,29,80,.363,24,63,.381,5,17,.294,11,15,.733,74
11897,2014-11-24,DAL,,IND,L 100-111,240,40,80,.500,32,56,.571,8,24,.333,12,21,.571,100
11898,2014-11-24,IND,@,DAL,W 111-100,240,37,77,.481,24,51,.471,13,26,.500,24,36,.667,111
11899,2014-11-24,HOU,,NYK,W 91-86,240,32,76,.421,18,40,.450,14,36,.389,13,19,.684,91
11900,2014-11-24,NYK,@,HOU,L 86-91,240,35,76,.461,29,54,.537,6,22,.273,10,15,.667,86
11901,2014-11-24,PHI,,POR,L 104-114,240,42,84,.500,42,76,.553,0,8,.000,20,24,.833,104
11902,2014-11-24,POR,@,PHI,W 114-104,240,44,89,.494,37,62,.597,7,27,.259,19,23,.826,114
11903,2014-11-24,PHO,@,TOR,L 100-104,240,39,84,.464,25,51,.490,14,33,.424,8,11,.727,100
11904,2014-11-24,TOR,,PHO,W 104-100,240,37,82,.451,33,65,.508,4,17,.235,26,32,.813,104
11905,2014-11-24,CHI,@,UTA,W 97-95,240,36,72,.500,27,52,.519,9,20,.450,16,23,.696,97
11906,2014-11-24,UTA,,CHI,L 95-97,240,42,86,.488,39,77,.506,3,9,.333,8,10,.800,95
11907,2014-11-23,BOS,,POR,L 88-94,240,37,95,.389,32,72,.444,5,23,.217,9,12,.750,88
11908,2014-11-23,POR,@,BOS,W 94-88,240,37,86,.430,30,67,.448,7,19,.368,13,15,.867,94
11909,2014-11-23,DEN,@,LAL,W 101-94 (OT),265,34,90,.378,24,53,.453,10,37,.270,23,38,.605,101
11910,2014-11-23,LAL,,DEN,L 94-101 (OT),265,33,89,.371,30,65,.462,3,24,.125,25,34,.735,94
11911,2014-11-23,LAC,@,MEM,L 91-107,240,32,77,.416,25,52,.481,7,25,.280,20,28,.714,91
11912,2014-11-23,MEM,,LAC,W 107-91,240,42,85,.494,35,64,.547,7,21,.333,16,23,.696,107
11913,2014-11-23,CHA,@,MIA,L 93-94,240,37,79,.468,30,58,.517,7,21,.333,12,16,.750,93
11914,2014-11-23,MIA,,CHO,W 94-93,240,33,66,.500,22,43,.512,11,23,.478,17,19,.895,94
11915,2014-11-23,GSW,@,OKC,W 91-86,240,33,93,.355,26,68,.382,7,25,.280,18,24,.750,91
11916,2014-11-23,OKC,,GSW,L 86-91,240,32,90,.356,29,73,.397,3,17,.176,19,27,.704,86
11917,2014-11-22,CLE,,TOR,L 93-110,240,35,81,.432,32,65,.492,3,16,.188,20,29,.690,93
11918,2014-11-22,TOR,@,CLE,W 110-93,240,32,80,.400,24,56,.429,8,24,.333,38,42,.905,110
11919,2014-11-22,DAL,@,HOU,L 92-95,240,35,88,.398,29,53,.547,6,35,.171,16,22,.727,92
11920,2014-11-22,HOU,,DAL,W 95-92,240,30,82,.366,15,36,.417,15,46,.326,20,23,.870,95
11921,2014-11-22,IND,,PHO,L 83-106,240,31,84,.369,24,61,.393,7,23,.304,14,20,.700,83
11922,2014-11-22,PHO,@,IND,W 106-83,240,38,85,.447,26,54,.481,12,31,.387,18,20,.900,106
11923,2014-11-22,MIL,,WAS,L 100-111,240,36,84,.429,31,69,.449,5,15,.333,23,26,.885,100
11924,2014-11-22,WAS,@,MIL,W 111-100,240,43,93,.462,35,75,.467,8,18,.444,17,22,.773,111
11925,2014-11-22,MIN,,SAC,L 101-113,240,37,90,.411,31,73,.425,6,17,.353,21,27,.778,101
11926,2014-11-22,SAC,@,MIN,W 113-101,240,40,81,.494,32,55,.582,8,26,.308,25,30,.833,113
11927,2014-11-22,NYK,,PHI,W 91-83,240,33,66,.500,27,49,.551,6,17,.353,19,21,.905,91
11928,2014-11-22,PHI,@,NYK,L 83-91,240,30,75,.400,22,49,.449,8,26,.308,15,25,.600,83
11929,2014-11-22,MIA,@,ORL,W 99-92,240,37,71,.521,25,45,.556,12,26,.462,13,18,.722,99
11930,2014-11-22,ORL,,MIA,L 92-99,240,35,78,.449,32,62,.516,3,16,.188,19,27,.704,92
11931,2014-11-22,BRK,@,SAS,L 87-99,240,34,91,.374,25,64,.391,9,27,.333,10,10,1.000,87
11932,2014-11-22,SAS,,BRK,W 99-87,240,41,79,.519,33,58,.569,8,21,.381,9,11,.818,99
11933,2014-11-22,NOP,@,UTA,W 106-94,240,42,93,.452,38,76,.500,4,17,.235,18,22,.818,106
11934,2014-11-22,UTA,,NOP,L 94-106,240,33,71,.465,28,57,.491,5,14,.357,23,29,.793,94
11935,2014-11-21,ATL,,DET,W 99-89,240,38,80,.475,33,56,.589,5,24,.208,18,26,.692,99
11936,2014-11-21,DET,@,ATL,L 89-99,240,31,83,.373,27,62,.435,4,21,.190,23,24,.958,89
11937,2014-11-21,CHA,,ORL,L 100-105,240,42,91,.462,35,71,.493,7,20,.350,9,15,.600,100
11938,2014-11-21,ORL,@,CHO,W 105-100,240,39,82,.476,35,66,.530,4,16,.250,23,32,.719,105
11939,2014-11-21,DAL,,LAL,W 140-106,240,51,82,.622,33,47,.702,18,35,.514,20,28,.714,140
11940,2014-11-21,LAL,@,DAL,L 106-140,240,44,85,.518,39,72,.542,5,13,.385,13,21,.619,106
11941,2014-11-21,DEN,,NOP,W 117-97,240,43,82,.524,32,58,.552,11,24,.458,20,25,.800,117
11942,2014-11-21,NOP,@,DEN,L 97-117,240,31,78,.397,26,62,.419,5,16,.313,30,34,.882,97
11943,2014-11-21,GSW,,UTA,W 101-88,240,41,82,.500,35,59,.593,6,23,.261,13,19,.684,101
11944,2014-11-21,UTA,@,GSW,L 88-101,240,35,82,.427,29,65,.446,6,17,.353,12,19,.632,88
11945,2014-11-21,BOS,@,MEM,L 100-117,240,38,88,.432,29,61,.475,9,27,.333,15,21,.714,100
11946,2014-11-21,MEM,,BOS,W 117-100,240,48,91,.527,40,75,.533,8,16,.500,13,14,.929,117
11947,2014-11-21,MIN,,SAS,L 92-121,240,37,90,.411,33,77,.429,4,13,.308,14,22,.636,92
11948,2014-11-21,SAS,@,MIN,W 121-92,240,46,84,.548,33,63,.524,13,21,.619,16,18,.889,121
11949,2014-11-21,BRK,@,OKC,W 94-92,240,31,67,.463,26,52,.500,5,15,.333,27,30,.900,94
11950,2014-11-21,OKC,,BRK,L 92-94,240,38,85,.447,34,65,.523,4,20,.200,12,19,.632,92
11951,2014-11-21,PHI,,PHO,L 96-122,240,36,78,.462,32,55,.582,4,23,.174,20,33,.606,96
11952,2014-11-21,PHO,@,PHI,W 122-96,240,44,86,.512,31,55,.564,13,31,.419,21,23,.913,122
11953,2014-11-21,CHI,@,POR,L 87-105,240,30,83,.361,22,61,.361,8,22,.364,19,28,.679,87
11954,2014-11-21,POR,,CHI,W 105-87,240,39,79,.494,30,63,.476,9,16,.563,18,22,.818,105
11955,2014-11-21,MIL,@,TOR,L 82-124,240,27,74,.365,21,54,.389,6,20,.300,22,32,.688,82
11956,2014-11-21,TOR,,MIL,W 124-82,240,45,86,.523,30,61,.492,15,25,.600,19,24,.792,124
11957,2014-11-21,CLE,@,WAS,L 78-91,240,27,75,.360,21,48,.438,6,27,.222,18,23,.783,78
11958,2014-11-21,WAS,,CLE,W 91-78,240,41,84,.488,37,74,.500,4,10,.400,5,9,.556,91
11959,2014-11-20,LAC,@,MIA,W 110-93,240,43,77,.558,30,46,.652,13,31,.419,11,17,.647,110
11960,2014-11-20,MIA,,LAC,L 93-110,240,30,67,.448,24,41,.585,6,26,.231,27,31,.871,93
11961,2014-11-20,CHI,@,SAC,L 88-103,240,36,84,.429,31,65,.477,5,19,.263,11,16,.688,88
11962,2014-11-20,SAC,,CHI,W 103-88,240,38,74,.514,34,68,.500,4,6,.667,23,27,.852,103
11963,2014-11-19,BRK,,MIL,L 118-122 (3OT),315,44,92,.478,35,61,.574,9,31,.290,21,29,.724,118
11964,2014-11-19,MIL,@,BRK,W 122-118 (3OT),315,48,108,.444,43,84,.512,5,24,.208,21,28,.750,122
11965,2014-11-19,CLE,,SAS,L 90-92,240,37,83,.446,30,65,.462,7,18,.389,9,13,.692,90
11966,2014-11-19,SAS,@,CLE,W 92-90,240,35,74,.473,30,58,.517,5,16,.313,17,25,.680,92
11967,2014-11-19,DEN,,OKC,W 107-100,240,40,82,.488,30,53,.566,10,29,.345,17,22,.773,107
11968,2014-11-19,OKC,@,DEN,L 100-107,240,36,79,.456,26,56,.464,10,23,.435,18,25,.720,100
11969,2014-11-19,DET,,PHO,L 86-88,240,33,87,.379,26,62,.419,7,25,.280,13,19,.684,86
11970,2014-11-19,PHO,@,DET,W 88-86,240,37,75,.493,33,60,.550,4,15,.267,10,13,.769,88
11971,2014-11-19,HOU,,LAL,L 92-98,240,30,74,.405,15,36,.417,15,38,.395,17,23,.739,92
11972,2014-11-19,LAL,@,HOU,W 98-92,240,37,91,.407,32,71,.451,5,20,.250,19,23,.826,98
11973,2014-11-19,CHA,@,IND,L 86-88,240,37,86,.430,32,72,.444,5,14,.357,7,12,.583,86
11974,2014-11-19,IND,,CHO,W 88-86,240,35,78,.449,33,63,.524,2,15,.133,16,24,.667,88
11975,2014-11-19,MIN,,NYK,W 115-99,240,44,89,.494,33,67,.493,11,22,.500,16,22,.727,115
11976,2014-11-19,NYK,@,MIN,L 99-115,240,34,69,.493,25,53,.472,9,16,.563,22,28,.786,99
11977,2014-11-19,LAC,@,ORL,W 114-90,240,45,84,.536,33,63,.524,12,21,.571,12,16,.750,114
11978,2014-11-19,ORL,,LAC,L 90-114,240,34,86,.395,26,62,.419,8,24,.333,14,18,.778,90
11979,2014-11-19,BOS,@,PHI,W 101-90,240,41,83,.494,35,63,.556,6,20,.300,13,21,.619,101
11980,2014-11-19,PHI,,BOS,L 90-101,240,34,86,.395,27,65,.415,7,21,.333,15,21,.714,90
11981,2014-11-19,MEM,@,TOR,L 92-96,240,35,80,.438,32,70,.457,3,10,.300,19,26,.731,92
11982,2014-11-19,TOR,,MEM,W 96-92,240,38,83,.458,29,57,.509,9,26,.346,11,13,.846,96
11983,2014-11-19,DAL,@,WAS,W 105-102,240,34,82,.415,22,54,.407,12,28,.429,25,29,.862,105
11984,2014-11-19,WAS,,DAL,L 102-105,240,37,84,.440,27,62,.435,10,22,.455,18,21,.857,102
11985,2014-11-18,ATL,,LAL,L 109-114,240,41,85,.482,32,58,.552,9,27,.333,18,23,.783,109
11986,2014-11-18,LAL,@,ATL,W 114-109,240,47,87,.540,41,70,.586,6,17,.353,14,22,.636,114
11987,2014-11-18,MIL,,NYK,W 117-113,240,43,78,.551,34,61,.557,9,17,.529,22,27,.815,117
11988,2014-11-18,NYK,@,MIL,L 113-117,240,44,80,.550,33,55,.600,11,25,.440,14,19,.737,113
11989,2014-11-18,NOP,@,SAC,W 106-100,240,39,79,.494,30,55,.545,9,24,.375,19,24,.792,106
11990,2014-11-18,SAC,,NOP,L 100-106,240,38,86,.442,34,75,.453,4,11,.364,20,29,.690,100
11991,2014-11-18,OKC,@,UTA,L 81-98,240,30,84,.357,22,61,.361,8,23,.348,13,19,.684,81
11992,2014-11-18,UTA,,OKC,W 98-81,240,35,81,.432,25,57,.439,10,24,.417,18,26,.692,98
11993,2014-11-17,BOS,,PHO,L 114-118,240,45,87,.517,41,77,.532,4,10,.400,20,31,.645,114
11994,2014-11-17,PHO,@,BOS,W 118-114,240,48,93,.516,39,72,.542,9,21,.429,13,16,.813,118
11995,2014-11-17,BRK,,MIA,L 83-95,240,29,70,.414,20,47,.426,9,23,.391,16,26,.615,83
11996,2014-11-17,MIA,@,BRK,W 95-83,240,31,72,.431,22,45,.489,9,27,.333,24,27,.889,95
11997,2014-11-17,CHA,,DAL,L 80-107,240,32,80,.400,22,58,.379,10,22,.455,6,13,.462,80
11998,2014-11-17,DAL,@,CHO,W 107-80,240,43,84,.512,33,56,.589,10,28,.357,11,16,.688,107
11999,2014-11-17,CLE,,DEN,L 97-106,240,34,79,.430,24,50,.480,10,29,.345,19,23,.826,97
12000,2014-11-17,DEN,@,CLE,W 106-97,240,41,85,.482,29,54,.537,12,31,.387,12,15,.800,106
12001,2014-11-17,DET,,ORL,L 93-107,240,32,80,.400,21,56,.375,11,24,.458,18,24,.750,93
12002,2014-11-17,ORL,@,DET,W 107-93,240,41,79,.519,28,53,.528,13,26,.500,12,15,.800,107
12003,2014-11-17,CHI,@,LAC,W 105-89,240,39,80,.488,29,54,.537,10,26,.385,17,25,.680,105
12004,2014-11-17,LAC,,CHI,L 89-105,240,36,81,.444,29,58,.500,7,23,.304,10,22,.455,89
12005,2014-11-17,HOU,@,MEM,L 93-119,240,34,78,.436,26,44,.591,8,34,.235,17,21,.810,93
12006,2014-11-17,MEM,,HOU,W 119-93,240,46,86,.535,39,69,.565,7,17,.412,20,22,.909,119
12007,2014-11-17,NOP,@,POR,L 93-102,240,38,85,.447,33,66,.500,5,19,.263,12,19,.632,93
12008,2014-11-17,POR,,NOP,W 102-93,240,38,76,.500,31,57,.544,7,19,.368,19,23,.826,102
12009,2014-11-17,PHI,@,SAS,L 75-100,240,27,83,.325,23,57,.404,4,26,.154,17,24,.708,75
12010,2014-11-17,SAS,,PHI,W 100-75,240,36,81,.444,26,55,.473,10,26,.385,18,21,.857,100
12011,2014-11-16,GSW,@,LAL,W 136-115,240,46,86,.535,32,58,.552,14,28,.500,30,34,.882,136
12012,2014-11-16,LAL,,GSW,L 115-136,240,39,99,.394,36,83,.434,3,16,.188,34,43,.791,115
12013,2014-11-16,MIA,,MIL,L 84-91,240,30,73,.411,19,48,.396,11,25,.440,13,22,.591,84
12014,2014-11-16,MIL,@,MIA,W 91-84,240,35,74,.473,30,56,.536,5,18,.278,16,26,.615,91
12015,2014-11-16,DEN,@,NYK,L 93-109,240,32,82,.390,19,48,.396,13,34,.382,16,26,.615,93
12016,2014-11-16,NYK,,DEN,W 109-93,240,41,76,.539,35,62,.565,6,14,.429,21,27,.778,109
12017,2014-11-16,HOU,@,OKC,W 69-65,240,23,80,.288,16,45,.356,7,35,.200,16,30,.533,69
12018,2014-11-16,OKC,,HOU,L 65-69,240,20,68,.294,17,49,.347,3,19,.158,22,28,.786,65
12019,2014-11-15,CHI,,IND,L 90-99,240,35,83,.422,31,66,.470,4,17,.235,16,23,.696,90
12020,2014-11-15,IND,@,CHI,W 99-90,240,37,77,.481,30,59,.508,7,18,.389,18,25,.720,99
12021,2014-11-15,ATL,@,CLE,L 94-127,240,40,90,.444,37,68,.544,3,22,.136,11,13,.846,94
12022,2014-11-15,CLE,,ATL,W 127-94,240,49,90,.544,30,59,.508,19,31,.613,10,13,.769,127
12023,2014-11-15,DAL,,MIN,W 131-117,240,52,94,.553,44,68,.647,8,26,.308,19,23,.826,131
12024,2014-11-15,MIN,@,DAL,L 117-131,240,43,86,.500,36,69,.522,7,17,.412,24,29,.828,117
12025,2014-11-15,CHA,@,GSW,L 87-112,240,32,84,.381,25,67,.373,7,17,.412,16,28,.571,87
12026,2014-11-15,GSW,,CHO,W 112-87,240,45,87,.517,34,61,.557,11,26,.423,11,14,.786,112
12027,2014-11-15,LAC,,PHO,W 120-107,240,36,68,.529,22,39,.564,14,29,.483,34,43,.791,120
12028,2014-11-15,PHO,@,LAC,L 107-120,240,38,99,.384,27,69,.391,11,30,.367,20,23,.870,107
12029,2014-11-15,DET,@,MEM,L 88-95,240,34,82,.415,24,56,.429,10,26,.385,10,17,.588,88
12030,2014-11-15,MEM,,DET,W 95-88,240,32,86,.372,28,71,.394,4,15,.267,27,33,.818,95
12031,2014-11-15,BRK,@,POR,L 87-97,240,35,89,.393,34,70,.486,1,19,.053,16,17,.941,87
12032,2014-11-15,POR,,BRK,W 97-87,240,33,78,.423,22,52,.423,11,26,.423,20,27,.741,97
12033,2014-11-15,SAC,,SAS,W 94-91,240,37,86,.430,37,74,.500,0,12,.000,20,24,.833,94
12034,2014-11-15,SAS,@,SAC,L 91-94,240,34,80,.425,27,56,.482,7,24,.292,16,18,.889,91
12035,2014-11-15,TOR,,UTA,W 111-93,240,43,84,.512,35,63,.556,8,21,.381,17,23,.739,111
12036,2014-11-15,UTA,@,TOR,L 93-111,240,33,75,.440,28,59,.475,5,16,.313,22,30,.733,93
12037,2014-11-15,ORL,@,WAS,L 93-98,240,37,78,.474,30,61,.492,7,17,.412,12,18,.667,93
12038,2014-11-15,WAS,,ORL,W 98-93,240,42,84,.500,39,74,.527,3,10,.300,11,16,.688,98
12039,2014-11-14,ATL,,MIA,W 114-103,240,42,75,.560,31,47,.660,11,28,.393,19,23,.826,114
12040,2014-11-14,MIA,@,ATL,L 103-114,240,35,74,.473,25,53,.472,10,21,.476,23,25,.920,103
12041,2014-11-14,BOS,,CLE,L 121-122,240,48,88,.545,42,68,.618,6,20,.300,19,23,.826,121
12042,2014-11-14,CLE,@,BOS,W 122-121,240,43,85,.506,35,62,.565,8,23,.348,28,37,.757,122
12043,2014-11-14,HOU,,PHI,W 88-87,240,29,78,.372,22,44,.500,7,34,.206,23,37,.622,88
12044,2014-11-14,PHI,@,HOU,L 87-88,240,34,80,.425,27,59,.458,7,21,.333,12,18,.667,87
12045,2014-11-14,DEN,@,IND,W 108-87,240,43,87,.494,35,64,.547,8,23,.348,14,25,.560,108
12046,2014-11-14,IND,,DEN,L 87-108,240,34,84,.405,26,62,.419,8,22,.364,11,22,.500,87
12047,2014-11-14,LAL,,SAS,L 80-93,240,28,75,.373,26,63,.413,2,12,.167,22,31,.710,80
12048,2014-11-14,SAS,@,LAL,W 93-80,240,33,80,.413,23,57,.404,10,23,.435,17,20,.850,93
12049,2014-11-14,MIN,@,NOP,L 91-139,240,29,72,.403,26,58,.448,3,14,.214,30,41,.732,91
12050,2014-11-14,NOP,,MIN,W 139-91,240,56,84,.667,41,64,.641,15,20,.750,12,16,.750,139
12051,2014-11-14,NYK,,UTA,L 100-102,240,39,82,.476,34,74,.459,5,8,.625,17,20,.850,100
12052,2014-11-14,UTA,@,NYK,W 102-100,240,36,70,.514,26,48,.542,10,22,.455,20,25,.800,102
12053,2014-11-14,DET,@,OKC,W 96-89 (OT),265,38,89,.427,27,58,.466,11,31,.355,9,15,.600,96
12054,2014-11-14,OKC,,DET,L 89-96 (OT),265,38,96,.396,26,60,.433,12,36,.333,1,6,.167,89
12055,2014-11-14,MIL,@,ORL,L 85-101,240,36,80,.450,34,61,.557,2,19,.105,11,14,.786,85
12056,2014-11-14,ORL,,MIL,W 101-85,240,35,80,.438,25,56,.446,10,24,.417,21,27,.778,101
12057,2014-11-14,CHA,@,PHO,W 103-95,240,39,91,.429,32,75,.427,7,16,.438,18,19,.947,103
12058,2014-11-14,PHO,,CHO,L 95-103,240,37,86,.430,29,57,.509,8,29,.276,13,14,.929,95
12059,2014-11-13,DAL,,PHI,W 123-70,240,41,80,.513,30,48,.625,11,32,.344,30,36,.833,123
12060,2014-11-13,PHI,@,DAL,L 70-123,240,23,77,.299,16,50,.320,7,27,.259,17,33,.515,70
12061,2014-11-13,BRK,@,GSW,L 99-107,240,39,89,.438,36,73,.493,3,16,.188,18,20,.900,99
12062,2014-11-13,GSW,,BRK,W 107-99,240,41,90,.456,30,56,.536,11,34,.324,14,21,.667,107
12063,2014-11-13,MEM,,SAC,W 111-110,240,39,77,.506,33,68,.485,6,9,.667,27,34,.794,111
12064,2014-11-13,SAC,@,MEM,L 110-111,240,37,77,.481,30,64,.469,7,13,.538,29,34,.853,110
12065,2014-11-13,CHI,@,TOR,W 100-93,240,37,77,.481,33,62,.532,4,15,.267,22,32,.688,100
12066,2014-11-13,TOR,,CHI,L 93-100,240,35,89,.393,27,64,.422,8,25,.320,15,21,.714,93
12067,2014-11-12,ATL,,UTA,W 100-97,240,39,76,.513,30,56,.536,9,20,.450,13,18,.722,100
12068,2014-11-12,UTA,@,ATL,L 97-100,240,43,86,.500,38,63,.603,5,23,.217,6,12,.500,97
12069,2014-11-12,BOS,,OKC,L 94-109,240,37,83,.446,28,50,.560,9,33,.273,11,13,.846,94
12070,2014-11-12,OKC,@,BOS,W 109-94,240,40,82,.488,30,58,.517,10,24,.417,19,22,.864,109
12071,2014-11-12,DEN,,POR,L 113-130,240,39,90,.433,31,67,.463,8,23,.348,27,33,.818,113
12072,2014-11-12,POR,@,DEN,W 130-113,240,45,88,.511,29,55,.527,16,33,.485,24,29,.828,130
12073,2014-11-12,IND,@,MIA,W 81-75,240,30,80,.375,22,54,.407,8,26,.308,13,15,.867,81
12074,2014-11-12,MIA,,IND,L 75-81,240,29,68,.426,20,48,.417,9,20,.450,8,18,.444,75
12075,2014-11-12,HOU,@,MIN,W 113-101,240,43,89,.483,30,61,.492,13,28,.464,14,19,.737,113
12076,2014-11-12,MIN,,HOU,L 101-113,240,36,81,.444,30,69,.435,6,12,.500,23,30,.767,101
12077,2014-11-12,LAL,@,NOP,L 102-109,240,35,84,.417,28,63,.444,7,21,.333,25,32,.781,102
12078,2014-11-12,NOP,,LAL,W 109-102,240,45,82,.549,37,63,.587,8,19,.421,11,18,.611,109
12079,2014-11-12,NYK,,ORL,L 95-97,240,37,86,.430,29,63,.460,8,23,.348,13,14,.929,95
12080,2014-11-12,ORL,@,NYK,W 97-95,240,33,70,.471,27,58,.466,6,12,.500,25,32,.781,97
12081,2014-11-12,BRK,@,PHO,L 104-112,240,35,74,.473,26,53,.491,9,21,.429,25,32,.781,104
12082,2014-11-12,PHO,,BRK,W 112-104,240,39,81,.481,31,57,.544,8,24,.333,26,29,.897,112
12083,2014-11-12,DET,@,WAS,L 103-107,240,38,81,.469,29,59,.492,9,22,.409,18,22,.818,103
12084,2014-11-12,WAS,,DET,W 107-103,240,40,83,.482,37,72,.514,3,11,.273,24,33,.727,107
12085,2014-11-11,DAL,,SAC,W 106-98,240,38,80,.475,28,53,.528,10,27,.370,20,24,.833,106
12086,2014-11-11,SAC,@,DAL,L 98-106,240,32,72,.444,23,53,.434,9,19,.474,25,32,.781,98
12087,2014-11-11,GSW,,SAS,L 100-113,240,38,70,.543,31,50,.620,7,20,.350,17,20,.850,100
12088,2014-11-11,SAS,@,GSW,W 113-100,240,46,93,.495,36,68,.529,10,25,.400,11,15,.733,113
12089,2014-11-11,LAL,@,MEM,L 102-107,240,41,87,.471,34,65,.523,7,22,.318,13,17,.765,102
12090,2014-11-11,MEM,,LAL,W 107-102,240,41,78,.526,37,67,.552,4,11,.364,21,26,.808,107
12091,2014-11-11,MIL,,OKC,W 85-78,240,33,81,.407,30,66,.455,3,15,.200,16,24,.667,85
12092,2014-11-11,OKC,@,MIL,L 78-85,240,29,87,.333,23,67,.343,6,20,.300,14,19,.737,78
12093,2014-11-11,CHA,@,POR,L 100-102,240,35,75,.467,28,59,.475,7,16,.438,23,27,.852,100
12094,2014-11-11,POR,,CHO,W 102-100,240,40,93,.430,32,68,.471,8,25,.320,14,16,.875,102
12095,2014-11-11,ORL,@,TOR,L 100-104,240,39,81,.481,27,56,.482,12,25,.480,10,16,.625,100
12096,2014-11-11,TOR,,ORL,W 104-100,240,35,77,.455,26,56,.464,9,21,.429,25,30,.833,104
12097,2014-11-10,CHI,,DET,W 102-91,240,39,88,.443,32,68,.471,7,20,.350,17,20,.850,102
12098,2014-11-10,DET,@,CHI,L 91-102,240,34,80,.425,27,66,.409,7,14,.500,16,25,.640,91
12099,2014-11-10,CLE,,NOP,W 118-111,240,40,81,.494,27,54,.500,13,27,.481,25,30,.833,118
12100,2014-11-10,NOP,@,CLE,L 111-118,240,41,93,.441,29,66,.439,12,27,.444,17,20,.850,111
12101,2014-11-10,IND,,UTA,W 97-86,240,39,90,.433,33,75,.440,6,15,.400,13,15,.867,97
12102,2014-11-10,UTA,@,IND,L 86-97,240,32,74,.432,26,53,.491,6,21,.286,16,21,.762,86
12103,2014-11-10,LAC,,SAS,L 85-89,240,33,74,.446,28,52,.538,5,22,.227,14,17,.824,85
12104,2014-11-10,SAS,@,LAC,W 89-85,240,33,83,.398,31,64,.484,2,19,.105,21,27,.778,89
12105,2014-11-10,ATL,@,NYK,W 91-85,240,27,71,.380,17,44,.386,10,27,.370,27,28,.964,91
12106,2014-11-10,NYK,,ATL,L 85-91,240,36,83,.434,30,57,.526,6,26,.231,7,12,.583,85
12107,2014-11-09,BRK,,ORL,W 104-96,240,40,83,.482,36,69,.522,4,14,.286,20,23,.870,104
12108,2014-11-09,ORL,@,BRK,L 96-104,240,39,75,.520,31,60,.517,8,15,.533,10,16,.625,96
12109,2014-11-09,DAL,,MIA,L 96-105,240,35,83,.422,26,54,.481,9,29,.310,17,24,.708,96
12110,2014-11-09,MIA,@,DAL,W 105-96,240,42,76,.553,33,53,.623,9,23,.391,12,20,.600,105
12111,2014-11-09,DET,,UTA,L 96-97,240,36,93,.387,30,70,.429,6,23,.261,18,25,.720,96
12112,2014-11-09,UTA,@,DET,W 97-96,240,33,72,.458,27,57,.474,6,15,.400,25,35,.714,97
12113,2014-11-09,CHA,@,LAL,L 92-107,240,35,79,.443,32,65,.492,3,14,.214,19,27,.704,92
12114,2014-11-09,LAL,,CHO,W 107-92,240,42,82,.512,36,65,.554,6,17,.353,17,22,.773,107
12115,2014-11-09,OKC,,SAC,W 101-93,240,36,78,.462,30,60,.500,6,18,.333,23,27,.852,101
12116,2014-11-09,SAC,@,OKC,L 93-101,240,36,80,.450,30,56,.536,6,24,.250,15,22,.682,93
12117,2014-11-09,GSW,@,PHO,L 95-107,240,33,69,.478,22,45,.489,11,24,.458,18,21,.857,95
12118,2014-11-09,PHO,,GSW,W 107-95,240,34,79,.430,22,49,.449,12,30,.400,27,33,.818,107
12119,2014-11-09,DEN,@,POR,L 100-116,240,36,91,.396,31,78,.397,5,13,.385,23,30,.767,100
12120,2014-11-09,POR,,DEN,W 116-100,240,45,100,.450,29,69,.420,16,31,.516,10,14,.714,116
12121,2014-11-09,PHI,@,TOR,L 88-120,240,33,87,.379,23,53,.434,10,34,.294,12,18,.667,88
12122,2014-11-09,TOR,,PHI,W 120-88,240,43,76,.566,36,59,.610,7,17,.412,27,30,.900,120
12123,2014-11-08,ATL,,NYK,W 103-96,240,33,81,.407,24,59,.407,9,22,.409,28,36,.778,103
12124,2014-11-08,NYK,@,ATL,L 96-103,240,40,84,.476,32,63,.508,8,21,.381,8,11,.727,96
12125,2014-11-08,BOS,@,CHI,W 106-101,240,42,81,.519,35,62,.565,7,19,.368,15,20,.750,106
12126,2014-11-08,CHI,,BOS,L 101-106,240,42,92,.457,34,74,.459,8,18,.444,9,15,.600,101
12127,2014-11-08,GSW,@,HOU,W 98-87,240,39,87,.448,30,59,.508,9,28,.321,11,17,.647,98
12128,2014-11-08,HOU,,GSW,L 87-98,240,30,86,.349,20,44,.455,10,42,.238,17,21,.810,87
12129,2014-11-08,IND,,WAS,L 90-97,240,33,77,.429,25,53,.472,8,24,.333,16,25,.640,90
12130,2014-11-08,WAS,@,IND,W 97-90,240,39,81,.481,37,70,.529,2,11,.182,17,23,.739,97
12131,2014-11-08,LAC,,POR,W 106-102,240,40,81,.494,35,69,.507,5,12,.417,21,30,.700,106
12132,2014-11-08,POR,@,LAC,L 102-106,240,36,80,.450,26,55,.473,10,25,.400,20,25,.800,102
12133,2014-11-08,MIA,,MIN,W 102-92,240,41,78,.526,36,65,.554,5,13,.385,15,17,.882,102
12134,2014-11-08,MIN,@,MIA,L 92-102,240,35,87,.402,31,71,.437,4,16,.250,18,23,.783,92
12135,2014-11-08,MEM,@,MIL,L 92-93,240,29,82,.354,26,68,.382,3,14,.214,31,34,.912,92
12136,2014-11-08,MIL,,MEM,W 93-92,240,40,88,.455,35,70,.500,5,18,.278,8,11,.727,93
12137,2014-11-08,NOP,@,SAS,W 100-99,240,40,85,.471,32,64,.500,8,21,.381,12,14,.857,100
12138,2014-11-08,SAS,,NOP,L 99-100,240,36,80,.450,31,62,.500,5,18,.278,22,29,.759,99
12139,2014-11-07,BOS,,IND,W 101-98,240,39,85,.459,30,58,.517,9,27,.333,14,16,.875,101
12140,2014-11-07,IND,@,BOS,L 98-101,240,40,88,.455,35,69,.507,5,19,.263,13,13,1.000,98
12141,2014-11-07,BRK,,NYK,W 110-99,240,38,74,.514,24,50,.480,14,24,.583,20,26,.769,110
12142,2014-11-07,NYK,@,BRK,L 99-110,240,37,90,.411,29,71,.408,8,19,.421,17,21,.810,99
12143,2014-11-07,ATL,@,CHO,L 119-122 (2OT),290,43,93,.462,30,60,.500,13,33,.394,20,26,.769,119
12144,2014-11-07,CHA,,ATL,W 122-119 (2OT),290,48,97,.495,42,76,.553,6,21,.286,20,27,.741,122
12145,2014-11-07,CLE,@,DEN,W 110-101,240,40,84,.476,34,61,.557,6,23,.261,24,33,.727,110
12146,2014-11-07,DEN,,CLE,L 101-110,240,40,85,.471,29,56,.518,11,29,.379,10,15,.667,101
12147,2014-11-07,DET,,MIL,W 98-95,240,37,75,.493,26,52,.500,11,23,.478,13,24,.542,98
12148,2014-11-07,MIL,@,DET,L 95-98,240,36,77,.468,31,57,.544,5,20,.250,18,23,.783,95
12149,2014-11-07,MEM,@,OKC,W 91-89,240,34,81,.420,25,63,.397,9,18,.500,14,17,.824,91
12150,2014-11-07,OKC,,MEM,L 89-91,240,37,79,.468,25,54,.463,12,25,.480,3,11,.273,89
12151,2014-11-07,MIN,@,ORL,L 103-112 (OT),265,40,93,.430,36,75,.480,4,18,.222,19,25,.760,103
12152,2014-11-07,ORL,,MIN,W 112-103 (OT),265,46,91,.505,41,81,.506,5,10,.500,15,19,.789,112
12153,2014-11-07,CHI,@,PHI,W 118-115,240,40,78,.513,28,54,.519,12,24,.500,26,34,.765,118
12154,2014-11-07,PHI,,CHI,L 115-118,240,43,91,.473,31,61,.508,12,30,.400,17,25,.680,115
12155,2014-11-07,PHO,,SAC,L 112-114 (2OT),290,42,98,.429,32,67,.478,10,31,.323,18,25,.720,112
12156,2014-11-07,SAC,@,PHO,W 114-112 (2OT),290,39,91,.429,36,75,.480,3,16,.188,33,39,.846,114
12157,2014-11-07,TOR,,WAS,W 103-84,240,35,80,.438,26,58,.448,9,22,.409,24,31,.774,103
12158,2014-11-07,WAS,@,TOR,L 84-103,240,30,83,.361,27,64,.422,3,19,.158,21,32,.656,84
12159,2014-11-07,DAL,@,UTA,W 105-82,240,42,88,.477,33,64,.516,9,24,.375,12,14,.857,105
12160,2014-11-07,UTA,,DAL,L 82-105,240,29,68,.426,20,40,.500,9,28,.321,15,19,.789,82
12161,2014-11-06,HOU,,SAS,W 98-81,240,34,72,.472,24,45,.533,10,27,.370,20,33,.606,98
12162,2014-11-06,SAS,@,HOU,L 81-98,240,31,90,.344,29,70,.414,2,20,.100,17,19,.895,81
12163,2014-11-06,DAL,@,POR,L 87-108,240,33,90,.367,28,67,.418,5,23,.217,16,16,1.000,87
12164,2014-11-06,POR,,DAL,W 108-87,240,40,77,.519,28,47,.596,12,30,.400,16,19,.842,108
12165,2014-11-05,BOS,,TOR,L 107-110,240,40,78,.513,30,52,.577,10,26,.385,17,18,.944,107
12166,2014-11-05,TOR,@,BOS,W 110-107,240,42,87,.483,35,71,.493,7,16,.438,19,23,.826,110
12167,2014-11-05,BRK,,MIN,L 91-98,240,36,82,.439,28,61,.459,8,21,.381,11,17,.647,91
12168,2014-11-05,MIN,@,BRK,W 98-91,240,37,90,.411,30,73,.411,7,17,.412,17,22,.773,98
12169,2014-11-05,CHA,,MIA,W 96-89,240,35,82,.427,30,64,.469,5,18,.278,21,29,.724,96
12170,2014-11-05,MIA,@,CHO,L 89-96,240,30,77,.390,26,55,.473,4,22,.182,25,31,.806,89
12171,2014-11-05,DET,,NYK,W 98-95,240,32,87,.368,21,64,.328,11,23,.478,23,33,.697,98
12172,2014-11-05,NYK,@,DET,L 95-98,240,39,90,.433,30,70,.429,9,20,.450,8,10,.800,95
12173,2014-11-05,GSW,,LAC,W 121-104,240,43,74,.581,28,49,.571,15,25,.600,20,20,1.000,121
12174,2014-11-05,LAC,@,GSW,L 104-121,240,38,82,.463,31,63,.492,7,19,.368,21,27,.778,104
12175,2014-11-05,CHI,@,MIL,W 95-86,240,34,73,.466,29,57,.509,5,16,.313,22,30,.733,95
12176,2014-11-05,MIL,,CHI,L 86-95,240,33,89,.371,30,74,.405,3,15,.200,17,20,.850,86
12177,2014-11-05,ORL,@,PHI,W 91-89,240,39,88,.443,36,68,.529,3,20,.150,10,12,.833,91
12178,2014-11-05,PHI,,ORL,L 89-91,240,33,77,.429,25,52,.481,8,25,.320,15,23,.652,89
12179,2014-11-05,MEM,@,PHO,W 102-91,240,40,80,.500,31,63,.492,9,17,.529,13,17,.765,102
12180,2014-11-05,PHO,,MEM,L 91-102,240,32,69,.464,24,48,.500,8,21,.381,19,21,.905,91
12181,2014-11-05,DEN,@,SAC,L 109-131,240,37,82,.451,28,54,.519,9,28,.321,26,31,.839,109
12182,2014-11-05,SAC,,DEN,W 131-109,240,42,76,.553,34,56,.607,8,20,.400,39,50,.780,131
12183,2014-11-05,ATL,@,SAS,L 92-94,240,38,92,.413,30,67,.448,8,25,.320,8,11,.727,92
12184,2014-11-05,SAS,,ATL,W 94-92,240,31,69,.449,26,52,.500,5,17,.294,27,38,.711,94
12185,2014-11-05,CLE,@,UTA,L 100-102,240,30,72,.417,24,56,.429,6,16,.375,34,40,.850,100
12186,2014-11-05,UTA,,CLE,W 102-100,240,39,77,.506,32,56,.571,7,21,.333,17,22,.773,102
12187,2014-11-05,IND,@,WAS,L 94-96 (OT),265,35,90,.389,27,63,.429,8,27,.296,16,20,.800,94
12188,2014-11-05,WAS,,IND,W 96-94 (OT),265,34,91,.374,27,74,.365,7,17,.412,21,23,.913,96
12189,2014-11-04,CHI,,ORL,W 98-90,240,35,75,.467,28,60,.467,7,15,.467,21,27,.778,98
12190,2014-11-04,ORL,@,CHI,L 90-98,240,38,88,.432,32,74,.432,6,14,.429,8,14,.571,90
12191,2014-11-04,IND,,MIL,L 81-87,240,31,78,.397,25,54,.463,6,24,.250,13,22,.591,81
12192,2014-11-04,MIL,@,IND,W 87-81,240,37,83,.446,30,62,.484,7,21,.333,6,7,.857,87
12193,2014-11-04,LAL,,PHO,L 106-112,240,35,88,.398,29,72,.403,6,16,.375,30,41,.732,106
12194,2014-11-04,PHO,@,LAL,W 112-106,240,41,91,.451,35,73,.479,6,18,.333,24,31,.774,112
12195,2014-11-04,HOU,@,MIA,W 108-91,240,35,68,.515,18,31,.581,17,37,.459,21,27,.778,108
12196,2014-11-04,MIA,,HOU,L 91-108,240,31,74,.419,19,46,.413,12,28,.429,17,27,.630,91
12197,2014-11-04,CHA,@,NOP,L 91-100,240,37,80,.463,31,59,.525,6,21,.286,11,13,.846,91
12198,2014-11-04,NOP,,CHO,W 100-91,240,38,81,.469,33,63,.524,5,18,.278,19,19,1.000,100
12199,2014-11-04,NYK,,WAS,L 83-98,240,30,81,.370,22,66,.333,8,15,.533,15,19,.789,83
12200,2014-11-04,WAS,@,NYK,W 98-83,240,39,80,.488,31,62,.500,8,18,.444,12,19,.632,98
12201,2014-11-04,CLE,@,POR,L 82-101,240,31,85,.365,22,64,.344,9,21,.429,11,14,.786,82
12202,2014-11-04,POR,,CLE,W 101-82,240,37,75,.493,29,50,.580,8,25,.320,19,25,.760,101
12203,2014-11-04,OKC,@,TOR,L 88-100,240,34,65,.523,28,44,.636,6,21,.286,14,25,.560,88
12204,2014-11-04,TOR,,OKC,W 100-88,240,32,81,.395,24,50,.480,8,31,.258,28,33,.848,100
12205,2014-11-03,BRK,,OKC,W 116-85,240,44,84,.524,33,61,.541,11,23,.478,17,19,.895,116
12206,2014-11-03,OKC,@,BRK,L 85-116,240,32,82,.390,24,59,.407,8,23,.348,13,21,.619,85
12207,2014-11-03,BOS,@,DAL,L 113-118,240,45,102,.441,34,71,.479,11,31,.355,12,16,.750,113
12208,2014-11-03,DAL,,BOS,W 118-113,240,44,82,.537,30,57,.526,14,25,.560,16,20,.800,118
12209,2014-11-03,DEN,,SAC,L 105-110,240,36,93,.387,31,69,.449,5,24,.208,28,33,.848,105
12210,2014-11-03,SAC,@,DEN,W 110-105,240,34,81,.420,32,72,.444,2,9,.222,40,47,.851,110
12211,2014-11-03,LAC,,UTA,W 107-101,240,41,81,.506,31,58,.534,10,23,.435,15,17,.882,107
12212,2014-11-03,UTA,@,LAC,L 101-107,240,36,77,.468,26,50,.520,10,27,.370,19,24,.792,101
12213,2014-11-03,MEM,,NOP,W 93-81,240,31,76,.408,27,62,.435,4,14,.286,27,37,.730,93
12214,2014-11-03,NOP,@,MEM,L 81-93,240,29,86,.337,25,62,.403,4,24,.167,19,29,.655,81
12215,2014-11-03,HOU,@,PHI,W 104-93,240,32,75,.427,16,41,.390,16,34,.471,24,30,.800,104
12216,2014-11-03,PHI,,HOU,L 93-104,240,33,74,.446,22,52,.423,11,22,.500,16,23,.696,93
12217,2014-11-02,LAC,,SAC,L 92-98,240,33,88,.375,24,57,.421,9,31,.290,17,21,.810,92
12218,2014-11-02,SAC,@,LAC,W 98-92,240,34,68,.500,31,58,.534,3,10,.300,27,33,.818,98
12219,2014-11-02,MIA,,TOR,W 107-102,240,35,70,.500,26,46,.565,9,24,.375,28,38,.737,107
12220,2014-11-02,TOR,@,MIA,L 102-107,240,37,79,.468,33,63,.524,4,16,.250,24,39,.615,102
12221,2014-11-02,CHA,@,NYK,L 93-96,240,33,70,.471,27,55,.491,6,15,.400,21,29,.724,93
12222,2014-11-02,NYK,,CHO,W 96-93,240,39,78,.500,31,62,.500,8,16,.500,10,17,.588,96
12223,2014-11-02,GSW,@,POR,W 95-90,240,36,81,.444,30,62,.484,6,19,.316,17,21,.810,95
12224,2014-11-02,POR,,GSW,L 90-95,240,37,92,.402,30,65,.462,7,27,.259,9,14,.643,90
12225,2014-11-01,ATL,,IND,W 102-92,240,35,69,.507,28,49,.571,7,20,.350,25,33,.758,102
12226,2014-11-01,IND,@,ATL,L 92-102,240,31,81,.383,19,49,.388,12,32,.375,18,21,.857,92
12227,2014-11-01,CHA,,MEM,L 69-71,240,26,72,.361,22,58,.379,4,14,.286,13,18,.722,69
12228,2014-11-01,MEM,@,CHO,W 71-69,240,29,80,.363,26,69,.377,3,11,.273,10,13,.769,71
12229,2014-11-01,BRK,@,DET,W 102-90,240,42,87,.483,35,61,.574,7,26,.269,11,13,.846,102
12230,2014-11-01,DET,,BRK,L 90-102,240,32,76,.421,31,59,.525,1,17,.059,25,35,.714,90
12231,2014-11-01,GSW,,LAL,W 127-104,240,46,83,.554,35,60,.583,11,23,.478,24,28,.857,127
12232,2014-11-01,LAL,@,GSW,L 104-127,240,41,88,.466,37,74,.500,4,14,.286,18,25,.720,104
12233,2014-11-01,BOS,@,HOU,L 90-104,240,37,98,.378,36,73,.493,1,25,.040,15,18,.833,90
12234,2014-11-01,HOU,,BOS,W 104-90,240,32,76,.421,20,42,.476,12,34,.353,28,40,.700,104
12235,2014-11-01,CHI,@,MIN,W 106-105,240,33,69,.478,24,46,.522,9,23,.391,31,40,.775,106
12236,2014-11-01,MIN,,CHI,L 105-106,240,38,85,.447,34,73,.466,4,12,.333,25,31,.806,105
12237,2014-11-01,DAL,@,NOP,W 109-104,240,46,89,.517,40,64,.625,6,25,.240,11,19,.579,109
12238,2014-11-01,NOP,,DAL,L 104-109,240,38,89,.427,31,70,.443,7,19,.368,21,28,.750,104
12239,2014-11-01,DEN,@,OKC,L 91-102,240,35,80,.438,28,54,.519,7,26,.269,14,20,.700,91
12240,2014-11-01,OKC,,DEN,W 102-91,240,37,80,.463,31,60,.517,6,20,.300,22,31,.710,102
12241,2014-11-01,ORL,,TOR,L 95-108,240,38,81,.469,31,61,.508,7,20,.350,12,24,.500,95
12242,2014-11-01,TOR,@,ORL,W 108-95,240,33,83,.398,29,62,.468,4,21,.190,38,48,.792,108
12243,2014-11-01,MIA,@,PHI,W 114-96,240,41,83,.494,29,59,.492,12,24,.500,20,29,.690,114
12244,2014-11-01,PHI,,MIA,L 96-114,240,35,67,.522,28,44,.636,7,23,.304,19,26,.731,96
12245,2014-11-01,PHO,@,UTA,L 91-118,240,36,87,.414,29,56,.518,7,31,.226,12,15,.800,91
12246,2014-11-01,UTA,,PHO,W 118-91,240,42,88,.477,35,62,.565,7,26,.269,27,33,.818,118
12247,2014-11-01,MIL,@,WAS,L 97-108,240,34,80,.425,25,58,.431,9,22,.409,20,24,.833,97
12248,2014-11-01,WAS,,MIL,W 108-97,240,40,73,.548,36,60,.600,4,13,.308,24,33,.727,108
12249,2014-10-31,CHI,,CLE,L 108-114 (OT),265,41,90,.456,28,59,.475,13,31,.419,13,17,.765,108
12250,2014-10-31,CLE,@,CHI,W 114-108 (OT),265,41,104,.394,38,89,.427,3,15,.200,29,33,.879,114
12251,2014-10-31,IND,,MEM,L 89-97,240,34,74,.459,26,53,.491,8,21,.381,13,16,.813,89
12252,2014-10-31,MEM,@,IND,W 97-89,240,35,79,.443,28,60,.467,7,19,.368,20,27,.741,97
12253,2014-10-31,LAC,@,LAL,W 118-111,240,34,71,.479,22,38,.579,12,33,.364,38,44,.864,118
12254,2014-10-31,LAL,,LAC,L 111-118,240,42,82,.512,35,62,.565,7,20,.350,20,28,.714,111
12255,2014-10-31,MIL,,PHI,W 93-81,240,36,88,.409,27,64,.422,9,24,.375,12,21,.571,93
12256,2014-10-31,PHI,@,MIL,L 81-93,240,32,86,.372,27,63,.429,5,23,.217,12,22,.545,81
12257,2014-10-31,PHO,,SAS,W 94-89,240,35,87,.402,33,69,.478,2,18,.111,22,26,.846,94
12258,2014-10-31,SAS,@,PHO,L 89-94,240,32,78,.410,24,53,.453,8,25,.320,17,23,.739,89
12259,2014-10-31,POR,@,SAC,L 94-103,240,34,83,.410,25,57,.439,9,26,.346,17,19,.895,94
12260,2014-10-31,SAC,,POR,W 103-94,240,34,81,.420,30,71,.423,4,10,.400,31,35,.886,103
12261,2014-10-30,CLE,,NYK,L 90-95,240,32,70,.457,23,46,.500,9,24,.375,17,20,.850,90
12262,2014-10-30,NYK,@,CLE,W 95-90,240,37,69,.536,31,57,.544,6,12,.500,15,18,.833,95
12263,2014-10-30,DAL,,UTA,W 120-102,240,47,85,.553,39,64,.609,8,21,.381,18,23,.783,120
12264,2014-10-30,UTA,@,DAL,L 102-120,240,36,83,.434,22,48,.458,14,35,.400,16,18,.889,102
12265,2014-10-30,LAC,,OKC,W 93-90,240,34,87,.391,27,57,.474,7,30,.233,18,25,.720,93
12266,2014-10-30,OKC,@,LAC,L 90-93,240,28,65,.431,22,44,.500,6,21,.286,28,34,.824,90
12267,2014-10-30,DET,@,MIN,L 91-97,240,38,91,.418,31,70,.443,7,21,.333,8,13,.615,91
12268,2014-10-30,MIN,,DET,W 97-91,240,37,76,.487,33,66,.500,4,10,.400,19,28,.679,97
12269,2014-10-30,ORL,,WAS,L 98-105,240,37,72,.514,31,57,.544,6,15,.400,18,24,.750,98
12270,2014-10-30,WAS,@,ORL,W 105-98,240,39,80,.488,32,67,.478,7,13,.538,20,26,.769,105
12271,2014-10-29,BOS,,BRK,W 121-105,240,49,88,.557,41,66,.621,8,22,.364,15,23,.652,121
12272,2014-10-29,BRK,@,BOS,L 105-121,240,39,80,.488,32,61,.525,7,19,.368,20,26,.769,105
12273,2014-10-29,CHA,,MIL,W 108-106 (OT),265,41,101,.406,35,80,.438,6,21,.286,20,29,.690,108
12274,2014-10-29,MIL,@,CHO,L 106-108 (OT),265,39,80,.488,32,66,.485,7,14,.500,21,24,.875,106
12275,2014-10-29,DEN,,DET,W 89-79,240,30,85,.353,24,61,.393,6,24,.250,23,31,.742,89
12276,2014-10-29,DET,@,DEN,L 79-89,240,31,84,.369,25,58,.431,6,26,.231,11,19,.579,79
12277,2014-10-29,IND,,PHI,W 103-91,240,38,81,.469,30,56,.536,8,25,.320,19,28,.679,103
12278,2014-10-29,PHI,@,IND,L 91-103,240,34,89,.382,28,68,.412,6,21,.286,17,30,.567,91
12279,2014-10-29,MEM,,MIN,W 105-101,240,43,82,.524,39,67,.582,4,15,.267,15,20,.750,105
12280,2014-10-29,MIN,@,MEM,L 101-105,240,39,86,.453,33,74,.446,6,12,.500,17,23,.739,101
12281,2014-10-29,MIA,,WAS,W 107-95,240,39,81,.481,30,53,.566,9,28,.321,20,23,.870,107
12282,2014-10-29,WAS,@,MIA,L 95-107,240,36,75,.480,30,56,.536,6,19,.316,17,24,.708,95
12283,2014-10-29,CHI,@,NYK,W 104-80,240,36,71,.507,29,47,.617,7,24,.292,25,30,.833,104
12284,2014-10-29,NYK,,CHI,L 80-104,240,31,85,.365,28,68,.412,3,17,.176,15,17,.882,80
12285,2014-10-29,LAL,@,PHO,L 99-119,240,37,86,.430,33,73,.452,4,13,.308,21,25,.840,99
12286,2014-10-29,PHO,,LAL,W 119-99,240,45,82,.549,29,50,.580,16,32,.500,13,18,.722,119
12287,2014-10-29,OKC,@,POR,L 89-106,240,33,81,.407,31,65,.477,2,16,.125,21,26,.808,89
12288,2014-10-29,POR,,OKC,W 106-89,240,39,87,.448,28,58,.483,11,29,.379,17,22,.773,106
12289,2014-10-29,GSW,@,SAC,W 95-77,240,33,75,.440,27,48,.563,6,27,.222,23,32,.719,95
12290,2014-10-29,SAC,,GSW,L 77-95,240,24,78,.308,21,60,.350,3,18,.167,26,35,.743,77
12291,2014-10-29,ATL,@,TOR,L 102-109,240,40,80,.500,27,58,.466,13,22,.591,9,17,.529,102
12292,2014-10-29,TOR,,ATL,W 109-102,240,37,90,.411,29,64,.453,8,26,.308,27,33,.818,109
12293,2014-10-29,HOU,@,UTA,W 104-93,240,40,77,.519,26,50,.520,14,27,.519,10,14,.714,104
12294,2014-10-29,UTA,,HOU,L 93-104,240,38,81,.469,35,63,.556,3,18,.167,14,17,.824,93
12295,2014-10-28,HOU,@,LAL,W 108-90,240,31,73,.425,19,44,.432,12,29,.414,34,50,.680,108
12296,2014-10-28,LAL,,HOU,L 90-108,240,28,79,.354,25,69,.362,3,10,.300,31,39,.795,90
12297,2014-10-28,NOP,,ORL,W 101-84,240,41,101,.406,37,84,.440,4,17,.235,15,31,.484,101
12298,2014-10-28,ORL,@,NOP,L 84-101,240,32,84,.381,28,73,.384,4,11,.364,16,21,.762,84
12299,2014-10-28,DAL,@,SAS,L 100-101,240,38,78,.487,30,57,.526,8,21,.381,16,19,.842,100
12300,2014-10-28,SAS,,DAL,W 101-100,240,37,70,.529,23,42,.548,14,28,.500,13,16,.813,101
12301,2014-04-16,BOS,,WAS,L 102-118,240,39,84,.464,32,54,.593,7,30,.233,17,23,.739,102
12302,2014-04-16,WAS,@,BOS,W 118-102,240,50,88,.568,44,70,.629,6,18,.333,12,17,.706,118
12303,2014-04-16,CHA,,CHI,W 91-86 (OT),265,34,85,.400,29,64,.453,5,21,.238,18,26,.692,91
12304,2014-04-16,CHI,@,CHA,L 86-91 (OT),265,34,86,.395,26,64,.406,8,22,.364,10,15,.667,86
12305,2014-04-16,BRK,@,CLE,L 85-114,240,30,79,.380,22,54,.407,8,25,.320,17,23,.739,85
12306,2014-04-16,CLE,,BRK,W 114-85,240,46,87,.529,38,67,.567,8,20,.400,14,17,.824,114
12307,2014-04-16,DEN,,GSW,L 112-116,240,37,84,.440,28,50,.560,9,34,.265,29,35,.829,112
12308,2014-04-16,GSW,@,DEN,W 116-112,240,44,90,.489,36,67,.537,8,23,.348,20,35,.571,116
12309,2014-04-16,DAL,@,MEM,L 105-106 (OT),265,44,92,.478,36,62,.581,8,30,.267,9,11,.818,105
12310,2014-04-16,MEM,,DAL,W 106-105 (OT),265,43,88,.489,38,68,.559,5,20,.250,15,25,.600,106
12311,2014-04-16,MIA,,PHI,L 87-100,240,30,73,.411,20,43,.465,10,30,.333,17,22,.773,87
12312,2014-04-16,PHI,@,MIA,W 100-87,240,38,74,.514,28,51,.549,10,23,.435,14,16,.875,100
12313,2014-04-16,ATL,@,MIL,W 111-103,240,41,76,.539,33,52,.635,8,24,.333,21,26,.808,111
12314,2014-04-16,MIL,,ATL,L 103-111,240,40,77,.519,33,59,.559,7,18,.389,16,21,.762,103
12315,2014-04-16,MIN,,UTA,L 130-136 (2OT),290,40,97,.412,32,72,.444,8,25,.320,42,54,.778,130
12316,2014-04-16,UTA,@,MIN,W 136-130 (2OT),290,53,108,.491,47,84,.560,6,24,.250,24,29,.828,136
12317,2014-04-16,HOU,@,NOP,L 100-105,240,35,81,.432,21,51,.412,14,30,.467,16,24,.667,100
12318,2014-04-16,NOP,,HOU,W 105-100,240,43,82,.524,37,70,.529,6,12,.500,13,20,.650,105
12319,2014-04-16,NYK,,TOR,W 95-92,240,37,81,.457,29,64,.453,8,17,.471,13,19,.684,95
12320,2014-04-16,TOR,@,NYK,L 92-95,240,36,80,.450,27,51,.529,9,29,.310,11,18,.611,92
12321,2014-04-16,DET,@,OKC,L 111-112,240,42,83,.506,34,64,.531,8,19,.421,19,31,.613,111
12322,2014-04-16,OKC,,DET,W 112-111,240,38,86,.442,33,63,.524,5,23,.217,31,41,.756,112
12323,2014-04-16,IND,@,ORL,W 101-86,240,41,88,.466,30,65,.462,11,23,.478,8,11,.727,101
12324,2014-04-16,ORL,,IND,L 86-101,240,32,79,.405,27,64,.422,5,15,.333,17,24,.708,86
12325,2014-04-16,LAC,@,POR,L 104-110,240,34,84,.405,26,50,.520,8,34,.235,28,33,.848,104
12326,2014-04-16,POR,,LAC,W 110-104,240,42,101,.416,32,75,.427,10,26,.385,16,22,.727,110
12327,2014-04-16,PHO,@,SAC,W 104-99,240,40,86,.465,32,66,.485,8,20,.400,16,22,.727,104
12328,2014-04-16,SAC,,PHO,L 99-104,240,37,86,.430,33,67,.493,4,19,.211,21,30,.700,99
12329,2014-04-16,LAL,@,SAS,W 113-100,240,45,91,.495,34,64,.531,11,27,.407,12,17,.706,113
12330,2014-04-16,SAS,,LAL,L 100-113,240,41,99,.414,31,69,.449,10,30,.333,8,10,.800,100
12331,2014-04-15,BRK,,NYK,L 98-109,240,33,75,.440,23,50,.460,10,25,.400,22,31,.710,98
12332,2014-04-15,NYK,@,BRK,W 109-98,240,32,67,.478,21,46,.457,11,21,.524,34,40,.850,109
12333,2014-04-15,DEN,@,LAC,L 105-117,240,35,82,.427,27,53,.509,8,29,.276,27,30,.900,105
12334,2014-04-15,LAC,,DEN,W 117-105,240,44,83,.530,35,59,.593,9,24,.375,20,30,.667,117
12335,2014-04-14,ATL,,CHA,L 93-95,240,34,79,.430,26,49,.531,8,30,.267,17,23,.739,93
12336,2014-04-14,CHA,@,ATL,W 95-93,240,35,80,.438,29,55,.527,6,25,.240,19,31,.613,95
12337,2014-04-14,CHI,,ORL,W 108-95,240,39,77,.506,34,64,.531,5,13,.385,25,32,.781,108
12338,2014-04-14,ORL,@,CHI,L 95-108,240,36,72,.500,29,57,.509,7,15,.467,16,19,.842,95
12339,2014-04-14,GSW,,MIN,W 130-120,240,49,101,.485,34,64,.531,15,37,.405,17,19,.895,130
12340,2014-04-14,MIN,@,GSW,L 120-130,240,43,81,.531,35,66,.530,8,15,.533,26,33,.788,120
12341,2014-04-14,HOU,,SAS,W 104-98,240,38,85,.447,34,63,.540,4,22,.182,24,29,.828,104
12342,2014-04-14,SAS,@,HOU,L 98-104,240,39,89,.438,35,72,.486,4,17,.235,16,18,.889,98
12343,2014-04-14,NOP,,OKC,W 101-89,240,35,79,.443,26,50,.520,9,29,.310,22,30,.733,101
12344,2014-04-14,OKC,@,NOP,L 89-101,240,31,77,.403,22,45,.489,9,32,.281,18,22,.818,89
12345,2014-04-14,BOS,@,PHI,L 108-113,240,40,86,.465,31,62,.500,9,24,.375,19,26,.731,108
12346,2014-04-14,PHI,,BOS,W 113-108,240,43,79,.544,40,67,.597,3,12,.250,24,38,.632,113
12347,2014-04-14,MEM,@,PHO,W 97-91,240,40,77,.519,34,62,.548,6,15,.400,11,15,.733,97
12348,2014-04-14,PHO,,MEM,L 91-97,240,38,80,.475,33,54,.611,5,26,.192,10,14,.714,91
12349,2014-04-14,MIL,@,TOR,L 100-110,240,38,73,.521,32,63,.508,6,10,.600,18,26,.692,100
12350,2014-04-14,TOR,,MIL,W 110-100,240,38,81,.469,24,49,.490,14,32,.438,20,26,.769,110
12351,2014-04-14,LAL,@,UTA,W 119-104,240,45,82,.549,35,58,.603,10,24,.417,19,22,.864,119
12352,2014-04-14,UTA,,LAL,L 104-119,240,42,81,.519,36,62,.581,6,19,.316,14,20,.700,104
12353,2014-04-14,MIA,@,WAS,L 93-114,240,36,80,.450,29,53,.547,7,27,.259,14,16,.875,93
12354,2014-04-14,WAS,,MIA,W 114-93,240,46,78,.590,32,49,.653,14,29,.483,8,15,.533,114
12355,2014-04-13,BRK,,ORL,W 97-88,240,34,73,.466,22,44,.500,12,29,.414,17,23,.739,97
12356,2014-04-13,ORL,@,BRK,L 88-97,240,35,74,.473,27,54,.500,8,20,.400,10,14,.714,88
12357,2014-04-13,DET,,TOR,L 107-116,240,35,84,.417,30,64,.469,5,20,.250,32,48,.667,107
12358,2014-04-13,TOR,@,DET,W 116-107,240,39,81,.481,30,58,.517,9,23,.391,29,35,.829,116
12359,2014-04-13,IND,,OKC,W 102-97,240,38,72,.528,29,52,.558,9,20,.450,17,23,.739,102
12360,2014-04-13,OKC,@,IND,L 97-102,240,36,84,.429,29,56,.518,7,28,.250,18,19,.947,97
12361,2014-04-13,LAL,,MEM,L 90-102,240,35,80,.438,24,53,.453,11,27,.407,9,11,.818,90
12362,2014-04-13,MEM,@,LAL,W 102-90,240,42,88,.477,34,73,.466,8,15,.533,10,13,.769,102
12363,2014-04-13,CHI,@,NYK,L 89-100,240,29,74,.392,23,52,.442,6,22,.273,25,32,.781,89
12364,2014-04-13,NYK,,CHI,W 100-89,240,37,81,.457,28,56,.500,9,25,.360,17,21,.810,100
12365,2014-04-13,GSW,@,POR,L 117-119 (OT),265,44,91,.484,27,54,.500,17,37,.459,12,16,.750,117
12366,2014-04-13,POR,,GSW,W 119-117 (OT),265,43,86,.500,33,62,.532,10,24,.417,23,32,.719,119
12367,2014-04-13,MIN,@,SAC,L 103-106,240,35,88,.398,28,66,.424,7,22,.318,26,30,.867,103
12368,2014-04-13,SAC,,MIN,W 106-103,240,41,82,.500,35,65,.538,6,17,.353,18,27,.667,106
12369,2014-04-12,ATL,,MIA,W 98-85,240,36,78,.462,26,56,.464,10,22,.455,16,19,.842,98
12370,2014-04-12,MIA,@,ATL,L 85-98,240,35,73,.479,29,48,.604,6,25,.240,9,19,.474,85
12371,2014-04-12,CHA,,PHI,W 111-105,240,39,72,.542,32,53,.604,7,19,.368,26,41,.634,111
12372,2014-04-12,PHI,@,CHA,L 105-111,240,41,93,.441,36,68,.529,5,25,.200,18,26,.692,105
12373,2014-04-12,BOS,@,CLE,W 111-99,240,42,90,.467,30,60,.500,12,30,.400,15,18,.833,111
12374,2014-04-12,CLE,,BOS,L 99-111,240,37,90,.411,32,72,.444,5,18,.278,20,30,.667,99
12375,2014-04-12,DAL,,PHO,W 101-98,240,39,79,.494,28,55,.509,11,24,.458,12,15,.800,101
12376,2014-04-12,PHO,@,DAL,L 98-101,240,36,78,.462,28,61,.459,8,17,.471,18,23,.783,98
12377,2014-04-12,DEN,,UTA,W 101-94,240,35,84,.417,28,62,.452,7,22,.318,24,29,.828,101
12378,2014-04-12,UTA,@,DEN,L 94-101,240,34,79,.430,32,66,.485,2,13,.154,24,32,.750,94
12379,2014-04-12,HOU,,NOP,W 111-104,240,35,74,.473,25,47,.532,10,27,.370,31,39,.795,111
12380,2014-04-12,NOP,@,HOU,L 104-111,240,39,88,.443,30,66,.455,9,22,.409,17,21,.810,104
12381,2014-04-12,LAC,,SAC,W 117-101,240,41,81,.506,32,62,.516,9,19,.474,26,36,.722,117
12382,2014-04-12,SAC,@,LAC,L 101-117,240,35,82,.427,31,73,.425,4,9,.444,27,33,.818,101
12383,2014-04-12,MIL,@,WAS,L 91-104,240,32,68,.471,27,60,.450,5,8,.625,22,34,.647,91
12384,2014-04-12,WAS,,MIL,W 104-91,240,40,84,.476,32,62,.516,8,22,.364,16,19,.842,104
12385,2014-04-11,BOS,,CHA,W 106-103,240,41,79,.519,30,56,.536,11,23,.478,13,13,1.000,106
12386,2014-04-11,CHA,@,BOS,L 103-106,240,44,87,.506,37,69,.536,7,18,.389,8,12,.667,103
12387,2014-04-11,ATL,@,BRK,W 93-88,240,36,79,.456,35,60,.583,1,19,.053,20,21,.952,93
12388,2014-04-11,BRK,,ATL,L 88-93,240,34,80,.425,28,58,.483,6,22,.273,14,25,.560,88
12389,2014-04-11,CHI,,DET,W 106-98,240,40,81,.494,35,62,.565,5,19,.263,21,23,.913,106
12390,2014-04-11,DET,@,CHI,L 98-106,240,40,86,.465,35,69,.507,5,17,.294,13,23,.565,98
12391,2014-04-11,GSW,@,LAL,W 112-95,240,45,92,.489,32,67,.478,13,25,.520,9,13,.692,112
12392,2014-04-11,LAL,,GSW,L 95-112,240,35,89,.393,26,61,.426,9,28,.321,16,20,.800,95
12393,2014-04-11,MEM,,PHI,W 117-95,240,44,81,.543,39,68,.574,5,13,.385,24,32,.750,117
12394,2014-04-11,PHI,@,MEM,L 95-117,240,39,88,.443,33,70,.471,6,18,.333,11,17,.647,95
12395,2014-04-11,IND,@,MIA,L 86-98,240,31,65,.477,23,51,.451,8,14,.571,16,19,.842,86
12396,2014-04-11,MIA,,IND,W 98-86,240,35,75,.467,29,59,.492,6,16,.375,22,28,.786,98
12397,2014-04-11,CLE,@,MIL,L 116-119,240,42,85,.494,38,65,.585,4,20,.200,28,35,.800,116
12398,2014-04-11,MIL,,CLE,W 119-116,240,44,84,.524,38,68,.559,6,16,.375,25,38,.658,119
12399,2014-04-11,HOU,@,MIN,L 110-112,240,36,83,.434,25,58,.431,11,25,.440,27,36,.750,110
12400,2014-04-11,MIN,,HOU,W 112-110,240,41,94,.436,38,82,.463,3,12,.250,27,40,.675,112
12401,2014-04-11,NOP,@,OKC,L 94-116,240,35,86,.407,26,68,.382,9,18,.500,15,19,.789,94
12402,2014-04-11,OKC,,NOP,W 116-94,240,44,82,.537,39,69,.565,5,13,.385,23,27,.852,116
12403,2014-04-11,ORL,,WAS,L 86-96,240,32,77,.416,28,58,.483,4,19,.211,18,24,.750,86
12404,2014-04-11,WAS,@,ORL,W 96-86,240,35,82,.427,33,63,.524,2,19,.105,24,33,.727,96
12405,2014-04-11,PHO,@,SAS,L 104-112,240,39,82,.476,30,56,.536,9,26,.346,17,19,.895,104
12406,2014-04-11,SAS,,PHO,W 112-104,240,43,96,.448,30,66,.455,13,30,.433,13,16,.813,112
12407,2014-04-11,NYK,@,TOR,W 108-100,240,35,73,.479,29,49,.592,6,24,.250,32,36,.889,108
12408,2014-04-11,TOR,,NYK,L 100-108,240,30,76,.395,15,43,.349,15,33,.455,25,31,.806,100
12409,2014-04-11,POR,@,UTA,W 111-99,240,40,87,.460,29,65,.446,11,22,.500,20,24,.833,111
12410,2014-04-11,UTA,,POR,L 99-111,240,40,86,.465,34,73,.466,6,13,.462,13,16,.813,99
12411,2014-04-10,DAL,,SAS,L 100-109,240,39,83,.470,34,71,.479,5,12,.417,17,21,.810,100
12412,2014-04-10,SAS,@,DAL,W 109-100,240,38,88,.432,22,54,.407,16,34,.471,17,22,.773,109
12413,2014-04-10,DEN,@,GSW,W 100-99,240,39,104,.375,29,70,.414,10,34,.294,12,19,.632,100
12414,2014-04-10,GSW,,DEN,L 99-100,240,40,88,.455,34,65,.523,6,23,.261,13,15,.867,99
12415,2014-04-09,ATL,,BOS,W 105-97,240,40,76,.526,31,53,.585,9,23,.391,16,22,.727,105
12416,2014-04-09,BOS,@,ATL,L 97-105,240,37,84,.440,25,58,.431,12,26,.462,11,14,.786,97
12417,2014-04-09,CLE,,DET,W 122-100,240,53,93,.570,42,67,.627,11,26,.423,5,9,.556,122
12418,2014-04-09,DET,@,CLE,L 100-122,240,34,96,.354,25,68,.368,9,28,.321,23,32,.719,100
12419,2014-04-09,DEN,,HOU,W 123-116,240,50,101,.495,39,73,.534,11,28,.393,12,14,.857,123
12420,2014-04-09,HOU,@,DEN,L 116-123,240,40,92,.435,25,52,.481,15,40,.375,21,25,.840,116
12421,2014-04-09,LAC,,OKC,L 101-107,240,36,86,.419,28,59,.475,8,27,.296,21,34,.618,101
12422,2014-04-09,OKC,@,LAC,W 107-101,240,38,90,.422,33,69,.478,5,21,.238,26,32,.813,107
12423,2014-04-09,MEM,,MIA,W 107-102,240,43,78,.551,36,58,.621,7,20,.350,14,21,.667,107
12424,2014-04-09,MIA,@,MEM,L 102-107,240,38,73,.521,23,48,.479,15,25,.600,11,12,.917,102
12425,2014-04-09,IND,@,MIL,W 104-102,240,41,85,.482,30,61,.492,11,24,.458,11,19,.579,104
12426,2014-04-09,MIL,,IND,L 102-104,240,38,87,.437,34,71,.479,4,16,.250,22,29,.759,102
12427,2014-04-09,CHI,@,MIN,W 102-87,240,41,82,.500,30,61,.492,11,21,.524,9,12,.750,102
12428,2014-04-09,MIN,,CHI,L 87-102,240,34,80,.425,30,63,.476,4,17,.235,15,16,.938,87
12429,2014-04-09,NOP,,PHO,L 88-94,240,34,80,.425,28,66,.424,6,14,.429,14,17,.824,88
12430,2014-04-09,PHO,@,NOP,W 94-88,240,39,80,.488,30,61,.492,9,19,.474,7,10,.700,94
12431,2014-04-09,BRK,@,ORL,L 111-115,240,38,79,.481,28,50,.560,10,29,.345,25,34,.735,111
12432,2014-04-09,ORL,,BRK,W 115-111,240,43,77,.558,32,53,.604,11,24,.458,18,30,.600,115
12433,2014-04-09,POR,,SAC,W 100-99,240,38,75,.507,31,52,.596,7,23,.304,17,22,.773,100
12434,2014-04-09,SAC,@,POR,L 99-100,240,39,91,.429,34,80,.425,5,11,.455,16,22,.727,99
12435,2014-04-09,PHI,@,TOR,L 114-125,240,44,85,.518,36,64,.563,8,21,.381,18,21,.857,114
12436,2014-04-09,TOR,,PHI,W 125-114,240,41,82,.500,29,57,.509,12,25,.480,31,37,.838,125
12437,2014-04-09,CHA,@,WAS,W 94-88 (OT),265,35,92,.380,24,67,.358,11,25,.440,13,15,.867,94
12438,2014-04-09,WAS,,CHA,L 88-94 (OT),265,37,82,.451,36,67,.537,1,15,.067,13,20,.650,88
12439,2014-04-08,ATL,,DET,L 95-102,240,34,89,.382,25,54,.463,9,35,.257,18,24,.750,95
12440,2014-04-08,DET,@,ATL,W 102-95,240,37,86,.430,31,69,.449,6,17,.353,22,32,.688,102
12441,2014-04-08,HOU,@,LAL,W 145-130,240,56,97,.577,45,71,.634,11,26,.423,22,28,.786,145
12442,2014-04-08,LAL,,HOU,L 130-145,240,44,95,.463,30,63,.476,14,32,.438,28,35,.800,130
12443,2014-04-08,BRK,@,MIA,W 88-87,240,36,68,.529,27,45,.600,9,23,.391,7,14,.500,88
12444,2014-04-08,MIA,,BRK,L 87-88,240,33,69,.478,26,45,.578,7,24,.292,14,19,.737,87
12445,2014-04-08,MIN,,SAS,W 110-91,240,42,91,.462,37,76,.487,5,15,.333,21,26,.808,110
12446,2014-04-08,SAS,@,MIN,L 91-110,240,36,81,.444,32,64,.500,4,17,.235,15,25,.600,91
12447,2014-04-08,OKC,@,SAC,W 107-92,240,38,80,.475,26,58,.448,12,22,.545,19,27,.704,107
12448,2014-04-08,SAC,,OKC,L 92-107,240,34,82,.415,31,68,.456,3,14,.214,21,28,.750,92
12449,2014-04-08,DAL,@,UTA,W 95-83,240,40,72,.556,31,49,.633,9,23,.391,6,11,.545,95
12450,2014-04-08,UTA,,DAL,L 83-95,240,36,87,.414,32,63,.508,4,24,.167,7,13,.538,83
12451,2014-04-06,GSW,,UTA,W 130-102,240,52,90,.578,35,57,.614,17,33,.515,9,9,1.000,130
12452,2014-04-06,UTA,@,GSW,L 102-130,240,39,86,.453,35,73,.479,4,13,.308,20,28,.714,102
12453,2014-04-06,DEN,@,HOU,L 125-130 (OT),265,51,107,.477,37,76,.487,14,31,.452,9,13,.692,125
12454,2014-04-06,HOU,,DEN,W 130-125 (OT),265,45,98,.459,32,62,.516,13,36,.361,27,40,.675,130
12455,2014-04-06,ATL,@,IND,W 107-88,240,41,73,.562,29,46,.630,12,27,.444,13,17,.765,107
12456,2014-04-06,IND,,ATL,L 88-107,240,32,78,.410,27,58,.466,5,20,.250,19,30,.633,88
12457,2014-04-06,LAC,,LAL,W 120-97,240,47,83,.566,37,64,.578,10,19,.526,16,26,.615,120
12458,2014-04-06,LAL,@,LAC,L 97-120,240,36,86,.419,29,55,.527,7,31,.226,18,23,.783,97
12459,2014-04-06,MIA,,NYK,W 102-91,240,34,61,.557,22,34,.647,12,27,.444,22,30,.733,102
12460,2014-04-06,NYK,@,MIA,L 91-102,240,33,88,.375,18,46,.391,15,42,.357,10,13,.769,91
12461,2014-04-06,OKC,@,PHO,L 115-122,240,40,84,.476,31,52,.596,9,32,.281,26,32,.813,115
12462,2014-04-06,PHO,,OKC,W 122-115,240,45,77,.584,34,54,.630,11,23,.478,21,31,.677,122
12463,2014-04-06,NOP,@,POR,L 94-100,240,38,90,.422,34,78,.436,4,12,.333,14,18,.778,94
12464,2014-04-06,POR,,NOP,W 100-94,240,41,87,.471,36,65,.554,5,22,.227,13,15,.867,100
12465,2014-04-06,DAL,@,SAC,W 93-91,240,36,89,.404,23,58,.397,13,31,.419,8,14,.571,93
12466,2014-04-06,SAC,,DAL,L 91-93,240,36,76,.474,31,58,.534,5,18,.278,14,20,.700,91
12467,2014-04-06,MEM,@,SAS,L 92-112,240,38,86,.442,33,72,.458,5,14,.357,11,17,.647,92
12468,2014-04-06,SAS,,MEM,W 112-92,240,43,77,.558,34,55,.618,9,22,.409,17,18,.944,112
12469,2014-04-05,CHA,@,CLE,W 96-94 (OT),265,34,91,.374,25,65,.385,9,26,.346,19,27,.704,96
12470,2014-04-05,CLE,,CHA,L 94-96 (OT),265,35,96,.365,28,74,.378,7,22,.318,17,21,.810,94
12471,2014-04-05,BOS,@,DET,L 111-115,240,42,88,.477,28,57,.491,14,31,.452,13,16,.813,111
12472,2014-04-05,DET,,BOS,W 115-111,240,38,79,.481,29,56,.518,9,23,.391,30,36,.833,115
12473,2014-04-05,MIL,,TOR,L 98-102,240,38,79,.481,37,70,.529,1,9,.111,21,27,.778,98
12474,2014-04-05,TOR,@,MIL,W 102-98,240,36,81,.444,24,54,.444,12,27,.444,18,22,.818,102
12475,2014-04-05,MIN,@,ORL,L 92-100,240,36,77,.468,35,63,.556,1,14,.071,19,28,.679,92
12476,2014-04-05,ORL,,MIN,W 100-92,240,43,79,.544,34,62,.548,9,17,.529,5,9,.556,100
12477,2014-04-05,BRK,@,PHI,W 105-101,240,41,80,.513,35,59,.593,6,21,.286,17,23,.739,105
12478,2014-04-05,PHI,,BRK,L 101-105,240,36,79,.456,26,56,.464,10,23,.435,19,27,.704,101
12479,2014-04-05,CHI,@,WAS,W 96-78,240,35,79,.443,26,56,.464,9,23,.391,17,21,.810,96
12480,2014-04-05,WAS,,CHI,L 78-96,240,34,86,.395,31,70,.443,3,16,.188,7,12,.583,78
12481,2014-04-04,ATL,,CLE,W 117-98,240,48,82,.585,35,53,.660,13,29,.448,8,10,.800,117
12482,2014-04-04,CLE,@,ATL,L 98-117,240,36,91,.396,31,70,.443,5,21,.238,21,25,.840,98
12483,2014-04-04,BOS,,PHI,L 102-111,240,38,87,.437,29,54,.537,9,33,.273,17,21,.810,102
12484,2014-04-04,PHI,@,BOS,W 111-102,240,39,77,.506,33,58,.569,6,19,.316,27,37,.730,111
12485,2014-04-04,BRK,,DET,W 116-104,240,46,76,.605,31,45,.689,15,31,.484,9,11,.818,116
12486,2014-04-04,DET,@,BRK,L 104-116,240,41,88,.466,32,61,.525,9,27,.333,13,21,.619,104
12487,2014-04-04,CHA,,ORL,W 91-80,240,33,78,.423,27,62,.435,6,16,.375,19,23,.826,91
12488,2014-04-04,ORL,@,CHA,L 80-91,240,31,87,.356,28,76,.368,3,11,.273,15,18,.833,80
12489,2014-04-04,CHI,,MIL,W 102-90,240,31,84,.369,24,62,.387,7,22,.318,33,42,.786,102
12490,2014-04-04,MIL,@,CHI,L 90-102,240,31,68,.456,29,60,.483,2,8,.250,26,35,.743,90
12491,2014-04-04,GSW,,SAC,W 102-69,240,42,93,.452,32,63,.508,10,30,.333,8,12,.667,102
12492,2014-04-04,SAC,@,GSW,L 69-102,240,25,78,.321,24,68,.353,1,10,.100,18,25,.720,69
12493,2014-04-04,HOU,,OKC,W 111-107,240,33,78,.423,20,47,.426,13,31,.419,32,37,.865,111
12494,2014-04-04,OKC,@,HOU,L 107-111,240,38,85,.447,25,54,.463,13,31,.419,18,20,.900,107
12495,2014-04-04,DAL,@,LAL,W 107-95,240,44,92,.478,39,71,.549,5,21,.238,14,15,.933,107
12496,2014-04-04,LAL,,DAL,L 95-107,240,35,83,.422,28,55,.509,7,28,.250,18,24,.750,95
12497,2014-04-04,DEN,@,MEM,L 92-100,240,29,80,.363,22,57,.386,7,23,.304,27,32,.844,92
12498,2014-04-04,MEM,,DEN,W 100-92,240,32,83,.386,30,72,.417,2,11,.182,34,38,.895,100
12499,2014-04-04,MIA,,MIN,L 121-122 (2OT),290,43,99,.434,32,63,.508,11,36,.306,24,30,.800,121
12500,2014-04-04,MIN,@,MIA,W 122-121 (2OT),290,43,93,.462,31,61,.508,12,32,.375,24,34,.706,122
12501,2014-04-04,NYK,,WAS,L 89-90,240,34,76,.447,20,45,.444,14,31,.452,7,8,.875,89
12502,2014-04-04,WAS,@,NYK,W 90-89,240,38,78,.487,33,59,.559,5,19,.263,9,15,.600,90
12503,2014-04-04,PHO,@,POR,W 109-93,240,39,97,.402,33,76,.434,6,21,.286,25,31,.806,109
12504,2014-04-04,POR,,PHO,L 93-109,240,35,81,.432,29,60,.483,6,21,.286,17,27,.630,93
12505,2014-04-04,IND,@,TOR,L 94-102,240,33,78,.423,27,67,.403,6,11,.545,22,28,.786,94
12506,2014-04-04,TOR,,IND,W 102-94,240,40,84,.476,30,62,.484,10,22,.455,12,16,.750,102
12507,2014-04-04,NOP,@,UTA,L 96-100,240,34,73,.466,26,54,.481,8,19,.421,20,29,.690,96
12508,2014-04-04,UTA,,NOP,W 100-96,240,33,64,.516,29,53,.547,4,11,.364,30,35,.857,100
12509,2014-04-03,DAL,@,LAC,W 113-107,240,41,82,.500,27,53,.509,14,29,.483,17,20,.850,113
12510,2014-04-03,LAC,,DAL,L 107-113,240,39,91,.429,33,64,.516,6,27,.222,23,29,.793,107
12511,2014-04-03,OKC,,SAS,W 106-94,240,40,81,.494,34,63,.540,6,18,.333,20,23,.870,106
12512,2014-04-03,SAS,@,OKC,L 94-106,240,38,88,.432,29,66,.439,9,22,.409,9,12,.750,94
12513,2014-04-02,ATL,,CHI,L 92-105,240,32,72,.444,24,48,.500,8,24,.333,20,26,.769,92
12514,2014-04-02,CHI,@,ATL,W 105-92,240,40,78,.513,28,53,.528,12,25,.480,13,15,.867,105
12515,2014-04-02,DEN,,NOP,W 137-107,240,52,92,.565,37,65,.569,15,27,.556,18,25,.720,137
12516,2014-04-02,NOP,@,DEN,L 107-137,240,35,74,.473,33,65,.508,2,9,.222,35,45,.778,107
12517,2014-04-02,DET,@,IND,L 94-101,240,34,93,.366,27,77,.351,7,16,.438,19,28,.679,94
12518,2014-04-02,IND,,DET,W 101-94,240,39,79,.494,34,61,.557,5,18,.278,18,24,.750,101
12519,2014-04-02,MIA,,MIL,W 96-77,240,39,77,.506,30,51,.588,9,26,.346,9,14,.643,96
12520,2014-04-02,MIL,@,MIA,L 77-96,240,32,73,.438,28,55,.509,4,18,.222,9,9,1.000,77
12521,2014-04-02,MEM,@,MIN,L 88-102,240,40,95,.421,36,84,.429,4,11,.364,4,6,.667,88
12522,2014-04-02,MIN,,MEM,W 102-88,240,43,81,.531,38,65,.585,5,16,.313,11,16,.688,102
12523,2014-04-02,BRK,@,NYK,L 81-110,240,26,65,.400,18,39,.462,8,26,.308,21,28,.750,81
12524,2014-04-02,NYK,,BRK,W 110-81,240,42,70,.600,31,45,.689,11,25,.440,15,20,.750,110
12525,2014-04-02,CLE,@,ORL,W 119-98,240,45,78,.577,36,60,.600,9,18,.500,20,24,.833,119
12526,2014-04-02,ORL,,CLE,L 98-119,240,35,79,.443,24,51,.471,11,28,.393,17,20,.850,98
12527,2014-04-02,CHA,@,PHI,W 123-93,240,42,79,.532,30,57,.526,12,22,.545,27,35,.771,123
12528,2014-04-02,PHI,,CHA,L 93-123,240,35,83,.422,31,65,.477,4,18,.222,19,26,.731,93
12529,2014-04-02,LAC,@,PHO,W 112-108,240,37,79,.468,26,53,.491,11,26,.423,27,30,.900,112
12530,2014-04-02,PHO,,LAC,L 108-112,240,36,78,.462,28,50,.560,8,28,.286,28,33,.848,108
12531,2014-04-02,LAL,@,SAC,L 102-107,240,37,96,.385,25,68,.368,12,28,.429,16,20,.800,102
12532,2014-04-02,SAC,,LAL,W 107-102,240,42,86,.488,37,71,.521,5,15,.333,18,27,.667,107
12533,2014-04-02,GSW,@,SAS,L 90-111,240,36,85,.424,28,64,.438,8,21,.381,10,10,1.000,90
12534,2014-04-02,SAS,,GSW,W 111-90,240,44,83,.530,40,64,.625,4,19,.211,19,22,.864,111
12535,2014-04-02,HOU,@,TOR,L 103-107,240,36,87,.414,27,61,.443,9,26,.346,22,30,.733,103
12536,2014-04-02,TOR,,HOU,W 107-103,240,34,75,.453,24,50,.480,10,25,.400,29,39,.744,107
12537,2014-04-02,BOS,@,WAS,L 92-118,240,32,81,.395,29,57,.509,3,24,.125,25,30,.833,92
12538,2014-04-02,WAS,,BOS,W 118-92,240,45,72,.625,35,53,.660,10,19,.526,18,21,.857,118
12539,2014-04-01,BRK,,HOU,W 105-96,240,44,83,.530,38,58,.655,6,25,.240,11,17,.647,105
12540,2014-04-01,HOU,@,BRK,L 96-105,240,32,84,.381,22,49,.449,10,35,.286,22,28,.786,96
12541,2014-04-01,DAL,,GSW,L 120-122 (OT),265,47,96,.490,33,66,.500,14,30,.467,12,16,.750,120
12542,2014-04-01,GSW,@,DAL,W 122-120 (OT),265,52,91,.571,37,60,.617,15,31,.484,3,6,.500,122
12543,2014-04-01,LAL,,POR,L 112-124,240,41,92,.446,30,67,.448,11,25,.440,19,22,.864,112
12544,2014-04-01,POR,@,LAL,W 124-112,240,46,99,.465,33,70,.471,13,29,.448,19,21,.905,124
12545,2014-03-31,ATL,,PHI,W 103-95,240,36,84,.429,29,53,.547,7,31,.226,24,30,.800,103
12546,2014-03-31,PHI,@,ATL,L 95-103,240,36,77,.468,25,47,.532,11,30,.367,12,20,.600,95
12547,2014-03-31,CHA,,WAS,W 100-94,240,34,78,.436,31,57,.544,3,21,.143,29,34,.853,100
12548,2014-03-31,WAS,@,CHA,L 94-100,240,38,79,.481,29,62,.468,9,17,.529,9,13,.692,94
12549,2014-03-31,BOS,@,CHI,L 80-94,240,31,77,.403,24,52,.462,7,25,.280,11,15,.733,80
12550,2014-03-31,CHI,,BOS,W 94-80,240,38,80,.475,35,64,.547,3,16,.188,15,16,.938,94
12551,2014-03-31,DEN,,MEM,L 92-94,240,36,73,.493,30,53,.566,6,20,.300,14,24,.583,92
12552,2014-03-31,MEM,@,DEN,W 94-92,240,38,85,.447,33,76,.434,5,9,.556,13,23,.565,94
12553,2014-03-31,DET,,MIL,W 116-111,240,46,97,.474,37,74,.500,9,23,.391,15,21,.714,116
12554,2014-03-31,MIL,@,DET,L 111-116,240,39,88,.443,34,71,.479,5,17,.294,28,36,.778,111
12555,2014-03-31,IND,,SAS,L 77-103,240,26,69,.377,20,55,.364,6,14,.429,19,24,.792,77
12556,2014-03-31,SAS,@,IND,W 103-77,240,37,80,.463,29,63,.460,8,17,.471,21,25,.840,103
12557,2014-03-31,MIA,,TOR,W 93-83,240,34,66,.515,27,41,.659,7,25,.280,18,22,.818,93
12558,2014-03-31,TOR,@,MIA,L 83-93,240,35,70,.500,27,44,.614,8,26,.308,5,10,.500,83
12559,2014-03-31,LAC,@,MIN,W 114-104,240,38,82,.463,26,52,.500,12,30,.400,26,32,.813,114
12560,2014-03-31,MIN,,LAC,L 104-114,240,41,96,.427,31,70,.443,10,26,.385,12,14,.857,104
12561,2014-03-31,NOP,,SAC,L 97-102,240,36,73,.493,31,59,.525,5,14,.357,20,26,.769,97
12562,2014-03-31,SAC,@,NOP,W 102-97,240,38,80,.475,35,69,.507,3,11,.273,23,31,.742,102
12563,2014-03-31,NYK,@,UTA,W 92-83,240,33,70,.471,24,41,.585,9,29,.310,17,24,.708,92
12564,2014-03-31,UTA,,NYK,L 83-92,240,33,85,.388,25,61,.410,8,24,.333,9,15,.600,83
12565,2014-03-30,BOS,,CHI,L 102-107,240,40,87,.460,30,58,.517,10,29,.345,12,16,.750,102
12566,2014-03-30,CHI,@,BOS,W 107-102,240,37,70,.529,29,54,.537,8,16,.500,25,31,.806,107
12567,2014-03-30,BRK,,MIN,W 114-99,240,43,86,.500,31,53,.585,12,33,.364,16,22,.727,114
12568,2014-03-30,MIN,@,BRK,L 99-114,240,39,83,.470,36,71,.507,3,12,.250,18,27,.667,99
12569,2014-03-30,CLE,,IND,W 90-76,240,34,76,.447,29,62,.468,5,14,.357,17,21,.810,90
12570,2014-03-30,IND,@,CLE,L 76-90,240,29,78,.372,21,56,.375,8,22,.364,10,16,.625,76
12571,2014-03-30,GSW,,NYK,L 84-89,240,28,79,.354,18,48,.375,10,31,.323,18,22,.818,84
12572,2014-03-30,NYK,@,GSW,W 89-84,240,32,80,.400,23,55,.418,9,25,.360,16,18,.889,89
12573,2014-03-30,LAL,,PHO,W 115-99,240,44,83,.530,39,65,.600,5,18,.278,22,24,.917,115
12574,2014-03-30,PHO,@,LAL,L 99-115,240,35,91,.385,27,55,.491,8,36,.222,21,28,.750,99
12575,2014-03-30,OKC,,UTA,W 116-96,240,41,74,.554,30,56,.536,11,18,.611,23,26,.885,116
12576,2014-03-30,UTA,@,OKC,L 96-116,240,36,86,.419,30,65,.462,6,21,.286,18,24,.750,96
12577,2014-03-30,ORL,,TOR,L 93-98,240,38,69,.551,31,50,.620,7,19,.368,10,14,.714,93
12578,2014-03-30,TOR,@,ORL,W 98-93,240,33,73,.452,27,54,.500,6,19,.316,26,27,.963,98
12579,2014-03-30,MEM,@,POR,L 98-105,240,41,89,.461,36,72,.500,5,17,.294,11,18,.611,98
12580,2014-03-30,POR,,MEM,W 105-98,240,39,75,.520,34,60,.567,5,15,.333,22,25,.880,105
12581,2014-03-29,DAL,,SAC,W 103-100,240,34,70,.486,27,47,.574,7,23,.304,28,35,.800,103
12582,2014-03-29,SAC,@,DAL,L 100-103,240,42,81,.519,39,71,.549,3,10,.300,13,19,.684,100
12583,2014-03-29,HOU,,LAC,L 107-118,240,32,79,.405,25,54,.463,7,25,.280,36,45,.800,107
12584,2014-03-29,LAC,@,HOU,W 118-107,240,42,89,.472,30,48,.625,12,41,.293,22,36,.611,118
12585,2014-03-29,MIA,@,MIL,W 88-67,240,32,74,.432,25,51,.490,7,23,.304,17,21,.810,88
12586,2014-03-29,MIL,,MIA,L 67-88,240,27,79,.342,23,65,.354,4,14,.286,9,14,.643,67
12587,2014-03-29,DET,@,PHI,L 98-123,240,33,85,.388,27,64,.422,6,21,.286,26,32,.813,98
12588,2014-03-29,PHI,,DET,W 123-98,240,48,92,.522,36,71,.507,12,21,.571,15,19,.789,123
12589,2014-03-29,NOP,@,SAS,L 80-96,240,32,81,.395,29,69,.420,3,12,.250,13,16,.813,80
12590,2014-03-29,SAS,,NOP,W 96-80,240,37,78,.474,28,57,.491,9,21,.429,13,20,.650,96
12591,2014-03-29,ATL,@,WAS,L 97-101,240,34,80,.425,25,49,.510,9,31,.290,20,28,.714,97
12592,2014-03-29,WAS,,ATL,W 101-97,240,39,79,.494,33,65,.508,6,14,.429,17,25,.680,101
12593,2014-03-28,BRK,,CLE,W 108-97,240,39,71,.549,25,42,.595,14,29,.483,16,21,.762,108
12594,2014-03-28,CLE,@,BRK,L 97-108,240,37,87,.425,27,63,.429,10,24,.417,13,16,.813,97
12595,2014-03-28,CHI,,POR,L 74-91,240,33,84,.393,30,67,.448,3,17,.176,5,7,.714,74
12596,2014-03-28,POR,@,CHI,W 91-74,240,35,80,.438,25,58,.431,10,22,.455,11,16,.688,91
12597,2014-03-28,DEN,,SAS,L 102-133,240,35,87,.402,29,64,.453,6,23,.261,26,35,.743,102
12598,2014-03-28,SAS,@,DEN,W 133-102,240,55,98,.561,42,74,.568,13,24,.542,10,14,.714,133
12599,2014-03-28,DET,,MIA,L 78-110,240,30,79,.380,27,55,.491,3,24,.125,15,21,.714,78
12600,2014-03-28,MIA,@,DET,W 110-78,240,43,79,.544,35,60,.583,8,19,.421,16,22,.727,110
12601,2014-03-28,GSW,,MEM,W 100-93,240,40,81,.494,31,61,.508,9,20,.450,11,14,.786,100
12602,2014-03-28,MEM,@,GSW,L 93-100,240,41,81,.506,39,69,.565,2,12,.167,9,16,.563,93
12603,2014-03-28,LAL,@,MIN,L 107-143,240,44,102,.431,37,77,.481,7,25,.280,12,15,.800,107
12604,2014-03-28,MIN,,LAL,W 143-107,240,51,76,.671,43,58,.741,8,18,.444,33,40,.825,143
12605,2014-03-28,NOP,,UTA,W 102-95,240,36,71,.507,30,57,.526,6,14,.429,24,32,.750,102
12606,2014-03-28,UTA,@,NOP,L 95-102,240,33,68,.485,26,47,.553,7,21,.333,22,27,.815,95
12607,2014-03-28,OKC,,SAC,W 94-81,240,33,69,.478,24,46,.522,9,23,.391,19,25,.760,94
12608,2014-03-28,SAC,@,OKC,L 81-94,240,31,85,.365,22,67,.328,9,18,.500,10,16,.625,81
12609,2014-03-28,CHA,@,ORL,L 105-110 (OT),265,43,97,.443,35,75,.467,8,22,.364,11,14,.786,105
12610,2014-03-28,ORL,,CHA,W 110-105 (OT),265,39,87,.448,33,69,.478,6,18,.333,26,35,.743,110
12611,2014-03-28,NYK,@,PHO,L 88-112,240,35,87,.402,27,62,.435,8,25,.320,10,16,.625,88
12612,2014-03-28,PHO,,NYK,W 112-88,240,40,88,.455,26,55,.473,14,33,.424,18,23,.783,112
12613,2014-03-28,BOS,@,TOR,L 103-105,240,40,76,.526,34,58,.586,6,18,.333,17,20,.850,103
12614,2014-03-28,TOR,,BOS,W 105-103,240,40,86,.465,35,66,.530,5,20,.250,20,22,.909,105
12615,2014-03-28,IND,@,WAS,L 78-91,240,28,79,.354,26,66,.394,2,13,.154,20,25,.800,78
12616,2014-03-28,WAS,,IND,W 91-78,240,34,87,.391,27,64,.422,7,23,.304,16,17,.941,91
12617,2014-03-27,ATL,,POR,L 85-100,240,34,84,.405,30,62,.484,4,22,.182,13,17,.765,85
12618,2014-03-27,POR,@,ATL,W 100-85,240,37,80,.463,27,54,.500,10,26,.385,16,21,.762,100
12619,2014-03-27,DAL,,LAC,L 103-109,240,37,79,.468,27,59,.458,10,20,.500,19,27,.704,103
12620,2014-03-27,LAC,@,DAL,W 109-103,240,38,82,.463,27,56,.482,11,26,.423,22,25,.880,109
12621,2014-03-27,HOU,,PHI,W 120-98,240,44,90,.489,35,64,.547,9,26,.346,23,34,.676,120
12622,2014-03-27,PHI,@,HOU,L 98-120,240,35,90,.389,21,54,.389,14,36,.389,14,22,.636,98
12623,2014-03-27,LAL,@,MIL,L 105-108,240,42,85,.494,35,64,.547,7,21,.333,14,18,.778,105
12624,2014-03-27,MIL,,LAL,W 108-105,240,39,70,.557,33,60,.550,6,10,.600,24,34,.706,108
12625,2014-03-26,BOS,,TOR,L 90-99,240,32,79,.405,23,57,.404,9,22,.409,17,22,.773,90
12626,2014-03-26,TOR,@,BOS,W 99-90,240,36,80,.450,25,57,.439,11,23,.478,16,18,.889,99
12627,2014-03-26,BRK,@,CHA,L 111-116 (OT),265,40,83,.482,23,46,.500,17,37,.459,14,16,.875,111
12628,2014-03-26,CHA,,BRK,W 116-111 (OT),265,46,92,.500,38,71,.535,8,21,.381,16,23,.696,116
12629,2014-03-26,CLE,@,DET,W 97-96,240,37,85,.435,28,59,.475,9,26,.346,14,24,.583,97
12630,2014-03-26,DET,,CLE,L 96-97,240,39,84,.464,28,58,.483,11,26,.423,7,13,.538,96
12631,2014-03-26,IND,,MIA,W 84-83,240,30,81,.370,23,67,.343,7,14,.500,17,21,.810,84
12632,2014-03-26,MIA,@,IND,L 83-84,240,28,61,.459,22,42,.524,6,19,.316,21,29,.724,83
12633,2014-03-26,ATL,@,MIN,L 83-107,240,31,82,.378,24,54,.444,7,28,.250,14,16,.875,83
12634,2014-03-26,MIN,,ATL,W 107-83,240,43,86,.500,34,64,.531,9,22,.409,12,16,.750,107
12635,2014-03-26,LAC,@,NOP,L 96-98,240,33,80,.413,20,50,.400,13,30,.433,17,28,.607,96
12636,2014-03-26,NOP,,LAC,W 98-96,240,38,90,.422,35,78,.449,3,12,.250,19,25,.760,98
12637,2014-03-26,NYK,@,SAC,W 107-99,240,40,73,.548,25,47,.532,15,26,.577,12,13,.923,107
12638,2014-03-26,SAC,,NYK,L 99-107,240,33,69,.478,27,52,.519,6,17,.353,27,35,.771,99
12639,2014-03-26,DEN,@,SAS,L 103-108,240,38,83,.458,31,64,.484,7,19,.368,20,25,.800,103
12640,2014-03-26,SAS,,DEN,W 108-103,240,43,88,.489,35,68,.515,8,20,.400,14,20,.700,108
12641,2014-03-26,MEM,@,UTA,W 91-87,240,36,79,.456,32,70,.457,4,9,.444,15,16,.938,91
12642,2014-03-26,UTA,,MEM,L 87-91,240,32,69,.464,27,53,.509,5,16,.313,18,26,.692,87
12643,2014-03-26,PHO,@,WAS,W 99-93,240,37,75,.493,23,47,.489,14,28,.500,11,12,.917,99
12644,2014-03-26,WAS,,PHO,L 93-99,240,37,81,.457,31,62,.500,6,19,.316,13,21,.619,93
12645,2014-03-25,CLE,,TOR,W 102-100,240,36,70,.514,32,57,.561,4,13,.308,26,33,.788,102
12646,2014-03-25,TOR,@,CLE,L 100-102,240,35,88,.398,21,56,.375,14,32,.438,16,26,.615,100
12647,2014-03-25,DAL,,OKC,W 128-119 (OT),265,45,90,.500,30,52,.577,15,38,.395,23,28,.821,128
12648,2014-03-25,OKC,@,DAL,L 119-128 (OT),265,46,93,.495,34,60,.567,12,33,.364,15,19,.789,119
12649,2014-03-25,LAL,,NYK,W 127-96,240,48,83,.578,30,55,.545,18,28,.643,13,15,.867,127
12650,2014-03-25,NYK,@,LAL,L 96-127,240,36,74,.486,32,59,.542,4,15,.267,20,27,.741,96
12651,2014-03-25,ORL,,POR,W 95-85,240,37,85,.435,31,68,.456,6,17,.353,15,22,.682,95
12652,2014-03-25,POR,@,ORL,L 85-95,240,32,86,.372,25,60,.417,7,26,.269,14,17,.824,85
12653,2014-03-24,ATL,,PHO,L 95-102,240,30,72,.417,22,49,.449,8,23,.348,27,33,.818,95
12654,2014-03-24,PHO,@,ATL,W 102-95,240,38,74,.514,26,50,.520,12,24,.500,14,16,.875,102
12655,2014-03-24,CHA,,HOU,L 89-100,240,32,86,.372,28,65,.431,4,21,.190,21,25,.840,89
12656,2014-03-24,HOU,@,CHA,W 100-89,240,39,82,.476,27,55,.491,12,27,.444,10,18,.556,100
12657,2014-03-24,CHI,,IND,W 89-77,240,35,84,.417,31,69,.449,4,15,.267,15,16,.938,89
12658,2014-03-24,IND,@,CHI,L 77-89,240,27,73,.370,23,63,.365,4,10,.400,19,21,.905,77
12659,2014-03-24,LAC,,MIL,W 106-98,240,38,78,.487,30,60,.500,8,18,.444,22,27,.815,106
12660,2014-03-24,MIL,@,LAC,L 98-106,240,41,85,.482,36,72,.500,5,13,.385,11,16,.688,98
12661,2014-03-24,MEM,,MIN,W 109-92,240,48,91,.527,42,79,.532,6,12,.500,7,13,.538,109
12662,2014-03-24,MIN,@,MEM,L 92-109,240,34,90,.378,27,66,.409,7,24,.292,17,20,.850,92
12663,2014-03-24,MIA,,POR,W 93-91,240,37,84,.440,32,69,.464,5,15,.333,14,23,.609,93
12664,2014-03-24,POR,@,MIA,L 91-93,240,28,74,.378,17,35,.486,11,39,.282,24,27,.889,91
12665,2014-03-24,BRK,@,NOP,L 104-109 (OT),265,33,90,.367,23,50,.460,10,40,.250,28,32,.875,104
12666,2014-03-24,NOP,,BRK,W 109-104 (OT),265,40,85,.471,31,65,.477,9,20,.450,20,27,.741,109
12667,2014-03-24,DEN,@,OKC,L 96-117,240,30,77,.390,21,49,.429,9,28,.321,27,40,.675,96
12668,2014-03-24,OKC,,DEN,W 117-96,240,45,89,.506,34,67,.507,11,22,.500,16,21,.762,117
12669,2014-03-24,PHI,@,SAS,L 91-113,240,36,88,.409,25,55,.455,11,33,.333,8,18,.444,91
12670,2014-03-24,SAS,,PHI,W 113-91,240,44,79,.557,31,52,.596,13,27,.481,12,16,.750,113
12671,2014-03-24,DET,@,UTA,W 114-94,240,46,83,.554,37,66,.561,9,17,.529,13,18,.722,114
12672,2014-03-24,UTA,,DET,L 94-114,240,34,83,.410,27,56,.482,7,27,.259,19,28,.679,94
12673,2014-03-23,BRK,@,DAL,W 107-104 (OT),265,34,84,.405,23,54,.426,11,30,.367,28,33,.848,107
12674,2014-03-23,DAL,,BRK,L 104-107 (OT),265,35,91,.385,25,60,.417,10,31,.323,24,31,.774,104
12675,2014-03-23,DEN,,WAS,W 105-102,240,40,91,.440,29,64,.453,11,27,.407,14,18,.778,105
12676,2014-03-23,WAS,@,DEN,L 102-105,240,41,85,.482,36,70,.514,5,15,.333,15,18,.833,102
12677,2014-03-23,LAL,,ORL,W 103-94,240,37,80,.463,31,64,.484,6,16,.375,23,29,.793,103
12678,2014-03-23,ORL,@,LAL,L 94-103,240,37,82,.451,31,63,.492,6,19,.316,14,17,.824,94
12679,2014-03-23,MIN,,PHO,L 120-127,240,40,91,.440,32,68,.471,8,23,.348,32,37,.865,120
12680,2014-03-23,PHO,@,MIN,W 127-120,240,46,80,.575,34,53,.642,12,27,.444,23,29,.793,127
12681,2014-03-23,CLE,@,NYK,W 106-100,240,42,69,.609,33,51,.647,9,18,.500,13,17,.765,106
12682,2014-03-23,NYK,,CLE,L 100-106,240,35,77,.455,23,50,.460,12,27,.444,18,19,.947,100
12683,2014-03-23,MIL,@,SAC,L 107-124,240,42,85,.494,38,67,.567,4,18,.222,19,30,.633,107
12684,2014-03-23,SAC,,MIL,W 124-107,240,44,86,.512,37,66,.561,7,20,.350,29,36,.806,124
12685,2014-03-23,ATL,@,TOR,L 86-96,240,33,76,.434,28,56,.500,5,20,.250,15,20,.750,86
12686,2014-03-23,TOR,,ATL,W 96-86,240,34,80,.425,26,56,.464,8,24,.333,20,28,.714,96
12687,2014-03-22,CHA,,POR,W 124-94,240,49,94,.521,41,75,.547,8,19,.421,18,19,.947,124
12688,2014-03-22,POR,@,CHA,L 94-124,240,34,84,.405,25,57,.439,9,27,.333,17,22,.773,94
12689,2014-03-22,CHI,,PHI,W 91-81,240,31,70,.443,26,56,.464,5,14,.357,24,31,.774,91
12690,2014-03-22,PHI,@,CHI,L 81-91,240,30,87,.345,29,67,.433,1,20,.050,20,22,.909,81
12691,2014-03-22,CLE,,HOU,L 111-118,240,46,92,.500,40,75,.533,6,17,.353,13,17,.765,111
12692,2014-03-22,HOU,@,CLE,W 118-111,240,38,79,.481,26,44,.591,12,35,.343,30,34,.882,118
12693,2014-03-22,GSW,,SAS,L 90-99,240,31,77,.403,28,62,.452,3,15,.200,25,29,.862,90
12694,2014-03-22,SAS,@,GSW,W 99-90,240,35,89,.393,25,61,.410,10,28,.357,19,25,.760,99
12695,2014-03-22,DET,@,LAC,L 103-112,240,42,93,.452,30,64,.469,12,29,.414,7,13,.538,103
12696,2014-03-22,LAC,,DET,W 112-103,240,45,83,.542,34,54,.630,11,29,.379,11,17,.647,112
12697,2014-03-22,IND,@,MEM,L 71-82,240,27,74,.365,21,59,.356,6,15,.400,11,14,.786,71
12698,2014-03-22,MEM,,IND,W 82-71,240,33,75,.440,28,62,.452,5,13,.385,11,17,.647,82
12699,2014-03-22,MIA,@,NOP,L 95-105,240,37,73,.507,29,47,.617,8,26,.308,13,17,.765,95
12700,2014-03-22,NOP,,MIA,W 105-95,240,43,84,.512,36,67,.537,7,17,.412,12,17,.706,105
12701,2014-03-22,ORL,@,UTA,L 88-89,240,31,79,.392,24,62,.387,7,17,.412,19,24,.792,88
12702,2014-03-22,UTA,,ORL,W 89-88,240,29,75,.387,18,48,.375,11,27,.407,20,26,.769,89
12703,2014-03-21,ATL,,NOP,L 105-111,240,38,85,.447,30,57,.526,8,28,.286,21,27,.778,105
12704,2014-03-21,NOP,@,ATL,W 111-105,240,36,70,.514,32,57,.561,4,13,.308,35,43,.814,111
12705,2014-03-21,BOS,@,BRK,L 98-114,240,35,83,.422,26,56,.464,9,27,.333,19,23,.826,98
12706,2014-03-21,BRK,,BOS,W 114-98,240,44,78,.564,35,61,.574,9,17,.529,17,24,.708,114
12707,2014-03-21,DAL,,DEN,W 122-106,240,48,89,.539,36,67,.537,12,22,.545,14,17,.824,122
12708,2014-03-21,DEN,@,DAL,L 106-122,240,40,81,.494,27,51,.529,13,30,.433,13,21,.619,106
12709,2014-03-21,CHI,@,IND,L 79-91,240,28,77,.364,23,66,.348,5,11,.455,18,24,.750,79
12710,2014-03-21,IND,,CHI,W 91-79,240,34,79,.430,32,68,.471,2,11,.182,21,25,.840,91
12711,2014-03-21,LAL,,WAS,L 107-117,240,43,91,.473,36,72,.500,7,19,.368,14,23,.609,107
12712,2014-03-21,WAS,@,LAL,W 117-107,240,42,87,.483,32,62,.516,10,25,.400,23,29,.793,117
12713,2014-03-21,MEM,@,MIA,L 86-91,240,36,79,.456,33,65,.508,3,14,.214,11,17,.647,86
12714,2014-03-21,MIA,,MEM,W 91-86,240,35,75,.467,28,55,.509,7,20,.350,14,16,.875,91
12715,2014-03-21,NYK,@,PHI,W 93-92,240,34,82,.415,27,53,.509,7,29,.241,18,25,.720,93
12716,2014-03-21,PHI,,NYK,L 92-93,240,34,91,.374,24,50,.480,10,41,.244,14,21,.667,92
12717,2014-03-21,DET,@,PHO,L 92-98,240,39,90,.433,35,74,.473,4,16,.250,10,26,.385,92
12718,2014-03-21,PHO,,DET,W 98-92,240,33,73,.452,25,48,.521,8,25,.320,24,35,.686,98
12719,2014-03-21,SAC,,SAS,L 79-99,240,32,80,.400,28,66,.424,4,14,.286,11,18,.611,79
12720,2014-03-21,SAS,@,SAC,W 99-79,240,36,93,.387,31,68,.456,5,25,.200,22,27,.815,99
12721,2014-03-21,OKC,@,TOR,W 119-118 (2OT),290,38,98,.388,26,62,.419,12,36,.333,31,38,.816,119
12722,2014-03-21,TOR,,OKC,L 118-119 (2OT),290,41,101,.406,33,72,.458,8,29,.276,28,33,.848,118
12723,2014-03-20,CLE,,OKC,L 95-102,240,36,81,.444,28,59,.475,8,22,.364,15,24,.625,95
12724,2014-03-20,OKC,@,CLE,W 102-95,240,38,89,.427,28,58,.483,10,31,.323,16,20,.800,102
12725,2014-03-20,GSW,,MIL,W 115-110,240,43,80,.538,35,53,.660,8,27,.296,21,25,.840,115
12726,2014-03-20,MIL,@,GSW,L 110-115,240,39,80,.488,36,68,.529,3,12,.250,29,39,.744,110
12727,2014-03-20,HOU,,MIN,W 129-106,240,49,85,.576,33,47,.702,16,38,.421,15,19,.789,129
12728,2014-03-20,MIN,@,HOU,L 106-129,240,38,87,.437,26,59,.441,12,28,.429,18,23,.783,106
12729,2014-03-20,POR,,WAS,W 116-103,240,41,81,.506,27,46,.587,14,35,.400,20,25,.800,116
12730,2014-03-20,WAS,@,POR,L 103-116,240,38,90,.422,26,63,.413,12,27,.444,15,17,.882,103
12731,2014-03-19,BOS,,MIA,W 101-96,240,39,77,.506,26,49,.531,13,28,.464,10,12,.833,101
12732,2014-03-19,MIA,@,BOS,L 96-101,240,40,81,.494,36,64,.563,4,17,.235,12,15,.800,96
12733,2014-03-19,BRK,,CHA,W 104-99,240,37,75,.493,28,55,.509,9,20,.450,21,35,.600,104
12734,2014-03-19,CHA,@,BRK,L 99-104,240,40,85,.471,31,58,.534,9,27,.333,10,12,.833,99
12735,2014-03-19,DAL,,MIN,L 122-123 (OT),265,47,95,.495,38,68,.559,9,27,.333,19,25,.760,122
12736,2014-03-19,MIN,@,DAL,W 123-122 (OT),265,44,92,.478,34,63,.540,10,29,.345,25,31,.806,123
12737,2014-03-19,DEN,,DET,W 118-109,240,44,86,.512,33,59,.559,11,27,.407,19,27,.704,118
12738,2014-03-19,DET,@,DEN,L 109-118,240,43,95,.453,33,69,.478,10,26,.385,13,19,.684,109
12739,2014-03-19,LAL,,SAS,L 109-125,240,39,91,.429,30,65,.462,9,26,.346,22,29,.759,109
12740,2014-03-19,SAS,@,LAL,W 125-109,240,50,95,.526,38,68,.559,12,27,.444,13,16,.813,125
12741,2014-03-19,MEM,,UTA,W 96-86,240,36,81,.444,34,70,.486,2,11,.182,22,25,.880,96
12742,2014-03-19,UTA,@,MEM,L 86-96,240,37,84,.440,30,66,.455,7,18,.389,5,10,.500,86
12743,2014-03-19,NOP,,TOR,L 100-107,240,36,67,.537,32,54,.593,4,13,.308,24,32,.750,100
12744,2014-03-19,TOR,@,NOP,W 107-100,240,36,86,.419,27,64,.422,9,22,.409,26,32,.813,107
12745,2014-03-19,IND,@,NYK,L 86-92,240,31,73,.425,26,50,.520,5,23,.217,19,27,.704,86
12746,2014-03-19,NYK,,IND,W 92-86,240,32,82,.390,28,65,.431,4,17,.235,24,29,.828,92
12747,2014-03-19,CHI,@,PHI,W 102-94,240,36,83,.434,28,68,.412,8,15,.533,22,27,.815,102
12748,2014-03-19,PHI,,CHI,L 94-102,240,37,81,.457,26,57,.456,11,24,.458,9,19,.474,94
12749,2014-03-19,ORL,@,PHO,L 93-109,240,32,80,.400,26,67,.388,6,13,.462,23,30,.767,93
12750,2014-03-19,PHO,,ORL,W 109-93,240,45,89,.506,34,64,.531,11,25,.440,8,12,.667,109
12751,2014-03-18,ATL,,TOR,W 118-113 (OT),265,40,94,.426,29,60,.483,11,34,.324,27,31,.871,118
12752,2014-03-18,TOR,@,ATL,L 113-118 (OT),265,40,81,.494,33,57,.579,7,24,.292,26,29,.897,113
12753,2014-03-18,CLE,,MIA,L 96-100,240,37,72,.514,30,50,.600,7,22,.318,15,22,.682,96
12754,2014-03-18,MIA,@,CLE,W 100-96,240,34,75,.453,22,45,.489,12,30,.400,20,31,.645,100
12755,2014-03-18,GSW,,ORL,W 103-89,240,37,82,.451,27,55,.491,10,27,.370,19,21,.905,103
12756,2014-03-18,ORL,@,GSW,L 89-103,240,35,77,.455,31,64,.484,4,13,.308,15,20,.750,89
12757,2014-03-18,MIL,@,POR,L 115-120 (OT),265,45,98,.459,37,81,.457,8,17,.471,17,26,.654,115
12758,2014-03-18,POR,,MIL,W 120-115 (OT),265,42,97,.433,30,58,.517,12,39,.308,24,27,.889,120
12759,2014-03-18,SAC,,WAS,W 117-111 (OT),265,40,87,.460,34,69,.493,6,18,.333,31,40,.775,117
12760,2014-03-18,WAS,@,SAC,L 111-117 (OT),265,40,91,.440,29,63,.460,11,28,.393,20,30,.667,111
12761,2014-03-17,BRK,,PHO,W 108-95,240,41,70,.586,32,49,.653,9,21,.429,17,27,.630,108
12762,2014-03-17,PHO,@,BRK,L 95-108,240,37,80,.463,31,58,.534,6,22,.273,15,28,.536,95
12763,2014-03-17,ATL,@,CHA,W 97-83,240,39,85,.459,26,51,.510,13,34,.382,6,7,.857,97
12764,2014-03-17,CHA,,ATL,L 83-97,240,30,85,.353,21,60,.350,9,25,.360,14,16,.875,83
12765,2014-03-17,CHI,,OKC,L 85-97,240,29,84,.345,24,62,.387,5,22,.227,22,31,.710,85
12766,2014-03-17,OKC,@,CHI,W 97-85,240,31,75,.413,18,50,.360,13,25,.520,22,28,.786,97
12767,2014-03-17,BOS,@,DAL,L 89-94,240,34,93,.366,25,71,.352,9,22,.409,12,14,.857,89
12768,2014-03-17,DAL,,BOS,W 94-89,240,33,78,.423,24,51,.471,9,27,.333,19,21,.905,94
12769,2014-03-17,DEN,,LAC,W 110-100,240,38,93,.409,32,68,.471,6,25,.240,28,33,.848,110
12770,2014-03-17,LAC,@,DEN,L 100-110,240,36,92,.391,31,71,.437,5,21,.238,23,25,.920,100
12771,2014-03-17,HOU,,UTA,W 124-86,240,46,79,.582,33,54,.611,13,25,.520,19,26,.731,124
12772,2014-03-17,UTA,@,HOU,L 86-124,240,34,83,.410,30,65,.462,4,18,.222,14,18,.778,86
12773,2014-03-17,IND,,PHI,W 99-90,240,31,81,.383,25,63,.397,6,18,.333,31,38,.816,99
12774,2014-03-17,PHI,@,IND,L 90-99,240,35,81,.432,26,58,.448,9,23,.391,11,20,.550,90
12775,2014-03-16,CLE,@,LAC,L 80-102,240,29,83,.349,21,59,.356,8,24,.333,14,20,.700,80
12776,2014-03-16,LAC,,CLE,W 102-80,240,42,94,.447,34,66,.515,8,28,.286,10,15,.667,102
12777,2014-03-16,HOU,@,MIA,L 104-113,240,37,75,.493,28,52,.538,9,23,.391,21,28,.750,104
12778,2014-03-16,MIA,,HOU,W 113-104,240,40,78,.513,31,56,.554,9,22,.409,24,29,.828,113
12779,2014-03-16,CHA,@,MIL,W 101-92,240,39,68,.574,30,48,.625,9,20,.450,14,18,.778,101
12780,2014-03-16,MIL,,CHA,L 92-101,240,37,89,.416,30,71,.423,7,18,.389,11,16,.688,92
12781,2014-03-16,MIN,,SAC,W 104-102,240,34,78,.436,28,61,.459,6,17,.353,30,38,.789,104
12782,2014-03-16,SAC,@,MIN,L 102-104,240,41,85,.482,35,66,.530,6,19,.316,14,19,.737,102
12783,2014-03-16,BOS,@,NOP,L 120-121 (OT),265,45,97,.464,33,71,.465,12,26,.462,18,23,.783,120
12784,2014-03-16,NOP,,BOS,W 121-120 (OT),265,47,94,.500,44,79,.557,3,15,.200,24,28,.857,121
12785,2014-03-16,DAL,@,OKC,W 109-86,240,40,75,.533,27,51,.529,13,24,.542,16,20,.800,109
12786,2014-03-16,OKC,,DAL,L 86-109,240,29,79,.367,20,50,.400,9,29,.310,19,27,.704,86
12787,2014-03-16,GSW,@,POR,W 113-112,240,42,88,.477,31,58,.534,11,30,.367,18,22,.818,113
12788,2014-03-16,POR,,GSW,L 112-113,240,37,88,.420,25,60,.417,12,28,.429,26,30,.867,112
12789,2014-03-16,SAS,,UTA,W 122-104,240,49,78,.628,39,62,.629,10,16,.625,14,19,.737,122
12790,2014-03-16,UTA,@,SAS,L 104-122,240,42,91,.462,37,80,.463,5,11,.455,15,21,.714,104
12791,2014-03-16,PHO,@,TOR,W 121-113,240,38,75,.507,27,52,.519,11,23,.478,34,38,.895,121
12792,2014-03-16,TOR,,PHO,L 113-121,240,42,85,.494,35,62,.565,7,23,.304,22,25,.880,113
12793,2014-03-15,ATL,,DEN,W 97-92,240,33,81,.407,19,49,.388,14,32,.438,17,29,.586,97
12794,2014-03-15,DEN,@,ATL,L 92-97,240,34,83,.410,26,58,.448,8,25,.320,16,25,.640,92
12795,2014-03-15,CHI,,SAC,W 94-87,240,31,78,.397,25,58,.431,6,20,.300,26,33,.788,94
12796,2014-03-15,SAC,@,CHI,L 87-94,240,31,85,.365,29,71,.408,2,14,.143,23,37,.622,87
12797,2014-03-15,DET,,IND,L 104-112 (OT),265,37,91,.407,30,68,.441,7,23,.304,23,30,.767,104
12798,2014-03-15,IND,@,DET,W 112-104 (OT),265,41,104,.394,34,80,.425,7,24,.292,23,25,.920,112
12799,2014-03-15,MIL,@,NYK,L 94-115,240,35,81,.432,31,71,.437,4,10,.400,20,27,.741,94
12800,2014-03-15,NYK,,MIL,W 115-94,240,42,76,.553,34,56,.607,8,20,.400,23,28,.821,115
12801,2014-03-15,MEM,@,PHI,W 103-77,240,38,70,.543,34,55,.618,4,15,.267,23,32,.719,103
12802,2014-03-15,PHI,,MEM,L 77-103,240,31,83,.373,25,60,.417,6,23,.261,9,19,.474,77
12803,2014-03-15,BRK,@,WAS,L 94-101,240,34,71,.479,23,50,.460,11,21,.524,15,22,.682,94
12804,2014-03-15,WAS,,BRK,W 101-94,240,36,77,.468,28,51,.549,8,26,.308,21,25,.840,101
12805,2014-03-14,BOS,,PHO,L 80-87,240,29,94,.309,26,73,.356,3,21,.143,19,21,.905,80
12806,2014-03-14,PHO,@,BOS,W 87-80,240,34,80,.425,29,54,.537,5,26,.192,14,20,.700,87
12807,2014-03-14,CHA,,MIN,W 105-93,240,44,91,.484,36,72,.500,8,19,.421,9,14,.643,105
12808,2014-03-14,MIN,@,CHA,L 93-105,240,35,82,.427,29,67,.433,6,15,.400,17,21,.810,93
12809,2014-03-14,CLE,@,GSW,W 103-94,240,40,82,.488,30,60,.500,10,22,.455,13,18,.722,103
12810,2014-03-14,GSW,,CLE,L 94-103,240,35,77,.455,24,48,.500,11,29,.379,13,19,.684,94
12811,2014-03-14,DEN,@,MIA,W 111-107,240,39,82,.476,31,61,.508,8,21,.381,25,29,.862,111
12812,2014-03-14,MIA,,DEN,L 107-111,240,42,81,.519,35,57,.614,7,24,.292,16,21,.762,107
12813,2014-03-14,NOP,,POR,L 103-111,240,41,86,.477,38,75,.507,3,11,.273,18,21,.857,103
12814,2014-03-14,POR,@,NOP,W 111-103,240,38,78,.487,24,45,.533,14,33,.424,21,27,.778,111
12815,2014-03-14,ORL,,WAS,L 101-105 (OT),265,43,97,.443,36,72,.500,7,25,.280,8,10,.800,101
12816,2014-03-14,WAS,@,ORL,W 105-101 (OT),265,36,90,.400,26,67,.388,10,23,.435,23,29,.793,105
12817,2014-03-14,IND,@,PHI,W 101-94,240,39,67,.582,30,46,.652,9,21,.429,14,22,.636,101
12818,2014-03-14,PHI,,IND,L 94-101,240,35,90,.389,27,64,.422,8,26,.308,16,18,.889,94
12819,2014-03-14,LAL,@,SAS,L 85-119,240,31,91,.341,27,70,.386,4,21,.190,19,25,.760,85
12820,2014-03-14,SAS,,LAL,W 119-85,240,48,98,.490,35,71,.493,13,27,.481,10,13,.769,119
12821,2014-03-14,MEM,@,TOR,L 86-99,240,33,74,.446,31,66,.470,2,8,.250,18,27,.667,86
12822,2014-03-14,TOR,,MEM,W 99-86,240,36,71,.507,27,54,.500,9,17,.529,18,22,.818,99
12823,2014-03-14,LAC,@,UTA,W 96-87,240,37,76,.487,28,53,.528,9,23,.391,13,20,.650,96
12824,2014-03-14,UTA,,LAC,L 87-96,240,35,77,.455,28,63,.444,7,14,.500,10,13,.769,87
12825,2014-03-13,ATL,,MIL,W 102-97,240,36,74,.486,23,45,.511,13,29,.448,17,20,.850,102
12826,2014-03-13,MIL,@,ATL,L 97-102,240,37,89,.416,34,70,.486,3,19,.158,20,26,.769,97
12827,2014-03-13,CHI,,HOU,W 111-87,240,43,86,.500,29,62,.468,14,24,.583,11,13,.846,111
12828,2014-03-13,HOU,@,CHI,L 87-111,240,28,79,.354,23,53,.434,5,26,.192,26,34,.765,87
12829,2014-03-13,LAL,@,OKC,L 102-131,240,37,94,.394,24,67,.358,13,27,.481,15,25,.600,102
12830,2014-03-13,OKC,,LAL,W 131-102,240,45,89,.506,32,59,.542,13,30,.433,28,30,.933,131
12831,2014-03-12,BOS,,NYK,L 92-116,240,34,81,.420,26,62,.419,8,19,.421,16,23,.696,92
12832,2014-03-12,NYK,@,BOS,W 116-92,240,42,80,.525,31,61,.508,11,19,.579,21,24,.875,116
12833,2014-03-12,GSW,@,LAC,L 98-111,240,36,82,.439,28,61,.459,8,21,.381,18,25,.720,98
12834,2014-03-12,LAC,,GSW,W 111-98,240,43,88,.489,35,70,.500,8,18,.444,17,24,.708,111
12835,2014-03-12,BRK,@,MIA,W 96-95,240,34,78,.436,22,49,.449,12,29,.414,16,19,.842,96
12836,2014-03-12,MIA,,BRK,L 95-96,240,33,68,.485,24,41,.585,9,27,.333,20,26,.769,95
12837,2014-03-12,MEM,@,NOP,W 90-88,240,32,74,.432,28,56,.500,4,18,.222,22,27,.815,90
12838,2014-03-12,NOP,,MEM,L 88-90,240,31,75,.413,27,57,.474,4,18,.222,22,22,1.000,88
12839,2014-03-12,DEN,@,ORL,W 120-112,240,47,92,.511,37,70,.529,10,22,.455,16,24,.667,120
12840,2014-03-12,ORL,,DEN,L 112-120,240,45,93,.484,36,69,.522,9,24,.375,13,13,1.000,112
12841,2014-03-12,PHI,,SAC,L 98-115,240,33,84,.393,25,61,.410,8,23,.348,24,28,.857,98
12842,2014-03-12,SAC,@,PHI,W 115-98,240,34,74,.459,27,56,.482,7,18,.389,40,50,.800,115
12843,2014-03-12,CLE,@,PHO,W 110-101,240,38,81,.469,26,57,.456,12,24,.500,22,27,.815,110
12844,2014-03-12,PHO,,CLE,L 101-110,240,39,90,.433,29,54,.537,10,36,.278,13,22,.591,101
12845,2014-03-12,POR,@,SAS,L 90-103,240,32,83,.386,28,62,.452,4,21,.190,22,30,.733,90
12846,2014-03-12,SAS,,POR,W 103-90,240,38,88,.432,27,64,.422,11,24,.458,16,22,.727,103
12847,2014-03-12,DET,@,TOR,L 87-101,240,34,78,.436,25,56,.446,9,22,.409,10,24,.417,87
12848,2014-03-12,TOR,,DET,W 101-87,240,37,88,.420,29,68,.426,8,20,.400,19,25,.760,101
12849,2014-03-12,DAL,@,UTA,W 108-101,240,42,79,.532,29,58,.500,13,21,.619,11,12,.917,108
12850,2014-03-12,UTA,,DAL,L 101-108,240,40,85,.471,35,59,.593,5,26,.192,16,21,.762,101
12851,2014-03-12,CHA,@,WAS,W 98-85,240,38,78,.487,33,60,.550,5,18,.278,17,22,.773,98
12852,2014-03-12,WAS,,CHA,L 85-98,240,35,82,.427,26,57,.456,9,25,.360,6,9,.667,85
12853,2014-03-11,CHI,,SAS,L 96-104,240,32,75,.427,24,57,.421,8,18,.444,24,28,.857,96
12854,2014-03-11,SAS,@,CHI,W 104-96,240,40,79,.506,28,58,.483,12,21,.571,12,15,.800,104
12855,2014-03-11,DET,,SAC,W 99-89,240,38,87,.437,31,69,.449,7,18,.389,16,19,.842,99
12856,2014-03-11,SAC,@,DET,L 89-99,240,34,84,.405,31,69,.449,3,15,.200,18,30,.600,89
12857,2014-03-11,DAL,@,GSW,L 85-108,240,30,82,.366,25,64,.391,5,18,.278,20,31,.645,85
12858,2014-03-11,GSW,,DAL,W 108-85,240,41,80,.513,29,55,.527,12,25,.480,14,17,.824,108
12859,2014-03-11,BOS,@,IND,L 83-94,240,32,91,.352,29,72,.403,3,19,.158,16,19,.842,83
12860,2014-03-11,IND,,BOS,W 94-83,240,40,73,.548,36,57,.632,4,16,.250,10,13,.769,94
12861,2014-03-11,MEM,,POR,W 109-99,240,47,84,.560,41,72,.569,6,12,.500,9,13,.692,109
12862,2014-03-11,POR,@,MEM,L 99-109,240,35,86,.407,28,69,.406,7,17,.412,22,29,.759,99
12863,2014-03-11,MIL,@,MIN,L 101-112,240,39,74,.527,34,59,.576,5,15,.333,18,29,.621,101
12864,2014-03-11,MIN,,MIL,W 112-101,240,41,85,.482,33,65,.508,8,20,.400,22,30,.733,112
12865,2014-03-11,HOU,@,OKC,L 98-106,240,33,79,.418,24,54,.444,9,25,.360,23,34,.676,98
12866,2014-03-11,OKC,,HOU,W 106-98,240,34,80,.425,23,51,.451,11,29,.379,27,34,.794,106
12867,2014-03-10,BRK,,TOR,W 101-97,240,34,70,.486,23,50,.460,11,20,.550,22,31,.710,101
12868,2014-03-10,TOR,@,BRK,L 97-101,240,35,71,.493,29,48,.604,6,23,.261,21,24,.875,97
12869,2014-03-10,CHA,,DEN,W 105-98,240,37,81,.457,29,61,.475,8,20,.400,23,28,.821,105
12870,2014-03-10,DEN,@,CHA,L 98-105,240,36,83,.434,31,59,.525,5,24,.208,21,31,.677,98
12871,2014-03-10,LAC,,PHO,W 112-105,240,43,78,.551,39,64,.609,4,14,.286,22,31,.710,112
12872,2014-03-10,PHO,@,LAC,L 105-112,240,39,85,.459,32,65,.492,7,20,.350,20,29,.690,105
12873,2014-03-10,MIA,,WAS,W 99-90,240,40,80,.500,30,59,.508,10,21,.476,9,9,1.000,99
12874,2014-03-10,WAS,@,MIA,L 90-99,240,36,89,.404,24,58,.414,12,31,.387,6,9,.667,90
12875,2014-03-10,MIL,,ORL,W 105-98,240,38,84,.452,30,57,.526,8,27,.296,21,25,.840,105
12876,2014-03-10,ORL,@,MIL,L 98-105,240,42,88,.477,33,65,.508,9,23,.391,5,8,.625,98
12877,2014-03-10,NYK,,PHI,W 123-110,240,44,81,.543,31,49,.633,13,32,.406,22,34,.647,123
12878,2014-03-10,PHI,@,NYK,L 110-123,240,43,84,.512,37,64,.578,6,20,.300,18,25,.720,110
12879,2014-03-10,ATL,@,UTA,W 112-110,240,38,78,.487,25,49,.510,13,29,.448,23,27,.852,112
12880,2014-03-10,UTA,,ATL,L 110-112,240,40,82,.488,30,61,.492,10,21,.476,20,24,.833,110
12881,2014-03-09,BOS,,DET,W 118-111,240,47,97,.485,37,66,.561,10,31,.323,14,21,.667,118
12882,2014-03-09,DET,@,BOS,L 111-118,240,40,86,.465,36,71,.507,4,15,.267,27,39,.692,111
12883,2014-03-09,BRK,,SAC,W 104-89,240,41,77,.532,29,52,.558,12,25,.480,10,16,.625,104
12884,2014-03-09,SAC,@,BRK,L 89-104,240,36,81,.444,31,58,.534,5,23,.217,12,21,.571,89
12885,2014-03-09,CHI,,MIA,W 95-88 (OT),265,38,90,.422,31,71,.437,7,19,.368,12,17,.706,95
12886,2014-03-09,MIA,@,CHI,L 88-95 (OT),265,30,74,.405,23,54,.426,7,20,.350,21,22,.955,88
12887,2014-03-09,DAL,,IND,W 105-94,240,36,81,.444,28,61,.459,8,20,.400,25,31,.806,105
12888,2014-03-09,IND,@,DAL,L 94-105,240,32,67,.478,25,51,.490,7,16,.438,23,29,.793,94
12889,2014-03-09,GSW,,PHO,W 113-107,240,45,85,.529,35,63,.556,10,22,.455,13,21,.619,113
12890,2014-03-09,PHO,@,GSW,L 107-113,240,36,75,.480,26,54,.481,10,21,.476,25,28,.893,107
12891,2014-03-09,HOU,,POR,W 118-113 (OT),265,38,89,.427,29,60,.483,9,29,.310,33,45,.733,118
12892,2014-03-09,POR,@,HOU,L 113-118 (OT),265,39,96,.406,30,71,.423,9,25,.360,26,33,.788,113
12893,2014-03-09,LAL,,OKC,W 114-110,240,38,81,.469,25,50,.500,13,31,.419,25,30,.833,114
12894,2014-03-09,OKC,@,LAL,L 110-114,240,42,100,.420,30,65,.462,12,35,.343,14,21,.667,110
12895,2014-03-09,MIN,,TOR,L 104-111,240,41,95,.432,34,76,.447,7,19,.368,15,20,.750,104
12896,2014-03-09,TOR,@,MIN,W 111-104,240,37,76,.487,23,52,.442,14,24,.583,23,31,.742,111
12897,2014-03-09,DEN,@,NOP,L 107-111 (OT),265,40,85,.471,33,62,.532,7,23,.304,20,26,.769,107
12898,2014-03-09,NOP,,DEN,W 111-107 (OT),265,41,90,.456,36,76,.474,5,14,.357,24,33,.727,111
12899,2014-03-08,CLE,,NYK,L 97-107,240,36,87,.414,27,64,.422,9,23,.391,16,18,.889,97
12900,2014-03-08,NYK,@,CLE,W 107-97,240,38,88,.432,24,57,.421,14,31,.452,17,23,.739,107
12901,2014-03-08,ATL,@,LAC,L 108-109,240,38,76,.500,26,48,.542,12,28,.429,20,26,.769,108
12902,2014-03-08,LAC,,ATL,W 109-108,240,42,79,.532,35,57,.614,7,22,.318,18,24,.750,109
12903,2014-03-08,CHA,@,MEM,L 89-111,240,37,93,.398,32,72,.444,5,21,.238,10,14,.714,89
12904,2014-03-08,MEM,,CHA,W 111-89,240,44,87,.506,37,74,.500,7,13,.538,16,22,.727,111
12905,2014-03-08,MIL,,WAS,L 107-114,240,39,87,.448,35,71,.493,4,16,.250,25,28,.893,107
12906,2014-03-08,WAS,@,MIL,W 114-107,240,43,80,.538,28,52,.538,15,28,.536,13,23,.565,114
12907,2014-03-08,PHI,,UTA,L 92-104,240,36,76,.474,31,54,.574,5,22,.227,15,20,.750,92
12908,2014-03-08,UTA,@,PHI,W 104-92,240,37,80,.463,27,57,.474,10,23,.435,20,28,.714,104
12909,2014-03-08,ORL,@,SAS,L 112-121,240,46,96,.479,39,78,.500,7,18,.389,13,17,.765,112
12910,2014-03-08,SAS,,ORL,W 121-112,240,43,81,.531,34,61,.557,9,20,.450,26,35,.743,121
12911,2014-03-07,BOS,,BRK,W 91-84,240,31,70,.443,23,49,.469,8,21,.381,21,26,.808,91
12912,2014-03-07,BRK,@,BOS,L 84-91,240,29,80,.363,25,50,.500,4,30,.133,22,26,.846,84
12913,2014-03-07,CHA,,CLE,W 101-92,240,36,77,.468,27,48,.563,9,29,.310,20,22,.909,101
12914,2014-03-07,CLE,@,CHA,L 92-101,240,37,86,.430,34,69,.493,3,17,.176,15,20,.750,92
12915,2014-03-07,CHI,,MEM,L 77-85,240,31,75,.413,29,62,.468,2,13,.154,13,14,.929,77
12916,2014-03-07,MEM,@,CHI,W 85-77,240,35,78,.449,30,70,.429,5,8,.625,10,18,.556,85
12917,2014-03-07,DAL,,POR,W 103-98,240,37,79,.468,33,66,.500,4,13,.308,25,34,.735,103
12918,2014-03-07,POR,@,DAL,L 98-103,240,38,83,.458,31,57,.544,7,26,.269,15,21,.714,98
12919,2014-03-07,DEN,,LAL,W 134-126,240,54,99,.545,40,75,.533,14,24,.583,12,21,.571,134
12920,2014-03-07,LAL,@,DEN,L 126-134,240,45,97,.464,33,70,.471,12,27,.444,24,30,.800,126
12921,2014-03-07,ATL,@,GSW,L 97-111,240,39,86,.453,31,52,.596,8,34,.235,11,13,.846,97
12922,2014-03-07,GSW,,ATL,W 111-97,240,43,80,.538,37,61,.607,6,19,.316,19,24,.792,111
12923,2014-03-07,HOU,,IND,W 112-86,240,40,76,.526,27,48,.563,13,28,.464,19,25,.760,112
12924,2014-03-07,IND,@,HOU,L 86-112,240,34,74,.459,27,58,.466,7,16,.438,11,15,.733,86
12925,2014-03-07,DET,@,MIN,L 101-114,240,38,94,.404,34,81,.420,4,13,.308,21,30,.700,101
12926,2014-03-07,MIN,,DET,W 114-101,240,41,91,.451,35,71,.493,6,20,.300,26,33,.788,114
12927,2014-03-07,MIL,@,NOP,L 104-112,240,40,89,.449,35,69,.507,5,20,.250,19,25,.760,104
12928,2014-03-07,NOP,,MIL,W 112-104,240,42,84,.500,34,64,.531,8,20,.400,20,23,.870,112
12929,2014-03-07,NYK,,UTA,W 108-81,240,42,85,.494,30,54,.556,12,31,.387,12,18,.667,108
12930,2014-03-07,UTA,@,NYK,L 81-108,240,30,73,.411,24,46,.522,6,27,.222,15,20,.750,81
12931,2014-03-07,SAC,@,TOR,L 87-99,240,30,72,.417,25,53,.472,5,19,.263,22,37,.595,87
12932,2014-03-07,TOR,,SAC,W 99-87,240,34,73,.466,24,52,.462,10,21,.476,21,28,.750,99
12933,2014-03-06,LAC,@,LAL,W 142-94,240,57,103,.553,45,77,.584,12,26,.462,16,22,.727,142
12934,2014-03-06,LAL,,LAC,L 94-142,240,34,86,.395,26,56,.464,8,30,.267,18,26,.692,94
12935,2014-03-06,OKC,@,PHO,L 122-128,240,45,90,.500,32,57,.561,13,33,.394,19,19,1.000,122
12936,2014-03-06,PHO,,OKC,W 128-122,240,42,80,.525,27,53,.509,15,27,.556,29,39,.744,128
12937,2014-03-06,MIA,@,SAS,L 87-111,240,34,79,.430,30,66,.455,4,13,.308,15,18,.833,87
12938,2014-03-06,SAS,,MIA,W 111-87,240,40,79,.506,31,56,.554,9,23,.391,22,26,.846,111
12939,2014-03-05,BOS,,GSW,L 88-108,240,30,76,.395,23,50,.460,7,26,.269,21,26,.808,88
12940,2014-03-05,GSW,@,BOS,W 108-88,240,46,98,.469,41,70,.586,5,28,.179,11,12,.917,108
12941,2014-03-05,BRK,,MEM,W 103-94,240,38,74,.514,23,48,.479,15,26,.577,12,13,.923,103
12942,2014-03-05,MEM,@,BRK,L 94-103,240,34,79,.430,28,64,.438,6,15,.400,20,25,.800,94
12943,2014-03-05,CHA,,IND,W 109-87,240,43,84,.512,34,66,.515,9,18,.500,14,20,.700,109
12944,2014-03-05,IND,@,CHA,L 87-109,240,31,76,.408,21,53,.396,10,23,.435,15,20,.750,87
12945,2014-03-05,DAL,@,DEN,L 110-115,240,46,87,.529,37,67,.552,9,20,.450,9,9,1.000,110
12946,2014-03-05,DEN,,DAL,W 115-110,240,37,79,.468,26,55,.473,11,24,.458,30,36,.833,115
12947,2014-03-05,CHI,@,DET,W 105-94,240,43,80,.538,38,61,.623,5,19,.263,14,17,.824,105
12948,2014-03-05,DET,,CHI,L 94-105,240,39,87,.448,37,76,.487,2,11,.182,14,17,.824,94
12949,2014-03-05,MIL,,SAC,L 102-116,240,36,82,.439,30,65,.462,6,17,.353,24,29,.828,102
12950,2014-03-05,SAC,@,MIL,W 116-102,240,43,83,.518,39,69,.565,4,14,.286,26,32,.813,116
12951,2014-03-05,MIN,,NYK,L 106-118,240,39,90,.433,32,64,.500,7,26,.269,21,24,.875,106
12952,2014-03-05,NYK,@,MIN,W 118-106,240,47,90,.522,36,63,.571,11,27,.407,13,19,.684,118
12953,2014-03-05,HOU,@,ORL,W 101-89,240,40,82,.488,34,60,.567,6,22,.273,15,24,.625,101
12954,2014-03-05,ORL,,HOU,L 89-101,240,38,84,.452,35,70,.500,3,14,.214,10,12,.833,89
12955,2014-03-05,ATL,@,POR,L 78-102,240,29,88,.330,25,61,.410,4,27,.148,16,19,.842,78
12956,2014-03-05,POR,,ATL,W 102-78,240,35,79,.443,22,50,.440,13,29,.448,19,21,.905,102
12957,2014-03-05,UTA,@,WAS,L 91-104,240,35,78,.449,27,55,.491,8,23,.348,13,22,.591,91
12958,2014-03-05,WAS,,UTA,W 104-91,240,44,81,.543,38,66,.576,6,15,.400,10,10,1.000,104
12959,2014-03-04,CLE,,SAS,L 101-122,240,38,79,.481,28,60,.467,10,19,.526,15,20,.750,101
12960,2014-03-04,SAS,@,CLE,W 122-101,240,43,90,.478,29,57,.509,14,33,.424,22,24,.917,122
12961,2014-03-04,HOU,,MIA,W 106-103,240,40,78,.513,32,55,.582,8,23,.348,18,27,.667,106
12962,2014-03-04,MIA,@,HOU,L 103-106,240,38,80,.475,31,53,.585,7,27,.259,20,29,.690,103
12963,2014-03-04,GSW,@,IND,W 98-96,240,37,84,.440,27,64,.422,10,20,.500,14,21,.667,98
12964,2014-03-04,IND,,GSW,L 96-98,240,36,86,.419,33,70,.471,3,16,.188,21,22,.955,96
12965,2014-03-04,LAL,,NOP,L 125-132,240,46,85,.541,36,63,.571,10,22,.455,23,31,.742,125
12966,2014-03-04,NOP,@,LAL,W 132-125,240,46,77,.597,39,60,.650,7,17,.412,33,40,.825,132
12967,2014-03-04,OKC,,PHI,W 125-92,240,43,76,.566,36,56,.643,7,20,.350,32,43,.744,125
12968,2014-03-04,PHI,@,OKC,L 92-125,240,32,94,.340,22,64,.344,10,30,.333,18,26,.692,92
12969,2014-03-04,LAC,@,PHO,W 104-96,240,40,78,.513,32,58,.552,8,20,.400,16,22,.727,104
12970,2014-03-04,PHO,,LAC,L 96-104,240,39,86,.453,32,67,.478,7,19,.368,11,19,.579,96
12971,2014-03-03,BRK,,CHI,W 96-80,240,34,73,.466,27,48,.563,7,25,.280,21,28,.750,96
12972,2014-03-03,CHI,@,BRK,L 80-96,240,30,65,.462,26,52,.500,4,13,.308,16,23,.696,80
12973,2014-03-03,DEN,,MIN,L 128-132,240,50,95,.526,38,62,.613,12,33,.364,16,25,.640,128
12974,2014-03-03,MIN,@,DEN,W 132-128,240,38,80,.475,34,64,.531,4,16,.250,52,64,.813,132
12975,2014-03-03,DET,,NYK,W 96-85,240,35,83,.422,31,71,.437,4,12,.333,22,30,.733,96
12976,2014-03-03,NYK,@,DET,L 85-96,240,32,83,.386,22,55,.400,10,28,.357,11,14,.786,85
12977,2014-03-03,CHA,@,MIA,L 107-124,240,42,82,.512,33,59,.559,9,23,.391,14,21,.667,107
12978,2014-03-03,MIA,,CHA,W 124-107,240,46,83,.554,30,55,.545,16,28,.571,16,20,.800,124
12979,2014-03-03,MIL,,UTA,W 114-88,240,42,74,.568,34,61,.557,8,13,.615,22,26,.846,114
12980,2014-03-03,UTA,@,MIL,L 88-114,240,31,79,.392,25,58,.431,6,21,.286,20,26,.769,88
12981,2014-03-03,LAL,@,POR,W 107-106,240,43,94,.457,35,76,.461,8,18,.444,13,15,.867,107
12982,2014-03-03,POR,,LAL,L 106-107,240,43,96,.448,34,67,.507,9,29,.310,11,19,.579,106
12983,2014-03-03,NOP,@,SAC,L 89-96,240,32,75,.427,26,55,.473,6,20,.300,19,28,.679,89
12984,2014-03-03,SAC,,NOP,W 96-89,240,32,68,.471,31,61,.508,1,7,.143,31,41,.756,96
12985,2014-03-03,MEM,@,WAS,W 110-104,240,43,79,.544,37,66,.561,6,13,.462,18,21,.857,110
12986,2014-03-03,WAS,,MEM,L 104-110,240,39,81,.481,30,62,.484,9,19,.474,17,21,.810,104
12987,2014-03-02,CHI,,NYK,W 109-90,240,39,84,.464,31,62,.500,8,22,.364,23,33,.697,109
12988,2014-03-02,NYK,@,CHI,L 90-109,240,35,79,.443,30,61,.492,5,18,.278,15,18,.833,90
12989,2014-03-02,IND,,UTA,W 94-91,240,34,82,.415,29,67,.433,5,15,.333,21,28,.750,94
12990,2014-03-02,UTA,@,IND,L 91-94,240,36,78,.462,30,64,.469,6,14,.429,13,18,.722,91
12991,2014-03-02,CHA,@,OKC,L 99-116,240,30,68,.441,22,46,.478,8,22,.364,31,40,.775,99
12992,2014-03-02,OKC,,CHA,W 116-99,240,41,82,.500,33,60,.550,8,22,.364,26,30,.867,116
12993,2014-03-02,ORL,,PHI,W 92-81,240,35,83,.422,34,70,.486,1,13,.077,21,27,.778,92
12994,2014-03-02,PHI,@,ORL,L 81-92,240,32,86,.372,27,62,.435,5,24,.208,12,18,.667,81
12995,2014-03-02,ATL,@,PHO,L 120-129,240,44,84,.524,30,53,.566,14,31,.452,18,26,.692,120
12996,2014-03-02,PHO,,ATL,W 129-120,240,44,80,.550,29,56,.518,15,24,.625,26,30,.867,129
12997,2014-03-02,DAL,@,SAS,L 106-112,240,45,97,.464,38,79,.481,7,18,.389,9,14,.643,106
12998,2014-03-02,SAS,,DAL,W 112-106,240,39,84,.464,29,57,.509,10,27,.370,24,28,.857,112
12999,2014-03-02,GSW,@,TOR,L 98-104,240,37,88,.420,29,65,.446,8,23,.348,16,20,.800,98
13000,2014-03-02,TOR,,GSW,W 104-98,240,38,79,.481,30,57,.526,8,22,.364,20,23,.870,104
13001,2014-03-01,BOS,,IND,L 97-102,240,38,89,.427,31,68,.456,7,21,.333,14,17,.824,97
13002,2014-03-01,IND,@,BOS,W 102-97,240,39,77,.506,34,64,.531,5,13,.385,19,23,.826,102
13003,2014-03-01,DET,@,HOU,L 110-118,240,45,100,.450,41,81,.506,4,19,.211,16,19,.842,110
13004,2014-03-01,HOU,,DET,W 118-110,240,42,84,.500,31,51,.608,11,33,.333,23,33,.697,118
13005,2014-03-01,LAC,,NOP,W 108-76,240,38,81,.469,29,56,.518,9,25,.360,23,32,.719,108
13006,2014-03-01,NOP,@,LAC,L 76-108,240,28,85,.329,25,63,.397,3,22,.136,17,19,.895,76
13007,2014-03-01,CLE,@,MEM,L 96-110,240,39,79,.494,32,61,.525,7,18,.389,11,15,.733,96
13008,2014-03-01,MEM,,CLE,W 110-96,240,44,81,.543,35,62,.565,9,19,.474,13,18,.722,110
13009,2014-03-01,MIA,,ORL,W 112-98,240,43,74,.581,37,58,.638,6,16,.375,20,24,.833,112
13010,2014-03-01,ORL,@,MIA,L 98-112,240,36,83,.434,32,65,.492,4,18,.222,22,29,.759,98
13011,2014-03-01,BRK,@,MIL,W 107-98,240,37,83,.446,27,58,.466,10,25,.400,23,31,.742,107
13012,2014-03-01,MIL,,BRK,L 98-107,240,34,74,.459,29,62,.468,5,12,.417,25,31,.806,98
13013,2014-03-01,PHI,,WAS,L 103-122,240,38,84,.452,33,62,.532,5,22,.227,22,32,.688,103
13014,2014-03-01,WAS,@,PHI,W 122-103,240,45,89,.506,33,63,.524,12,26,.462,20,28,.714,122
13015,2014-03-01,DEN,@,POR,L 96-102,240,33,83,.398,26,60,.433,7,23,.304,23,35,.657,96
13016,2014-03-01,POR,,DEN,W 102-96,240,37,81,.457,32,54,.593,5,27,.185,23,24,.958,102
13017,2014-03-01,MIN,@,SAC,W 108-97,240,37,81,.457,32,60,.533,5,21,.238,29,38,.763,108
13018,2014-03-01,SAC,,MIN,L 97-108,240,37,82,.451,30,60,.500,7,22,.318,16,21,.762,97
13019,2014-02-28,CLE,,UTA,W 99-79,240,43,88,.489,39,73,.534,4,15,.267,9,12,.750,99
13020,2014-02-28,UTA,@,CLE,L 79-99,240,28,80,.350,14,51,.275,14,29,.483,9,14,.643,79
13021,2014-02-28,CHI,@,DAL,W 100-91,240,36,71,.507,27,52,.519,9,19,.474,19,28,.679,100
13022,2014-02-28,DAL,,CHI,L 91-100,240,34,85,.400,23,54,.426,11,31,.355,12,17,.706,91
13023,2014-02-28,LAL,,SAC,W 126-122,240,48,80,.600,29,53,.547,19,27,.704,11,16,.688,126
13024,2014-02-28,SAC,@,LAL,L 122-126,240,47,93,.505,42,78,.538,5,15,.333,23,32,.719,122
13025,2014-02-28,GSW,@,NYK,W 126-103,240,44,92,.478,30,57,.526,14,35,.400,24,31,.774,126
13026,2014-02-28,NYK,,GSW,L 103-126,240,36,95,.379,26,70,.371,10,25,.400,21,23,.913,103
13027,2014-02-28,MEM,@,OKC,L 107-113,240,41,80,.513,31,64,.484,10,16,.625,15,20,.750,107
13028,2014-02-28,OKC,,MEM,W 113-107,240,38,77,.494,28,55,.509,10,22,.455,27,32,.844,113
13029,2014-02-28,NOP,@,PHO,L 104-116,240,42,78,.538,37,65,.569,5,13,.385,15,17,.882,104
13030,2014-02-28,PHO,,NOP,W 116-104,240,40,74,.541,30,51,.588,10,23,.435,26,32,.813,116
13031,2014-02-28,CHA,@,SAS,L 82-92,240,33,90,.367,30,73,.411,3,17,.176,13,15,.867,82
13032,2014-02-28,SAS,,CHA,W 92-82,240,34,73,.466,25,53,.472,9,20,.450,15,15,1.000,92
13033,2014-02-27,BRK,@,DEN,W 112-89,240,39,82,.476,29,51,.569,10,31,.323,24,29,.828,112
13034,2014-02-27,DEN,,BRK,L 89-112,240,30,81,.370,24,59,.407,6,22,.273,23,33,.697,89
13035,2014-02-27,IND,,MIL,W 101-96,240,38,74,.514,32,59,.542,6,15,.400,19,22,.864,101
13036,2014-02-27,MIL,@,IND,L 96-101,240,38,87,.437,26,63,.413,12,24,.500,8,11,.727,96
13037,2014-02-27,MIA,,NYK,W 108-82,240,45,74,.608,39,59,.661,6,15,.400,12,18,.667,108
13038,2014-02-27,NYK,@,MIA,L 82-108,240,31,83,.373,27,60,.450,4,23,.174,16,22,.727,82
13039,2014-02-27,TOR,,WAS,L 129-134 (3OT),315,45,100,.450,33,70,.471,12,30,.400,27,36,.750,129
13040,2014-02-27,WAS,@,TOR,W 134-129 (3OT),315,51,108,.472,46,86,.535,5,22,.227,27,37,.730,134
13041,2014-02-26,ATL,@,BOS,L 104-115,240,38,76,.500,29,57,.509,9,19,.474,19,24,.792,104
13042,2014-02-26,BOS,,ATL,W 115-104,240,43,90,.478,35,68,.515,8,22,.364,21,23,.913,115
13043,2014-02-26,CHI,,GSW,W 103-83,240,37,83,.446,32,69,.464,5,14,.357,24,30,.800,103
13044,2014-02-26,GSW,@,CHI,L 83-103,240,30,84,.357,25,63,.397,5,21,.238,18,22,.818,83
13045,2014-02-26,DAL,,NOP,W 108-89,240,41,79,.519,31,57,.544,10,22,.455,16,17,.941,108
13046,2014-02-26,NOP,@,DAL,L 89-108,240,36,71,.507,27,51,.529,9,20,.450,8,19,.421,89
13047,2014-02-26,HOU,@,LAC,L 93-101,240,34,77,.442,26,52,.500,8,25,.320,17,24,.708,93
13048,2014-02-26,LAC,,HOU,W 101-93,240,41,93,.441,33,69,.478,8,24,.333,11,13,.846,101
13049,2014-02-26,LAL,@,MEM,L 103-108,240,38,77,.494,23,49,.469,15,28,.536,12,18,.667,103
13050,2014-02-26,MEM,,LAL,W 108-103,240,45,92,.489,41,79,.519,4,13,.308,14,21,.667,108
13051,2014-02-26,CLE,@,OKC,W 114-104,240,40,86,.465,29,60,.483,11,26,.423,23,24,.958,114
13052,2014-02-26,OKC,,CLE,L 104-114,240,39,80,.488,26,49,.531,13,31,.419,13,17,.765,104
13053,2014-02-26,ORL,@,PHI,W 101-90,240,39,94,.415,30,76,.395,9,18,.500,14,16,.875,101
13054,2014-02-26,PHI,,ORL,L 90-101,240,32,87,.368,27,65,.415,5,22,.227,21,28,.750,90
13055,2014-02-26,BRK,@,POR,L 80-124,240,32,81,.395,28,59,.475,4,22,.182,12,17,.706,80
13056,2014-02-26,POR,,BRK,W 124-80,240,46,86,.535,33,55,.600,13,31,.419,19,21,.905,124
13057,2014-02-26,DET,@,SAS,L 110-120,240,45,90,.500,40,80,.500,5,10,.500,15,17,.882,110
13058,2014-02-26,SAS,,DET,W 120-110,240,44,82,.537,35,63,.556,9,19,.474,23,25,.920,120
13059,2014-02-26,PHO,@,UTA,L 86-109,240,31,80,.388,25,61,.410,6,19,.316,18,29,.621,86
13060,2014-02-26,UTA,,PHO,W 109-86,240,42,74,.568,33,56,.589,9,18,.500,16,24,.667,109
13061,2014-02-25,ATL,,CHI,L 103-107,240,38,84,.452,24,51,.471,14,33,.424,13,16,.813,103
13062,2014-02-25,CHI,@,ATL,W 107-103,240,37,88,.420,29,64,.453,8,24,.333,25,29,.862,107
13063,2014-02-25,CLE,,TOR,L 93-99,240,34,84,.405,29,67,.433,5,17,.294,20,24,.833,93
13064,2014-02-25,TOR,@,CLE,W 99-93,240,35,79,.443,25,47,.532,10,32,.313,19,24,.792,99
13065,2014-02-25,DEN,,POR,L 95-100,240,37,103,.359,33,83,.398,4,20,.200,17,26,.654,95
13066,2014-02-25,POR,@,DEN,W 100-95,240,28,76,.368,16,45,.356,12,31,.387,32,38,.842,100
13067,2014-02-25,IND,,LAL,W 118-98,240,47,101,.465,42,85,.494,5,16,.313,19,25,.760,118
13068,2014-02-25,LAL,@,IND,L 98-118,240,39,90,.433,31,67,.463,8,23,.348,12,20,.600,98
13069,2014-02-25,MIN,@,PHO,W 110-101,240,42,87,.483,37,69,.536,5,18,.278,21,32,.656,110
13070,2014-02-25,PHO,,MIN,L 101-110,240,42,95,.442,39,80,.488,3,15,.200,14,18,.778,101
13071,2014-02-25,HOU,@,SAC,W 129-103,240,41,72,.569,30,50,.600,11,22,.500,36,42,.857,129
13072,2014-02-25,SAC,,HOU,L 103-129,240,36,90,.400,31,72,.431,5,18,.278,26,31,.839,103
13073,2014-02-25,ORL,@,WAS,L 106-115,240,43,86,.500,35,61,.574,8,25,.320,12,14,.857,106
13074,2014-02-25,WAS,,ORL,W 115-106,240,42,80,.525,32,64,.500,10,16,.625,21,28,.750,115
13075,2014-02-24,DET,,GSW,L 96-104,240,40,99,.404,36,86,.419,4,13,.308,12,18,.667,96
13076,2014-02-24,GSW,@,DET,W 104-96,240,38,82,.463,25,51,.490,13,31,.419,15,22,.682,104
13077,2014-02-24,LAC,@,NOP,W 123-110,240,43,83,.518,27,55,.491,16,28,.571,21,26,.808,123
13078,2014-02-24,NOP,,LAC,L 110-123,240,37,87,.425,30,69,.435,7,18,.389,29,35,.829,110
13079,2014-02-24,DAL,@,NYK,W 110-108,240,41,86,.477,26,50,.520,15,36,.417,13,16,.813,110
13080,2014-02-24,NYK,,DAL,L 108-110,240,40,76,.526,26,43,.605,14,33,.424,14,16,.875,108
13081,2014-02-24,MIL,@,PHI,W 130-110,240,48,84,.571,36,64,.563,12,20,.600,22,29,.759,130
13082,2014-02-24,PHI,,MIL,L 110-130,240,43,88,.489,35,64,.547,8,24,.333,16,23,.696,110
13083,2014-02-24,BOS,@,UTA,L 98-110,240,37,84,.440,33,69,.478,4,15,.267,20,21,.952,98
13084,2014-02-24,UTA,,BOS,W 110-98,240,44,80,.550,38,63,.603,6,17,.353,16,21,.762,110
13085,2014-02-23,CLE,,WAS,L 83-96,240,30,78,.385,28,60,.467,2,18,.111,21,26,.808,83
13086,2014-02-23,WAS,@,CLE,W 96-83,240,41,96,.427,33,76,.434,8,20,.400,6,10,.600,96
13087,2014-02-23,DEN,,SAC,L 95-109,240,33,88,.375,18,56,.321,15,32,.469,14,21,.667,95
13088,2014-02-23,SAC,@,DEN,W 109-95,240,37,78,.474,32,65,.492,5,13,.385,30,36,.833,109
13089,2014-02-23,BRK,@,LAL,W 108-102,240,36,76,.474,24,51,.471,12,25,.480,24,32,.750,108
13090,2014-02-23,LAL,,BRK,L 102-108,240,39,76,.513,32,59,.542,7,17,.412,17,26,.654,102
13091,2014-02-23,CHI,@,MIA,L 79-93,240,29,81,.358,23,60,.383,6,21,.286,15,17,.882,79
13092,2014-02-23,MIA,,CHI,W 93-79,240,37,88,.420,28,65,.431,9,23,.391,10,14,.714,93
13093,2014-02-23,LAC,@,OKC,W 125-117,240,42,81,.519,29,51,.569,13,30,.433,28,39,.718,125
13094,2014-02-23,OKC,,LAC,L 117-125,240,43,93,.462,31,64,.484,12,29,.414,19,24,.792,117
13095,2014-02-23,HOU,@,PHO,W 115-112,240,41,78,.526,36,62,.581,5,16,.313,28,32,.875,115
13096,2014-02-23,PHO,,HOU,L 112-115,240,42,86,.488,31,60,.517,11,26,.423,17,24,.708,112
13097,2014-02-23,MIN,@,POR,L 97-108,240,37,94,.394,28,66,.424,9,28,.321,14,20,.700,97
13098,2014-02-23,POR,,MIN,W 108-97,240,40,83,.482,27,55,.491,13,28,.464,15,16,.938,108
13099,2014-02-23,ORL,@,TOR,L 90-105,240,36,87,.414,31,73,.425,5,14,.357,13,17,.765,90
13100,2014-02-23,TOR,,ORL,W 105-90,240,34,65,.523,25,48,.521,9,17,.529,28,36,.778,105
13101,2014-02-22,ATL,,NYK,W 107-98,240,32,74,.432,16,43,.372,16,31,.516,27,33,.818,107
13102,2014-02-22,NYK,@,ATL,L 98-107,240,39,89,.438,29,61,.475,10,28,.357,10,16,.625,98
13103,2014-02-22,CHA,,MEM,W 92-89,240,30,82,.366,22,62,.355,8,20,.400,24,27,.889,92
13104,2014-02-22,MEM,@,CHA,L 89-92,240,34,79,.430,30,64,.469,4,15,.267,17,22,.773,89
13105,2014-02-22,DAL,@,DET,W 113-102,240,44,90,.489,36,67,.537,8,23,.348,17,22,.773,113
13106,2014-02-22,DET,,DAL,L 102-113,240,40,82,.488,38,71,.535,2,11,.182,20,30,.667,102
13107,2014-02-22,BRK,@,GSW,L 86-93,240,32,78,.410,30,57,.526,2,21,.095,20,24,.833,86
13108,2014-02-22,GSW,,BRK,W 93-86,240,37,85,.435,31,65,.477,6,20,.300,13,17,.765,93
13109,2014-02-22,IND,@,MIL,W 110-100,240,36,80,.450,27,62,.435,9,18,.500,29,40,.725,110
13110,2014-02-22,MIL,,IND,L 100-110,240,35,83,.422,26,56,.464,9,27,.333,21,32,.656,100
13111,2014-02-22,BOS,@,SAC,L 98-105,240,34,87,.391,28,66,.424,6,21,.286,24,36,.667,98
13112,2014-02-22,SAC,,BOS,W 105-98,240,38,73,.521,33,64,.516,5,9,.556,24,28,.857,105
13113,2014-02-22,MIN,@,UTA,W 121-104,240,43,84,.512,32,62,.516,11,22,.500,24,33,.727,121
13114,2014-02-22,UTA,,MIN,L 104-121,240,37,79,.468,34,60,.567,3,19,.158,27,36,.750,104
13115,2014-02-22,NOP,@,WAS,L 93-94,240,35,81,.432,29,68,.426,6,13,.462,17,21,.810,93
13116,2014-02-22,WAS,,NOP,W 94-93,240,36,74,.486,33,60,.550,3,14,.214,19,26,.731,94
13117,2014-02-21,CHA,,NOP,W 90-87,240,31,80,.388,28,65,.431,3,15,.200,25,36,.694,90
13118,2014-02-21,NOP,@,CHA,L 87-90,240,35,83,.422,26,60,.433,9,23,.391,8,11,.727,87
13119,2014-02-21,CHI,,DEN,W 117-89,240,42,84,.500,32,67,.478,10,17,.588,23,27,.852,117
13120,2014-02-21,DEN,@,CHI,L 89-117,240,35,87,.402,28,72,.389,7,15,.467,12,22,.545,89
13121,2014-02-21,ATL,@,DET,L 107-115,240,40,88,.455,27,57,.474,13,31,.419,14,20,.700,107
13122,2014-02-21,DET,,ATL,W 115-107,240,47,87,.540,39,67,.582,8,20,.400,13,29,.448,115
13123,2014-02-21,BOS,@,LAL,L 92-101,240,38,97,.392,34,75,.453,4,22,.182,12,17,.706,92
13124,2014-02-21,LAL,,BOS,W 101-92,240,40,83,.482,33,61,.541,7,22,.318,14,19,.737,101
13125,2014-02-21,LAC,@,MEM,L 96-102,240,31,80,.388,24,56,.429,7,24,.292,27,43,.628,96
13126,2014-02-21,MEM,,LAC,W 102-96,240,42,87,.483,37,72,.514,5,15,.333,13,15,.867,102
13127,2014-02-21,NYK,@,ORL,L 121-129 (2OT),290,45,95,.474,30,61,.492,15,34,.441,16,23,.696,121
13128,2014-02-21,ORL,,NYK,W 129-121 (2OT),290,49,99,.495,40,83,.482,9,16,.563,22,26,.846,129
13129,2014-02-21,DAL,@,PHI,W 124-112,240,48,77,.623,39,54,.722,9,23,.391,19,25,.760,124
13130,2014-02-21,PHI,,DAL,L 112-124,240,42,94,.447,37,69,.536,5,25,.200,23,32,.719,112
13131,2014-02-21,PHO,,SAS,W 106-85,240,42,82,.512,37,57,.649,5,25,.200,17,25,.680,106
13132,2014-02-21,SAS,@,PHO,L 85-106,240,29,83,.349,27,62,.435,2,21,.095,25,27,.926,85
13133,2014-02-21,POR,,UTA,W 102-94,240,39,91,.429,32,71,.451,7,20,.350,17,17,1.000,102
13134,2014-02-21,UTA,@,POR,L 94-102,240,37,82,.451,31,69,.449,6,13,.462,14,18,.778,94
13135,2014-02-21,CLE,@,TOR,L 91-98,240,32,82,.390,26,62,.419,6,20,.300,21,29,.724,91
13136,2014-02-21,TOR,,CLE,W 98-91,240,40,93,.430,33,72,.458,7,21,.333,11,13,.846,98
13137,2014-02-20,GSW,,HOU,W 102-99 (OT),265,37,93,.398,28,66,.424,9,27,.333,19,24,.792,102
13138,2014-02-20,HOU,@,GSW,L 99-102 (OT),265,37,101,.366,28,71,.394,9,30,.300,16,25,.640,99
13139,2014-02-20,DEN,@,MIL,W 101-90,240,39,76,.513,31,58,.534,8,18,.444,15,26,.577,101
13140,2014-02-20,MIL,,DEN,L 90-101,240,35,82,.427,31,61,.508,4,21,.190,16,20,.800,90
13141,2014-02-20,MIA,@,OKC,W 103-81,240,41,75,.547,36,54,.667,5,21,.238,16,21,.762,103
13142,2014-02-20,OKC,,MIA,L 81-103,240,28,74,.378,26,54,.481,2,20,.100,23,30,.767,81
13143,2014-02-19,ATL,,WAS,L 97-114,240,33,73,.452,27,57,.474,6,16,.375,25,30,.833,97
13144,2014-02-19,WAS,@,ATL,W 114-97,240,46,89,.517,33,65,.508,13,24,.542,9,11,.818,114
13145,2014-02-19,CHA,,DET,W 116-98,240,42,82,.512,34,62,.548,8,20,.400,24,31,.774,116
13146,2014-02-19,DET,@,CHA,L 98-116,240,38,90,.422,30,72,.417,8,18,.444,14,20,.700,98
13147,2014-02-19,CLE,,ORL,W 101-93,240,33,80,.413,28,60,.467,5,20,.250,30,37,.811,101
13148,2014-02-19,ORL,@,CLE,L 93-101,240,35,89,.393,29,67,.433,6,22,.273,17,24,.708,93
13149,2014-02-19,HOU,@,LAL,W 134-108,240,52,104,.500,34,69,.493,18,35,.514,12,25,.480,134
13150,2014-02-19,LAL,,HOU,L 108-134,240,41,84,.488,27,57,.474,14,27,.519,12,15,.800,108
13151,2014-02-19,IND,@,MIN,L 91-104,240,35,87,.402,29,65,.446,6,22,.273,15,20,.750,91
13152,2014-02-19,MIN,,IND,W 104-91,240,40,83,.482,34,63,.540,6,20,.300,18,31,.581,104
13153,2014-02-19,NOP,,NYK,L 91-98,240,35,75,.467,28,54,.519,7,21,.333,14,21,.667,91
13154,2014-02-19,NYK,@,NOP,W 98-91,240,37,83,.446,27,62,.435,10,21,.476,14,20,.700,98
13155,2014-02-19,BOS,@,PHO,L 94-100,240,34,87,.391,29,70,.414,5,17,.294,21,28,.750,94
13156,2014-02-19,PHO,,BOS,W 100-94,240,36,82,.439,25,54,.463,11,28,.393,17,26,.654,100
13157,2014-02-19,POR,,SAS,L 109-111,240,42,93,.452,35,71,.493,7,22,.318,18,25,.720,109
13158,2014-02-19,SAS,@,POR,W 111-109,240,43,88,.489,34,64,.531,9,24,.375,16,21,.762,111
13159,2014-02-19,GSW,@,SAC,W 101-92,240,39,86,.453,36,67,.537,3,19,.158,20,24,.833,101
13160,2014-02-19,SAC,,GSW,L 92-101,240,33,79,.418,27,62,.435,6,17,.353,20,28,.714,92
13161,2014-02-19,CHI,@,TOR,W 94-92,240,36,72,.500,29,60,.483,7,12,.583,15,20,.750,94
13162,2014-02-19,TOR,,CHI,L 92-94,240,35,83,.422,32,66,.485,3,17,.176,19,23,.826,92
13163,2014-02-19,BRK,@,UTA,W 105-99,240,41,82,.500,32,59,.542,9,23,.391,14,20,.700,105
13164,2014-02-19,UTA,,BRK,L 99-105,240,37,82,.451,28,58,.483,9,24,.375,16,17,.941,99
13165,2014-02-18,DAL,,MIA,L 106-117,240,34,85,.400,25,58,.431,9,27,.333,29,32,.906,106
13166,2014-02-18,MIA,@,DAL,W 117-106,240,44,77,.571,34,51,.667,10,26,.385,19,24,.792,117
13167,2014-02-18,DEN,,PHO,L 107-112 (OT),265,38,99,.384,33,71,.465,5,28,.179,26,37,.703,107
13168,2014-02-18,PHO,@,DEN,W 112-107 (OT),265,35,93,.376,24,64,.375,11,29,.379,31,39,.795,112
13169,2014-02-18,CHA,@,DET,W 108-96,240,39,75,.520,32,58,.552,7,17,.412,23,37,.622,108
13170,2014-02-18,DET,,CHA,L 96-108,240,39,98,.398,34,82,.415,5,16,.313,13,23,.565,96
13171,2014-02-18,ATL,@,IND,L 98-108,240,37,77,.481,25,51,.490,12,26,.462,12,19,.632,98
13172,2014-02-18,IND,,ATL,W 108-98,240,39,79,.494,30,56,.536,9,23,.391,21,26,.808,108
13173,2014-02-18,LAC,,SAS,L 103-113,240,35,81,.432,29,60,.483,6,21,.286,27,38,.711,103
13174,2014-02-18,SAS,@,LAC,W 113-103,240,44,88,.500,35,68,.515,9,20,.450,16,21,.762,113
13175,2014-02-18,MEM,,NYK,W 98-93,240,37,75,.493,31,63,.492,6,12,.500,18,24,.750,98
13176,2014-02-18,NYK,@,MEM,L 93-98,240,35,85,.412,29,58,.500,6,27,.222,17,20,.850,93
13177,2014-02-18,MIL,,ORL,W 104-100,240,35,82,.427,23,56,.411,12,26,.462,22,30,.733,104
13178,2014-02-18,ORL,@,MIL,L 100-104,240,40,80,.500,29,55,.527,11,25,.440,9,16,.563,100
13179,2014-02-18,CLE,@,PHI,W 114-85,240,40,87,.460,34,69,.493,6,18,.333,28,33,.848,114
13180,2014-02-18,PHI,,CLE,L 85-114,240,31,87,.356,26,65,.400,5,22,.227,18,27,.667,85
13181,2014-02-18,TOR,@,WAS,W 103-93,240,42,74,.568,35,58,.603,7,16,.438,12,15,.800,103
13182,2014-02-18,WAS,,TOR,L 93-103,240,38,81,.469,34,66,.515,4,15,.267,13,21,.619,93
13183,2014-02-13,BRK,@,CHI,L 76-92,240,26,67,.388,21,50,.420,5,17,.294,19,28,.679,76
13184,2014-02-13,CHI,,BRK,W 92-76,240,35,70,.500,31,56,.554,4,14,.286,18,21,.857,92
13185,2014-02-13,LAL,,OKC,L 103-107,240,40,83,.482,30,55,.545,10,28,.357,13,22,.591,103
13186,2014-02-13,OKC,@,LAL,W 107-103,240,39,88,.443,31,60,.517,8,28,.286,21,24,.875,107
13187,2014-02-12,BOS,,SAS,L 92-104,240,37,80,.463,31,63,.492,6,17,.353,12,17,.706,92
13188,2014-02-12,SAS,@,BOS,W 104-92,240,41,82,.500,32,63,.508,9,19,.474,13,14,.929,104
13189,2014-02-12,BRK,,CHA,W 105-89,240,40,80,.500,27,49,.551,13,31,.419,12,15,.800,105
13190,2014-02-12,CHA,@,BRK,L 89-105,240,36,87,.414,26,60,.433,10,27,.370,7,15,.467,89
13191,2014-02-12,CLE,@,DET,W 93-89,240,34,84,.405,29,69,.420,5,15,.333,20,30,.667,93
13192,2014-02-12,DET,,CLE,L 89-93,240,33,83,.398,29,60,.483,4,23,.174,19,27,.704,89
13193,2014-02-12,GSW,,MIA,L 110-111,240,40,83,.482,31,67,.463,9,16,.563,21,26,.808,110
13194,2014-02-12,MIA,@,GSW,W 111-110,240,42,78,.538,32,56,.571,10,22,.455,17,25,.680,111
13195,2014-02-12,HOU,,WAS,W 113-112,240,34,64,.531,24,42,.571,10,22,.455,35,47,.745,113
13196,2014-02-12,WAS,@,HOU,L 112-113,240,44,97,.454,28,65,.431,16,32,.500,8,16,.500,112
13197,2014-02-12,DAL,@,IND,W 81-73,240,30,84,.357,25,65,.385,5,19,.263,16,21,.762,81
13198,2014-02-12,IND,,DAL,L 73-81,240,27,84,.321,20,60,.333,7,24,.292,12,14,.857,73
13199,2014-02-12,LAC,,POR,W 122-117,240,46,79,.582,42,69,.609,4,10,.400,26,31,.839,122
13200,2014-02-12,POR,@,LAC,L 117-122,240,43,84,.512,30,53,.566,13,31,.419,18,22,.818,117
13201,2014-02-12,MIL,,NOP,L 98-102,240,39,80,.488,33,64,.516,6,16,.375,14,19,.737,98
13202,2014-02-12,NOP,@,MIL,W 102-98,240,41,79,.519,35,66,.530,6,13,.462,14,17,.824,102
13203,2014-02-12,DEN,@,MIN,L 90-117,240,33,84,.393,24,60,.400,9,24,.375,15,20,.750,90
13204,2014-02-12,MIN,,DEN,W 117-90,240,45,86,.523,33,60,.550,12,26,.462,15,23,.652,117
13205,2014-02-12,NYK,,SAC,L 101-106 (OT),265,41,90,.456,32,66,.485,9,24,.375,10,14,.714,101
13206,2014-02-12,SAC,@,NYK,W 106-101 (OT),265,40,85,.471,30,62,.484,10,23,.435,16,19,.842,106
13207,2014-02-12,MEM,@,ORL,W 86-81,240,36,77,.468,34,65,.523,2,12,.167,12,18,.667,86
13208,2014-02-12,ORL,,MEM,L 81-86,240,34,83,.410,30,70,.429,4,13,.308,9,10,.900,81
13209,2014-02-12,ATL,@,TOR,L 83-104,240,30,78,.385,26,58,.448,4,20,.200,19,23,.826,83
13210,2014-02-12,TOR,,ATL,W 104-83,240,38,94,.404,27,61,.443,11,33,.333,17,22,.773,104
13211,2014-02-12,PHI,@,UTA,L 100-105,240,37,80,.463,29,61,.475,8,19,.421,18,23,.783,100
13212,2014-02-12,UTA,,PHI,W 105-100,240,37,87,.425,34,71,.479,3,16,.188,28,32,.875,105
13213,2014-02-11,CHA,,DAL,W 114-89,240,45,82,.549,33,58,.569,12,24,.500,12,15,.800,114
13214,2014-02-11,DAL,@,CHA,L 89-114,240,37,82,.451,32,68,.471,5,14,.357,10,12,.833,89
13215,2014-02-11,ATL,@,CHI,L 85-100,240,35,80,.438,25,57,.439,10,23,.435,5,9,.556,85
13216,2014-02-11,CHI,,ATL,W 100-85,240,43,85,.506,35,65,.538,8,20,.400,6,13,.462,100
13217,2014-02-11,CLE,,SAC,W 109-99,240,41,86,.477,29,65,.446,12,21,.571,15,23,.652,109
13218,2014-02-11,SAC,@,CLE,L 99-109,240,34,74,.459,26,48,.542,8,26,.308,23,33,.697,99
13219,2014-02-11,LAL,,UTA,L 79-96,240,33,85,.388,29,69,.420,4,16,.250,9,13,.692,79
13220,2014-02-11,UTA,@,LAL,W 96-79,240,37,85,.435,31,68,.456,6,17,.353,16,25,.640,96
13221,2014-02-11,MEM,,WAS,W 92-89,240,33,70,.471,30,57,.526,3,13,.231,23,27,.852,92
13222,2014-02-11,WAS,@,MEM,L 89-92,240,34,74,.459,27,50,.540,7,24,.292,14,20,.700,89
13223,2014-02-11,MIA,@,PHO,W 103-97,240,36,76,.474,27,49,.551,9,27,.333,22,30,.733,103
13224,2014-02-11,PHO,,MIA,L 97-103,240,35,76,.461,23,48,.479,12,28,.429,15,17,.882,97
13225,2014-02-11,OKC,@,POR,W 98-95,240,40,83,.482,33,69,.478,7,14,.500,11,12,.917,98
13226,2014-02-11,POR,,OKC,L 95-98,240,32,85,.376,25,62,.403,7,23,.304,24,27,.889,95
13227,2014-02-10,DET,,SAS,W 109-100,240,43,90,.478,38,74,.514,5,16,.313,18,26,.692,109
13228,2014-02-10,SAS,@,DET,L 100-109,240,43,82,.524,38,65,.585,5,17,.294,9,11,.818,100
13229,2014-02-10,GSW,,PHI,W 123-80,240,43,88,.489,31,59,.525,12,29,.414,25,30,.833,123
13230,2014-02-10,PHI,@,GSW,L 80-123,240,33,90,.367,31,73,.425,2,17,.118,12,17,.706,80
13231,2014-02-10,DEN,@,IND,L 80-119,240,28,89,.315,22,63,.349,6,26,.231,18,26,.692,80
13232,2014-02-10,IND,,DEN,W 119-80,240,46,80,.575,42,64,.656,4,16,.250,23,26,.885,119
13233,2014-02-10,BOS,@,MIL,W 102-86,240,42,88,.477,35,68,.515,7,20,.350,11,14,.786,102
13234,2014-02-10,MIL,,BOS,L 86-102,240,31,72,.431,25,56,.446,6,16,.375,18,25,.720,86
13235,2014-02-10,HOU,@,MIN,W 107-89,240,39,82,.476,28,55,.509,11,27,.407,18,20,.900,107
13236,2014-02-10,MIN,,HOU,L 89-107,240,31,87,.356,25,62,.403,6,25,.240,21,21,1.000,89
13237,2014-02-10,NOP,@,TOR,L 101-108,240,39,77,.506,33,65,.508,6,12,.500,17,26,.654,101
13238,2014-02-10,TOR,,NOP,W 108-101,240,36,76,.474,26,52,.500,10,24,.417,26,33,.788,108
13239,2014-02-09,BOS,,DAL,L 91-102,240,33,92,.359,22,65,.338,11,27,.407,14,15,.933,91
13240,2014-02-09,DAL,@,BOS,W 102-91,240,37,82,.451,27,59,.458,10,23,.435,18,20,.900,102
13241,2014-02-09,BRK,,NOP,W 93-81,240,35,66,.530,29,38,.763,6,28,.214,17,29,.586,93
13242,2014-02-09,NOP,@,BRK,L 81-93,240,30,83,.361,24,65,.369,6,18,.333,15,27,.556,81
13243,2014-02-09,CLE,,MEM,W 91-83 (OT),265,35,88,.398,25,68,.368,10,20,.500,11,18,.611,91
13244,2014-02-09,MEM,@,CLE,L 83-91 (OT),265,33,86,.384,30,72,.417,3,14,.214,14,16,.875,83
13245,2014-02-09,LAC,,PHI,W 123-78,240,50,89,.562,41,61,.672,9,28,.321,14,17,.824,123
13246,2014-02-09,PHI,@,LAC,L 78-123,240,27,100,.270,24,72,.333,3,28,.107,21,25,.840,78
13247,2014-02-09,CHI,@,LAL,W 92-86,240,34,80,.425,27,58,.466,7,22,.318,17,17,1.000,92
13248,2014-02-09,LAL,,CHI,L 86-92,240,36,82,.439,30,63,.476,6,19,.316,8,11,.727,86
13249,2014-02-09,NYK,@,OKC,L 100-112,240,38,86,.442,29,62,.468,9,24,.375,15,20,.750,100
13250,2014-02-09,OKC,,NYK,W 112-100,240,40,73,.548,28,46,.609,12,27,.444,20,27,.741,112
13251,2014-02-09,IND,@,ORL,L 92-93,240,35,79,.443,24,55,.436,11,24,.458,11,19,.579,92
13252,2014-02-09,ORL,,IND,W 93-92,240,34,83,.410,29,71,.408,5,12,.417,20,26,.769,93
13253,2014-02-09,SAC,@,WAS,L 84-93,240,29,82,.354,27,71,.380,2,11,.182,24,28,.857,84
13254,2014-02-09,WAS,,SAC,W 93-84,240,34,79,.430,26,58,.448,8,21,.381,17,22,.773,93
13255,2014-02-08,ATL,,MEM,L 76-79,240,30,70,.429,22,50,.440,8,20,.400,8,15,.533,76
13256,2014-02-08,MEM,@,ATL,W 79-76,240,37,90,.411,33,78,.423,4,12,.333,1,1,1.000,79
13257,2014-02-08,CHA,,SAS,L 100-104,240,39,89,.438,33,73,.452,6,16,.375,16,22,.727,100
13258,2014-02-08,SAS,@,CHA,W 104-100,240,36,77,.468,28,56,.500,8,21,.381,24,28,.857,104
13259,2014-02-08,DEN,@,DET,L 109-126,240,41,88,.466,26,55,.473,15,33,.455,12,22,.545,109
13260,2014-02-08,DET,,DEN,W 126-109,240,50,98,.510,42,78,.538,8,20,.400,18,23,.783,126
13261,2014-02-08,HOU,@,MIL,W 101-95,240,42,85,.494,34,61,.557,8,24,.333,9,13,.692,101
13262,2014-02-08,MIL,,HOU,L 95-101,240,40,90,.444,34,75,.453,6,15,.400,9,11,.818,95
13263,2014-02-08,MIN,,POR,L 110-117,240,40,97,.412,35,80,.438,5,17,.294,25,34,.735,110
13264,2014-02-08,POR,@,MIN,W 117-110,240,40,83,.482,32,60,.533,8,23,.348,29,38,.763,117
13265,2014-02-08,GSW,@,PHO,L 109-122,240,41,84,.488,33,59,.559,8,25,.320,19,26,.731,109
13266,2014-02-08,PHO,,GSW,W 122-109,240,43,80,.538,32,59,.542,11,21,.524,25,30,.833,122
13267,2014-02-08,MIA,@,UTA,L 89-94,240,29,67,.433,22,44,.500,7,23,.304,24,30,.800,89
13268,2014-02-08,UTA,,MIA,W 94-89,240,36,74,.486,26,49,.531,10,25,.400,12,19,.632,94
13269,2014-02-07,BOS,,SAC,W 99-89,240,40,88,.455,31,66,.470,9,22,.409,10,15,.667,99
13270,2014-02-07,SAC,@,BOS,L 89-99,240,31,87,.356,26,72,.361,5,15,.333,22,24,.917,89
13271,2014-02-07,DAL,,UTA,W 103-81,240,38,81,.469,28,63,.444,10,18,.556,17,22,.773,103
13272,2014-02-07,UTA,@,DAL,L 81-103,240,31,76,.408,19,41,.463,12,35,.343,7,14,.500,81
13273,2014-02-07,BRK,@,DET,L 95-111,240,32,89,.360,20,58,.345,12,31,.387,19,29,.655,95
13274,2014-02-07,DET,,BRK,W 111-95,240,43,84,.512,34,67,.507,9,17,.529,16,24,.667,111
13275,2014-02-07,IND,,POR,W 118-113 (OT),265,42,92,.457,37,79,.468,5,13,.385,29,35,.829,118
13276,2014-02-07,POR,@,IND,L 113-118 (OT),265,45,104,.433,38,84,.452,7,20,.350,16,20,.800,113
13277,2014-02-07,LAC,,TOR,W 118-105,240,36,71,.507,27,47,.574,9,24,.375,37,54,.685,118
13278,2014-02-07,TOR,@,LAC,L 105-118,240,34,85,.400,27,59,.458,7,26,.269,30,40,.750,105
13279,2014-02-07,MIN,@,NOP,L 91-98,240,28,75,.373,24,57,.421,4,18,.222,31,37,.838,91
13280,2014-02-07,NOP,,MIN,W 98-91,240,39,81,.481,31,66,.470,8,15,.533,12,16,.750,98
13281,2014-02-07,DEN,@,NYK,L 90-117,240,32,76,.421,25,50,.500,7,26,.269,19,26,.731,90
13282,2014-02-07,NYK,,DEN,W 117-90,240,48,85,.565,37,57,.649,11,28,.393,10,14,.714,117
13283,2014-02-07,OKC,@,ORL,L 102-103,240,37,73,.507,27,51,.529,10,22,.455,18,19,.947,102
13284,2014-02-07,ORL,,OKC,W 103-102,240,38,80,.475,33,68,.485,5,12,.417,22,26,.846,103
13285,2014-02-07,LAL,@,PHI,W 112-98,240,45,89,.506,37,71,.521,8,18,.444,14,20,.700,112
13286,2014-02-07,PHI,,LAL,L 98-112,240,37,87,.425,22,55,.400,15,32,.469,9,17,.529,98
13287,2014-02-07,CLE,@,WAS,W 115-113,240,40,77,.519,34,62,.548,6,15,.400,29,33,.879,115
13288,2014-02-07,WAS,,CLE,L 113-115,240,43,85,.506,32,65,.492,11,20,.550,16,23,.696,113
13289,2014-02-06,BRK,,SAS,W 103-89,240,46,93,.495,42,80,.525,4,13,.308,7,10,.700,103
13290,2014-02-06,SAS,@,BRK,L 89-103,240,29,73,.397,22,52,.423,7,21,.333,24,29,.828,89
13291,2014-02-06,CHI,@,GSW,L 87-102,240,32,77,.416,28,63,.444,4,14,.286,19,20,.950,87
13292,2014-02-06,GSW,,CHI,W 102-87,240,40,83,.482,29,61,.475,11,22,.500,11,15,.733,102
13293,2014-02-05,CLE,,LAL,L 108-119,240,38,101,.376,33,68,.485,5,33,.152,27,37,.730,108
13294,2014-02-05,LAL,@,CLE,W 119-108,240,42,79,.532,24,42,.571,18,37,.486,17,22,.773,119
13295,2014-02-05,DEN,,MIL,W 110-100,240,39,84,.464,29,61,.475,10,23,.435,22,26,.846,110
13296,2014-02-05,MIL,@,DEN,L 100-110,240,36,95,.379,29,79,.367,7,16,.438,21,31,.677,100
13297,2014-02-05,HOU,,PHO,W 122-108,240,39,71,.549,28,55,.509,11,16,.688,33,42,.786,122
13298,2014-02-05,PHO,@,HOU,L 108-122,240,42,90,.467,34,60,.567,8,30,.267,16,21,.762,108
13299,2014-02-05,LAC,,MIA,L 112-116,240,37,86,.430,30,61,.492,7,25,.280,31,42,.738,112
13300,2014-02-05,MIA,@,LAC,W 116-112,240,41,78,.526,28,47,.596,13,31,.419,21,26,.808,116
13301,2014-02-05,DAL,@,MEM,W 110-96,240,42,78,.538,34,60,.567,8,18,.444,18,25,.720,110
13302,2014-02-05,MEM,,DAL,L 96-110,240,37,69,.536,31,53,.585,6,16,.375,16,22,.727,96
13303,2014-02-05,ATL,@,NOP,L 100-105,240,38,84,.452,24,54,.444,14,30,.467,10,14,.714,100
13304,2014-02-05,NOP,,ATL,W 105-100,240,40,86,.465,35,72,.486,5,14,.357,20,22,.909,105
13305,2014-02-05,NYK,,POR,L 90-94,240,36,90,.400,32,69,.464,4,21,.190,14,20,.700,90
13306,2014-02-05,POR,@,NYK,W 94-90,240,30,79,.380,22,58,.379,8,21,.381,26,33,.788,94
13307,2014-02-05,MIN,@,OKC,L 97-106,240,37,78,.474,31,58,.534,6,20,.300,17,23,.739,97
13308,2014-02-05,OKC,,MIN,W 106-97,240,44,91,.484,34,64,.531,10,27,.370,8,11,.727,106
13309,2014-02-05,DET,@,ORL,L 98-112,240,39,85,.459,33,65,.508,6,20,.300,14,23,.609,98
13310,2014-02-05,ORL,,DET,W 112-98,240,44,89,.494,38,71,.535,6,18,.333,18,20,.900,112
13311,2014-02-05,BOS,@,PHI,W 114-108,240,41,84,.488,33,65,.508,8,19,.421,24,33,.727,114
13312,2014-02-05,PHI,,BOS,L 108-114,240,42,94,.447,35,73,.479,7,21,.333,17,20,.850,108
13313,2014-02-05,SAC,,TOR,W 109-101,240,32,81,.395,28,69,.406,4,12,.333,41,51,.804,109
13314,2014-02-05,TOR,@,SAC,L 101-109,240,36,84,.429,26,59,.441,10,25,.400,19,24,.792,101
13315,2014-02-05,SAS,@,WAS,W 125-118 (2OT),290,48,98,.490,39,70,.557,9,28,.321,20,25,.800,125
13316,2014-02-05,WAS,,SAS,L 118-125 (2OT),290,44,101,.436,39,85,.459,5,16,.313,25,32,.781,118
13317,2014-02-04,ATL,,IND,L 85-89,240,33,76,.434,26,51,.510,7,25,.280,12,15,.800,85
13318,2014-02-04,IND,@,ATL,W 89-85,240,34,74,.459,29,56,.518,5,18,.278,16,20,.800,89
13319,2014-02-04,CHA,@,GSW,W 91-75,240,37,78,.474,32,65,.492,5,13,.385,12,19,.632,91
13320,2014-02-04,GSW,,CHA,L 75-91,240,29,93,.312,25,73,.342,4,20,.200,13,16,.813,75
13321,2014-02-04,LAL,@,MIN,L 99-109,240,33,79,.418,23,58,.397,10,21,.476,23,26,.885,99
13322,2014-02-04,MIN,,LAL,W 109-99,240,37,83,.446,29,66,.439,8,17,.471,27,38,.711,109
13323,2014-02-04,CHI,@,PHO,W 101-92,240,35,78,.449,29,60,.483,6,18,.333,25,31,.806,101
13324,2014-02-04,PHO,,CHI,L 92-101,240,31,80,.388,23,52,.442,8,28,.286,22,29,.759,92
13325,2014-02-03,BRK,,PHI,W 108-102,240,32,72,.444,22,47,.468,10,25,.400,34,39,.872,108
13326,2014-02-03,PHI,@,BRK,L 102-108,240,37,71,.521,29,51,.569,8,20,.400,20,28,.714,102
13327,2014-02-03,CLE,@,DAL,L 107-124,240,37,80,.463,29,56,.518,8,24,.333,25,33,.758,107
13328,2014-02-03,DAL,,CLE,W 124-107,240,44,80,.550,32,54,.593,12,26,.462,24,26,.923,124
13329,2014-02-03,DEN,,LAC,W 116-115,240,40,83,.482,35,65,.538,5,18,.278,31,44,.705,116
13330,2014-02-03,LAC,@,DEN,L 115-116,240,42,84,.500,36,63,.571,6,21,.286,25,34,.735,115
13331,2014-02-03,IND,,ORL,W 98-79,240,38,90,.422,30,65,.462,8,25,.320,14,17,.824,98
13332,2014-02-03,ORL,@,IND,L 79-98,240,33,83,.398,26,67,.388,7,16,.438,6,10,.600,79
13333,2014-02-03,DET,@,MIA,L 96-102,240,34,83,.410,28,65,.431,6,18,.333,22,29,.759,96
13334,2014-02-03,MIA,,DET,W 102-96,240,39,85,.459,32,65,.492,7,20,.350,17,21,.810,102
13335,2014-02-03,MIL,,NYK,W 101-98,240,36,81,.444,25,63,.397,11,18,.611,18,21,.857,101
13336,2014-02-03,NYK,@,MIL,L 98-101,240,34,78,.436,19,44,.432,15,34,.441,15,24,.625,98
13337,2014-02-03,NOP,,SAS,L 95-102,240,36,79,.456,30,65,.462,6,14,.429,17,20,.850,95
13338,2014-02-03,SAS,@,NOP,W 102-95,240,38,81,.469,33,63,.524,5,18,.278,21,25,.840,102
13339,2014-02-03,MEM,@,OKC,L 77-86,240,32,81,.395,30,65,.462,2,16,.125,11,15,.733,77
13340,2014-02-03,OKC,,MEM,W 86-77,240,34,76,.447,30,58,.517,4,18,.222,14,23,.609,86
13341,2014-02-03,CHI,@,SAC,L 70-99,240,22,78,.282,18,58,.310,4,20,.200,22,34,.647,70
13342,2014-02-03,SAC,,CHI,W 99-70,240,36,69,.522,34,61,.557,2,8,.250,25,34,.735,99
13343,2014-02-03,TOR,@,UTA,W 94-79,240,37,84,.440,31,63,.492,6,21,.286,14,16,.875,94
13344,2014-02-03,UTA,,TOR,L 79-94,240,32,78,.410,29,61,.475,3,17,.176,12,13,.923,79
13345,2014-02-03,POR,@,WAS,L 90-100,240,37,81,.457,32,62,.516,5,19,.263,11,12,.917,90
13346,2014-02-03,WAS,,POR,W 100-90,240,37,84,.440,30,67,.448,7,17,.412,19,22,.864,100
13347,2014-02-02,BOS,,ORL,W 96-89,240,41,82,.500,37,68,.544,4,14,.286,10,12,.833,96
13348,2014-02-02,ORL,@,BOS,L 89-96,240,33,80,.413,28,66,.424,5,14,.357,18,22,.818,89
13349,2014-02-01,ATL,,MIN,W 120-113,240,43,92,.467,34,69,.493,9,23,.391,25,30,.833,120
13350,2014-02-01,MIN,@,ATL,L 113-120,240,37,84,.440,31,68,.456,6,16,.375,33,39,.846,113
13351,2014-02-01,DET,,PHI,W 113-96,240,41,92,.446,34,67,.507,7,25,.280,24,40,.600,113
13352,2014-02-01,PHI,@,DET,L 96-113,240,38,89,.427,33,68,.485,5,21,.238,15,23,.652,96
13353,2014-02-01,CLE,@,HOU,L 92-106,240,38,87,.437,30,57,.526,8,30,.267,8,10,.800,92
13354,2014-02-01,HOU,,CLE,W 106-92,240,41,80,.513,34,54,.630,7,26,.269,17,24,.708,106
13355,2014-02-01,BRK,@,IND,L 96-97,240,34,77,.442,27,54,.500,7,23,.304,21,23,.913,96
13356,2014-02-01,IND,,BRK,W 97-96,240,31,73,.425,28,58,.483,3,15,.200,32,37,.865,97
13357,2014-02-01,LAC,,UTA,W 102-87,240,38,74,.514,36,62,.581,2,12,.167,24,37,.649,102
13358,2014-02-01,UTA,@,LAC,L 87-102,240,29,81,.358,19,51,.373,10,30,.333,19,28,.679,87
13359,2014-02-01,MEM,,MIL,W 99-90,240,38,79,.481,32,69,.464,6,10,.600,17,22,.773,99
13360,2014-02-01,MIL,@,MEM,L 90-99,240,30,76,.395,21,53,.396,9,23,.391,21,25,.840,90
13361,2014-02-01,CHI,@,NOP,L 79-88,240,27,70,.386,24,54,.444,3,16,.188,22,33,.667,79
13362,2014-02-01,NOP,,CHI,W 88-79,240,38,80,.475,34,71,.479,4,9,.444,8,10,.800,88
13363,2014-02-01,MIA,@,NYK,W 106-91,240,41,76,.539,33,53,.623,8,23,.348,16,24,.667,106
13364,2014-02-01,NYK,,MIA,L 91-106,240,33,67,.493,22,41,.537,11,26,.423,14,23,.609,91
13365,2014-02-01,CHA,@,PHO,L 95-105,240,33,79,.418,25,56,.446,8,23,.348,21,29,.724,95
13366,2014-02-01,PHO,,CHA,W 105-95,240,39,80,.488,32,59,.542,7,21,.333,20,23,.870,105
13367,2014-02-01,POR,,TOR,W 106-103,240,35,76,.461,27,58,.466,8,18,.444,28,35,.800,106
13368,2014-02-01,TOR,@,POR,L 103-106,240,40,87,.460,34,67,.507,6,20,.300,17,25,.680,103
13369,2014-02-01,SAC,@,SAS,L 93-95,240,34,83,.410,29,69,.420,5,14,.357,20,25,.800,93
13370,2014-02-01,SAS,,SAC,W 95-93,240,36,75,.480,30,53,.566,6,22,.273,17,26,.654,95
13371,2014-02-01,OKC,@,WAS,L 81-96,240,31,78,.397,27,54,.500,4,24,.167,15,17,.882,81
13372,2014-02-01,WAS,,OKC,W 96-81,240,41,89,.461,33,65,.508,8,24,.333,6,9,.667,96
13373,2014-01-31,BRK,,OKC,L 95-120,240,35,74,.473,24,50,.480,11,24,.458,14,17,.824,95
13374,2014-01-31,OKC,@,BRK,W 120-95,240,49,77,.636,44,62,.710,5,15,.333,17,20,.850,120
13375,2014-01-31,DAL,,SAC,W 107-103,240,38,80,.475,36,61,.590,2,19,.105,29,36,.806,107
13376,2014-01-31,SAC,@,DAL,L 103-107,240,38,75,.507,31,54,.574,7,21,.333,20,23,.870,103
13377,2014-01-31,DEN,,TOR,L 90-100,240,36,80,.450,28,59,.475,8,21,.381,10,14,.714,90
13378,2014-01-31,TOR,@,DEN,W 100-90,240,37,85,.435,29,64,.453,8,21,.381,18,20,.900,100
13379,2014-01-31,CHA,@,LAL,W 110-100,240,46,88,.523,44,77,.571,2,11,.182,16,22,.727,110
13380,2014-01-31,LAL,,CHA,L 100-110,240,36,93,.387,30,67,.448,6,26,.231,22,27,.815,100
13381,2014-01-31,MEM,@,MIN,W 94-90,240,38,80,.475,34,68,.500,4,12,.333,14,22,.636,94
13382,2014-01-31,MIN,,MEM,L 90-94,240,39,84,.464,33,62,.532,6,22,.273,6,7,.857,90
13383,2014-01-31,MIL,@,ORL,L 102-113,240,39,87,.448,29,66,.439,10,21,.476,14,24,.583,102
13384,2014-01-31,ORL,,MIL,W 113-102,240,43,83,.518,36,67,.537,7,16,.438,20,25,.800,113
13385,2014-01-31,ATL,@,PHI,W 125-99,240,45,89,.506,37,73,.507,8,16,.500,27,34,.794,125
13386,2014-01-31,PHI,,ATL,L 99-125,240,32,87,.368,26,65,.400,6,22,.273,29,37,.784,99
13387,2014-01-31,GSW,@,UTA,W 95-90,240,33,88,.375,23,62,.371,10,26,.385,19,24,.792,95
13388,2014-01-31,UTA,,GSW,L 90-95,240,35,73,.479,32,64,.500,3,9,.333,17,21,.810,90
13389,2014-01-30,GSW,,LAC,W 111-92,240,45,91,.495,39,70,.557,6,21,.286,15,20,.750,111
13390,2014-01-30,LAC,@,GSW,L 92-111,240,31,76,.408,23,52,.442,8,24,.333,22,34,.647,92
13391,2014-01-30,IND,,PHO,L 94-102,240,38,87,.437,37,72,.514,1,15,.067,17,24,.708,94
13392,2014-01-30,PHO,@,IND,W 102-94,240,39,91,.429,31,74,.419,8,17,.471,16,20,.800,102
13393,2014-01-30,CLE,@,NYK,L 86-117,240,31,87,.356,23,64,.359,8,23,.348,16,22,.727,86
13394,2014-01-30,NYK,,CLE,W 117-86,240,43,76,.566,31,50,.620,12,26,.462,19,28,.679,117
13395,2014-01-29,BOS,,PHI,L 94-95,240,32,87,.368,25,68,.368,7,19,.368,23,30,.767,94
13396,2014-01-29,PHI,@,BOS,W 95-94,240,37,86,.430,30,65,.462,7,21,.333,14,25,.560,95
13397,2014-01-29,DAL,,HOU,L 115-117,240,40,86,.465,35,67,.522,5,19,.263,30,36,.833,115
13398,2014-01-29,HOU,@,DAL,W 117-115,240,41,74,.554,32,53,.604,9,21,.429,26,36,.722,117
13399,2014-01-29,CHA,@,DEN,W 101-98,240,33,78,.423,28,64,.438,5,14,.357,30,42,.714,101
13400,2014-01-29,DEN,,CHA,L 98-101,240,39,100,.390,30,72,.417,9,28,.321,11,13,.846,98
13401,2014-01-29,LAC,,WAS,W 110-103,240,36,73,.493,30,58,.517,6,15,.400,32,42,.762,110
13402,2014-01-29,WAS,@,LAC,L 103-110,240,45,88,.511,42,66,.636,3,22,.136,10,17,.588,103
13403,2014-01-29,MIA,,OKC,L 95-112,240,37,72,.514,34,53,.642,3,19,.158,18,22,.818,95
13404,2014-01-29,OKC,@,MIA,W 112-95,240,41,80,.513,25,53,.472,16,27,.593,14,19,.737,112
13405,2014-01-29,MIL,,PHO,L 117-126,240,38,89,.427,31,70,.443,7,19,.368,34,36,.944,117
13406,2014-01-29,PHO,@,MIL,W 126-117,240,42,78,.538,30,55,.545,12,23,.522,30,32,.938,126
13407,2014-01-29,MIN,,NOP,W 88-77,240,33,82,.402,29,62,.468,4,20,.200,18,25,.720,88
13408,2014-01-29,NOP,@,MIN,L 77-88,240,29,82,.354,27,61,.443,2,21,.095,17,23,.739,77
13409,2014-01-29,MEM,@,SAC,W 99-89,240,41,75,.547,37,61,.607,4,14,.286,13,16,.813,99
13410,2014-01-29,SAC,,MEM,L 89-99,240,38,79,.481,33,58,.569,5,21,.238,8,8,1.000,89
13411,2014-01-29,CHI,@,SAS,W 96-86,240,37,83,.446,33,71,.465,4,12,.333,18,23,.783,96
13412,2014-01-29,SAS,,CHI,L 86-96,240,33,71,.465,28,58,.483,5,13,.385,15,16,.938,86
13413,2014-01-29,ORL,@,TOR,L 83-98,240,28,84,.333,22,65,.338,6,19,.316,21,26,.808,83
13414,2014-01-29,TOR,,ORL,W 98-83,240,37,87,.425,23,56,.411,14,31,.452,10,13,.769,98
13415,2014-01-28,CLE,,NOP,L 89-100,240,33,80,.413,27,65,.415,6,15,.400,17,27,.630,89
13416,2014-01-28,NOP,@,CLE,W 100-89,240,39,74,.527,35,61,.574,4,13,.308,18,23,.783,100
13417,2014-01-28,DET,,ORL,W 103-87,240,39,86,.453,33,66,.500,6,20,.300,19,28,.679,103
13418,2014-01-28,ORL,@,DET,L 87-103,240,32,77,.416,24,57,.421,8,20,.400,15,25,.600,87
13419,2014-01-28,GSW,,WAS,L 85-88,240,30,80,.375,23,57,.404,7,23,.304,18,23,.783,85
13420,2014-01-28,WAS,@,GSW,W 88-85,240,34,90,.378,24,68,.353,10,22,.455,10,15,.667,88
13421,2014-01-28,HOU,,SAS,W 97-90,240,33,75,.440,28,57,.491,5,18,.278,26,47,.553,97
13422,2014-01-28,SAS,@,HOU,L 90-97,240,35,82,.427,29,59,.492,6,23,.261,14,21,.667,90
13423,2014-01-28,IND,@,LAL,W 104-92,240,42,99,.424,37,78,.474,5,21,.238,15,27,.556,104
13424,2014-01-28,LAL,,IND,L 92-104,240,37,94,.394,32,70,.457,5,24,.208,13,16,.813,92
13425,2014-01-28,BOS,@,NYK,L 88-114,240,32,82,.390,26,60,.433,6,22,.273,18,24,.750,88
13426,2014-01-28,NYK,,BOS,W 114-88,240,44,82,.537,34,62,.548,10,20,.500,16,23,.696,114
13427,2014-01-28,MEM,@,POR,W 98-81,240,43,83,.518,37,70,.529,6,13,.462,6,10,.600,98
13428,2014-01-28,POR,,MEM,L 81-98,240,30,87,.345,26,63,.413,4,24,.167,17,22,.773,81
13429,2014-01-27,BRK,,TOR,L 103-104,240,37,77,.481,26,53,.491,11,24,.458,18,22,.818,103
13430,2014-01-27,TOR,@,BRK,W 104-103,240,37,79,.468,28,57,.491,9,22,.409,21,26,.808,104
13431,2014-01-27,CHI,,MIN,L 86-95,240,32,85,.376,24,61,.393,8,24,.333,14,16,.875,86
13432,2014-01-27,MIN,@,CHI,W 95-86,240,34,73,.466,29,56,.518,5,17,.294,22,26,.846,95
13433,2014-01-27,LAC,@,MIL,W 114-86,240,43,79,.544,29,51,.569,14,28,.500,14,19,.737,114
13434,2014-01-27,MIL,,LAC,L 86-114,240,34,89,.382,30,67,.448,4,22,.182,14,22,.636,86
13435,2014-01-27,ATL,@,OKC,L 109-111,240,43,88,.489,31,63,.492,12,25,.480,11,12,.917,109
13436,2014-01-27,OKC,,ATL,W 111-109,240,43,82,.524,30,57,.526,13,25,.520,12,18,.667,111
13437,2014-01-27,PHI,,PHO,L 113-124,240,40,87,.460,32,67,.478,8,20,.400,25,26,.962,113
13438,2014-01-27,PHO,@,PHI,W 124-113,240,43,80,.538,34,60,.567,9,20,.450,29,35,.829,124
13439,2014-01-27,SAC,@,UTA,L 99-106,240,37,90,.411,32,68,.471,5,22,.227,20,26,.769,99
13440,2014-01-27,UTA,,SAC,W 106-99,240,32,80,.400,25,60,.417,7,20,.350,35,53,.660,106
13441,2014-01-26,BOS,,BRK,L 79-85,240,28,75,.373,21,49,.429,7,26,.269,16,19,.842,79
13442,2014-01-26,BRK,@,BOS,W 85-79,240,33,84,.393,27,59,.458,6,25,.240,13,18,.722,85
13443,2014-01-26,CLE,,PHO,L 90-99,240,34,86,.395,29,70,.414,5,16,.313,17,24,.708,90
13444,2014-01-26,PHO,@,CLE,W 99-90,240,34,82,.415,25,55,.455,9,27,.333,22,28,.786,99
13445,2014-01-26,DAL,,DET,W 116-106,240,43,74,.581,36,53,.679,7,21,.333,23,28,.821,116
13446,2014-01-26,DET,@,DAL,L 106-116,240,43,91,.473,39,78,.500,4,13,.308,16,28,.571,106
13447,2014-01-26,GSW,,POR,W 103-88,240,38,91,.418,28,66,.424,10,25,.400,17,21,.810,103
13448,2014-01-26,POR,@,GSW,L 88-103,240,28,83,.337,22,62,.355,6,21,.286,26,33,.788,88
13449,2014-01-26,MIA,,SAS,W 113-101,240,43,74,.581,35,55,.636,8,19,.421,19,20,.950,113
13450,2014-01-26,SAS,@,MIA,L 101-113,240,38,76,.500,32,54,.593,6,22,.273,19,23,.826,101
13451,2014-01-26,NOP,,ORL,W 100-92,240,37,81,.457,32,69,.464,5,12,.417,21,27,.778,100
13452,2014-01-26,ORL,@,NOP,L 92-100,240,36,77,.468,33,62,.532,3,15,.200,17,19,.895,92
13453,2014-01-26,LAL,@,NYK,L 103-110,240,39,75,.520,28,52,.538,11,23,.478,14,18,.778,103
13454,2014-01-26,NYK,,LAL,W 110-103,240,43,90,.478,32,64,.500,11,26,.423,13,18,.722,110
13455,2014-01-26,DEN,@,SAC,W 125-117,240,42,81,.519,32,56,.571,10,25,.400,31,40,.775,125
13456,2014-01-26,SAC,,DEN,L 117-125,240,42,81,.519,38,65,.585,4,16,.250,29,34,.853,117
13457,2014-01-25,CHA,,CHI,L 87-89,240,37,88,.420,31,69,.449,6,19,.316,7,10,.700,87
13458,2014-01-25,CHI,@,CHA,W 89-87,240,31,77,.403,20,54,.370,11,23,.478,16,22,.727,89
13459,2014-01-25,DEN,,IND,W 109-96,240,40,83,.482,32,63,.508,8,20,.400,21,37,.568,109
13460,2014-01-25,IND,@,DEN,L 96-109,240,37,88,.420,32,76,.421,5,12,.417,17,27,.630,96
13461,2014-01-25,HOU,@,MEM,L 81-99,240,30,81,.370,21,49,.429,9,32,.281,12,17,.706,81
13462,2014-01-25,MEM,,HOU,W 99-81,240,41,88,.466,34,69,.493,7,19,.368,10,14,.714,99
13463,2014-01-25,ATL,@,MIL,W 112-87,240,40,76,.526,27,50,.540,13,26,.500,19,25,.760,112
13464,2014-01-25,MIL,,ATL,L 87-112,240,38,82,.463,33,61,.541,5,21,.238,6,13,.462,87
13465,2014-01-25,OKC,@,PHI,W 103-91,240,40,76,.526,36,55,.655,4,21,.190,19,25,.760,103
13466,2014-01-25,PHI,,OKC,L 91-103,240,34,90,.378,30,63,.476,4,27,.148,19,27,.704,91
13467,2014-01-25,MIN,@,POR,L 104-115,240,38,89,.427,29,67,.433,9,22,.409,19,22,.864,104
13468,2014-01-25,POR,,MIN,W 115-104,240,46,95,.484,42,79,.532,4,16,.250,19,24,.792,115
13469,2014-01-25,LAC,@,TOR,W 126-118,240,46,84,.548,34,62,.548,12,22,.545,22,25,.880,126
13470,2014-01-25,TOR,,LAC,L 118-126,240,36,74,.486,22,45,.489,14,29,.483,32,38,.842,118
13471,2014-01-25,UTA,,WAS,W 104-101,240,38,81,.469,28,57,.491,10,24,.417,18,22,.818,104
13472,2014-01-25,WAS,@,UTA,L 101-104,240,39,91,.429,32,71,.451,7,20,.350,16,18,.889,101
13473,2014-01-24,ATL,,SAS,L 79-105,240,29,76,.382,27,63,.429,2,13,.154,19,27,.704,79
13474,2014-01-24,SAS,@,ATL,W 105-79,240,41,84,.488,30,66,.455,11,18,.611,12,17,.706,105
13475,2014-01-24,BOS,,OKC,L 83-101,240,32,75,.427,27,48,.563,5,27,.185,14,19,.737,83
13476,2014-01-24,OKC,@,BOS,W 101-83,240,43,80,.538,38,67,.567,5,13,.385,10,13,.769,101
13477,2014-01-24,BRK,,DAL,W 107-106,240,37,73,.507,27,46,.587,10,27,.370,23,28,.821,107
13478,2014-01-24,DAL,@,BRK,L 106-107,240,34,78,.436,24,58,.414,10,20,.500,28,33,.848,106
13479,2014-01-24,CHI,,LAC,L 95-112,240,40,93,.430,34,74,.459,6,19,.316,9,11,.818,95
13480,2014-01-24,LAC,@,CHI,W 112-95,240,41,76,.539,28,55,.509,13,21,.619,17,26,.654,112
13481,2014-01-24,CLE,,MIL,W 93-78,240,37,88,.420,33,74,.446,4,14,.286,15,23,.652,93
13482,2014-01-24,MIL,@,CLE,L 78-93,240,30,74,.405,23,50,.460,7,24,.292,11,14,.786,78
13483,2014-01-24,DET,,NOP,L 101-103,240,37,85,.435,31,67,.463,6,18,.333,21,28,.750,101
13484,2014-01-24,NOP,@,DET,W 103-101,240,37,73,.507,30,56,.536,7,17,.412,22,24,.917,103
13485,2014-01-24,GSW,,MIN,L 120-121,240,49,89,.551,40,67,.597,9,22,.409,13,15,.867,120
13486,2014-01-24,MIN,@,GSW,W 121-120,240,47,94,.500,38,72,.528,9,22,.409,18,28,.643,121
13487,2014-01-24,HOU,,MEM,L 87-88,240,32,79,.405,18,45,.400,14,34,.412,9,14,.643,87
13488,2014-01-24,MEM,@,HOU,W 88-87,240,36,78,.462,32,71,.451,4,7,.571,12,16,.750,88
13489,2014-01-24,CHA,@,NYK,L 96-125,240,37,76,.487,27,52,.519,10,24,.417,12,14,.857,96
13490,2014-01-24,NYK,,CHA,W 125-96,240,50,90,.556,36,63,.571,14,27,.519,11,11,1.000,125
13491,2014-01-24,LAL,@,ORL,L 105-114,240,41,90,.456,29,68,.426,12,22,.545,11,17,.647,105
13492,2014-01-24,ORL,,LAL,W 114-105,240,39,81,.481,30,64,.469,9,17,.529,27,34,.794,114
13493,2014-01-24,PHI,,TOR,L 95-104,240,38,89,.427,32,69,.464,6,20,.300,13,16,.813,95
13494,2014-01-24,TOR,@,PHI,W 104-95,240,40,84,.476,32,64,.500,8,20,.400,16,22,.727,104
13495,2014-01-24,PHO,,WAS,L 95-101,240,34,71,.479,27,49,.551,7,22,.318,20,25,.800,95
13496,2014-01-24,WAS,@,PHO,W 101-95,240,39,86,.453,33,70,.471,6,16,.375,17,23,.739,101
13497,2014-01-24,IND,@,SAC,W 116-111 (OT),265,41,95,.432,33,71,.465,8,24,.333,26,33,.788,116
13498,2014-01-24,SAC,,IND,L 111-116 (OT),265,39,101,.386,27,69,.391,12,32,.375,21,29,.724,111
13499,2014-01-23,LAL,@,MIA,L 102-109,240,40,88,.455,31,63,.492,9,25,.360,13,21,.619,102
13500,2014-01-23,MIA,,LAL,W 109-102,240,45,78,.577,37,58,.638,8,20,.400,11,23,.478,109
13501,2014-01-23,DEN,@,POR,L 105-110,240,39,79,.494,29,56,.518,10,23,.435,17,20,.850,105
13502,2014-01-23,POR,,DEN,W 110-105,240,38,88,.432,34,70,.486,4,18,.222,30,34,.882,110
13503,2014-01-22,CHA,,LAC,W 95-91,240,39,84,.464,34,69,.493,5,15,.333,12,20,.600,95
13504,2014-01-22,LAC,@,CHA,L 91-95,240,39,90,.433,33,64,.516,6,26,.231,7,9,.778,91
13505,2014-01-22,CHI,@,CLE,W 98-87,240,37,70,.529,27,49,.551,10,21,.476,14,18,.778,98
13506,2014-01-22,CLE,,CHI,L 87-98,240,33,88,.375,25,69,.362,8,19,.421,13,18,.722,87
13507,2014-01-22,HOU,,SAC,W 119-98,240,43,90,.478,35,59,.593,8,31,.258,25,40,.625,119
13508,2014-01-22,SAC,@,HOU,L 98-119,240,34,86,.395,22,56,.393,12,30,.400,18,30,.600,98
13509,2014-01-22,DET,@,MIL,L 101-104,240,36,84,.429,32,69,.464,4,15,.267,25,34,.735,101
13510,2014-01-22,MIL,,DET,W 104-101,240,41,84,.488,33,57,.579,8,27,.296,14,22,.636,104
13511,2014-01-22,NYK,,PHI,L 106-110,240,37,82,.451,22,49,.449,15,33,.455,17,24,.708,106
13512,2014-01-22,PHI,@,NYK,W 110-106,240,42,88,.477,33,74,.446,9,14,.643,17,24,.708,110
13513,2014-01-22,ATL,@,ORL,W 112-109,240,41,83,.494,32,58,.552,9,25,.360,21,24,.875,112
13514,2014-01-22,ORL,,ATL,L 109-112,240,41,83,.494,35,71,.493,6,12,.500,21,24,.875,109
13515,2014-01-22,IND,@,PHO,L 100-124,240,38,75,.507,33,60,.550,5,15,.333,19,28,.679,100
13516,2014-01-22,PHO,,IND,W 124-100,240,45,83,.542,34,67,.507,11,16,.688,23,32,.719,124
13517,2014-01-22,OKC,@,SAS,W 111-105,240,45,83,.542,35,65,.538,10,18,.556,11,16,.688,111
13518,2014-01-22,SAS,,OKC,L 105-111,240,40,75,.533,30,53,.566,10,22,.455,15,22,.682,105
13519,2014-01-22,DAL,@,TOR,L 85-93,240,34,73,.466,27,53,.509,7,20,.350,10,14,.714,85
13520,2014-01-22,TOR,,DAL,W 93-85,240,32,76,.421,25,53,.472,7,23,.304,22,32,.688,93
13521,2014-01-22,BOS,@,WAS,W 113-111 (OT),265,41,89,.461,26,55,.473,15,34,.441,16,23,.696,113
13522,2014-01-22,WAS,,BOS,L 111-113 (OT),265,42,94,.447,35,72,.486,7,22,.318,20,27,.741,111
13523,2014-01-21,BRK,,ORL,W 101-90,240,40,81,.494,30,53,.566,10,28,.357,11,13,.846,101
13524,2014-01-21,ORL,@,BRK,L 90-101,240,33,72,.458,26,53,.491,7,19,.368,17,23,.739,90
13525,2014-01-21,BOS,@,MIA,L 86-93,240,33,84,.393,28,57,.491,5,27,.185,15,18,.833,86
13526,2014-01-21,MIA,,BOS,W 93-86,240,38,74,.514,33,54,.611,5,20,.250,12,16,.750,93
13527,2014-01-21,NOP,,SAC,L 97-114,240,33,69,.478,28,58,.483,5,11,.455,26,38,.684,97
13528,2014-01-21,SAC,@,NOP,W 114-97,240,42,82,.512,33,61,.541,9,21,.429,21,31,.677,114
13529,2014-01-21,OKC,,POR,W 105-97,240,42,87,.483,32,72,.444,10,15,.667,11,17,.647,105
13530,2014-01-21,POR,@,OKC,L 97-105,240,40,86,.465,33,67,.493,7,19,.368,10,16,.625,97
13531,2014-01-21,MIN,@,UTA,W 112-97,240,41,90,.456,33,69,.478,8,21,.381,22,24,.917,112
13532,2014-01-21,UTA,,MIN,L 97-112,240,41,87,.471,36,70,.514,5,17,.294,10,12,.833,97
13533,2014-01-20,ATL,,MIA,W 121-114,240,42,81,.519,30,50,.600,12,31,.387,25,27,.926,121
13534,2014-01-20,MIA,@,ATL,L 114-121,240,38,78,.487,23,45,.511,15,33,.455,23,28,.821,114
13535,2014-01-20,CHA,,TOR,W 100-95,240,32,65,.492,23,49,.469,9,16,.563,27,33,.818,100
13536,2014-01-20,TOR,@,CHA,L 95-100,240,39,95,.411,29,66,.439,10,29,.345,7,10,.700,95
13537,2014-01-20,CHI,,LAL,W 102-100 (OT),265,39,102,.382,32,81,.395,7,21,.333,17,24,.708,102
13538,2014-01-20,LAL,@,CHI,L 100-102 (OT),265,35,83,.422,27,58,.466,8,25,.320,22,26,.846,100
13539,2014-01-20,CLE,,DAL,L 97-102,240,33,81,.407,28,58,.483,5,23,.217,26,33,.788,97
13540,2014-01-20,DAL,@,CLE,W 102-97,240,38,83,.458,34,63,.540,4,20,.200,22,28,.786,102
13541,2014-01-20,DET,,LAC,L 103-112,240,40,79,.506,38,65,.585,2,14,.143,21,29,.724,103
13542,2014-01-20,LAC,@,DET,W 112-103,240,40,72,.556,31,51,.608,9,21,.429,23,37,.622,112
13543,2014-01-20,GSW,,IND,L 94-102,240,35,86,.407,25,56,.446,10,30,.333,14,20,.700,94
13544,2014-01-20,IND,@,GSW,W 102-94,240,41,91,.451,33,72,.458,8,19,.421,12,15,.800,102
13545,2014-01-20,HOU,,POR,W 126-113,240,45,86,.523,29,53,.547,16,33,.485,20,24,.833,126
13546,2014-01-20,POR,@,HOU,L 113-126,240,44,97,.454,36,72,.500,8,25,.320,17,22,.773,113
13547,2014-01-20,MEM,,NOP,L 92-95,240,31,74,.419,24,55,.436,7,19,.368,23,28,.821,92
13548,2014-01-20,NOP,@,MEM,W 95-92,240,35,77,.455,30,68,.441,5,9,.556,20,23,.870,95
13549,2014-01-20,BRK,@,NYK,W 103-80,240,37,75,.493,23,37,.622,14,38,.368,15,20,.750,103
13550,2014-01-20,NYK,,BRK,L 80-103,240,24,71,.338,16,46,.348,8,25,.320,24,37,.649,80
13551,2014-01-20,PHI,@,WAS,L 99-107,240,37,88,.420,33,70,.471,4,18,.222,21,31,.677,99
13552,2014-01-20,WAS,,PHI,W 107-99,240,37,84,.440,32,66,.485,5,18,.278,28,35,.800,107
13553,2014-01-19,OKC,,SAC,W 108-93,240,39,86,.453,30,65,.462,9,21,.429,21,30,.700,108
13554,2014-01-19,SAC,@,OKC,L 93-108,240,33,77,.429,28,60,.467,5,17,.294,22,28,.786,93
13555,2014-01-19,BOS,@,ORL,L 91-93,240,33,90,.367,30,77,.390,3,13,.231,22,24,.917,91
13556,2014-01-19,ORL,,BOS,W 93-91,240,30,71,.423,26,56,.464,4,15,.267,29,36,.806,93
13557,2014-01-19,DEN,@,PHO,L 103-117,240,36,82,.439,27,54,.500,9,28,.321,22,30,.733,103
13558,2014-01-19,PHO,,DEN,W 117-103,240,46,91,.505,38,72,.528,8,19,.421,17,26,.654,117
13559,2014-01-19,MIL,@,SAS,L 82-110,240,33,88,.375,27,67,.403,6,21,.286,10,17,.588,82
13560,2014-01-19,SAS,,MIL,W 110-82,240,43,76,.566,32,58,.552,11,18,.611,13,21,.619,110
13561,2014-01-19,LAL,@,TOR,W 112-106,240,37,80,.463,25,58,.431,12,22,.545,26,28,.929,112
13562,2014-01-19,TOR,,LAL,L 106-112,240,44,90,.489,35,60,.583,9,30,.300,9,11,.818,106
13563,2014-01-18,CHA,,MIA,L 96-104 (OT),265,36,75,.480,29,58,.500,7,17,.412,17,23,.739,96
13564,2014-01-18,MIA,@,CHA,W 104-96 (OT),265,39,79,.494,32,58,.552,7,21,.333,19,29,.655,104
13565,2014-01-18,CHI,,PHI,W 103-78,240,40,82,.488,34,62,.548,6,20,.300,17,20,.850,103
13566,2014-01-18,PHI,@,CHI,L 78-103,240,34,97,.351,32,78,.410,2,19,.105,8,12,.667,78
13567,2014-01-18,DAL,,POR,L 111-127,240,42,90,.467,35,72,.486,7,18,.389,20,25,.800,111
13568,2014-01-18,POR,@,DAL,W 127-111,240,46,90,.511,37,64,.578,9,26,.346,26,28,.929,127
13569,2014-01-18,HOU,,MIL,W 114-104,240,41,85,.482,34,58,.586,7,27,.259,25,37,.676,114
13570,2014-01-18,MIL,@,HOU,L 104-114,240,40,80,.500,29,57,.509,11,23,.478,13,21,.619,104
13571,2014-01-18,IND,,LAC,W 106-92,240,38,83,.458,29,64,.453,9,19,.474,21,22,.955,106
13572,2014-01-18,LAC,@,IND,L 92-106,240,33,83,.398,28,63,.444,5,20,.250,21,24,.875,92
13573,2014-01-18,MIN,,UTA,W 98-72,240,36,83,.434,30,66,.455,6,17,.353,20,34,.588,98
13574,2014-01-18,UTA,@,MIN,L 72-98,240,21,73,.288,14,48,.292,7,25,.280,23,29,.793,72
13575,2014-01-18,GSW,@,NOP,W 97-87,240,37,84,.440,31,62,.500,6,22,.273,17,19,.895,97
13576,2014-01-18,NOP,,GSW,L 87-97,240,32,83,.386,30,72,.417,2,11,.182,21,28,.750,87
13577,2014-01-18,DET,@,WAS,W 104-98,240,40,81,.494,34,60,.567,6,21,.286,18,31,.581,104
13578,2014-01-18,WAS,,DET,L 98-104,240,37,76,.487,29,55,.527,8,21,.381,16,29,.552,98
13579,2014-01-17,BOS,,LAL,L 104-107,240,44,99,.444,37,76,.487,7,23,.304,9,11,.818,104
13580,2014-01-17,LAL,@,BOS,W 107-104,240,37,74,.500,25,54,.463,12,20,.600,21,28,.750,107
13581,2014-01-17,CLE,@,DEN,W 117-109,240,42,88,.477,37,72,.514,5,16,.313,28,35,.800,117
13582,2014-01-17,DEN,,CLE,L 109-117,240,40,92,.435,26,55,.473,14,37,.378,15,19,.789,109
13583,2014-01-17,DET,,UTA,L 89-110,240,32,74,.432,28,58,.483,4,16,.250,21,31,.677,89
13584,2014-01-17,UTA,@,DET,W 110-89,240,43,79,.544,34,57,.596,9,22,.409,15,19,.789,110
13585,2014-01-17,MEM,,SAC,W 91-90,240,36,78,.462,30,61,.492,6,17,.353,13,18,.722,91
13586,2014-01-17,SAC,@,MEM,L 90-91,240,33,81,.407,28,70,.400,5,11,.455,19,23,.826,90
13587,2014-01-17,LAC,@,NYK,W 109-95,240,33,78,.423,25,48,.521,8,30,.267,35,42,.833,109
13588,2014-01-17,NYK,,LAC,L 95-109,240,29,83,.349,22,60,.367,7,23,.304,30,36,.833,95
13589,2014-01-17,GSW,@,OKC,L 121-127,240,43,82,.524,27,55,.491,16,27,.593,19,34,.559,121
13590,2014-01-17,OKC,,GSW,W 127-121,240,47,81,.580,38,59,.644,9,22,.409,24,33,.727,127
13591,2014-01-17,CHA,@,ORL,W 111-101,240,39,74,.527,32,59,.542,7,15,.467,26,35,.743,111
13592,2014-01-17,ORL,,CHA,L 101-111,240,38,82,.463,28,57,.491,10,25,.400,15,21,.714,101
13593,2014-01-17,MIA,@,PHI,W 101-86,240,38,80,.475,30,57,.526,8,23,.348,17,20,.850,101
13594,2014-01-17,PHI,,MIA,L 86-101,240,31,84,.369,29,64,.453,2,20,.100,22,37,.595,86
13595,2014-01-17,DAL,@,PHO,W 110-107,240,44,83,.530,35,59,.593,9,24,.375,13,19,.684,110
13596,2014-01-17,PHO,,DAL,L 107-110,240,42,93,.452,35,71,.493,7,22,.318,16,21,.762,107
13597,2014-01-17,POR,@,SAS,W 109-100,240,41,86,.477,33,70,.471,8,16,.500,19,20,.950,109
13598,2014-01-17,SAS,,POR,L 100-109,240,38,84,.452,30,64,.469,8,20,.400,16,20,.800,100
13599,2014-01-17,MIN,@,TOR,L 89-94,240,36,82,.439,33,64,.516,3,18,.167,14,20,.700,89
13600,2014-01-17,TOR,,MIN,W 94-89,240,34,78,.436,23,54,.426,11,24,.458,15,20,.750,94
13601,2014-01-17,CHI,@,WAS,L 93-96,240,35,76,.461,26,52,.500,9,24,.375,14,16,.875,93
13602,2014-01-17,WAS,,CHI,W 96-93,240,40,79,.506,34,68,.500,6,11,.545,10,13,.769,96
13603,2014-01-16,ATL,,BRK,L 110-127,240,40,81,.494,32,56,.571,8,25,.320,22,22,1.000,110
13604,2014-01-16,BRK,@,ATL,W 127-110,240,53,91,.582,37,64,.578,16,27,.593,5,7,.714,127
13605,2014-01-16,HOU,,OKC,L 92-104,240,33,82,.402,21,48,.438,12,34,.353,14,21,.667,92
13606,2014-01-16,OKC,@,HOU,W 104-92,240,38,82,.463,32,57,.561,6,25,.240,22,25,.880,104
13607,2014-01-16,IND,,NYK,W 117-89,240,43,86,.500,33,63,.524,10,23,.435,21,23,.913,117
13608,2014-01-16,NYK,@,IND,L 89-117,240,34,85,.400,30,66,.455,4,19,.211,17,22,.773,89
13609,2014-01-15,BOS,,TOR,W 88-83,240,29,84,.345,25,67,.373,4,17,.235,26,36,.722,88
13610,2014-01-15,TOR,@,BOS,L 83-88,240,30,78,.385,19,54,.352,11,24,.458,12,25,.480,83
13611,2014-01-15,DEN,@,GSW,W 123-116,240,45,83,.542,33,59,.559,12,24,.500,21,29,.724,123
13612,2014-01-15,GSW,,DEN,L 116-123,240,39,90,.433,30,62,.484,9,28,.321,29,33,.879,116
13613,2014-01-15,DAL,@,LAC,L 127-129,240,51,97,.526,39,72,.542,12,25,.480,13,21,.619,127
13614,2014-01-15,LAC,,DAL,W 129-127,240,42,83,.506,25,49,.510,17,34,.500,28,37,.757,129
13615,2014-01-15,MEM,@,MIL,W 82-77,240,33,82,.402,28,62,.452,5,20,.250,11,18,.611,82
13616,2014-01-15,MIL,,MEM,L 77-82,240,31,82,.378,25,62,.403,6,20,.300,9,12,.750,77
13617,2014-01-15,MIN,,SAC,L 108-111,240,39,88,.443,31,68,.456,8,20,.400,22,29,.759,108
13618,2014-01-15,SAC,@,MIN,W 111-108,240,45,82,.549,40,70,.571,5,12,.417,16,19,.842,111
13619,2014-01-15,HOU,@,NOP,W 103-100,240,37,72,.514,33,59,.559,4,13,.308,25,41,.610,103
13620,2014-01-15,NOP,,HOU,L 100-103,240,35,77,.455,27,57,.474,8,20,.400,22,29,.759,100
13621,2014-01-15,CHI,@,ORL,W 128-125 (3OT),315,48,113,.425,36,80,.450,12,33,.364,20,23,.870,128
13622,2014-01-15,ORL,,CHI,L 125-128 (3OT),315,53,104,.510,47,78,.603,6,26,.231,13,16,.813,125
13623,2014-01-15,CHA,@,PHI,L 92-95,240,35,88,.398,30,68,.441,5,20,.250,17,26,.654,92
13624,2014-01-15,PHI,,CHA,W 95-92,240,39,77,.506,33,62,.532,6,15,.400,11,20,.550,95
13625,2014-01-15,LAL,@,PHO,L 114-121,240,43,91,.473,37,71,.521,6,20,.300,22,24,.917,114
13626,2014-01-15,PHO,,LAL,W 121-114,240,49,100,.490,45,81,.556,4,19,.211,19,25,.760,121
13627,2014-01-15,CLE,@,POR,L 96-108,240,39,89,.438,33,66,.500,6,23,.261,12,18,.667,96
13628,2014-01-15,POR,,CLE,W 108-96,240,42,88,.477,31,61,.508,11,27,.407,13,17,.765,108
13629,2014-01-15,SAS,,UTA,W 109-105,240,43,80,.538,36,64,.563,7,16,.438,16,18,.889,109
13630,2014-01-15,UTA,@,SAS,L 105-109,240,44,89,.494,40,81,.494,4,8,.500,13,19,.684,105
13631,2014-01-15,MIA,@,WAS,L 97-114,240,37,84,.440,30,59,.508,7,25,.280,16,17,.941,97
13632,2014-01-15,WAS,,MIA,W 114-97,240,41,75,.547,31,53,.585,10,22,.455,22,26,.846,114
13633,2014-01-14,CHA,,NYK,W 108-98,240,38,75,.507,32,61,.525,6,14,.429,26,33,.788,108
13634,2014-01-14,NYK,@,CHA,L 98-108,240,39,81,.481,33,64,.516,6,17,.353,14,18,.778,98
13635,2014-01-14,IND,,SAC,W 116-92,240,45,82,.549,39,66,.591,6,16,.375,20,25,.800,116
13636,2014-01-14,SAC,@,IND,L 92-116,240,39,92,.424,35,79,.443,4,13,.308,10,17,.588,92
13637,2014-01-14,CLE,@,LAL,W 120-118,240,41,88,.466,28,71,.394,13,17,.765,25,32,.781,120
13638,2014-01-14,LAL,,CLE,L 118-120,240,44,84,.524,31,50,.620,13,34,.382,17,23,.739,118
13639,2014-01-14,MEM,,OKC,W 90-87,240,32,80,.400,28,66,.424,4,14,.286,22,27,.815,90
13640,2014-01-14,OKC,@,MEM,L 87-90,240,33,81,.407,28,60,.467,5,21,.238,16,20,.800,87
13641,2014-01-13,BOS,,HOU,L 92-104,240,38,101,.376,35,84,.417,3,17,.176,13,14,.929,92
13642,2014-01-13,HOU,@,BOS,W 104-92,240,37,79,.468,29,60,.483,8,19,.421,22,34,.647,104
13643,2014-01-13,CHI,,WAS,L 88-102,240,34,79,.430,25,58,.431,9,21,.429,11,19,.579,88
13644,2014-01-13,WAS,@,CHI,W 102-88,240,39,75,.520,32,57,.561,7,18,.389,17,28,.607,102
13645,2014-01-13,DAL,,ORL,W 107-88,240,40,79,.506,27,52,.519,13,27,.481,14,15,.933,107
13646,2014-01-13,ORL,@,DAL,L 88-107,240,34,76,.447,27,52,.519,7,24,.292,13,16,.813,88
13647,2014-01-13,NOP,,SAS,L 95-101,240,38,87,.437,31,76,.408,7,11,.636,12,17,.706,95
13648,2014-01-13,SAS,@,NOP,W 101-95,240,35,67,.522,30,55,.545,5,12,.417,26,31,.839,101
13649,2014-01-13,NYK,,PHO,W 98-96 (OT),265,35,81,.432,28,61,.459,7,20,.350,21,27,.778,98
13650,2014-01-13,PHO,@,NYK,L 96-98 (OT),265,33,93,.355,26,63,.413,7,30,.233,23,28,.821,96
13651,2014-01-13,MIL,@,TOR,L 94-116,240,35,83,.422,26,64,.406,9,19,.474,15,22,.682,94
13652,2014-01-13,TOR,,MIL,W 116-94,240,40,79,.506,28,56,.500,12,23,.522,24,30,.800,116
13653,2014-01-13,DEN,@,UTA,L 103-118,240,37,84,.440,30,58,.517,7,26,.269,22,35,.629,103
13654,2014-01-13,UTA,,DEN,W 118-103,240,44,79,.557,36,61,.590,8,18,.444,22,29,.759,118
13655,2014-01-12,ATL,@,MEM,L 101-108,240,38,80,.475,29,53,.547,9,27,.333,16,24,.667,101
13656,2014-01-12,MEM,,ATL,W 108-101,240,43,83,.518,37,68,.544,6,15,.400,16,20,.800,108
13657,2014-01-12,CLE,@,SAC,L 80-124,240,31,80,.388,24,59,.407,7,21,.333,11,23,.478,80
13658,2014-01-12,SAC,,CLE,W 124-80,240,42,81,.519,27,51,.529,15,30,.500,25,30,.833,124
13659,2014-01-12,MIN,@,SAS,L 86-104,240,33,93,.355,28,76,.368,5,17,.294,15,18,.833,86
13660,2014-01-12,SAS,,MIN,W 104-86,240,42,74,.568,33,61,.541,9,13,.692,11,14,.786,104
13661,2014-01-11,CHA,@,CHI,L 97-103,240,37,79,.468,33,68,.485,4,11,.364,19,20,.950,97
13662,2014-01-11,CHI,,CHA,W 103-97,240,38,81,.469,32,67,.478,6,14,.429,21,26,.808,103
13663,2014-01-11,DAL,,NOP,W 110-107,240,30,67,.448,19,40,.475,11,27,.407,39,45,.867,110
13664,2014-01-11,NOP,@,DAL,L 107-110,240,37,77,.481,29,58,.500,8,19,.421,25,31,.806,107
13665,2014-01-11,DEN,,ORL,W 120-94,240,44,87,.506,32,59,.542,12,28,.429,20,26,.769,120
13666,2014-01-11,ORL,@,DEN,L 94-120,240,37,84,.440,33,64,.516,4,20,.200,16,23,.696,94
13667,2014-01-11,DET,,PHO,W 110-108,240,44,94,.468,41,77,.532,3,17,.176,19,27,.704,110
13668,2014-01-11,PHO,@,DET,L 108-110,240,37,94,.394,24,59,.407,13,35,.371,21,25,.840,108
13669,2014-01-11,MIL,@,OKC,L 85-101,240,32,81,.395,20,50,.400,12,31,.387,9,14,.643,85
13670,2014-01-11,OKC,,MIL,W 101-85,240,35,86,.407,25,61,.410,10,25,.400,21,27,.778,101
13671,2014-01-11,NYK,@,PHI,W 102-92,240,39,82,.476,33,64,.516,6,18,.333,18,23,.783,102
13672,2014-01-11,PHI,,NYK,L 92-102,240,36,78,.462,31,59,.525,5,19,.263,15,21,.714,92
13673,2014-01-11,BOS,@,POR,L 104-112,240,44,95,.463,40,81,.494,4,14,.286,12,17,.706,104
13674,2014-01-11,POR,,BOS,W 112-104,240,40,93,.430,30,72,.417,10,21,.476,22,26,.846,112
13675,2014-01-11,BRK,@,TOR,L 80-96,240,30,75,.400,22,50,.440,8,25,.320,12,18,.667,80
13676,2014-01-11,TOR,,BRK,W 96-80,240,32,79,.405,21,54,.389,11,25,.440,21,28,.750,96
13677,2014-01-11,HOU,@,WAS,W 114-107,240,38,73,.521,30,55,.545,8,18,.444,30,42,.714,114
13678,2014-01-11,WAS,,HOU,L 107-114,240,40,95,.421,35,76,.461,5,19,.263,22,31,.710,107
13679,2014-01-10,ATL,,HOU,W 83-80,240,32,86,.372,23,54,.426,9,32,.281,10,11,.909,83
13680,2014-01-10,HOU,@,ATL,L 80-83,240,29,70,.414,23,51,.451,6,19,.316,16,22,.727,80
13681,2014-01-10,BRK,,MIA,W 104-95 (2OT),290,40,86,.465,33,66,.500,7,20,.350,17,21,.810,104
13682,2014-01-10,MIA,@,BRK,L 95-104 (2OT),290,34,80,.425,28,57,.491,6,23,.261,21,27,.778,95
13683,2014-01-10,BOS,@,GSW,L 97-99,240,38,85,.447,31,66,.470,7,19,.368,14,16,.875,97
13684,2014-01-10,GSW,,BOS,W 99-97,240,38,92,.413,30,66,.455,8,26,.308,15,21,.714,99
13685,2014-01-10,IND,,WAS,W 93-66,240,37,83,.446,31,70,.443,6,13,.462,13,22,.591,93
13686,2014-01-10,WAS,@,IND,L 66-93,240,26,81,.321,21,67,.313,5,14,.357,9,23,.391,66
13687,2014-01-10,LAC,,LAL,W 123-87,240,45,92,.489,38,69,.551,7,23,.304,26,35,.743,123
13688,2014-01-10,LAL,@,LAC,L 87-123,240,29,84,.345,25,68,.368,4,16,.250,25,28,.893,87
13689,2014-01-10,MEM,,PHO,W 104-99,240,42,86,.488,36,71,.507,6,15,.400,14,23,.609,104
13690,2014-01-10,PHO,@,MEM,L 99-104,240,38,92,.413,27,62,.435,11,30,.367,12,16,.750,99
13691,2014-01-10,CHI,@,MIL,W 81-72,240,24,62,.387,18,46,.391,6,16,.375,27,39,.692,81
13692,2014-01-10,MIL,,CHI,L 72-81,240,28,88,.318,21,67,.313,7,21,.333,9,12,.750,72
13693,2014-01-10,CHA,@,MIN,L 92-119,240,37,84,.440,29,65,.446,8,19,.421,10,14,.714,92
13694,2014-01-10,MIN,,CHA,W 119-92,240,48,88,.545,39,69,.565,9,19,.474,14,19,.737,119
13695,2014-01-10,DAL,@,NOP,W 107-90,240,41,78,.526,27,50,.540,14,28,.500,11,16,.688,107
13696,2014-01-10,NOP,,DAL,L 90-107,240,36,80,.450,33,73,.452,3,7,.429,15,19,.789,90
13697,2014-01-10,DET,@,PHI,W 114-104,240,40,94,.426,29,64,.453,11,30,.367,23,33,.697,114
13698,2014-01-10,PHI,,DET,L 104-114,240,41,95,.432,33,71,.465,8,24,.333,14,20,.700,104
13699,2014-01-10,ORL,@,SAC,L 83-103,240,26,78,.333,18,51,.353,8,27,.296,23,29,.793,83
13700,2014-01-10,SAC,,ORL,W 103-83,240,41,80,.513,38,66,.576,3,14,.214,18,19,.947,103
13701,2014-01-10,CLE,@,UTA,W 113-102,240,45,83,.542,38,69,.551,7,14,.500,16,20,.800,113
13702,2014-01-10,UTA,,CLE,L 102-113,240,39,81,.481,30,61,.492,9,20,.450,15,27,.556,102
13703,2014-01-09,DEN,,OKC,W 101-88,240,37,90,.411,23,59,.390,14,31,.452,13,18,.722,101
13704,2014-01-09,OKC,@,DEN,L 88-101,240,30,85,.353,24,61,.393,6,24,.250,22,27,.815,88
13705,2014-01-09,MIA,@,NYK,L 92-102,240,37,68,.544,30,47,.638,7,21,.333,11,21,.524,92
13706,2014-01-09,NYK,,MIA,W 102-92,240,44,82,.537,35,58,.603,9,24,.375,5,10,.500,102
13707,2014-01-08,ATL,,IND,W 97-87,240,34,75,.453,24,52,.462,10,23,.435,19,22,.864,97
13708,2014-01-08,IND,@,ATL,L 87-97,240,35,87,.402,26,60,.433,9,27,.333,8,9,.889,87
13709,2014-01-08,BRK,,GSW,W 102-98,240,34,77,.442,29,58,.500,5,19,.263,29,35,.829,102
13710,2014-01-08,GSW,@,BRK,L 98-102,240,36,78,.462,27,52,.519,9,26,.346,17,23,.739,98
13711,2014-01-08,HOU,,LAL,W 113-99,240,39,86,.453,32,58,.552,7,28,.250,28,50,.560,113
13712,2014-01-08,LAL,@,HOU,L 99-113,240,36,88,.409,29,64,.453,7,24,.292,20,25,.800,99
13713,2014-01-08,BOS,@,LAC,L 105-111,240,39,83,.470,34,66,.515,5,17,.294,22,30,.733,105
13714,2014-01-08,LAC,,BOS,W 111-105,240,36,79,.456,25,49,.510,11,30,.367,28,39,.718,111
13715,2014-01-08,MIN,,PHO,L 103-104,240,34,86,.395,28,70,.400,6,16,.375,29,35,.829,103
13716,2014-01-08,PHO,@,MIN,W 104-103,240,38,92,.413,27,63,.429,11,29,.379,17,23,.739,104
13717,2014-01-08,NOP,,WAS,L 96-102,240,35,78,.449,31,65,.477,4,13,.308,22,27,.815,96
13718,2014-01-08,WAS,@,NOP,W 102-96,240,38,80,.475,28,59,.475,10,21,.476,16,26,.615,102
13719,2014-01-08,ORL,@,POR,L 94-110,240,33,83,.398,26,63,.413,7,20,.350,21,27,.778,94
13720,2014-01-08,POR,,ORL,W 110-94,240,45,95,.474,36,65,.554,9,30,.300,11,13,.846,110
13721,2014-01-08,DAL,@,SAS,L 90-112,240,39,93,.419,32,74,.432,7,19,.368,5,8,.625,90
13722,2014-01-08,SAS,,DAL,W 112-90,240,40,76,.526,31,56,.554,9,20,.450,23,26,.885,112
13723,2014-01-08,DET,@,TOR,L 91-112,240,34,86,.395,30,70,.429,4,16,.250,19,35,.543,91
13724,2014-01-08,TOR,,DET,W 112-91,240,35,86,.407,24,55,.436,11,31,.355,31,34,.912,112
13725,2014-01-07,CHA,,WAS,L 83-97,240,31,72,.431,25,56,.446,6,16,.375,15,24,.625,83
13726,2014-01-07,WAS,@,CHA,W 97-83,240,40,85,.471,35,68,.515,5,17,.294,12,15,.800,97
13727,2014-01-07,CHI,,PHO,W 92-87,240,36,82,.439,30,68,.441,6,14,.429,14,23,.609,92
13728,2014-01-07,PHO,@,CHI,L 87-92,240,33,82,.402,27,59,.458,6,23,.261,15,19,.789,87
13729,2014-01-07,CLE,,PHI,W 111-93,240,44,89,.494,31,61,.508,13,28,.464,10,18,.556,111
13730,2014-01-07,PHI,@,CLE,L 93-111,240,34,86,.395,30,67,.448,4,19,.211,21,27,.778,93
13731,2014-01-07,DAL,,LAL,W 110-97,240,48,90,.533,43,73,.589,5,17,.294,9,15,.600,110
13732,2014-01-07,LAL,@,DAL,L 97-110,240,34,81,.420,23,50,.460,11,31,.355,18,26,.692,97
13733,2014-01-07,BOS,@,DEN,L 98-129,240,35,91,.385,31,73,.425,4,18,.222,24,32,.750,98
13734,2014-01-07,DEN,,BOS,W 129-98,240,43,83,.518,29,52,.558,14,31,.452,29,38,.763,129
13735,2014-01-07,IND,,TOR,W 86-79,240,32,75,.427,31,64,.484,1,11,.091,21,26,.808,86
13736,2014-01-07,TOR,@,IND,L 79-86,240,30,81,.370,25,62,.403,5,19,.263,14,18,.778,79
13737,2014-01-07,MEM,,SAS,L 108-110 (OT),265,46,99,.465,40,82,.488,6,17,.353,10,15,.667,108
13738,2014-01-07,SAS,@,MEM,W 110-108 (OT),265,43,83,.518,36,59,.610,7,24,.292,17,25,.680,110
13739,2014-01-07,MIA,,NOP,W 107-88,240,40,78,.513,31,51,.608,9,27,.333,18,23,.783,107
13740,2014-01-07,NOP,@,MIA,L 88-107,240,36,77,.468,33,68,.485,3,9,.333,13,17,.765,88
13741,2014-01-07,GSW,@,MIL,W 101-80,240,39,85,.459,29,53,.547,10,32,.313,13,20,.650,101
13742,2014-01-07,MIL,,GSW,L 80-101,240,31,80,.388,26,65,.400,5,15,.333,13,18,.722,80
13743,2014-01-07,DET,@,NYK,L 85-89,240,32,86,.372,29,67,.433,3,19,.158,18,23,.783,85
13744,2014-01-07,NYK,,DET,W 89-85,240,33,81,.407,24,55,.436,9,26,.346,14,20,.700,89
13745,2014-01-07,POR,@,SAC,L 119-123,240,39,90,.433,29,63,.460,10,27,.370,31,36,.861,119
13746,2014-01-07,SAC,,POR,W 123-119,240,40,85,.471,33,70,.471,7,15,.467,36,50,.720,123
13747,2014-01-07,OKC,@,UTA,L 101-112,240,35,89,.393,29,55,.527,6,34,.176,25,31,.806,101
13748,2014-01-07,UTA,,OKC,W 112-101,240,40,68,.588,32,50,.640,8,18,.444,24,31,.774,112
13749,2014-01-06,ATL,@,BRK,L 86-91,240,27,70,.386,19,46,.413,8,24,.333,24,26,.923,86
13750,2014-01-06,BRK,,ATL,W 91-86,240,33,80,.413,25,53,.472,8,27,.296,17,26,.654,91
13751,2014-01-06,LAC,,ORL,W 101-81,240,35,83,.422,24,52,.462,11,31,.355,20,24,.833,101
13752,2014-01-06,ORL,@,LAC,L 81-101,240,30,84,.357,23,65,.354,7,19,.368,14,21,.667,81
13753,2014-01-06,MIN,@,PHI,W 126-95,240,46,100,.460,30,74,.405,16,26,.615,18,23,.783,126
13754,2014-01-06,PHI,,MIN,L 95-126,240,38,80,.475,30,62,.484,8,18,.444,11,16,.688,95
13755,2014-01-05,CLE,,IND,L 78-82,240,27,79,.342,21,59,.356,6,20,.300,18,20,.900,78
13756,2014-01-05,IND,@,CLE,W 82-78,240,28,77,.364,20,53,.377,8,24,.333,18,22,.818,82
13757,2014-01-05,DAL,,NYK,L 80-92,240,32,78,.410,26,52,.500,6,26,.231,10,18,.556,80
13758,2014-01-05,NYK,@,DAL,W 92-80,240,37,76,.487,32,63,.508,5,13,.385,13,16,.813,92
13759,2014-01-05,DET,,MEM,L 84-112,240,35,86,.407,31,69,.449,4,17,.235,10,20,.500,84
13760,2014-01-05,MEM,@,DET,W 112-84,240,43,92,.467,35,77,.455,8,15,.533,18,22,.818,112
13761,2014-01-05,DEN,@,LAL,W 137-115,240,53,99,.535,41,70,.586,12,29,.414,19,24,.792,137
13762,2014-01-05,LAL,,DEN,L 115-137,240,42,89,.472,39,68,.574,3,21,.143,28,36,.778,115
13763,2014-01-05,MIA,,TOR,W 102-97,240,38,81,.469,35,70,.500,3,11,.273,23,27,.852,102
13764,2014-01-05,TOR,@,MIA,L 97-102,240,39,77,.506,32,55,.582,7,22,.318,12,21,.571,97
13765,2014-01-05,BOS,@,OKC,L 96-119,240,35,80,.438,24,57,.421,11,23,.478,15,24,.625,96
13766,2014-01-05,OKC,,BOS,W 119-96,240,43,83,.518,34,64,.531,9,19,.474,24,31,.774,119
13767,2014-01-05,GSW,@,WAS,W 112-96,240,43,85,.506,34,63,.540,9,22,.409,17,20,.850,112
13768,2014-01-05,WAS,,GSW,L 96-112,240,37,86,.430,31,66,.470,6,20,.300,16,16,1.000,96
13769,2014-01-04,BRK,,CLE,W 89-82,240,31,71,.437,23,47,.489,8,24,.333,19,22,.864,89
13770,2014-01-04,CLE,@,BRK,L 82-89,240,29,79,.367,19,57,.333,10,22,.455,14,20,.700,82
13771,2014-01-04,ATL,@,CHI,L 84-91,240,32,86,.372,24,58,.414,8,28,.286,12,14,.857,84
13772,2014-01-04,CHI,,ATL,W 91-84,240,33,81,.407,27,64,.422,6,17,.353,19,24,.792,91
13773,2014-01-04,IND,,NOP,W 99-82,240,39,83,.470,32,61,.525,7,22,.318,14,19,.737,99
13774,2014-01-04,NOP,@,IND,L 82-99,240,31,68,.456,28,59,.475,3,9,.333,17,26,.654,82
13775,2014-01-04,MIN,,OKC,L 111-115,240,43,94,.457,36,74,.486,7,20,.350,18,29,.621,111
13776,2014-01-04,OKC,@,MIN,W 115-111,240,40,83,.482,32,59,.542,8,24,.333,27,28,.964,115
13777,2014-01-04,MIA,@,ORL,W 110-94,240,40,74,.541,34,58,.586,6,16,.375,24,31,.774,110
13778,2014-01-04,ORL,,MIA,L 94-110,240,33,80,.413,25,54,.463,8,26,.308,20,24,.833,94
13779,2014-01-04,MIL,@,PHO,L 100-116,240,37,68,.544,27,47,.574,10,21,.476,16,20,.800,100
13780,2014-01-04,PHO,,MIL,W 116-100,240,41,85,.482,29,58,.500,12,27,.444,22,25,.880,116
13781,2014-01-04,PHI,@,POR,W 101-99,240,40,88,.455,36,74,.486,4,14,.286,17,24,.708,101
13782,2014-01-04,POR,,PHI,L 99-101,240,36,99,.364,33,77,.429,3,22,.136,24,30,.800,99
13783,2014-01-04,CHA,@,SAC,W 113-103,240,45,83,.542,36,68,.529,9,15,.600,14,23,.609,113
13784,2014-01-04,SAC,,CHA,L 103-113,240,42,92,.457,36,75,.480,6,17,.353,13,19,.684,103
13785,2014-01-04,LAC,@,SAS,L 92-116,240,37,79,.468,34,64,.531,3,15,.200,15,21,.714,92
13786,2014-01-04,SAS,,LAC,W 116-92,240,50,90,.556,46,72,.639,4,18,.222,12,16,.750,116
13787,2014-01-03,ATL,,GSW,L 100-101,240,37,80,.463,27,49,.551,10,31,.323,16,19,.842,100
13788,2014-01-03,GSW,@,ATL,W 101-100,240,39,87,.448,33,60,.550,6,27,.222,17,25,.680,101
13789,2014-01-03,BOS,,NOP,L 92-95,240,31,89,.348,24,60,.400,7,29,.241,23,28,.821,92
13790,2014-01-03,NOP,@,BOS,W 95-92,240,38,77,.494,36,71,.507,2,6,.333,17,22,.773,95
13791,2014-01-03,DAL,,LAC,L 112-119,240,45,88,.511,33,60,.550,12,28,.429,10,14,.714,112
13792,2014-01-03,LAC,@,DAL,W 119-112,240,40,82,.488,31,59,.525,9,23,.391,30,38,.789,119
13793,2014-01-03,DEN,,MEM,W 111-108,240,43,80,.538,34,58,.586,9,22,.409,16,21,.762,111
13794,2014-01-03,MEM,@,DEN,L 108-111,240,37,76,.487,32,64,.500,5,12,.417,29,38,.763,108
13795,2014-01-03,HOU,,NYK,W 102-100,240,34,74,.459,24,48,.500,10,26,.385,24,28,.857,102
13796,2014-01-03,NYK,@,HOU,L 100-102,240,37,89,.416,28,65,.431,9,24,.375,17,24,.708,100
13797,2014-01-03,LAL,,UTA,W 110-99,240,42,81,.519,32,57,.561,10,24,.417,16,21,.762,110
13798,2014-01-03,UTA,@,LAL,L 99-110,240,38,86,.442,30,60,.500,8,26,.308,15,23,.652,99
13799,2014-01-03,TOR,@,WAS,W 101-88,240,40,79,.506,29,57,.509,11,22,.500,10,13,.769,101
13800,2014-01-03,WAS,,TOR,L 88-101,240,34,82,.415,30,70,.429,4,12,.333,16,17,.941,88
13801,2014-01-02,BOS,@,CHI,L 82-94,240,32,81,.395,30,69,.435,2,12,.167,16,23,.696,82
13802,2014-01-02,CHI,,BOS,W 94-82,240,35,84,.417,33,69,.478,2,15,.133,22,28,.786,94
13803,2014-01-02,CLE,,ORL,W 87-81 (OT),265,33,96,.344,29,77,.377,4,19,.211,17,24,.708,87
13804,2014-01-02,ORL,@,CLE,L 81-87 (OT),265,32,84,.381,25,59,.424,7,25,.280,10,18,.556,81
13805,2014-01-02,GSW,@,MIA,W 123-114,240,46,82,.561,31,53,.585,15,29,.517,16,19,.842,123
13806,2014-01-02,MIA,,GSW,L 114-123,240,40,78,.513,32,60,.533,8,18,.444,26,31,.839,114
13807,2014-01-02,BRK,@,OKC,W 95-93,240,31,70,.443,22,46,.478,9,24,.375,24,31,.774,95
13808,2014-01-02,OKC,,BRK,L 93-95,240,34,68,.500,25,46,.543,9,22,.409,16,19,.842,93
13809,2014-01-02,MEM,@,PHO,W 99-91,240,44,92,.478,41,78,.526,3,14,.214,8,14,.571,99
13810,2014-01-02,PHO,,MEM,L 91-99,240,37,90,.411,29,60,.483,8,30,.267,9,16,.563,91
13811,2014-01-02,CHA,@,POR,L 104-134,240,34,79,.430,27,63,.429,7,16,.438,29,36,.806,104
13812,2014-01-02,POR,,CHA,W 134-104,240,54,93,.581,33,60,.550,21,33,.636,5,7,.714,134
13813,2014-01-02,PHI,@,SAC,W 113-104,240,42,90,.467,37,71,.521,5,19,.263,24,31,.774,113
13814,2014-01-02,SAC,,PHI,L 104-113,240,35,83,.422,28,60,.467,7,23,.304,27,37,.730,104
13815,2014-01-02,NYK,@,SAS,W 105-101,240,39,76,.513,30,59,.508,9,17,.529,18,20,.900,105
13816,2014-01-02,SAS,,NYK,L 101-105,240,37,77,.481,23,45,.511,14,32,.438,13,19,.684,101
13817,2014-01-02,MIL,@,UTA,L 87-96,240,36,76,.474,32,54,.593,4,22,.182,11,14,.786,87
13818,2014-01-02,UTA,,MIL,W 96-87,240,36,81,.444,29,65,.446,7,16,.438,17,17,1.000,96
13819,2014-01-01,DEN,,PHI,L 102-114,240,36,91,.396,31,66,.470,5,25,.200,25,35,.714,102
13820,2014-01-01,PHI,@,DEN,W 114-102,240,43,92,.467,34,69,.493,9,23,.391,19,28,.679,114
13821,2014-01-01,CHA,@,LAC,L 85-112,240,29,76,.382,23,55,.418,6,21,.286,21,22,.955,85
13822,2014-01-01,LAC,,CHA,W 112-85,240,47,85,.553,36,51,.706,11,34,.324,7,10,.700,112
13823,2014-01-01,MIN,,NOP,W 124-112,240,44,79,.557,36,57,.632,8,22,.364,28,35,.800,124
13824,2014-01-01,NOP,@,MIN,L 112-124,240,45,87,.517,39,67,.582,6,20,.300,16,22,.727,112
13825,2014-01-01,IND,@,TOR,L 82-95,240,32,74,.432,27,60,.450,5,14,.357,13,20,.650,82
13826,2014-01-01,TOR,,IND,W 95-82,240,34,78,.436,27,59,.458,7,19,.368,20,23,.870,95
13827,2014-01-01,DAL,@,WAS,W 87-78,240,30,78,.385,24,54,.444,6,24,.250,21,23,.913,87
13828,2014-01-01,WAS,,DAL,L 78-87,240,33,88,.375,28,64,.438,5,24,.208,7,10,.700,78
13829,2013-12-31,ATL,@,BOS,W 92-91,240,33,91,.363,28,62,.452,5,29,.172,21,25,.840,92
13830,2013-12-31,BOS,,ATL,L 91-92,240,35,84,.417,30,64,.469,5,20,.250,16,17,.941,91
13831,2013-12-31,CHI,,TOR,L 79-85,240,30,82,.366,28,73,.384,2,9,.222,17,21,.810,79
13832,2013-12-31,TOR,@,CHI,W 85-79,240,29,69,.420,25,55,.455,4,14,.286,23,31,.742,85
13833,2013-12-31,HOU,,SAC,L 106-110,240,39,81,.481,32,53,.604,7,28,.250,21,33,.636,106
13834,2013-12-31,SAC,@,HOU,W 110-106,240,42,85,.494,35,63,.556,7,22,.318,19,23,.826,110
13835,2013-12-31,CLE,@,IND,L 76-91,240,29,80,.363,28,68,.412,1,12,.083,17,23,.739,76
13836,2013-12-31,IND,,CLE,W 91-76,240,34,77,.442,29,52,.558,5,25,.200,18,22,.818,91
13837,2013-12-31,LAL,,MIL,L 79-94,240,29,81,.358,22,57,.386,7,24,.292,14,18,.778,79
13838,2013-12-31,MIL,@,LAL,W 94-79,240,40,91,.440,34,68,.500,6,23,.261,8,14,.571,94
13839,2013-12-31,OKC,,POR,L 94-98,240,36,82,.439,33,68,.485,3,14,.214,19,26,.731,94
13840,2013-12-31,POR,@,OKC,W 98-94,240,36,91,.396,28,58,.483,8,33,.242,18,21,.857,98
13841,2013-12-31,GSW,@,ORL,W 94-81,240,41,85,.482,35,58,.603,6,27,.222,6,10,.600,94
13842,2013-12-31,ORL,,GSW,L 81-94,240,34,89,.382,29,70,.414,5,19,.263,8,13,.615,81
13843,2013-12-31,BRK,@,SAS,L 92-113,240,37,84,.440,32,69,.464,5,15,.333,13,15,.867,92
13844,2013-12-31,SAS,,BRK,W 113-92,240,40,78,.513,31,58,.534,9,20,.450,24,28,.857,113
13845,2013-12-30,DEN,,MIA,L 94-97,240,38,81,.469,30,61,.492,8,20,.400,10,11,.909,94
13846,2013-12-30,MIA,@,DEN,W 97-94,240,34,67,.507,23,44,.523,11,23,.478,18,28,.643,97
13847,2013-12-30,DET,,WAS,L 99-106,240,36,82,.439,30,62,.484,6,20,.300,21,35,.600,99
13848,2013-12-30,WAS,@,DET,W 106-99,240,39,78,.500,32,59,.542,7,19,.368,21,27,.778,106
13849,2013-12-30,LAC,,PHO,L 88-107,240,31,85,.365,24,65,.369,7,20,.350,19,26,.731,88
13850,2013-12-30,PHO,@,LAC,W 107-88,240,41,85,.482,29,54,.537,12,31,.387,13,22,.591,107
13851,2013-12-30,CHI,@,MEM,W 95-91,240,28,65,.431,22,50,.440,6,15,.400,33,42,.786,95
13852,2013-12-30,MEM,,CHI,L 91-95,240,35,78,.449,35,73,.479,0,5,.000,21,28,.750,91
13853,2013-12-30,DAL,@,MIN,W 100-98,240,41,86,.477,35,62,.565,6,24,.250,12,14,.857,100
13854,2013-12-30,MIN,,DAL,L 98-100,240,36,79,.456,30,56,.536,6,23,.261,20,23,.870,98
13855,2013-12-30,NOP,,POR,W 110-108,240,48,89,.539,46,78,.590,2,11,.182,12,15,.800,110
13856,2013-12-30,POR,@,NOP,L 108-110,240,39,88,.443,27,56,.482,12,32,.375,18,24,.750,108
13857,2013-12-30,CHA,@,UTA,L 80-83,240,31,84,.369,24,70,.343,7,14,.500,11,15,.733,80
13858,2013-12-30,UTA,,CHA,W 83-80,240,34,80,.425,26,59,.441,8,21,.381,7,9,.778,83
13859,2013-12-29,CLE,,GSW,L 104-108 (OT),265,38,92,.413,28,76,.368,10,16,.625,18,21,.857,104
13860,2013-12-29,GSW,@,CLE,W 108-104 (OT),265,42,95,.442,32,62,.516,10,33,.303,14,19,.737,108
13861,2013-12-29,LAL,,PHI,L 104-111,240,31,84,.369,19,47,.404,12,37,.324,30,34,.882,104
13862,2013-12-29,PHI,@,LAL,W 111-104,240,39,95,.411,33,71,.465,6,24,.250,27,33,.818,111
13863,2013-12-29,HOU,@,OKC,L 86-117,240,31,85,.365,24,57,.421,7,28,.250,17,31,.548,86
13864,2013-12-29,OKC,,HOU,W 117-86,240,47,82,.573,37,60,.617,10,22,.455,13,16,.813,117
13865,2013-12-29,ATL,@,ORL,L 102-109,240,36,81,.444,21,42,.500,15,39,.385,15,21,.714,102
13866,2013-12-29,ORL,,ATL,W 109-102,240,41,74,.554,33,53,.623,8,21,.381,19,24,.792,109
13867,2013-12-29,SAC,@,SAS,L 104-112,240,41,91,.451,34,77,.442,7,14,.500,15,20,.750,104
13868,2013-12-29,SAS,,SAC,W 112-104,240,44,94,.468,36,70,.514,8,24,.333,16,19,.842,112
13869,2013-12-28,ATL,,CHA,W 118-116 (OT),265,37,91,.407,21,52,.404,16,39,.410,28,34,.824,118
13870,2013-12-28,CHA,@,ATL,L 116-118 (OT),265,45,104,.433,35,78,.449,10,26,.385,16,22,.727,116
13871,2013-12-28,BOS,,CLE,W 103-100,240,38,83,.458,29,58,.500,9,25,.360,18,25,.720,103
13872,2013-12-28,CLE,@,BOS,L 100-103,240,37,79,.468,28,61,.459,9,18,.500,17,24,.708,100
13873,2013-12-28,CHI,,DAL,L 83-105,240,32,74,.432,29,57,.509,3,17,.176,16,19,.842,83
13874,2013-12-28,DAL,@,CHI,W 105-83,240,41,78,.526,28,52,.538,13,26,.500,10,11,.909,105
13875,2013-12-28,HOU,,NOP,W 107-98,240,38,77,.494,32,51,.627,6,26,.231,25,32,.781,107
13876,2013-12-28,NOP,@,HOU,L 98-107,240,41,93,.441,31,71,.437,10,22,.455,6,8,.750,98
13877,2013-12-28,BRK,@,IND,L 91-105,240,36,77,.468,28,56,.500,8,21,.381,11,16,.688,91
13878,2013-12-28,IND,,BRK,W 105-91,240,38,71,.535,30,52,.577,8,19,.421,21,25,.840,105
13879,2013-12-28,LAC,,UTA,W 98-90,240,35,77,.455,32,63,.508,3,14,.214,25,32,.781,98
13880,2013-12-28,UTA,@,LAC,L 90-98,240,32,76,.421,25,57,.439,7,19,.368,19,21,.905,90
13881,2013-12-28,DEN,@,MEM,L 99-120,240,33,70,.471,23,48,.479,10,22,.455,23,28,.821,99
13882,2013-12-28,MEM,,DEN,W 120-99,240,47,91,.516,39,72,.542,8,19,.421,18,25,.720,120
13883,2013-12-28,MIL,,MIN,L 95-117,240,40,89,.449,35,67,.522,5,22,.227,10,17,.588,95
13884,2013-12-28,MIN,@,MIL,W 117-95,240,43,90,.478,32,66,.485,11,24,.458,20,29,.690,117
13885,2013-12-28,PHI,@,PHO,L 101-115,240,37,95,.389,26,66,.394,11,29,.379,16,22,.727,101
13886,2013-12-28,PHO,,PHI,W 115-101,240,44,95,.463,35,62,.565,9,33,.273,18,23,.783,115
13887,2013-12-28,MIA,@,POR,W 108-107,240,45,88,.511,37,74,.500,8,14,.571,10,11,.909,108
13888,2013-12-28,POR,,MIA,L 107-108,240,39,77,.506,28,51,.549,11,26,.423,18,21,.857,107
13889,2013-12-28,NYK,@,TOR,L 100-115,240,39,80,.488,32,59,.542,7,21,.333,15,20,.750,100
13890,2013-12-28,TOR,,NYK,W 115-100,240,36,80,.450,21,48,.438,15,32,.469,28,34,.824,115
13891,2013-12-28,DET,@,WAS,L 82-106,240,31,77,.403,24,56,.429,7,21,.333,13,17,.765,82
13892,2013-12-28,WAS,,DET,W 106-82,240,43,86,.500,34,67,.507,9,19,.474,11,17,.647,106
13893,2013-12-27,BRK,,MIL,W 104-93,240,34,79,.430,22,53,.415,12,26,.462,24,32,.750,104
13894,2013-12-27,MIL,@,BRK,L 93-104,240,33,88,.375,24,56,.429,9,32,.281,18,25,.720,93
13895,2013-12-27,CHA,,OKC,L 85-89,240,30,80,.375,21,57,.368,9,23,.391,16,20,.800,85
13896,2013-12-27,OKC,@,CHA,W 89-85,240,33,80,.413,25,55,.455,8,25,.320,15,24,.625,89
13897,2013-12-27,GSW,,PHO,W 115-86,240,45,85,.529,37,65,.569,8,20,.400,17,24,.708,115
13898,2013-12-27,PHO,@,GSW,L 86-115,240,32,89,.360,28,66,.424,4,23,.174,18,23,.783,86
13899,2013-12-27,MIN,,WAS,W 120-98,240,42,85,.494,37,70,.529,5,15,.333,31,38,.816,120
13900,2013-12-27,WAS,@,MIN,L 98-120,240,38,83,.458,30,62,.484,8,21,.381,14,17,.824,98
13901,2013-12-27,DEN,@,NOP,L 89-105,240,33,82,.402,27,59,.458,6,23,.261,17,24,.708,89
13902,2013-12-27,NOP,,DEN,W 105-89,240,42,89,.472,31,65,.477,11,24,.458,10,15,.667,105
13903,2013-12-27,NYK,,TOR,L 83-95,240,30,79,.380,20,60,.333,10,19,.526,13,21,.619,83
13904,2013-12-27,TOR,@,NYK,W 95-83,240,31,73,.425,21,45,.467,10,28,.357,23,33,.697,95
13905,2013-12-27,DET,@,ORL,L 92-109,240,39,95,.411,34,77,.442,5,18,.278,9,18,.500,92
13906,2013-12-27,ORL,,DET,W 109-92,240,45,85,.529,41,71,.577,4,14,.286,15,23,.652,109
13907,2013-12-27,MIA,@,SAC,L 103-108 (OT),265,38,86,.442,27,54,.500,11,32,.344,16,21,.762,103
13908,2013-12-27,SAC,,MIA,W 108-103 (OT),265,41,83,.494,36,63,.571,5,20,.250,21,25,.840,108
13909,2013-12-27,LAL,@,UTA,L 103-105,240,40,80,.500,33,57,.579,7,23,.304,16,23,.696,103
13910,2013-12-27,UTA,,LAL,W 105-103,240,40,88,.455,31,65,.477,9,23,.391,16,20,.800,105
13911,2013-12-26,ATL,@,CLE,W 127-125 (2OT),290,51,103,.495,40,69,.580,11,34,.324,14,19,.737,127
13912,2013-12-26,CLE,,ATL,L 125-127 (2OT),290,49,94,.521,41,73,.562,8,21,.381,19,26,.731,125
13913,2013-12-26,DAL,,SAS,L 107-116,240,39,85,.459,34,68,.500,5,17,.294,24,31,.774,107
13914,2013-12-26,SAS,@,DAL,W 116-107,240,37,75,.493,30,59,.508,7,16,.438,35,42,.833,116
13915,2013-12-26,HOU,,MEM,W 100-92,240,31,71,.437,26,47,.553,5,24,.208,33,40,.825,100
13916,2013-12-26,MEM,@,HOU,L 92-100,240,38,93,.409,33,75,.440,5,18,.278,11,20,.550,92
13917,2013-12-26,LAC,@,POR,L 112-116 (OT),265,49,110,.445,41,90,.456,8,20,.400,6,12,.500,112
13918,2013-12-26,POR,,LAC,W 116-112 (OT),265,42,96,.438,29,60,.483,13,36,.361,19,22,.864,116
13919,2013-12-25,BRK,,CHI,L 78-95,240,25,71,.352,20,54,.370,5,17,.294,23,31,.742,78
13920,2013-12-25,CHI,@,BRK,W 95-78,240,36,74,.486,31,57,.544,5,17,.294,18,20,.900,95
13921,2013-12-25,GSW,,LAC,W 105-103,240,40,95,.421,30,71,.423,10,24,.417,15,22,.682,105
13922,2013-12-25,LAC,@,GSW,L 103-105,240,40,81,.494,36,63,.571,4,18,.222,19,23,.826,103
13923,2013-12-25,LAL,,MIA,L 95-101,240,33,79,.418,19,43,.442,14,36,.389,15,26,.577,95
13924,2013-12-25,MIA,@,LAL,W 101-95,240,41,80,.513,32,53,.604,9,27,.333,10,17,.588,101
13925,2013-12-25,NYK,,OKC,L 94-123,240,38,90,.422,32,67,.478,6,23,.261,12,19,.632,94
13926,2013-12-25,OKC,@,NYK,W 123-94,240,45,84,.536,32,60,.533,13,24,.542,20,26,.769,123
13927,2013-12-25,HOU,@,SAS,W 111-98,240,45,86,.523,33,62,.532,12,24,.500,9,18,.500,111
13928,2013-12-25,SAS,,HOU,L 98-111,240,37,91,.407,32,71,.451,5,20,.250,19,23,.826,98
13929,2013-12-23,BRK,,IND,L 86-103,240,29,76,.382,23,50,.460,6,26,.231,22,25,.880,86
13930,2013-12-23,IND,@,BRK,W 103-86,240,38,83,.458,29,55,.527,9,28,.321,18,19,.947,103
13931,2013-12-23,CHA,,MIL,W 111-110 (OT),265,43,99,.434,33,82,.402,10,17,.588,15,20,.750,111
13932,2013-12-23,MIL,@,CHA,L 110-111 (OT),265,42,97,.433,32,69,.464,10,28,.357,16,17,.941,110
13933,2013-12-23,CLE,,DET,L 92-115,240,34,88,.386,26,60,.433,8,28,.286,16,24,.667,92
13934,2013-12-23,DET,@,CLE,W 115-92,240,46,96,.479,36,72,.500,10,24,.417,13,18,.722,115
13935,2013-12-23,DEN,,GSW,L 81-89,240,31,81,.383,28,68,.412,3,13,.231,16,21,.762,81
13936,2013-12-23,GSW,@,DEN,W 89-81,240,36,84,.429,29,68,.426,7,16,.438,10,18,.556,89
13937,2013-12-23,DAL,@,HOU,W 111-104,240,40,79,.506,29,57,.509,11,22,.500,20,23,.870,111
13938,2013-12-23,HOU,,DAL,L 104-111,240,38,70,.543,31,51,.608,7,19,.368,21,29,.724,104
13939,2013-12-23,MEM,,UTA,W 104-94,240,39,83,.470,28,63,.444,11,20,.550,15,20,.750,104
13940,2013-12-23,UTA,@,MEM,L 94-104,240,35,75,.467,24,51,.471,11,24,.458,13,15,.867,94
13941,2013-12-23,ATL,@,MIA,L 119-121 (OT),265,44,91,.484,27,57,.474,17,34,.500,14,19,.737,119
13942,2013-12-23,MIA,,ATL,W 121-119 (OT),265,46,91,.505,36,62,.581,10,29,.345,19,29,.655,121
13943,2013-12-23,NYK,@,ORL,W 103-98,240,39,86,.453,29,65,.446,10,21,.476,15,19,.789,103
13944,2013-12-23,ORL,,NYK,L 98-103,240,37,89,.416,29,64,.453,8,25,.320,16,22,.727,98
13945,2013-12-23,LAL,@,PHO,L 90-117,240,30,81,.370,24,61,.393,6,20,.300,24,37,.649,90
13946,2013-12-23,PHO,,LAL,W 117-90,240,42,90,.467,28,58,.483,14,32,.438,19,25,.760,117
13947,2013-12-23,NOP,@,SAC,W 113-100,240,41,83,.494,33,66,.500,8,17,.471,23,27,.852,113
13948,2013-12-23,SAC,,NOP,L 100-113,240,31,74,.419,24,57,.421,7,17,.412,31,42,.738,100
13949,2013-12-23,SAS,,TOR,W 112-99,240,41,91,.451,32,68,.471,9,23,.391,21,27,.778,112
13950,2013-12-23,TOR,@,SAS,L 99-112,240,37,81,.457,30,60,.500,7,21,.333,18,25,.720,99
13951,2013-12-22,BOS,@,IND,L 79-106,240,32,84,.381,26,70,.371,6,14,.429,9,13,.692,79
13952,2013-12-22,IND,,BOS,W 106-79,240,41,83,.494,32,64,.500,9,19,.474,15,22,.682,106
13953,2013-12-22,LAC,,MIN,W 120-116 (OT),265,46,97,.474,39,68,.574,7,29,.241,21,27,.778,120
13954,2013-12-22,MIN,@,LAC,L 116-120 (OT),265,45,96,.469,39,74,.527,6,22,.273,20,27,.741,116
13955,2013-12-22,OKC,,TOR,L 98-104,240,28,76,.368,21,53,.396,7,23,.304,35,36,.972,98
13956,2013-12-22,TOR,@,OKC,W 104-98,240,36,91,.396,28,71,.394,8,20,.400,24,29,.828,104
13957,2013-12-21,BOS,,WAS,L 99-106,240,42,87,.483,38,67,.567,4,20,.200,11,18,.611,99
13958,2013-12-21,WAS,@,BOS,W 106-99,240,41,87,.471,33,66,.500,8,21,.381,16,22,.727,106
13959,2013-12-21,CHA,,UTA,L 85-88,240,36,83,.434,34,71,.479,2,12,.167,11,16,.688,85
13960,2013-12-21,UTA,@,CHA,W 88-85,240,32,83,.386,22,62,.355,10,21,.476,14,18,.778,88
13961,2013-12-21,CHI,,CLE,W 100-84,240,37,69,.536,27,54,.500,10,15,.667,16,24,.667,100
13962,2013-12-21,CLE,@,CHI,L 84-100,240,36,90,.400,32,72,.444,4,18,.222,8,9,.889,84
13963,2013-12-21,DET,,HOU,L 97-114,240,40,89,.449,39,77,.506,1,12,.083,16,26,.615,97
13964,2013-12-21,HOU,@,DET,W 114-97,240,44,79,.557,35,56,.625,9,23,.391,17,23,.739,114
13965,2013-12-21,GSW,,LAL,W 102-83,240,38,98,.388,26,67,.388,12,31,.387,14,19,.737,102
13966,2013-12-21,LAL,@,GSW,L 83-102,240,26,80,.325,22,60,.367,4,20,.200,27,33,.818,83
13967,2013-12-21,DEN,@,LAC,L 91-112,240,31,88,.352,25,58,.431,6,30,.200,23,29,.793,91
13968,2013-12-21,LAC,,DEN,W 112-91,240,39,86,.453,26,53,.491,13,33,.394,21,31,.677,112
13969,2013-12-21,MIL,,PHI,W 116-106,240,43,82,.524,36,57,.632,7,25,.280,23,25,.920,116
13970,2013-12-21,PHI,@,MIL,L 106-116,240,38,93,.409,28,70,.400,10,23,.435,20,22,.909,106
13971,2013-12-21,MEM,@,NYK,W 95-87,240,39,82,.476,38,73,.521,1,9,.111,16,19,.842,95
13972,2013-12-21,NYK,,MEM,L 87-95,240,33,79,.418,27,57,.474,6,22,.273,15,23,.652,87
13973,2013-12-21,ORL,,SAC,L 100-105,240,39,82,.476,31,62,.500,8,20,.400,14,23,.609,100
13974,2013-12-21,SAC,@,ORL,W 105-100,240,39,79,.494,27,56,.482,12,23,.522,15,23,.652,105
13975,2013-12-21,DAL,@,PHO,L 108-123,240,44,91,.484,41,74,.554,3,17,.176,17,23,.739,108
13976,2013-12-21,PHO,,DAL,W 123-108,240,44,86,.512,29,56,.518,15,30,.500,20,22,.909,123
13977,2013-12-21,NOP,@,POR,L 107-110,240,44,94,.468,38,77,.494,6,17,.353,13,19,.684,107
13978,2013-12-21,POR,,NOP,W 110-107,240,43,98,.439,35,69,.507,8,29,.276,16,18,.889,110
13979,2013-12-21,OKC,@,SAS,W 113-100,240,43,88,.489,31,61,.508,12,27,.444,15,18,.833,113
13980,2013-12-21,SAS,,OKC,L 100-113,240,35,82,.427,26,63,.413,9,19,.474,21,26,.808,100
13981,2013-12-20,ATL,,UTA,W 118-85,240,45,86,.523,35,60,.583,10,26,.385,18,24,.750,118
13982,2013-12-20,UTA,@,ATL,L 85-118,240,35,94,.372,32,76,.421,3,18,.167,12,15,.800,85
13983,2013-12-20,CLE,,MIL,W 114-111 (OT),265,39,100,.390,28,72,.389,11,28,.393,25,27,.926,114
13984,2013-12-20,MIL,@,CLE,L 111-114 (OT),265,40,100,.400,30,71,.423,10,29,.345,21,25,.840,111
13985,2013-12-20,DAL,,TOR,L 108-109 (OT),265,46,91,.505,36,70,.514,10,21,.476,6,10,.600,108
13986,2013-12-20,TOR,@,DAL,W 109-108 (OT),265,42,91,.462,31,70,.443,11,21,.524,14,18,.778,109
13987,2013-12-20,DEN,,PHO,L 99-103,240,35,85,.412,31,68,.456,4,17,.235,25,29,.862,99
13988,2013-12-20,PHO,@,DEN,W 103-99,240,35,88,.398,23,54,.426,12,34,.353,21,31,.677,103
13989,2013-12-20,CHA,@,DET,W 116-106,240,44,84,.524,41,74,.554,3,10,.300,25,28,.893,116
13990,2013-12-20,DET,,CHA,L 106-116,240,42,90,.467,30,67,.448,12,23,.522,10,17,.588,106
13991,2013-12-20,HOU,@,IND,L 81-114,240,32,84,.381,28,62,.452,4,22,.182,13,24,.542,81
13992,2013-12-20,IND,,HOU,W 114-81,240,43,81,.531,31,55,.564,12,26,.462,16,22,.727,114
13993,2013-12-20,LAL,,MIN,W 104-91,240,42,78,.538,35,59,.593,7,19,.368,13,15,.867,104
13994,2013-12-20,MIN,@,LAL,L 91-104,240,33,95,.347,28,73,.384,5,22,.227,20,25,.800,91
13995,2013-12-20,MIA,,SAC,W 122-103,240,51,83,.614,41,60,.683,10,23,.435,10,14,.714,122
13996,2013-12-20,SAC,@,MIA,L 103-122,240,43,74,.581,36,52,.692,7,22,.318,10,24,.417,103
13997,2013-12-20,BRK,@,PHI,L 120-121 (OT),265,42,85,.494,27,52,.519,15,33,.455,21,30,.700,120
13998,2013-12-20,PHI,,BRK,W 121-120 (OT),265,51,100,.510,42,71,.592,9,29,.310,10,15,.667,121
13999,2013-12-19,GSW,,SAS,L 102-104,240,42,90,.467,34,59,.576,8,31,.258,10,11,.909,102
14000,2013-12-19,SAS,@,GSW,W 104-102,240,40,89,.449,29,62,.468,11,27,.407,13,19,.684,104
14001,2013-12-19,CHI,@,OKC,L 95-107,240,29,77,.377,21,48,.438,8,29,.276,29,39,.744,95
14002,2013-12-19,OKC,,CHI,W 107-95,240,43,84,.512,34,69,.493,9,15,.600,12,14,.857,107
14003,2013-12-18,ATL,,SAC,W 124-107,240,47,81,.580,32,56,.571,15,25,.600,15,18,.833,124
14004,2013-12-18,SAC,@,ATL,L 107-124,240,40,84,.476,34,69,.493,6,15,.400,21,25,.840,107
14005,2013-12-18,BOS,,DET,L 106-107,240,40,81,.494,34,63,.540,6,18,.333,20,22,.909,106
14006,2013-12-18,DET,@,BOS,W 107-106,240,41,88,.466,31,61,.508,10,27,.370,15,20,.750,107
14007,2013-12-18,BRK,,WAS,L 107-113,240,39,74,.527,30,53,.566,9,21,.429,20,24,.833,107
14008,2013-12-18,WAS,@,BRK,W 113-107,240,38,88,.432,26,68,.382,12,20,.600,25,30,.833,113
14009,2013-12-18,DAL,,MEM,W 105-91,240,40,73,.548,35,58,.603,5,15,.333,20,23,.870,105
14010,2013-12-18,MEM,@,DAL,L 91-105,240,37,93,.398,29,75,.387,8,18,.444,9,14,.643,91
14011,2013-12-18,CHI,@,HOU,L 94-109,240,38,79,.481,33,67,.493,5,12,.417,13,23,.565,94
14012,2013-12-18,HOU,,CHI,W 109-94,240,44,82,.537,36,60,.600,8,22,.364,13,16,.813,109
14013,2013-12-18,LAC,,NOP,W 108-95,240,33,78,.423,22,49,.449,11,29,.379,31,36,.861,108
14014,2013-12-18,NOP,@,LAC,L 95-108,240,37,93,.398,30,73,.411,7,20,.350,14,20,.700,95
14015,2013-12-18,IND,@,MIA,L 94-97,240,32,73,.438,27,59,.458,5,14,.357,25,28,.893,94
14016,2013-12-18,MIA,,IND,W 97-94,240,37,77,.481,32,56,.571,5,21,.238,18,22,.818,97
14017,2013-12-18,MIL,,NYK,L 101-107 (2OT),290,34,82,.415,26,60,.433,8,22,.364,25,35,.714,101
14018,2013-12-18,NYK,@,MIL,W 107-101 (2OT),290,38,101,.376,21,60,.350,17,41,.415,14,19,.737,107
14019,2013-12-18,MIN,,POR,W 120-109,240,46,93,.495,39,74,.527,7,19,.368,21,26,.808,120
14020,2013-12-18,POR,@,MIN,L 109-120,240,40,94,.426,26,54,.481,14,40,.350,15,19,.789,109
14021,2013-12-18,ORL,,UTA,L 82-86,240,28,86,.326,21,71,.296,7,15,.467,19,20,.950,82
14022,2013-12-18,UTA,@,ORL,W 86-82,240,33,82,.402,25,61,.410,8,21,.381,12,15,.800,86
14023,2013-12-18,PHO,,SAS,L 101-108,240,38,82,.463,31,67,.463,7,15,.467,18,24,.750,101
14024,2013-12-18,SAS,@,PHO,W 108-101,240,41,87,.471,34,69,.493,7,18,.389,19,24,.792,108
14025,2013-12-18,CHA,@,TOR,W 104-102 (OT),265,37,81,.457,29,66,.439,8,15,.533,22,34,.647,104
14026,2013-12-18,TOR,,CHA,L 102-104 (OT),265,41,96,.427,35,70,.500,6,26,.231,14,20,.700,102
14027,2013-12-17,CHA,,SAC,W 95-87,240,35,78,.449,27,61,.443,8,17,.471,17,24,.708,95
14028,2013-12-17,SAC,@,CHA,L 87-95,240,30,80,.375,26,65,.400,4,15,.267,23,28,.821,87
14029,2013-12-17,CLE,,POR,L 116-119,240,48,102,.471,39,85,.459,9,17,.529,11,16,.688,116
14030,2013-12-17,POR,@,CLE,W 119-116,240,41,92,.446,26,59,.441,15,33,.455,22,25,.880,119
14031,2013-12-17,DEN,,OKC,L 93-105,240,36,87,.414,31,68,.456,5,19,.263,16,22,.727,93
14032,2013-12-17,OKC,@,DEN,W 105-93,240,43,88,.489,38,66,.576,5,22,.227,14,20,.700,105
14033,2013-12-17,GSW,,NOP,W 104-93,240,41,91,.451,36,71,.507,5,20,.250,17,24,.708,104
14034,2013-12-17,NOP,@,GSW,L 93-104,240,33,88,.375,28,70,.400,5,18,.278,22,30,.733,93
14035,2013-12-17,LAL,@,MEM,W 96-92,240,37,75,.493,30,53,.566,7,22,.318,15,19,.789,96
14036,2013-12-17,MEM,,LAL,L 92-96,240,37,91,.407,32,75,.427,5,16,.313,13,17,.765,92
14037,2013-12-16,ATL,,LAL,W 114-100,240,45,92,.489,34,65,.523,11,27,.407,13,15,.867,114
14038,2013-12-16,LAL,@,ATL,L 100-114,240,39,82,.476,34,61,.557,5,21,.238,17,21,.810,100
14039,2013-12-16,BOS,,MIN,W 101-97,240,38,86,.442,31,65,.477,7,21,.333,18,23,.783,101
14040,2013-12-16,MIN,@,BOS,L 97-101,240,37,98,.378,29,69,.420,8,29,.276,15,26,.577,97
14041,2013-12-16,BRK,,PHI,W 130-94,240,47,78,.603,26,43,.605,21,35,.600,15,26,.577,130
14042,2013-12-16,PHI,@,BRK,L 94-130,240,37,90,.411,29,60,.483,8,30,.267,12,20,.600,94
14043,2013-12-16,CHI,,ORL,L 82-83,240,28,81,.346,23,63,.365,5,18,.278,21,26,.808,82
14044,2013-12-16,ORL,@,CHI,W 83-82,240,33,83,.398,28,71,.394,5,12,.417,12,16,.750,83
14045,2013-12-16,DET,@,IND,W 101-96,240,38,88,.432,31,68,.456,7,20,.350,18,28,.643,101
14046,2013-12-16,IND,,DET,L 96-101,240,35,81,.432,29,64,.453,6,17,.353,20,27,.741,96
14047,2013-12-16,LAC,,SAS,W 115-92,240,39,76,.513,28,53,.528,11,23,.478,26,35,.743,115
14048,2013-12-16,SAS,@,LAC,L 92-115,240,37,76,.487,31,58,.534,6,18,.333,12,21,.571,92
14049,2013-12-16,MIA,,UTA,W 117-94,240,45,71,.634,39,56,.696,6,15,.400,21,26,.808,117
14050,2013-12-16,UTA,@,MIA,L 94-117,240,39,84,.464,34,66,.515,5,18,.278,11,17,.647,94
14051,2013-12-16,NYK,,WAS,L 101-102,240,33,79,.418,22,49,.449,11,30,.367,24,31,.774,101
14052,2013-12-16,WAS,@,NYK,W 102-101,240,39,72,.542,28,54,.519,11,18,.611,13,17,.765,102
14053,2013-12-15,DEN,,NOP,W 102-93,240,37,85,.435,30,61,.492,7,24,.292,21,28,.750,102
14054,2013-12-15,NOP,@,DEN,L 93-102,240,37,85,.435,30,61,.492,7,24,.292,12,19,.632,93
14055,2013-12-15,DET,,POR,L 109-111 (OT),265,44,94,.468,41,79,.519,3,15,.200,18,27,.667,109
14056,2013-12-15,POR,@,DET,W 111-109 (OT),265,41,99,.414,34,73,.466,7,26,.269,22,26,.846,111
14057,2013-12-15,MEM,,MIN,L 93-101,240,37,83,.446,32,68,.471,5,15,.333,14,20,.700,93
14058,2013-12-15,MIN,@,MEM,W 101-93,240,35,79,.443,23,53,.434,12,26,.462,19,25,.760,101
14059,2013-12-15,OKC,,ORL,W 101-98,240,39,87,.448,34,68,.500,5,19,.263,18,20,.900,101
14060,2013-12-15,ORL,@,OKC,L 98-101,240,37,82,.451,30,58,.517,7,24,.292,17,26,.654,98
14061,2013-12-15,GSW,@,PHO,L 102-106,240,34,80,.425,23,58,.397,11,22,.500,23,33,.697,102
14062,2013-12-15,PHO,,GSW,W 106-102,240,35,79,.443,22,52,.423,13,27,.481,23,34,.676,106
14063,2013-12-15,HOU,@,SAC,L 91-106,240,31,75,.413,24,48,.500,7,27,.259,22,38,.579,91
14064,2013-12-15,SAC,,HOU,W 106-91,240,39,81,.481,36,68,.529,3,13,.231,25,30,.833,106
14065,2013-12-14,CHA,,LAL,L 85-88,240,39,89,.438,37,76,.487,2,13,.154,5,8,.625,85
14066,2013-12-14,LAL,@,CHA,W 88-85,240,30,77,.390,23,57,.404,7,20,.350,21,23,.913,88
14067,2013-12-14,CHI,,TOR,L 77-99,240,31,86,.360,25,68,.368,6,18,.333,9,12,.750,77
14068,2013-12-14,TOR,@,CHI,W 99-77,240,40,83,.482,35,68,.515,5,15,.333,14,18,.778,99
14069,2013-12-14,DAL,,MIL,W 106-93,240,42,88,.477,32,64,.500,10,24,.417,12,18,.667,106
14070,2013-12-14,MIL,@,DAL,L 93-106,240,36,81,.444,31,64,.484,5,17,.294,16,19,.842,93
14071,2013-12-14,CLE,@,MIA,L 107-114,240,39,84,.464,29,55,.527,10,29,.345,19,25,.760,107
14072,2013-12-14,MIA,,CLE,W 114-107,240,42,76,.553,34,55,.618,8,21,.381,22,30,.733,114
14073,2013-12-14,ATL,@,NYK,L 106-111,240,40,66,.606,25,34,.735,15,32,.469,11,11,1.000,106
14074,2013-12-14,NYK,,ATL,W 111-106,240,44,87,.506,36,68,.529,8,19,.421,15,18,.833,111
14075,2013-12-14,PHI,,POR,L 105-139,240,39,87,.448,30,72,.417,9,15,.600,18,26,.692,105
14076,2013-12-14,POR,@,PHI,W 139-105,240,52,93,.559,31,56,.554,21,37,.568,14,20,.700,139
14077,2013-12-14,SAS,@,UTA,W 100-84,240,41,88,.466,33,68,.485,8,20,.400,10,12,.833,100
14078,2013-12-14,UTA,,SAS,L 84-100,240,35,89,.393,29,69,.420,6,20,.300,8,11,.727,84
14079,2013-12-14,LAC,@,WAS,W 113-97,240,39,69,.565,30,48,.625,9,21,.429,26,31,.839,113
14080,2013-12-14,WAS,,LAC,L 97-113,240,40,81,.494,37,67,.552,3,14,.214,14,20,.700,97
14081,2013-12-13,ATL,,WAS,W 101-99 (OT),265,38,89,.427,31,68,.456,7,21,.333,18,24,.750,101
14082,2013-12-13,WAS,@,ATL,L 99-101 (OT),265,42,100,.420,38,86,.442,4,14,.286,11,18,.611,99
14083,2013-12-13,BOS,,NYK,W 90-86,240,33,68,.485,26,47,.553,7,21,.333,17,25,.680,90
14084,2013-12-13,NYK,@,BOS,L 86-90,240,32,80,.400,27,59,.458,5,21,.238,17,19,.895,86
14085,2013-12-13,DEN,,UTA,L 93-103,240,36,85,.424,29,64,.453,7,21,.333,14,24,.583,93
14086,2013-12-13,UTA,@,DEN,W 103-93,240,38,84,.452,30,63,.476,8,21,.381,19,20,.950,103
14087,2013-12-13,BRK,@,DET,L 99-103,240,36,79,.456,24,56,.429,12,23,.522,15,20,.750,99
14088,2013-12-13,DET,,BRK,W 103-99,240,39,83,.470,36,73,.493,3,10,.300,22,31,.710,103
14089,2013-12-13,GSW,,HOU,L 112-116,240,43,90,.478,37,68,.544,6,22,.273,20,24,.833,112
14090,2013-12-13,HOU,@,GSW,W 116-112,240,39,79,.494,27,50,.540,12,29,.414,26,35,.743,116
14091,2013-12-13,CHA,@,IND,L 94-99,240,39,83,.470,35,71,.493,4,12,.333,12,17,.706,94
14092,2013-12-13,IND,,CHA,W 99-94,240,36,76,.474,28,55,.509,8,21,.381,19,25,.760,99
14093,2013-12-13,CHI,@,MIL,W 91-90,240,34,81,.420,27,57,.474,7,24,.292,16,19,.842,91
14094,2013-12-13,MIL,,CHI,L 90-91,240,33,74,.446,29,64,.453,4,10,.400,20,25,.800,90
14095,2013-12-13,MEM,@,NOP,L 98-104,240,40,80,.500,34,65,.523,6,15,.400,12,17,.706,98
14096,2013-12-13,NOP,,MEM,W 104-98,240,39,76,.513,30,54,.556,9,22,.409,17,20,.850,104
14097,2013-12-13,LAL,@,OKC,L 97-122,240,36,87,.414,29,62,.468,7,25,.280,18,31,.581,97
14098,2013-12-13,OKC,,LAL,W 122-97,240,47,99,.475,39,74,.527,8,25,.320,20,23,.870,122
14099,2013-12-13,CLE,@,ORL,W 109-100,240,42,87,.483,34,66,.515,8,21,.381,17,20,.850,109
14100,2013-12-13,ORL,,CLE,L 100-109,240,37,85,.435,26,55,.473,11,30,.367,15,16,.938,100
14101,2013-12-13,PHO,,SAC,W 116-107,240,41,83,.494,29,59,.492,12,24,.500,22,29,.759,116
14102,2013-12-13,SAC,@,PHO,L 107-116,240,38,87,.437,32,68,.471,6,19,.316,25,29,.862,107
14103,2013-12-13,MIN,@,SAS,L 110-117,240,38,88,.432,27,65,.415,11,23,.478,23,26,.885,110
14104,2013-12-13,SAS,,MIN,W 117-110,240,48,87,.552,38,65,.585,10,22,.455,11,13,.846,117
14105,2013-12-13,PHI,@,TOR,L 100-108,240,37,84,.440,28,61,.459,9,23,.391,17,21,.810,100
14106,2013-12-13,TOR,,PHI,W 108-100,240,39,82,.476,29,57,.509,10,25,.400,20,24,.833,108
14107,2013-12-12,BRK,,LAC,W 102-93,240,33,74,.446,25,54,.463,8,20,.400,28,30,.933,102
14108,2013-12-12,LAC,@,BRK,L 93-102,240,26,70,.371,20,46,.435,6,24,.250,35,52,.673,93
14109,2013-12-12,HOU,@,POR,L 104-111,240,40,94,.426,35,74,.473,5,20,.250,19,24,.792,104
14110,2013-12-12,POR,,HOU,W 111-104,240,39,89,.438,31,62,.500,8,27,.296,25,30,.833,111
14111,2013-12-11,BOS,,LAC,L 88-96,240,33,80,.413,27,63,.429,6,17,.353,16,19,.842,88
14112,2013-12-11,LAC,@,BOS,W 96-88,240,34,76,.447,28,59,.475,6,17,.353,22,34,.647,96
14113,2013-12-11,CHA,,ORL,L 83-92,240,31,84,.369,27,67,.403,4,17,.235,17,18,.944,83
14114,2013-12-11,ORL,@,CHA,W 92-83,240,38,90,.422,31,71,.437,7,19,.368,9,9,1.000,92
14115,2013-12-11,DAL,@,GSW,L 93-95,240,37,88,.420,29,65,.446,8,23,.348,11,14,.786,93
14116,2013-12-11,GSW,,DAL,W 95-93,240,37,86,.430,25,58,.431,12,28,.429,9,15,.600,95
14117,2013-12-11,MEM,,OKC,L 100-116,240,34,81,.420,28,66,.424,6,15,.400,26,34,.765,100
14118,2013-12-11,OKC,@,MEM,W 116-100,240,40,71,.563,31,53,.585,9,18,.500,27,33,.818,116
14119,2013-12-11,MIL,,SAS,L 77-109,240,29,84,.345,27,69,.391,2,15,.133,17,23,.739,77
14120,2013-12-11,SAS,@,MIL,W 109-77,240,46,88,.523,42,71,.592,4,17,.235,13,17,.765,109
14121,2013-12-11,MIN,,PHI,W 106-99,240,37,96,.385,30,76,.395,7,20,.350,25,29,.862,106
14122,2013-12-11,PHI,@,MIN,L 99-106,240,39,74,.527,30,54,.556,9,20,.450,12,14,.857,99
14123,2013-12-11,DET,@,NOP,L 106-111 (OT),265,42,96,.438,37,75,.493,5,21,.238,17,27,.630,106
14124,2013-12-11,NOP,,DET,W 111-106 (OT),265,38,84,.452,29,61,.475,9,23,.391,26,32,.813,111
14125,2013-12-11,CHI,@,NYK,L 78-83,240,24,72,.333,18,51,.353,6,21,.286,24,29,.828,78
14126,2013-12-11,NYK,,CHI,W 83-78,240,31,76,.408,26,57,.456,5,19,.263,16,19,.842,83
14127,2013-12-11,SAC,,UTA,L 101-122,240,35,78,.449,31,65,.477,4,13,.308,27,33,.818,101
14128,2013-12-11,UTA,@,SAC,W 122-101,240,48,89,.539,35,66,.530,13,23,.565,13,15,.867,122
14129,2013-12-10,ATL,,OKC,L 92-101,240,31,87,.356,22,61,.361,9,26,.346,21,27,.778,92
14130,2013-12-10,OKC,@,ATL,W 101-92,240,38,86,.442,34,68,.500,4,18,.222,21,28,.750,101
14131,2013-12-10,BOS,@,BRK,L 96-104,240,35,80,.438,24,58,.414,11,22,.500,15,21,.714,96
14132,2013-12-10,BRK,,BOS,W 104-96,240,39,70,.557,36,58,.621,3,12,.250,23,28,.821,104
14133,2013-12-10,CHI,,MIL,L 74-78,240,31,83,.373,28,68,.412,3,15,.200,9,14,.643,74
14134,2013-12-10,MIL,@,CHI,W 78-74,240,30,75,.400,28,64,.438,2,11,.182,16,20,.800,78
14135,2013-12-10,CLE,,NYK,W 109-94,240,42,74,.568,33,55,.600,9,19,.474,16,22,.727,109
14136,2013-12-10,NYK,@,CLE,L 94-109,240,40,87,.460,30,56,.536,10,31,.323,4,5,.800,94
14137,2013-12-10,DET,,MIN,L 94-121,240,39,83,.470,31,55,.564,8,28,.286,8,16,.500,94
14138,2013-12-10,MIN,@,DET,W 121-94,240,41,85,.482,30,61,.492,11,24,.458,28,33,.848,121
14139,2013-12-10,IND,,MIA,W 90-84,240,34,67,.507,29,52,.558,5,15,.333,17,25,.680,90
14140,2013-12-10,MIA,@,IND,L 84-90,240,33,77,.429,29,56,.518,4,21,.190,14,20,.700,84
14141,2013-12-10,LAL,,PHO,L 108-114,240,39,80,.488,34,61,.557,5,19,.263,25,32,.781,108
14142,2013-12-10,PHO,@,LAL,W 114-108,240,44,85,.518,37,62,.597,7,23,.304,19,21,.905,114
14143,2013-12-10,SAS,@,TOR,W 116-103,240,45,82,.549,32,59,.542,13,23,.565,13,16,.813,116
14144,2013-12-10,TOR,,SAS,L 103-116,240,38,83,.458,28,60,.467,10,23,.435,17,19,.895,103
14145,2013-12-09,CHA,,GSW,W 115-111,240,43,94,.457,37,82,.451,6,12,.500,23,29,.793,115
14146,2013-12-09,GSW,@,CHA,L 111-115,240,41,90,.456,30,53,.566,11,37,.297,18,22,.818,111
14147,2013-12-09,MEM,,ORL,W 94-85,240,36,86,.419,26,69,.377,10,17,.588,12,17,.706,94
14148,2013-12-09,ORL,@,MEM,L 85-94,240,30,75,.400,24,53,.453,6,22,.273,19,20,.950,85
14149,2013-12-09,LAC,@,PHI,W 94-83,240,35,82,.427,30,55,.545,5,27,.185,19,29,.655,94
14150,2013-12-09,PHI,,LAC,L 83-94,240,33,92,.359,30,71,.423,3,21,.143,14,19,.737,83
14151,2013-12-09,DAL,@,SAC,L 97-112,240,37,95,.389,32,68,.471,5,27,.185,18,20,.900,97
14152,2013-12-09,SAC,,DAL,W 112-97,240,38,81,.469,29,56,.518,9,25,.360,27,34,.794,112
14153,2013-12-09,POR,@,UTA,W 105-94,240,40,85,.471,34,66,.515,6,19,.316,19,20,.950,105
14154,2013-12-09,UTA,,POR,L 94-105,240,36,82,.439,35,75,.467,1,7,.143,21,23,.913,94
14155,2013-12-09,DEN,@,WAS,W 75-74,240,30,73,.411,23,52,.442,7,21,.333,8,14,.571,75
14156,2013-12-09,WAS,,DEN,L 74-75,240,32,89,.360,27,65,.415,5,24,.208,5,9,.556,74
14157,2013-12-08,DET,,MIA,L 95-110,240,36,85,.424,29,65,.446,7,20,.350,16,22,.727,95
14158,2013-12-08,MIA,@,DET,W 110-95,240,40,72,.556,29,44,.659,11,28,.393,19,21,.905,110
14159,2013-12-08,HOU,,ORL,W 98-88,240,32,76,.421,22,43,.512,10,33,.303,24,42,.571,98
14160,2013-12-08,ORL,@,HOU,L 88-98,240,32,93,.344,24,64,.375,8,29,.276,16,28,.571,88
14161,2013-12-08,LAL,,TOR,L 94-106,240,34,79,.430,25,51,.490,9,28,.321,17,20,.850,94
14162,2013-12-08,TOR,@,LAL,W 106-94,240,40,82,.488,36,56,.643,4,26,.154,22,25,.880,106
14163,2013-12-08,BOS,@,NYK,W 114-73,240,39,72,.542,25,47,.532,14,25,.560,22,27,.815,114
14164,2013-12-08,NYK,,BOS,L 73-114,240,25,73,.342,19,57,.333,6,16,.375,17,23,.739,73
14165,2013-12-08,IND,@,OKC,L 94-118,240,34,85,.400,27,64,.422,7,21,.333,19,21,.905,94
14166,2013-12-08,OKC,,IND,W 118-94,240,47,77,.610,42,64,.656,5,13,.385,19,20,.950,118
14167,2013-12-07,CHI,,DET,L 75-92,240,30,90,.333,27,72,.375,3,18,.167,12,15,.800,75
14168,2013-12-07,DET,@,CHI,W 92-75,240,34,80,.425,22,61,.361,12,19,.632,12,15,.800,92
14169,2013-12-07,CLE,,LAC,W 88-82,240,31,83,.373,27,69,.391,4,14,.286,22,30,.733,88
14170,2013-12-07,LAC,@,CLE,L 82-88,240,28,87,.322,21,52,.404,7,35,.200,19,26,.731,82
14171,2013-12-07,GSW,@,MEM,W 108-82,240,44,88,.500,36,70,.514,8,18,.444,12,14,.857,108
14172,2013-12-07,MEM,,GSW,L 82-108,240,31,85,.365,29,75,.387,2,10,.200,18,22,.818,82
14173,2013-12-07,BRK,@,MIL,W 90-82,240,34,74,.459,29,56,.518,5,18,.278,17,23,.739,90
14174,2013-12-07,MIL,,BRK,L 82-90,240,30,73,.411,23,53,.434,7,20,.350,15,22,.682,82
14175,2013-12-07,MIA,@,MIN,W 103-82,240,43,78,.551,39,60,.650,4,18,.222,13,19,.684,103
14176,2013-12-07,MIN,,MIA,L 82-103,240,24,82,.293,19,60,.317,5,22,.227,29,39,.744,82
14177,2013-12-07,DEN,@,PHI,W 103-92,240,35,83,.422,28,61,.459,7,22,.318,26,34,.765,103
14178,2013-12-07,PHI,,DEN,L 92-103,240,40,88,.455,37,72,.514,3,16,.188,9,14,.643,92
14179,2013-12-07,DAL,@,POR,W 108-106,240,46,87,.529,38,71,.535,8,16,.500,8,11,.727,108
14180,2013-12-07,POR,,DAL,L 106-108,240,39,87,.448,30,57,.526,9,30,.300,19,24,.792,106
14181,2013-12-07,IND,@,SAS,W 111-100,240,38,71,.535,29,52,.558,9,19,.474,26,28,.929,111
14182,2013-12-07,SAS,,IND,L 100-111,240,41,91,.451,28,65,.431,13,26,.500,5,6,.833,100
14183,2013-12-07,SAC,@,UTA,W 112-102 (OT),265,39,94,.415,36,79,.456,3,15,.200,31,38,.816,112
14184,2013-12-07,UTA,,SAC,L 102-112 (OT),265,36,89,.404,28,70,.400,8,19,.421,22,30,.733,102
14185,2013-12-06,ATL,,CLE,W 108-89,240,47,91,.516,39,68,.574,8,23,.348,6,11,.545,108
14186,2013-12-06,CLE,@,ATL,L 89-108,240,38,94,.404,33,74,.446,5,20,.250,8,17,.471,89
14187,2013-12-06,BOS,,DEN,W 106-98,240,43,83,.518,37,63,.587,6,20,.300,14,18,.778,106
14188,2013-12-06,DEN,@,BOS,L 98-106,240,34,77,.442,28,60,.467,6,17,.353,24,29,.828,98
14189,2013-12-06,CHA,,PHI,W 105-88,240,42,91,.462,38,70,.543,4,21,.190,17,25,.680,105
14190,2013-12-06,PHI,@,CHA,L 88-105,240,37,92,.402,31,65,.477,6,27,.222,8,13,.615,88
14191,2013-12-06,GSW,@,HOU,L 83-105,240,27,76,.355,25,60,.417,2,16,.125,27,34,.794,83
14192,2013-12-06,HOU,,GSW,W 105-83,240,37,83,.446,31,55,.564,6,28,.214,25,39,.641,105
14193,2013-12-06,NOP,,OKC,L 95-109,240,33,88,.375,30,72,.417,3,16,.188,26,34,.765,95
14194,2013-12-06,OKC,@,NOP,W 109-95,240,39,77,.506,32,56,.571,7,21,.333,24,30,.800,109
14195,2013-12-06,NYK,,ORL,W 121-83,240,44,83,.530,27,49,.551,17,34,.500,16,19,.842,121
14196,2013-12-06,ORL,@,NYK,L 83-121,240,30,70,.429,20,45,.444,10,25,.400,13,20,.650,83
14197,2013-12-06,PHO,,TOR,W 106-97,240,37,82,.451,28,59,.475,9,23,.391,23,32,.719,106
14198,2013-12-06,TOR,@,PHO,L 97-106,240,35,87,.402,30,68,.441,5,19,.263,22,25,.880,97
14199,2013-12-06,POR,,UTA,W 130-98,240,46,83,.554,29,60,.483,17,23,.739,21,24,.875,130
14200,2013-12-06,UTA,@,POR,L 98-130,240,39,93,.419,35,82,.427,4,11,.364,16,19,.842,98
14201,2013-12-06,LAL,@,SAC,W 106-100,240,41,86,.477,29,54,.537,12,32,.375,12,18,.667,106
14202,2013-12-06,SAC,,LAL,L 100-106,240,37,86,.430,27,64,.422,10,22,.455,16,22,.727,100
14203,2013-12-06,MIL,@,WAS,W 109-105 (OT),265,42,92,.457,36,72,.500,6,20,.300,19,26,.731,109
14204,2013-12-06,WAS,,MIL,L 105-109 (OT),265,33,83,.398,25,56,.446,8,27,.296,31,41,.756,105
14205,2013-12-05,BRK,,NYK,L 83-113,240,29,73,.397,25,57,.439,4,16,.250,21,31,.677,83
14206,2013-12-05,NYK,@,BRK,W 113-83,240,44,77,.571,28,50,.560,16,27,.593,9,11,.818,113
14207,2013-12-05,CHI,,MIA,W 107-87,240,37,74,.500,27,55,.491,10,19,.526,23,32,.719,107
14208,2013-12-05,MIA,@,CHI,L 87-107,240,32,77,.416,26,55,.473,6,22,.273,17,24,.708,87
14209,2013-12-05,LAC,@,MEM,W 101-81,240,38,80,.475,27,60,.450,11,20,.550,14,18,.778,101
14210,2013-12-05,MEM,,LAC,L 81-101,240,29,77,.377,26,64,.406,3,13,.231,20,26,.769,81
14211,2013-12-04,ATL,,LAC,W 107-97,240,42,82,.512,30,59,.508,12,23,.522,11,16,.688,107
14212,2013-12-04,LAC,@,ATL,L 97-107,240,39,83,.470,35,64,.547,4,19,.211,15,20,.750,97
14213,2013-12-04,CLE,,DEN,W 98-88,240,37,91,.407,32,77,.416,5,14,.357,19,24,.792,98
14214,2013-12-04,DEN,@,CLE,L 88-98,240,36,92,.391,30,69,.435,6,23,.261,10,13,.769,88
14215,2013-12-04,HOU,,PHO,L 88-97,240,31,88,.352,22,57,.386,9,31,.290,17,19,.895,88
14216,2013-12-04,PHO,@,HOU,W 97-88,240,36,79,.456,25,55,.455,11,24,.458,14,19,.737,97
14217,2013-12-04,DET,@,MIL,W 105-98,240,33,86,.384,26,65,.400,7,21,.333,32,42,.762,105
14218,2013-12-04,MIL,,DET,L 98-105,240,36,91,.396,27,64,.422,9,27,.333,17,22,.773,98
14219,2013-12-04,DAL,@,NOP,W 100-97,240,37,86,.430,26,62,.419,11,24,.458,15,22,.682,100
14220,2013-12-04,NOP,,DAL,L 97-100,240,38,94,.404,31,72,.431,7,22,.318,14,15,.933,97
14221,2013-12-04,OKC,@,POR,L 104-111,240,39,89,.438,34,78,.436,5,11,.455,21,24,.875,104
14222,2013-12-04,POR,,OKC,W 111-104,240,44,98,.449,36,75,.480,8,23,.348,15,17,.882,111
14223,2013-12-04,IND,@,UTA,W 95-86,240,40,84,.476,37,68,.544,3,16,.188,12,15,.800,95
14224,2013-12-04,UTA,,IND,L 86-95,240,33,80,.413,29,69,.420,4,11,.364,16,18,.889,86
14225,2013-12-03,BOS,,MIL,W 108-100,240,38,77,.494,27,53,.509,11,24,.458,21,27,.778,108
14226,2013-12-03,MIL,@,BOS,L 100-108,240,37,78,.474,29,60,.483,8,18,.444,18,21,.857,100
14227,2013-12-03,BRK,,DEN,L 87-111,240,30,75,.400,28,59,.475,2,16,.125,25,34,.735,87
14228,2013-12-03,DEN,@,BRK,W 111-87,240,43,85,.506,36,67,.537,7,18,.389,18,28,.643,111
14229,2013-12-03,CHA,@,DAL,L 82-89,240,30,78,.385,27,61,.443,3,17,.176,19,25,.760,82
14230,2013-12-03,DAL,,CHA,W 89-82,240,33,82,.402,25,61,.410,8,21,.381,15,17,.882,89
14231,2013-12-03,GSW,,TOR,W 112-103,240,40,79,.506,28,50,.560,12,29,.414,20,25,.800,112
14232,2013-12-03,TOR,@,GSW,L 103-112,240,40,77,.519,32,57,.561,8,20,.400,15,18,.833,103
14233,2013-12-03,MEM,,PHO,W 110-91,240,46,84,.548,41,70,.586,5,14,.357,13,21,.619,110
14234,2013-12-03,PHO,@,MEM,L 91-110,240,37,87,.425,30,58,.517,7,29,.241,10,15,.667,91
14235,2013-12-03,DET,@,MIA,W 107-97,240,41,80,.513,34,64,.531,7,16,.438,18,26,.692,107
14236,2013-12-03,MIA,,DET,L 97-107,240,36,82,.439,27,54,.500,9,28,.321,16,23,.696,97
14237,2013-12-03,ORL,@,PHI,L 125-126 (2OT),290,47,94,.500,41,68,.603,6,26,.231,25,32,.781,125
14238,2013-12-03,PHI,,ORL,W 126-125 (2OT),290,46,96,.479,35,67,.522,11,29,.379,23,33,.697,126
14239,2013-12-03,OKC,@,SAC,W 97-95,240,36,83,.434,29,63,.460,7,20,.350,18,20,.900,97
14240,2013-12-03,SAC,,OKC,L 95-97,240,35,89,.393,25,60,.417,10,29,.345,15,19,.789,95
14241,2013-12-02,CHI,,NOP,L 128-131 (3OT),315,48,101,.475,40,78,.513,8,23,.348,24,34,.706,128
14242,2013-12-02,NOP,@,CHI,W 131-128 (3OT),315,50,113,.442,39,90,.433,11,23,.478,20,27,.741,131
14243,2013-12-02,IND,@,POR,L 102-106,240,39,88,.443,30,66,.455,9,22,.409,15,17,.882,102
14244,2013-12-02,POR,,IND,W 106-102,240,36,76,.474,31,63,.492,5,13,.385,29,33,.879,106
14245,2013-12-02,ATL,@,SAS,L 100-102,240,42,96,.438,31,65,.477,11,31,.355,5,5,1.000,100
14246,2013-12-02,SAS,,ATL,W 102-100,240,42,78,.538,36,60,.600,6,18,.333,12,17,.706,102
14247,2013-12-02,HOU,@,UTA,L 103-109,240,40,83,.482,31,55,.564,9,28,.321,14,20,.700,103
14248,2013-12-02,UTA,,HOU,W 109-103,240,43,79,.544,33,62,.532,10,17,.588,13,16,.813,109
14249,2013-12-02,ORL,@,WAS,L 80-98,240,30,77,.390,27,62,.435,3,15,.200,17,19,.895,80
14250,2013-12-02,WAS,,ORL,W 98-80,240,33,73,.452,24,60,.400,9,13,.692,23,29,.793,98
14251,2013-12-01,DET,,PHI,W 115-100,240,41,89,.461,31,61,.508,10,28,.357,23,39,.590,115
14252,2013-12-01,PHI,@,DET,L 100-115,240,38,88,.432,31,65,.477,7,23,.304,17,19,.895,100
14253,2013-12-01,IND,@,LAC,W 105-100,240,39,89,.438,31,63,.492,8,26,.308,19,26,.731,105
14254,2013-12-01,LAC,,IND,L 100-105,240,36,82,.439,32,67,.478,4,15,.267,24,31,.774,100
14255,2013-12-01,LAL,,POR,L 108-114,240,40,87,.460,30,59,.508,10,28,.357,18,23,.783,108
14256,2013-12-01,POR,@,LAL,W 114-108,240,38,87,.437,29,64,.453,9,23,.391,29,34,.853,114
14257,2013-12-01,CHA,@,MIA,L 98-99,240,35,76,.461,31,61,.508,4,15,.267,24,28,.857,98
14258,2013-12-01,MIA,,CHA,W 99-98,240,36,69,.522,28,51,.549,8,18,.444,19,25,.760,99
14259,2013-12-01,NOP,@,NYK,W 103-99,240,38,77,.494,28,56,.500,10,21,.476,17,23,.739,103
14260,2013-12-01,NYK,,NOP,L 99-103,240,34,76,.447,21,41,.512,13,35,.371,18,21,.857,99
14261,2013-12-01,MIN,@,OKC,L 103-113,240,37,89,.416,28,60,.467,9,29,.310,20,26,.769,103
14262,2013-12-01,OKC,,MIN,W 113-103,240,49,87,.563,40,68,.588,9,19,.474,6,9,.667,113
14263,2013-12-01,GSW,@,SAC,W 115-113,240,42,82,.512,27,57,.474,15,25,.600,16,22,.727,115
14264,2013-12-01,SAC,,GSW,L 113-115,240,40,76,.526,31,57,.544,9,19,.474,24,28,.857,113
14265,2013-12-01,DEN,@,TOR,W 112-98,240,44,87,.506,34,64,.531,10,23,.435,14,19,.737,112
14266,2013-12-01,TOR,,DEN,L 98-112,240,35,87,.402,27,65,.415,8,22,.364,20,26,.769,98
14267,2013-11-30,CHI,@,CLE,L 93-97,240,39,82,.476,33,67,.493,6,15,.400,9,15,.600,93
14268,2013-11-30,CLE,,CHI,W 97-93,240,37,78,.474,30,63,.476,7,15,.467,16,19,.842,97
14269,2013-11-30,DAL,,MIN,L 106-112,240,45,92,.489,38,68,.559,7,24,.292,9,11,.818,106
14270,2013-11-30,MIN,@,DAL,W 112-106,240,40,79,.506,29,53,.547,11,26,.423,21,30,.700,112
14271,2013-11-30,BRK,@,MEM,W 97-88,240,34,73,.466,25,55,.455,9,18,.500,20,26,.769,97
14272,2013-11-30,MEM,,BRK,L 88-97,240,36,77,.468,29,62,.468,7,15,.467,9,12,.750,88
14273,2013-11-30,BOS,@,MIL,L 85-92,240,35,84,.417,31,65,.477,4,19,.211,11,15,.733,85
14274,2013-11-30,MIL,,BOS,W 92-85,240,36,78,.462,28,61,.459,8,17,.471,12,20,.600,92
14275,2013-11-30,PHO,,UTA,L 104-112,240,37,78,.474,25,51,.490,12,27,.444,18,25,.720,104
14276,2013-11-30,UTA,@,PHO,W 112-104,240,39,76,.513,30,58,.517,9,18,.500,25,29,.862,112
14277,2013-11-30,HOU,@,SAS,W 112-106,240,40,90,.444,27,60,.450,13,30,.433,19,30,.633,112
14278,2013-11-30,SAS,,HOU,L 106-112,240,44,91,.484,35,65,.538,9,26,.346,9,13,.692,106
14279,2013-11-30,ATL,@,WAS,L 101-108,240,36,81,.444,29,64,.453,7,17,.412,22,26,.846,101
14280,2013-11-30,WAS,,ATL,W 108-101,240,38,78,.487,26,54,.481,12,24,.500,20,30,.667,108
14281,2013-11-29,ATL,,DAL,W 88-87,240,31,73,.425,28,58,.483,3,15,.200,23,30,.767,88
14282,2013-11-29,DAL,@,ATL,L 87-88,240,29,77,.377,20,53,.377,9,24,.375,20,21,.952,87
14283,2013-11-29,BOS,,CLE,W 103-86,240,38,76,.500,27,53,.509,11,23,.478,16,26,.615,103
14284,2013-11-29,CLE,@,BOS,L 86-103,240,32,86,.372,28,68,.412,4,18,.222,18,27,.667,86
14285,2013-11-29,CHA,,MIL,W 92-76,240,35,79,.443,32,64,.500,3,15,.200,19,31,.613,92
14286,2013-11-29,MIL,@,CHA,L 76-92,240,28,84,.333,23,67,.343,5,17,.294,15,20,.750,76
14287,2013-11-29,DEN,,NYK,W 97-95,240,31,71,.437,22,47,.468,9,24,.375,26,34,.765,97
14288,2013-11-29,NYK,@,DEN,L 95-97,240,34,83,.410,28,61,.459,6,22,.273,21,25,.840,95
14289,2013-11-29,DET,,LAL,L 102-106,240,44,100,.440,43,92,.467,1,8,.125,13,25,.520,102
14290,2013-11-29,LAL,@,DET,W 106-102,240,36,80,.450,22,49,.449,14,31,.452,20,30,.667,106
14291,2013-11-29,BRK,@,HOU,L 95-114,240,37,89,.416,31,67,.463,6,22,.273,15,23,.652,95
14292,2013-11-29,HOU,,BRK,W 114-95,240,39,74,.527,20,42,.476,19,32,.594,17,20,.850,114
14293,2013-11-29,IND,,WAS,W 93-73,240,38,85,.447,29,63,.460,9,22,.409,8,10,.800,93
14294,2013-11-29,WAS,@,IND,L 73-93,240,29,73,.397,23,55,.418,6,18,.333,9,13,.692,73
14295,2013-11-29,GSW,@,OKC,L 112-113 (OT),265,42,95,.442,34,69,.493,8,26,.308,20,29,.690,112
14296,2013-11-29,OKC,,GSW,W 113-112 (OT),265,36,92,.391,30,74,.405,6,18,.333,35,42,.833,113
14297,2013-11-29,ORL,,SAS,L 91-109,240,34,78,.436,25,59,.424,9,19,.474,14,15,.933,91
14298,2013-11-29,SAS,@,ORL,W 109-91,240,42,76,.553,34,59,.576,8,17,.471,17,17,1.000,109
14299,2013-11-29,NOP,@,PHI,W 121-105,240,51,93,.548,43,73,.589,8,20,.400,11,14,.786,121
14300,2013-11-29,PHI,,NOP,L 105-121,240,42,92,.457,30,61,.492,12,31,.387,9,21,.429,105
14301,2013-11-29,LAC,@,SAC,W 104-98 (OT),265,37,83,.446,31,63,.492,6,20,.300,24,37,.649,104
14302,2013-11-29,SAC,,LAC,L 98-104 (OT),265,42,91,.462,36,68,.529,6,23,.261,8,10,.800,98
14303,2013-11-29,MIA,@,TOR,W 90-83,240,36,76,.474,27,54,.500,9,22,.409,9,13,.692,90
14304,2013-11-29,TOR,,MIA,L 83-90,240,28,73,.384,20,43,.465,8,30,.267,19,32,.594,83
14305,2013-11-29,PHO,@,UTA,W 112-101,240,41,75,.547,33,50,.660,8,25,.320,22,25,.880,112
14306,2013-11-29,UTA,,PHO,L 101-112,240,40,83,.482,35,63,.556,5,20,.250,16,20,.800,101
14307,2013-11-27,BOS,,MEM,L 93-100,240,38,89,.427,31,69,.449,7,20,.350,10,13,.769,93
14308,2013-11-27,MEM,@,BOS,W 100-93,240,36,80,.450,33,71,.465,3,9,.333,25,31,.806,100
14309,2013-11-27,BRK,,LAL,L 94-99,240,31,83,.373,20,53,.377,11,30,.367,21,26,.808,94
14310,2013-11-27,LAL,@,BRK,W 99-94,240,34,85,.400,21,55,.382,13,30,.433,18,22,.818,99
14311,2013-11-27,CHA,,IND,L 74-99,240,26,83,.313,23,74,.311,3,9,.333,19,28,.679,74
14312,2013-11-27,IND,@,CHA,W 99-74,240,32,84,.381,22,59,.373,10,25,.400,25,32,.781,99
14313,2013-11-27,CLE,,MIA,L 84-95,240,29,83,.349,19,55,.345,10,28,.357,16,24,.667,84
14314,2013-11-27,MIA,@,CLE,W 95-84,240,35,72,.486,31,53,.585,4,19,.211,21,25,.840,95
14315,2013-11-27,DAL,,GSW,W 103-99,240,44,99,.444,37,81,.457,7,18,.389,8,10,.800,103
14316,2013-11-27,GSW,@,DAL,L 99-103,240,32,76,.421,23,53,.434,9,23,.391,26,34,.765,99
14317,2013-11-27,CHI,@,DET,W 99-79,240,42,79,.532,36,62,.581,6,17,.353,9,12,.750,99
14318,2013-11-27,DET,,CHI,L 79-99,240,34,77,.442,32,65,.492,2,12,.167,9,19,.474,79
14319,2013-11-27,ATL,@,HOU,L 84-113,240,32,75,.427,24,53,.453,8,22,.364,12,15,.800,84
14320,2013-11-27,HOU,,ATL,W 113-84,240,43,78,.551,29,51,.569,14,27,.519,13,21,.619,113
14321,2013-11-27,LAC,,NYK,W 93-80,240,32,74,.432,26,49,.531,6,25,.240,23,31,.742,93
14322,2013-11-27,NYK,@,LAC,L 80-93,240,32,83,.386,29,63,.460,3,20,.150,13,15,.867,80
14323,2013-11-27,MIL,,WAS,L 92-100 (OT),265,37,85,.435,27,60,.450,10,25,.400,8,10,.800,92
14324,2013-11-27,WAS,@,MIL,W 100-92 (OT),265,37,74,.500,27,48,.563,10,26,.385,16,22,.727,100
14325,2013-11-27,DEN,@,MIN,W 117-110,240,45,88,.511,37,72,.514,8,16,.500,19,25,.760,117
14326,2013-11-27,MIN,,DEN,L 110-117,240,40,88,.455,35,68,.515,5,20,.250,25,28,.893,110
14327,2013-11-27,OKC,,SAS,W 94-88,240,39,84,.464,35,69,.507,4,15,.267,12,15,.800,94
14328,2013-11-27,SAS,@,OKC,L 88-94,240,36,92,.391,29,65,.446,7,27,.259,9,14,.643,88
14329,2013-11-27,ORL,,PHI,W 105-94,240,43,82,.524,39,63,.619,4,19,.211,15,21,.714,105
14330,2013-11-27,PHI,@,ORL,L 94-105,240,38,85,.447,31,63,.492,7,22,.318,11,17,.647,94
14331,2013-11-27,PHO,,POR,W 120-106,240,42,81,.519,32,57,.561,10,24,.417,26,31,.839,120
14332,2013-11-27,POR,@,PHO,L 106-120,240,39,86,.453,32,67,.478,7,19,.368,21,24,.875,106
14333,2013-11-26,ATL,,ORL,L 92-109,240,30,73,.411,21,51,.412,9,22,.409,23,27,.852,92
14334,2013-11-26,ORL,@,ATL,W 109-92,240,42,83,.506,34,61,.557,8,22,.364,17,20,.850,109
14335,2013-11-26,GSW,@,NOP,W 102-101,240,40,88,.455,33,69,.478,7,19,.368,15,21,.714,102
14336,2013-11-26,NOP,,GSW,L 101-102,240,41,87,.471,32,68,.471,9,19,.474,10,13,.769,101
14337,2013-11-26,BRK,@,TOR,W 102-100,240,39,77,.506,35,63,.556,4,14,.286,20,22,.909,102
14338,2013-11-26,TOR,,BRK,L 100-102,240,34,78,.436,23,52,.442,11,26,.423,21,22,.955,100
14339,2013-11-26,LAL,@,WAS,L 111-116,240,44,83,.530,31,55,.564,13,28,.464,10,13,.769,111
14340,2013-11-26,WAS,,LAL,W 116-111,240,46,87,.529,40,66,.606,6,21,.286,18,22,.818,116
14341,2013-11-25,BOS,@,CHA,W 96-86,240,35,80,.438,26,60,.433,9,20,.450,17,21,.810,96
14342,2013-11-25,CHA,,BOS,L 86-96,240,33,74,.446,30,65,.462,3,9,.333,17,20,.850,86
14343,2013-11-25,DAL,,DEN,L 96-110,240,38,82,.463,33,63,.524,5,19,.263,15,19,.789,96
14344,2013-11-25,DEN,@,DAL,W 110-96,240,41,75,.547,33,55,.600,8,20,.400,20,28,.714,110
14345,2013-11-25,DET,,MIL,W 113-94,240,43,80,.538,31,51,.608,12,29,.414,15,23,.652,113
14346,2013-11-25,MIL,@,DET,L 94-113,240,33,73,.452,27,54,.500,6,19,.316,22,26,.846,94
14347,2013-11-25,IND,,MIN,W 98-84,240,40,80,.500,32,65,.492,8,15,.533,10,17,.588,98
14348,2013-11-25,MIN,@,IND,L 84-98,240,29,88,.330,26,69,.377,3,19,.158,23,28,.821,84
14349,2013-11-25,HOU,@,MEM,W 93-86,240,34,69,.493,28,45,.622,6,24,.250,19,27,.704,93
14350,2013-11-25,MEM,,HOU,L 86-93,240,34,82,.415,30,69,.435,4,13,.308,14,18,.778,86
14351,2013-11-25,MIA,,PHO,W 107-92,240,39,79,.494,32,57,.561,7,22,.318,22,24,.917,107
14352,2013-11-25,PHO,@,MIA,L 92-107,240,33,83,.398,25,51,.490,8,32,.250,18,24,.750,92
14353,2013-11-25,NYK,@,POR,L 91-102,240,38,85,.447,32,70,.457,6,15,.400,9,14,.643,91
14354,2013-11-25,POR,,NYK,W 102-91,240,37,84,.440,28,59,.475,9,25,.360,19,22,.864,102
14355,2013-11-25,NOP,@,SAS,L 93-112,240,37,97,.381,35,82,.427,2,15,.133,17,20,.850,93
14356,2013-11-25,SAS,,NOP,W 112-93,240,44,81,.543,34,56,.607,10,25,.400,14,19,.737,112
14357,2013-11-25,CHI,@,UTA,L 83-89 (OT),265,31,79,.392,30,66,.455,1,13,.077,20,28,.714,83
14358,2013-11-25,UTA,,CHI,W 89-83 (OT),265,33,85,.388,26,68,.382,7,17,.412,16,19,.842,89
14359,2013-11-24,BRK,,DET,L 97-109,240,35,77,.455,21,51,.412,14,26,.538,13,18,.722,97
14360,2013-11-24,DET,@,BRK,W 109-97,240,38,80,.475,33,63,.524,5,17,.294,28,40,.700,109
14361,2013-11-24,CHI,@,LAC,L 82-121,240,32,81,.395,28,69,.406,4,12,.333,14,23,.609,82
14362,2013-11-24,LAC,,CHI,W 121-82,240,48,82,.585,40,61,.656,8,21,.381,17,19,.895,121
14363,2013-11-24,LAL,,SAC,W 100-86,240,40,87,.460,32,61,.525,8,26,.308,12,15,.800,100
14364,2013-11-24,SAC,@,LAL,L 86-100,240,35,84,.417,27,60,.450,8,24,.333,8,15,.533,86
14365,2013-11-24,OKC,,UTA,W 95-73,240,36,71,.507,31,59,.525,5,12,.417,18,22,.818,95
14366,2013-11-24,UTA,@,OKC,L 73-95,240,28,71,.394,24,53,.453,4,18,.222,13,29,.448,73
14367,2013-11-24,ORL,,PHO,L 96-104,240,39,84,.464,33,63,.524,6,21,.286,12,14,.857,96
14368,2013-11-24,PHO,@,ORL,W 104-96,240,46,95,.484,35,66,.530,11,29,.379,1,3,.333,104
14369,2013-11-23,ATL,,BOS,L 87-94,240,36,93,.387,31,73,.425,5,20,.250,10,12,.833,87
14370,2013-11-23,BOS,@,ATL,W 94-87,240,33,72,.458,29,56,.518,4,16,.250,24,31,.774,94
14371,2013-11-23,DAL,@,DEN,L 100-102,240,35,87,.402,28,66,.424,7,21,.333,23,25,.920,100
14372,2013-11-23,DEN,,DAL,W 102-100,240,35,79,.443,24,47,.511,11,32,.344,21,30,.700,102
14373,2013-11-23,GSW,,POR,L 101-113,240,36,77,.468,29,60,.483,7,17,.412,22,30,.733,101
14374,2013-11-23,POR,@,GSW,W 113-101,240,37,86,.430,27,65,.415,10,21,.476,29,35,.829,113
14375,2013-11-23,HOU,,MIN,W 112-101,240,41,79,.519,24,48,.500,17,31,.548,13,16,.813,112
14376,2013-11-23,MIN,@,HOU,L 101-112,240,40,100,.400,32,74,.432,8,26,.308,13,17,.765,101
14377,2013-11-23,IND,,PHI,W 106-98,240,35,76,.461,30,58,.517,5,18,.278,31,38,.816,106
14378,2013-11-23,PHI,@,IND,L 98-106,240,35,102,.343,31,77,.403,4,25,.160,24,32,.750,98
14379,2013-11-23,LAC,,SAC,W 103-102,240,33,68,.485,22,43,.512,11,25,.440,26,45,.578,103
14380,2013-11-23,SAC,@,LAC,L 102-103,240,37,88,.420,32,71,.451,5,17,.294,23,30,.767,102
14381,2013-11-23,MIA,,ORL,W 101-99,240,37,78,.474,31,53,.585,6,25,.240,21,26,.808,101
14382,2013-11-23,ORL,@,MIA,L 99-101,240,34,73,.466,24,50,.480,10,23,.435,21,29,.724,99
14383,2013-11-23,CHA,@,MIL,W 96-72,240,38,77,.494,33,63,.524,5,14,.357,15,27,.556,96
14384,2013-11-23,MIL,,CHA,L 72-96,240,30,85,.353,25,67,.373,5,18,.278,7,9,.778,72
14385,2013-11-23,CLE,@,SAS,L 96-126,240,39,83,.470,35,70,.500,4,13,.308,14,20,.700,96
14386,2013-11-23,SAS,,CLE,W 126-96,240,46,80,.575,30,56,.536,16,24,.667,18,23,.783,126
14387,2013-11-23,NYK,@,WAS,L 89-98,240,36,82,.439,25,53,.472,11,29,.379,6,15,.400,89
14388,2013-11-23,WAS,,NYK,W 98-89,240,37,76,.487,30,57,.526,7,19,.368,17,22,.773,98
14389,2013-11-22,BOS,,IND,L 82-97,240,35,69,.507,30,58,.517,5,11,.455,7,9,.778,82
14390,2013-11-22,IND,@,BOS,W 97-82,240,38,81,.469,32,64,.500,6,17,.353,15,18,.833,97
14391,2013-11-22,CHA,,PHO,L 91-98,240,32,77,.416,29,63,.460,3,14,.214,24,33,.727,91
14392,2013-11-22,PHO,@,CHA,W 98-91,240,33,70,.471,23,47,.489,10,23,.435,22,38,.579,98
14393,2013-11-22,DAL,,UTA,W 103-93,240,38,75,.507,31,58,.534,7,17,.412,20,27,.741,103
14394,2013-11-22,UTA,@,DAL,L 93-103,240,39,78,.500,32,58,.552,7,20,.350,8,12,.667,93
14395,2013-11-22,ATL,@,DET,W 96-89,240,37,85,.435,29,62,.468,8,23,.348,14,21,.667,96
14396,2013-11-22,DET,,ATL,L 89-96,240,36,84,.429,33,71,.465,3,13,.231,14,22,.636,89
14397,2013-11-22,GSW,@,LAL,L 95-102,240,34,82,.415,25,60,.417,9,22,.409,18,28,.643,95
14398,2013-11-22,LAL,,GSW,W 102-95,240,39,82,.476,28,58,.483,11,24,.458,13,17,.765,102
14399,2013-11-22,MEM,,SAS,L 86-102,240,35,80,.438,32,69,.464,3,11,.273,13,17,.765,86
14400,2013-11-22,SAS,@,MEM,W 102-86,240,42,79,.532,35,62,.565,7,17,.412,11,16,.688,102
14401,2013-11-22,BRK,@,MIN,L 81-111,240,31,78,.397,26,62,.419,5,16,.313,14,20,.700,81
14402,2013-11-22,MIN,,BRK,W 111-81,240,40,97,.412,29,61,.475,11,36,.306,20,23,.870,111
14403,2013-11-22,CLE,@,NOP,L 100-104,240,41,77,.532,33,54,.611,8,23,.348,10,16,.625,100
14404,2013-11-22,NOP,,CLE,W 104-100,240,36,88,.409,30,71,.423,6,17,.353,26,33,.788,104
14405,2013-11-22,MIL,@,PHI,L 107-115 (OT),265,41,93,.441,33,64,.516,8,29,.276,17,24,.708,107
14406,2013-11-22,PHI,,MIL,W 115-107 (OT),265,45,79,.570,38,59,.644,7,20,.350,18,29,.621,115
14407,2013-11-22,CHI,@,POR,L 95-98,240,32,83,.386,27,69,.391,5,14,.357,26,29,.897,95
14408,2013-11-22,POR,,CHI,W 98-95,240,36,88,.409,24,62,.387,12,26,.462,14,15,.933,98
14409,2013-11-22,TOR,,WAS,W 96-88,240,37,78,.474,32,60,.533,5,18,.278,17,23,.739,96
14410,2013-11-22,WAS,@,TOR,L 88-96,240,36,86,.419,30,69,.435,6,17,.353,10,13,.769,88
14411,2013-11-21,CHI,@,DEN,L 87-97,240,38,98,.388,35,88,.398,3,10,.300,8,14,.571,87
14412,2013-11-21,DEN,,CHI,W 97-87,240,38,84,.452,29,63,.460,9,21,.429,12,22,.545,97
14413,2013-11-21,LAC,@,OKC,L 91-105,240,38,92,.413,30,64,.469,8,28,.286,7,15,.467,91
14414,2013-11-21,OKC,,LAC,W 105-91,240,41,79,.519,37,60,.617,4,19,.211,19,29,.655,105
14415,2013-11-20,ATL,,DET,W 93-85,240,36,71,.507,32,56,.571,4,15,.267,17,24,.708,93
14416,2013-11-20,DET,@,ATL,L 85-93,240,35,87,.402,29,65,.446,6,22,.273,9,12,.750,85
14417,2013-11-20,BRK,@,CHA,L 91-95,240,32,67,.478,23,48,.479,9,19,.474,18,25,.720,91
14418,2013-11-20,CHA,,BRK,W 95-91,240,36,81,.444,31,68,.456,5,13,.385,18,30,.600,95
14419,2013-11-20,CLE,,WAS,L 91-98,240,32,77,.416,23,54,.426,9,23,.391,18,21,.857,91
14420,2013-11-20,WAS,@,CLE,W 98-91,240,38,84,.452,30,65,.462,8,19,.421,14,14,1.000,98
14421,2013-11-20,DAL,,HOU,W 123-120,240,42,72,.583,31,50,.620,11,22,.500,28,33,.848,123
14422,2013-11-20,HOU,@,DAL,L 120-123,240,42,76,.553,30,45,.667,12,31,.387,24,33,.727,120
14423,2013-11-20,GSW,,MEM,L 81-88 (OT),265,36,82,.439,31,64,.484,5,18,.278,4,8,.500,81
14424,2013-11-20,MEM,@,GSW,W 88-81 (OT),265,34,88,.386,31,76,.408,3,12,.250,17,19,.895,88
14425,2013-11-20,MIL,,POR,L 82-91,240,35,80,.438,30,66,.455,5,14,.357,7,12,.583,82
14426,2013-11-20,POR,@,MIL,W 91-82,240,35,86,.407,24,55,.436,11,31,.355,10,15,.667,91
14427,2013-11-20,LAC,@,MIN,W 102-98,240,40,81,.494,28,57,.491,12,24,.500,10,16,.625,102
14428,2013-11-20,MIN,,LAC,L 98-102,240,34,90,.378,29,68,.426,5,22,.227,25,31,.806,98
14429,2013-11-20,NOP,,UTA,W 105-98,240,40,79,.506,35,64,.547,5,15,.333,20,33,.606,105
14430,2013-11-20,UTA,@,NOP,L 98-105,240,37,83,.446,29,59,.492,8,24,.333,16,20,.800,98
14431,2013-11-20,IND,@,NYK,W 103-96 (OT),265,33,87,.379,24,57,.421,9,30,.300,28,36,.778,103
14432,2013-11-20,NYK,,IND,L 96-103 (OT),265,37,100,.370,29,70,.414,8,30,.267,14,17,.824,96
14433,2013-11-20,MIA,@,ORL,W 120-92,240,38,74,.514,23,50,.460,15,24,.625,29,32,.906,120
14434,2013-11-20,ORL,,MIA,L 92-120,240,29,71,.408,14,42,.333,15,29,.517,19,21,.905,92
14435,2013-11-20,PHI,,TOR,L 98-108,240,34,76,.447,27,56,.482,7,20,.350,23,31,.742,98
14436,2013-11-20,TOR,@,PHI,W 108-98,240,36,86,.419,22,57,.386,14,29,.483,22,28,.786,108
14437,2013-11-20,PHO,,SAC,L 106-113,240,38,85,.447,23,52,.442,15,33,.455,15,22,.682,106
14438,2013-11-20,SAC,@,PHO,W 113-106,240,37,80,.463,30,63,.476,7,17,.412,32,38,.842,113
14439,2013-11-20,BOS,@,SAS,L 93-104,240,39,86,.453,35,71,.493,4,15,.267,11,12,.917,93
14440,2013-11-20,SAS,,BOS,W 104-93,240,39,81,.481,31,60,.517,8,21,.381,18,24,.750,104
14441,2013-11-19,DET,,NYK,W 92-86,240,35,70,.500,28,51,.549,7,19,.368,15,21,.714,92
14442,2013-11-19,NYK,@,DET,L 86-92,240,33,76,.434,27,52,.519,6,24,.250,14,18,.778,86
14443,2013-11-19,BOS,@,HOU,L 85-109,240,32,99,.323,25,79,.316,7,20,.350,14,20,.700,85
14444,2013-11-19,HOU,,BOS,W 109-85,240,41,72,.569,32,51,.627,9,21,.429,18,24,.750,109
14445,2013-11-19,ATL,@,MIA,L 88-104,240,33,74,.446,22,50,.440,11,24,.458,11,15,.733,88
14446,2013-11-19,MIA,,ATL,W 104-88,240,41,81,.506,31,60,.517,10,21,.476,12,19,.632,104
14447,2013-11-19,PHO,@,SAC,L 104-107,240,37,79,.468,27,50,.540,10,29,.345,20,28,.714,104
14448,2013-11-19,SAC,,PHO,W 107-104,240,39,83,.470,31,61,.508,8,22,.364,21,28,.750,107
14449,2013-11-19,MIN,@,WAS,L 100-104,240,37,85,.435,27,57,.474,10,28,.357,16,24,.667,100
14450,2013-11-19,WAS,,MIN,W 104-100,240,41,85,.482,34,70,.486,7,15,.467,15,15,1.000,104
14451,2013-11-18,BRK,,POR,L 98-108,240,31,85,.365,28,72,.389,3,13,.231,33,35,.943,98
14452,2013-11-18,POR,@,BRK,W 108-98,240,41,76,.539,33,58,.569,8,18,.444,18,21,.857,108
14453,2013-11-18,CHA,@,CHI,L 81-86,240,33,91,.363,26,75,.347,7,16,.438,8,16,.500,81
14454,2013-11-18,CHI,,CHA,W 86-81,240,27,75,.360,21,63,.333,6,12,.500,26,31,.839,86
14455,2013-11-18,DAL,,PHI,W 97-94,240,34,78,.436,25,49,.510,9,29,.310,20,26,.769,97
14456,2013-11-18,PHI,@,DAL,L 94-97,240,38,99,.384,32,78,.410,6,21,.286,12,22,.545,94
14457,2013-11-18,LAC,,MEM,L 102-106,240,34,86,.395,27,63,.429,7,23,.304,27,32,.844,102
14458,2013-11-18,MEM,@,LAC,W 106-102,240,39,81,.481,34,69,.493,5,12,.417,23,30,.767,106
14459,2013-11-18,DEN,@,OKC,L 113-115,240,40,83,.482,32,60,.533,8,23,.348,25,43,.581,113
14460,2013-11-18,OKC,,DEN,W 115-113,240,38,93,.409,25,66,.379,13,27,.481,26,32,.813,115
14461,2013-11-18,GSW,@,UTA,W 98-87,240,32,79,.405,20,57,.351,12,22,.545,22,30,.733,98
14462,2013-11-18,UTA,,GSW,L 87-98,240,32,81,.395,25,66,.379,7,15,.467,16,19,.842,87
14463,2013-11-17,DET,@,LAL,L 99-114,240,42,87,.483,34,64,.531,8,23,.348,7,17,.412,99
14464,2013-11-17,LAL,,DET,W 114-99,240,47,90,.522,37,65,.569,10,25,.400,10,10,1.000,114
14465,2013-11-17,MEM,@,SAC,W 97-86,240,40,72,.556,36,59,.610,4,13,.308,13,18,.722,97
14466,2013-11-17,SAC,,MEM,L 86-97,240,33,87,.379,26,64,.406,7,23,.304,13,17,.765,86
14467,2013-11-17,POR,@,TOR,W 118-110 (OT),265,44,99,.444,29,67,.433,15,32,.469,15,20,.750,118
14468,2013-11-17,TOR,,POR,L 110-118 (OT),265,42,94,.447,39,77,.506,3,17,.176,23,31,.742,110
14469,2013-11-16,CHA,,MIA,L 81-97,240,29,83,.349,21,56,.375,8,27,.296,15,20,.750,81
14470,2013-11-16,MIA,@,CHA,W 97-81,240,35,69,.507,29,54,.537,6,15,.400,21,23,.913,97
14471,2013-11-16,CHI,,IND,W 110-94,240,40,79,.506,29,60,.483,11,19,.579,19,24,.792,110
14472,2013-11-16,IND,@,CHI,L 94-110,240,34,85,.400,30,69,.435,4,16,.250,22,28,.786,94
14473,2013-11-16,GSW,,UTA,W 102-88,240,41,80,.513,32,59,.542,9,21,.429,11,14,.786,102
14474,2013-11-16,UTA,@,GSW,L 88-102,240,35,77,.455,27,60,.450,8,17,.471,10,16,.625,88
14475,2013-11-16,DEN,@,HOU,L 111-122,240,45,99,.455,37,75,.493,8,24,.333,13,18,.722,111
14476,2013-11-16,HOU,,DEN,W 122-111,240,41,81,.506,32,60,.533,9,21,.429,31,44,.705,122
14477,2013-11-16,BRK,@,LAC,L 103-110,240,36,85,.424,27,62,.435,9,23,.391,22,33,.667,103
14478,2013-11-16,LAC,,BRK,W 110-103,240,40,77,.519,30,54,.556,10,23,.435,20,30,.667,110
14479,2013-11-16,MIL,,OKC,L 79-92,240,30,86,.349,22,64,.344,8,22,.364,11,15,.733,79
14480,2013-11-16,OKC,@,MIL,W 92-79,240,34,82,.415,29,65,.446,5,17,.294,19,27,.704,92
14481,2013-11-16,BOS,@,MIN,L 88-106,240,34,86,.395,29,68,.426,5,18,.278,15,18,.833,88
14482,2013-11-16,MIN,,BOS,W 106-88,240,40,94,.426,33,71,.465,7,23,.304,19,22,.864,106
14483,2013-11-16,NOP,,PHI,W 135-98,240,52,86,.605,39,58,.672,13,28,.464,18,27,.667,135
14484,2013-11-16,PHI,@,NOP,L 98-135,240,35,83,.422,29,64,.453,6,19,.316,22,31,.710,98
14485,2013-11-16,ATL,@,NYK,W 110-90,240,44,78,.564,35,56,.625,9,22,.409,13,17,.765,110
14486,2013-11-16,NYK,,ATL,L 90-110,240,34,90,.378,24,60,.400,10,30,.333,12,16,.750,90
14487,2013-11-16,DAL,@,ORL,W 108-100,240,43,84,.512,33,57,.579,10,27,.370,12,18,.667,108
14488,2013-11-16,ORL,,DAL,L 100-108,240,37,70,.529,33,55,.600,4,15,.267,22,28,.786,100
14489,2013-11-16,CLE,@,WAS,W 103-96 (OT),265,36,81,.444,26,60,.433,10,21,.476,21,22,.955,103
14490,2013-11-16,WAS,,CLE,L 96-103 (OT),265,37,93,.398,31,68,.456,6,25,.240,16,22,.727,96
14491,2013-11-15,ATL,,PHI,W 113-103,240,39,81,.481,29,58,.500,10,23,.435,25,31,.806,113
14492,2013-11-15,PHI,@,ATL,L 103-113,240,40,86,.465,35,67,.522,5,19,.263,18,23,.783,103
14493,2013-11-15,BOS,,POR,L 96-109,240,37,81,.457,30,63,.476,7,18,.389,15,19,.789,96
14494,2013-11-15,POR,@,BOS,W 109-96,240,40,82,.488,31,56,.554,9,26,.346,20,22,.909,109
14495,2013-11-15,CHA,@,CLE,W 86-80,240,32,80,.400,24,60,.400,8,20,.400,14,20,.700,86
14496,2013-11-15,CLE,,CHA,L 80-86,240,32,79,.405,28,64,.438,4,15,.267,12,17,.706,80
14497,2013-11-15,DEN,,MIN,W 117-113,240,47,97,.485,40,77,.519,7,20,.350,16,21,.762,117
14498,2013-11-15,MIN,@,DEN,L 113-117,240,46,94,.489,40,72,.556,6,22,.273,15,19,.789,113
14499,2013-11-15,IND,,MIL,W 104-77,240,40,79,.506,35,63,.556,5,16,.313,19,21,.905,104
14500,2013-11-15,MIL,@,IND,L 77-104,240,30,88,.341,22,72,.306,8,16,.500,9,11,.818,77
14501,2013-11-15,LAL,,MEM,L 86-89,240,35,80,.438,25,56,.446,10,24,.417,6,11,.545,86
14502,2013-11-15,MEM,@,LAL,W 89-86,240,37,85,.435,36,72,.500,1,13,.077,14,14,1.000,89
14503,2013-11-15,DAL,@,MIA,L 104-110,240,37,74,.500,25,46,.543,12,28,.429,18,21,.857,104
14504,2013-11-15,MIA,,DAL,W 110-104,240,40,74,.541,35,61,.574,5,13,.385,25,30,.833,110
14505,2013-11-15,BRK,@,PHO,W 100-98 (OT),265,38,87,.437,36,75,.480,2,12,.167,22,29,.759,100
14506,2013-11-15,PHO,,BRK,L 98-100 (OT),265,34,79,.430,24,51,.471,10,28,.357,20,25,.800,98
14507,2013-11-15,DET,@,SAC,W 97-90,240,38,85,.447,32,62,.516,6,23,.261,15,24,.625,97
14508,2013-11-15,SAC,,DET,L 90-97,240,34,80,.425,24,55,.436,10,25,.400,12,17,.706,90
14509,2013-11-15,CHI,@,TOR,W 96-80,240,36,80,.450,29,64,.453,7,16,.438,17,19,.895,96
14510,2013-11-15,TOR,,CHI,L 80-96,240,29,82,.354,24,61,.393,5,21,.238,17,22,.773,80
14511,2013-11-15,SAS,@,UTA,W 91-82,240,35,76,.461,31,61,.508,4,15,.267,17,22,.773,91
14512,2013-11-15,UTA,,SAS,L 82-91,240,35,91,.385,30,75,.400,5,16,.313,7,11,.636,82
14513,2013-11-14,GSW,,OKC,W 116-115,240,45,94,.479,31,71,.437,14,23,.609,12,14,.857,116
14514,2013-11-14,OKC,@,GSW,L 115-116,240,41,80,.513,32,58,.552,9,22,.409,24,28,.857,115
14515,2013-11-14,HOU,@,NYK,W 109-106,240,31,68,.456,22,40,.550,9,28,.321,38,44,.864,109
14516,2013-11-14,NYK,,HOU,L 106-109,240,38,87,.437,30,67,.448,8,20,.400,22,27,.815,106
14517,2013-11-13,ATL,,NYK,L 91-95,240,35,77,.455,30,53,.566,5,24,.208,16,21,.762,91
14518,2013-11-13,NYK,@,ATL,W 95-91,240,37,88,.420,25,54,.463,12,34,.353,9,13,.692,95
14519,2013-11-13,BOS,,CHA,L 83-89,240,29,77,.377,22,56,.393,7,21,.333,18,25,.720,83
14520,2013-11-13,CHA,@,BOS,W 89-83,240,30,82,.366,27,70,.386,3,12,.250,26,30,.867,89
14521,2013-11-13,DEN,,LAL,W 111-99,240,40,100,.400,34,79,.430,6,21,.286,25,37,.676,111
14522,2013-11-13,LAL,@,DEN,L 99-111,240,37,94,.394,29,73,.397,8,21,.381,17,26,.654,99
14523,2013-11-13,LAC,,OKC,W 111-103,240,39,86,.453,33,58,.569,6,28,.214,27,34,.794,111
14524,2013-11-13,OKC,@,LAC,L 103-111,240,35,75,.467,29,59,.492,6,16,.375,27,33,.818,103
14525,2013-11-13,MEM,,TOR,L 87-103,240,35,82,.427,29,61,.475,6,21,.286,11,17,.647,87
14526,2013-11-13,TOR,@,MEM,W 103-87,240,31,67,.463,23,52,.442,8,15,.533,33,39,.846,103
14527,2013-11-13,CLE,@,MIN,L 95-124,240,36,87,.414,31,71,.437,5,16,.313,18,21,.857,95
14528,2013-11-13,MIN,,CLE,W 124-95,240,45,82,.549,34,60,.567,11,22,.500,23,26,.885,124
14529,2013-11-13,MIL,@,ORL,L 91-94,240,33,74,.446,28,61,.459,5,13,.385,20,22,.909,91
14530,2013-11-13,ORL,,MIL,W 94-91,240,35,82,.427,26,56,.464,9,26,.346,15,21,.714,94
14531,2013-11-13,HOU,@,PHI,L 117-123 (OT),265,43,96,.448,28,55,.509,15,41,.366,16,25,.640,117
14532,2013-11-13,PHI,,HOU,W 123-117 (OT),265,43,103,.417,32,78,.410,11,25,.440,26,34,.765,123
14533,2013-11-13,PHO,@,POR,L 89-90,240,37,86,.430,32,71,.451,5,15,.333,10,13,.769,89
14534,2013-11-13,POR,,PHO,W 90-89,240,35,84,.417,29,69,.420,6,15,.400,14,23,.609,90
14535,2013-11-13,BRK,@,SAC,L 86-107,240,31,82,.378,28,69,.406,3,13,.231,21,27,.778,86
14536,2013-11-13,SAC,,BRK,W 107-86,240,41,94,.436,33,70,.471,8,24,.333,17,23,.739,107
14537,2013-11-13,SAS,,WAS,W 92-79,240,39,77,.506,31,55,.564,8,22,.364,6,8,.750,92
14538,2013-11-13,WAS,@,SAS,L 79-92,240,33,91,.363,28,76,.368,5,15,.333,8,11,.727,79
14539,2013-11-13,NOP,@,UTA,L 105-111,240,42,85,.494,37,73,.507,5,12,.417,16,20,.800,105
14540,2013-11-13,UTA,,NOP,W 111-105,240,37,72,.514,28,50,.560,9,22,.409,28,39,.718,111
14541,2013-11-12,DAL,,WAS,W 105-95,240,41,84,.488,31,58,.534,10,26,.385,13,19,.684,105
14542,2013-11-12,WAS,@,DAL,L 95-105,240,33,75,.440,24,49,.490,9,26,.346,20,29,.690,95
14543,2013-11-12,DET,@,GSW,L 95-113,240,37,87,.425,34,69,.493,3,18,.167,18,27,.667,95
14544,2013-11-12,GSW,,DET,W 113-95,240,42,70,.600,34,54,.630,8,16,.500,21,26,.808,113
14545,2013-11-12,LAL,,NOP,W 116-95,240,44,79,.557,33,59,.559,11,20,.550,17,21,.810,116
14546,2013-11-12,NOP,@,LAL,L 95-116,240,34,84,.405,31,74,.419,3,10,.300,24,33,.727,95
14547,2013-11-12,MIA,,MIL,W 118-95,240,46,79,.582,34,56,.607,12,23,.522,14,24,.583,118
14548,2013-11-12,MIL,@,MIA,L 95-118,240,33,79,.418,22,49,.449,11,30,.367,18,21,.857,95
14549,2013-11-11,BOS,,ORL,W 120-105,240,51,85,.600,46,73,.630,5,12,.417,13,15,.867,120
14550,2013-11-11,ORL,@,BOS,L 105-120,240,39,85,.459,32,67,.478,7,18,.389,20,23,.870,105
14551,2013-11-11,ATL,@,CHA,W 103-94,240,35,76,.461,25,49,.510,10,27,.370,23,28,.821,103
14552,2013-11-11,CHA,,ATL,L 94-103,240,33,81,.407,28,68,.412,5,13,.385,23,29,.793,94
14553,2013-11-11,CHI,,CLE,W 96-81,240,34,83,.410,30,67,.448,4,16,.250,24,26,.923,96
14554,2013-11-11,CLE,@,CHI,L 81-96,240,31,75,.413,26,61,.426,5,14,.357,14,20,.700,81
14555,2013-11-11,HOU,,TOR,W 110-104 (2OT),290,37,84,.440,30,58,.517,7,26,.269,29,47,.617,110
14556,2013-11-11,TOR,@,HOU,L 104-110 (2OT),290,38,114,.333,30,89,.337,8,25,.320,20,27,.741,104
14557,2013-11-11,IND,,MEM,W 95-79,240,37,76,.487,31,57,.544,6,19,.316,15,18,.833,95
14558,2013-11-11,MEM,@,IND,L 79-95,240,31,75,.413,27,67,.403,4,8,.500,13,19,.684,79
14559,2013-11-11,LAC,,MIN,W 109-107,240,44,80,.550,40,64,.625,4,16,.250,17,28,.607,109
14560,2013-11-11,MIN,@,LAC,L 107-109,240,40,96,.417,29,67,.433,11,29,.379,16,18,.889,107
14561,2013-11-11,PHI,,SAS,L 85-109,240,34,82,.415,29,63,.460,5,19,.263,12,16,.750,85
14562,2013-11-11,SAS,@,PHI,W 109-85,240,44,89,.494,31,61,.508,13,28,.464,8,11,.727,109
14563,2013-11-11,DET,@,POR,L 103-109,240,42,91,.462,39,77,.506,3,14,.214,16,21,.762,103
14564,2013-11-11,POR,,DET,W 109-103,240,42,82,.512,31,59,.525,11,23,.478,14,15,.933,109
14565,2013-11-11,DEN,@,UTA,W 100-81,240,36,80,.450,31,63,.492,5,17,.294,23,27,.852,100
14566,2013-11-11,UTA,,DEN,L 81-100,240,31,77,.403,28,60,.467,3,17,.176,16,23,.696,81
14567,2013-11-10,LAL,,MIN,L 90-113,240,35,92,.380,25,66,.379,10,26,.385,10,18,.556,90
14568,2013-11-10,MIN,@,LAL,W 113-90,240,44,90,.489,34,70,.486,10,20,.500,15,19,.789,113
14569,2013-11-10,NYK,,SAS,L 89-120,240,31,82,.378,25,60,.417,6,22,.273,21,29,.724,89
14570,2013-11-10,SAS,@,NYK,W 120-89,240,41,76,.539,29,48,.604,12,28,.429,26,30,.867,120
14571,2013-11-10,OKC,,WAS,W 106-105 (OT),265,41,92,.446,35,72,.486,6,20,.300,18,22,.818,106
14572,2013-11-10,WAS,@,OKC,L 105-106 (OT),265,40,88,.455,28,59,.475,12,29,.414,13,26,.500,105
14573,2013-11-10,NOP,@,PHO,L 94-101,240,39,88,.443,35,75,.467,4,13,.308,12,13,.923,94
14574,2013-11-10,PHO,,NOP,W 101-94,240,38,78,.487,31,56,.554,7,22,.318,18,23,.783,101
14575,2013-11-09,ATL,,ORL,W 104-94,240,43,90,.478,37,71,.521,6,19,.316,12,17,.706,104
14576,2013-11-09,ORL,@,ATL,L 94-104,240,38,82,.463,30,65,.462,8,17,.471,10,18,.556,94
14577,2013-11-09,BRK,,IND,L 91-96,240,35,76,.461,27,57,.474,8,19,.421,13,16,.813,91
14578,2013-11-09,IND,@,BRK,W 96-91,240,37,80,.463,30,66,.455,7,14,.500,15,20,.750,96
14579,2013-11-09,CLE,,PHI,W 127-125 (2OT),290,46,102,.451,33,71,.465,13,31,.419,22,29,.759,127
14580,2013-11-09,PHI,@,CLE,L 125-127 (2OT),290,47,99,.475,36,72,.500,11,27,.407,20,23,.870,125
14581,2013-11-09,HOU,,LAC,L 94-107,240,35,78,.449,28,52,.538,7,26,.269,17,27,.630,94
14582,2013-11-09,LAC,@,HOU,W 107-94,240,42,88,.477,33,64,.516,9,24,.375,14,23,.609,107
14583,2013-11-09,GSW,@,MEM,L 90-108,240,33,78,.423,23,48,.479,10,30,.333,14,26,.538,90
14584,2013-11-09,MEM,,GSW,W 108-90,240,42,79,.532,37,66,.561,5,13,.385,19,25,.760,108
14585,2013-11-09,BOS,@,MIA,W 111-110,240,46,89,.517,36,68,.529,10,21,.476,9,12,.750,111
14586,2013-11-09,MIA,,BOS,L 110-111,240,41,71,.577,36,61,.590,5,10,.500,23,34,.676,110
14587,2013-11-09,DAL,@,MIL,W 91-83,240,33,78,.423,27,59,.458,6,19,.316,19,21,.905,91
14588,2013-11-09,MIL,,DAL,L 83-91,240,31,81,.383,20,58,.345,11,23,.478,10,16,.625,83
14589,2013-11-09,POR,@,SAC,W 96-85,240,36,82,.439,27,62,.435,9,20,.450,15,22,.682,96
14590,2013-11-09,SAC,,POR,L 85-96,240,36,78,.462,33,66,.500,3,12,.250,10,14,.714,85
14591,2013-11-09,TOR,,UTA,W 115-91,240,40,83,.482,30,58,.517,10,25,.400,25,29,.862,115
14592,2013-11-09,UTA,@,TOR,L 91-115,240,34,77,.442,31,59,.525,3,18,.167,20,24,.833,91
14593,2013-11-08,CHA,,NYK,L 91-101,240,31,76,.408,27,60,.450,4,16,.250,25,30,.833,91
14594,2013-11-08,NYK,@,CHA,W 101-91,240,42,90,.467,30,64,.469,12,26,.462,5,9,.556,101
14595,2013-11-08,CHI,,UTA,W 97-73,240,38,72,.528,35,64,.547,3,8,.375,18,25,.720,97
14596,2013-11-08,UTA,@,CHI,L 73-97,240,25,85,.294,18,65,.277,7,20,.350,16,25,.640,73
14597,2013-11-08,DET,,OKC,L 110-119,240,39,91,.429,28,60,.467,11,31,.355,21,27,.778,110
14598,2013-11-08,OKC,@,DET,W 119-110,240,37,82,.451,31,65,.477,6,17,.353,39,44,.886,119
14599,2013-11-08,IND,,TOR,W 91-84,240,36,78,.462,30,57,.526,6,21,.286,13,16,.813,91
14600,2013-11-08,TOR,@,IND,L 84-91,240,32,81,.395,26,63,.413,6,18,.333,14,16,.875,84
14601,2013-11-08,DAL,@,MIN,L 108-116,240,44,90,.489,34,68,.500,10,22,.455,10,15,.667,108
14602,2013-11-08,MIN,,DAL,W 116-108,240,41,89,.461,33,69,.478,8,20,.400,26,30,.867,116
14603,2013-11-08,LAL,@,NOP,L 85-96,240,31,80,.388,25,61,.410,6,19,.316,17,26,.654,85
14604,2013-11-08,NOP,,LAL,W 96-85,240,38,87,.437,35,78,.449,3,9,.333,17,22,.773,96
14605,2013-11-08,BOS,@,ORL,W 91-89,240,34,95,.358,32,81,.395,2,14,.143,21,26,.808,91
14606,2013-11-08,ORL,,BOS,L 89-91,240,33,83,.398,29,63,.460,4,20,.200,19,29,.655,89
14607,2013-11-08,CLE,@,PHI,L 79-94,240,30,90,.333,21,64,.328,9,26,.346,10,14,.714,79
14608,2013-11-08,PHI,,CLE,W 94-79,240,40,84,.476,33,63,.524,7,21,.333,7,9,.778,94
14609,2013-11-08,DEN,@,PHO,L 103-114,240,36,80,.450,28,58,.483,8,22,.364,23,28,.821,103
14610,2013-11-08,PHO,,DEN,W 114-103,240,40,83,.482,31,63,.492,9,20,.450,25,32,.781,114
14611,2013-11-08,POR,,SAC,W 104-91,240,39,80,.488,29,57,.509,10,23,.435,16,18,.889,104
14612,2013-11-08,SAC,@,POR,L 91-104,240,36,86,.419,30,64,.469,6,22,.273,13,15,.867,91
14613,2013-11-08,GSW,@,SAS,L 74-76,240,29,71,.408,21,51,.412,8,20,.400,8,10,.800,74
14614,2013-11-08,SAS,,GSW,W 76-74,240,31,79,.392,26,60,.433,5,19,.263,9,18,.500,76
14615,2013-11-08,BRK,@,WAS,L 108-112 (OT),265,41,88,.466,35,64,.547,6,24,.250,20,29,.690,108
14616,2013-11-08,WAS,,BRK,W 112-108 (OT),265,41,88,.466,31,64,.484,10,24,.417,20,26,.769,112
14617,2013-11-07,ATL,@,DEN,L 107-109,240,43,94,.457,35,68,.515,8,26,.308,13,19,.684,107
14618,2013-11-07,DEN,,ATL,W 109-107,240,42,86,.488,28,61,.459,14,25,.560,11,17,.647,109
14619,2013-11-07,HOU,,LAL,L 98-99,240,29,77,.377,22,50,.440,7,27,.259,33,52,.635,98
14620,2013-11-07,LAL,@,HOU,W 99-98,240,36,92,.391,20,57,.351,16,35,.457,11,15,.733,99
14621,2013-11-07,LAC,@,MIA,L 97-102,240,36,73,.493,28,49,.571,8,24,.333,17,21,.810,97
14622,2013-11-07,MIA,,LAC,W 102-97,240,38,71,.535,33,55,.600,5,16,.313,21,33,.636,102
14623,2013-11-06,BOS,,UTA,W 97-87,240,40,89,.449,33,69,.478,7,20,.350,10,14,.714,97
14624,2013-11-06,UTA,@,BOS,L 87-97,240,37,80,.463,36,70,.514,1,10,.100,12,18,.667,87
14625,2013-11-06,CHA,,TOR,W 92-90,240,36,73,.493,33,58,.569,3,15,.200,17,30,.567,92
14626,2013-11-06,TOR,@,CHA,L 90-92,240,35,79,.443,28,63,.444,7,16,.438,13,15,.867,90
14627,2013-11-06,CHI,@,IND,L 80-97,240,26,73,.356,21,58,.362,5,15,.333,23,27,.852,80
14628,2013-11-06,IND,,CHI,W 97-80,240,36,86,.419,29,68,.426,7,18,.389,18,21,.857,97
14629,2013-11-06,MEM,,NOP,L 84-99,240,34,71,.479,30,56,.536,4,15,.267,12,14,.857,84
14630,2013-11-06,NOP,@,MEM,W 99-84,240,38,78,.487,34,65,.523,4,13,.308,19,21,.905,99
14631,2013-11-06,CLE,@,MIL,L 104-109,240,38,85,.447,26,57,.456,12,28,.429,16,22,.727,104
14632,2013-11-06,MIL,,CLE,W 109-104,240,36,72,.500,23,49,.469,13,23,.565,24,26,.923,109
14633,2013-11-06,GSW,@,MIN,W 106-93,240,42,84,.500,34,64,.531,8,20,.400,14,20,.700,106
14634,2013-11-06,MIN,,GSW,L 93-106,240,34,90,.378,30,74,.405,4,16,.250,21,27,.778,93
14635,2013-11-06,DAL,@,OKC,L 93-107,240,36,85,.424,27,62,.435,9,23,.391,12,14,.857,93
14636,2013-11-06,OKC,,DAL,W 107-93,240,43,79,.544,38,66,.576,5,13,.385,16,23,.696,107
14637,2013-11-06,LAC,@,ORL,L 90-98,240,36,95,.379,33,76,.434,3,19,.158,15,21,.714,90
14638,2013-11-06,ORL,,LAC,W 98-90,240,40,82,.488,35,66,.530,5,16,.313,13,17,.765,98
14639,2013-11-06,PHI,,WAS,L 102-116,240,39,83,.470,33,65,.508,6,18,.333,18,26,.692,102
14640,2013-11-06,WAS,@,PHI,W 116-102,240,43,98,.439,25,65,.385,18,33,.545,12,16,.750,116
14641,2013-11-06,PHO,@,SAS,L 96-99,240,42,85,.494,35,66,.530,7,19,.368,5,9,.556,96
14642,2013-11-06,SAS,,PHO,W 99-96,240,41,85,.482,35,69,.507,6,16,.375,11,15,.733,99
14643,2013-11-05,BRK,,UTA,W 104-88,240,40,78,.513,36,67,.537,4,11,.364,20,32,.625,104
14644,2013-11-05,UTA,@,BRK,L 88-104,240,31,82,.378,27,64,.422,4,18,.222,22,30,.733,88
14645,2013-11-05,DAL,,LAL,W 123-104,240,49,94,.521,36,67,.537,13,27,.481,12,14,.857,123
14646,2013-11-05,LAL,@,DAL,L 104-123,240,39,88,.443,27,57,.474,12,31,.387,14,20,.700,104
14647,2013-11-05,DEN,,SAS,L 94-102,240,35,83,.422,26,64,.406,9,19,.474,15,20,.750,94
14648,2013-11-05,SAS,@,DEN,W 102-94,240,40,86,.465,36,70,.514,4,16,.250,18,20,.900,102
14649,2013-11-05,DET,,IND,L 91-99,240,33,87,.379,28,62,.452,5,25,.200,20,25,.800,91
14650,2013-11-05,IND,@,DET,W 99-91,240,38,73,.521,29,52,.558,9,21,.429,14,23,.609,99
14651,2013-11-05,NOP,,PHO,L 98-104,240,37,85,.435,27,67,.403,10,18,.556,14,19,.737,98
14652,2013-11-05,PHO,@,NOP,W 104-98,240,39,78,.500,27,53,.509,12,25,.480,14,22,.636,104
14653,2013-11-05,CHA,@,NYK,W 102-97,240,30,71,.423,22,50,.440,8,21,.381,34,42,.810,102
14654,2013-11-05,NYK,,CHA,L 97-102,240,35,82,.427,27,54,.500,8,28,.286,19,23,.826,97
14655,2013-11-05,HOU,@,POR,W 116-101,240,41,75,.547,35,53,.660,6,22,.273,28,34,.824,116
14656,2013-11-05,POR,,HOU,L 101-116,240,36,87,.414,26,56,.464,10,31,.323,19,29,.655,101
14657,2013-11-05,ATL,@,SAC,W 105-100,240,39,81,.481,31,59,.525,8,22,.364,19,26,.731,105
14658,2013-11-05,SAC,,ATL,L 100-105,240,35,80,.438,25,49,.510,10,31,.323,20,21,.952,100
14659,2013-11-05,MIA,@,TOR,W 104-95,240,41,83,.494,31,60,.517,10,23,.435,12,14,.857,104
14660,2013-11-05,TOR,,MIA,L 95-104,240,31,72,.431,25,51,.490,6,21,.286,27,33,.818,95
14661,2013-11-04,CLE,,MIN,W 93-92,240,39,85,.459,34,69,.493,5,16,.313,10,11,.909,93
14662,2013-11-04,MIN,@,CLE,L 92-93,240,34,94,.362,29,66,.439,5,28,.179,19,24,.792,92
14663,2013-11-04,HOU,@,LAC,L 118-137,240,41,82,.500,34,57,.596,7,25,.280,29,43,.674,118
14664,2013-11-04,LAC,,HOU,W 137-118,240,49,94,.521,34,56,.607,15,38,.395,24,28,.857,137
14665,2013-11-04,BOS,@,MEM,L 88-95,240,33,70,.471,26,50,.520,7,20,.350,15,18,.833,88
14666,2013-11-04,MEM,,BOS,W 95-88,240,36,74,.486,31,59,.525,5,15,.333,18,22,.818,95
14667,2013-11-04,GSW,@,PHI,W 110-90,240,41,92,.446,26,54,.481,15,38,.395,13,20,.650,110
14668,2013-11-04,PHI,,GSW,L 90-110,240,31,88,.352,26,63,.413,5,25,.200,23,37,.622,90
14669,2013-11-03,BOS,@,DET,L 77-87,240,31,74,.419,28,58,.483,3,16,.188,12,12,1.000,77
14670,2013-11-03,DET,,BOS,W 87-77,240,34,76,.447,32,63,.508,2,13,.154,17,29,.586,87
14671,2013-11-03,ATL,@,LAL,L 103-105,240,40,90,.444,31,68,.456,9,22,.409,14,26,.538,103
14672,2013-11-03,LAL,,ATL,W 105-103,240,38,89,.427,29,64,.453,9,25,.360,20,24,.833,105
14673,2013-11-03,MIA,,WAS,W 103-93,240,37,70,.529,26,43,.605,11,27,.407,18,27,.667,103
14674,2013-11-03,WAS,@,MIA,L 93-103,240,35,82,.427,23,52,.442,12,30,.400,11,16,.688,93
14675,2013-11-03,MIN,@,NYK,W 109-100,240,35,79,.443,25,52,.481,10,27,.370,29,38,.763,109
14676,2013-11-03,NYK,,MIN,L 100-109,240,40,89,.449,31,57,.544,9,32,.281,11,13,.846,100
14677,2013-11-03,OKC,,PHO,W 103-96,240,35,82,.427,33,64,.516,2,18,.111,31,37,.838,103
14678,2013-11-03,PHO,@,OKC,L 96-103,240,32,80,.400,18,43,.419,14,37,.378,18,22,.818,96
14679,2013-11-03,BRK,@,ORL,L 86-107,240,34,89,.382,30,72,.417,4,17,.235,14,15,.933,86
14680,2013-11-03,ORL,,BRK,W 107-86,240,42,89,.472,35,72,.486,7,17,.412,16,22,.727,107
14681,2013-11-02,DAL,,MEM,W 111-99,240,32,80,.400,25,61,.410,7,19,.368,40,46,.870,111
14682,2013-11-02,MEM,@,DAL,L 99-111,240,37,87,.425,34,71,.479,3,16,.188,22,26,.846,99
14683,2013-11-02,GSW,,SAC,W 98-87,240,39,76,.513,28,49,.571,11,27,.407,9,12,.750,98
14684,2013-11-02,SAC,@,GSW,L 87-98,240,30,87,.345,24,61,.393,6,26,.231,21,24,.875,87
14685,2013-11-02,CLE,@,IND,L 74-89,240,29,83,.349,26,68,.382,3,15,.200,13,15,.867,74
14686,2013-11-02,IND,,CLE,W 89-74,240,32,77,.416,22,49,.449,10,28,.357,15,20,.750,89
14687,2013-11-02,MIL,,TOR,L 90-97,240,37,84,.440,31,67,.463,6,17,.353,10,18,.556,90
14688,2013-11-02,TOR,@,MIL,W 97-90,240,31,78,.397,24,55,.436,7,23,.304,28,38,.737,97
14689,2013-11-02,CHA,@,NOP,L 84-105,240,30,80,.375,27,59,.458,3,21,.143,21,36,.583,84
14690,2013-11-02,NOP,,CHA,W 105-84,240,37,75,.493,30,62,.484,7,13,.538,24,28,.857,105
14691,2013-11-02,CHI,@,PHI,L 104-107,240,42,93,.452,39,79,.494,3,14,.214,17,19,.895,104
14692,2013-11-02,PHI,,CHI,W 107-104,240,42,86,.488,31,64,.484,11,22,.500,12,18,.667,107
14693,2013-11-02,POR,,SAS,W 115-105,240,45,81,.556,37,61,.607,8,20,.400,17,19,.895,115
14694,2013-11-02,SAS,@,POR,L 105-115,240,47,94,.500,41,82,.500,6,12,.500,5,8,.625,105
14695,2013-11-02,HOU,@,UTA,W 104-93,240,34,67,.507,25,45,.556,9,22,.409,27,35,.771,104
14696,2013-11-02,UTA,,HOU,L 93-104,240,34,81,.420,30,59,.508,4,22,.182,21,27,.778,93
14697,2013-11-01,ATL,,TOR,W 102-95,240,36,77,.468,26,54,.481,10,23,.435,20,31,.645,102
14698,2013-11-01,TOR,@,ATL,L 95-102,240,40,88,.455,33,65,.508,7,23,.304,8,14,.571,95
14699,2013-11-01,BOS,,MIL,L 98-105,240,34,76,.447,30,60,.500,4,16,.250,26,38,.684,98
14700,2013-11-01,MIL,@,BOS,W 105-98,240,35,84,.417,29,69,.420,6,15,.400,29,34,.853,105
14701,2013-11-01,BRK,,MIA,W 101-100,240,33,68,.485,25,52,.481,8,16,.500,27,39,.692,101
14702,2013-11-01,MIA,@,BRK,L 100-101,240,32,67,.478,25,53,.472,7,14,.500,29,36,.806,100
14703,2013-11-01,CHA,,CLE,W 90-84,240,33,73,.452,30,61,.492,3,12,.250,21,34,.618,90
14704,2013-11-01,CLE,@,CHA,L 84-90,240,32,84,.381,28,66,.424,4,18,.222,16,22,.727,84
14705,2013-11-01,DEN,,POR,L 98-113,240,36,99,.364,30,81,.370,6,18,.333,20,34,.588,98
14706,2013-11-01,POR,@,DEN,W 113-98,240,44,103,.427,30,81,.370,14,22,.636,11,15,.733,113
14707,2013-11-01,DAL,@,HOU,L 105-113,240,38,100,.380,29,73,.397,9,27,.333,20,25,.800,105
14708,2013-11-01,HOU,,DAL,W 113-105,240,34,73,.466,23,44,.523,11,29,.379,34,51,.667,113
14709,2013-11-01,LAL,,SAS,L 85-91,240,30,82,.366,22,55,.400,8,27,.296,17,24,.708,85
14710,2013-11-01,SAS,@,LAL,W 91-85,240,38,94,.404,33,73,.452,5,21,.238,10,14,.714,91
14711,2013-11-01,DET,@,MEM,L 108-111 (OT),265,42,89,.472,35,68,.515,7,21,.333,17,24,.708,108
14712,2013-11-01,MEM,,DET,W 111-108 (OT),265,40,77,.519,34,59,.576,6,18,.333,25,30,.833,111
14713,2013-11-01,MIN,,OKC,W 100-81,240,33,77,.429,25,57,.439,8,20,.400,26,33,.788,100
14714,2013-11-01,OKC,@,MIN,L 81-100,240,29,83,.349,22,52,.423,7,31,.226,16,19,.842,81
14715,2013-11-01,NOP,@,ORL,L 90-110,240,32,92,.348,26,80,.325,6,12,.500,20,26,.769,90
14716,2013-11-01,ORL,,NOP,W 110-90,240,39,70,.557,28,48,.583,11,22,.500,21,27,.778,110
14717,2013-11-01,PHO,,UTA,W 87-84,240,31,83,.373,25,61,.410,6,22,.273,19,24,.792,87
14718,2013-11-01,UTA,@,PHO,L 84-87,240,31,85,.365,26,68,.382,5,17,.294,17,27,.630,84
14719,2013-11-01,LAC,@,SAC,W 110-101,240,35,70,.500,23,46,.500,12,24,.500,28,34,.824,110
14720,2013-11-01,SAC,,LAC,L 101-110,240,36,79,.456,30,62,.484,6,17,.353,23,32,.719,101
14721,2013-11-01,PHI,@,WAS,W 109-102,240,48,94,.511,42,71,.592,6,23,.261,7,14,.500,109
14722,2013-11-01,WAS,,PHI,L 102-109,240,41,94,.436,32,68,.471,9,26,.346,11,17,.647,102
14723,2013-10-31,CHI,,NYK,W 82-81,240,31,76,.408,28,60,.467,3,16,.188,17,19,.895,82
14724,2013-10-31,NYK,@,CHI,L 81-82,240,31,86,.360,22,62,.355,9,24,.375,10,14,.714,81
14725,2013-10-31,GSW,@,LAC,L 115-126,240,40,76,.526,28,55,.509,12,21,.571,23,33,.697,115
14726,2013-10-31,LAC,,GSW,W 126-115,240,42,85,.494,33,57,.579,9,28,.321,33,50,.660,126
14727,2013-10-30,BRK,@,CLE,L 94-98,240,33,82,.402,24,58,.414,9,24,.375,19,24,.792,94
14728,2013-10-30,CLE,,BRK,W 98-94,240,35,84,.417,30,69,.435,5,15,.333,23,34,.676,98
14729,2013-10-30,ATL,@,DAL,L 109-118,240,37,76,.487,29,52,.558,8,24,.333,27,35,.771,109
14730,2013-10-30,DAL,,ATL,W 118-109,240,44,77,.571,33,53,.623,11,24,.458,19,24,.792,118
14731,2013-10-30,DET,,WAS,W 113-102,240,39,78,.500,30,54,.556,9,24,.375,26,33,.788,113
14732,2013-10-30,WAS,@,DET,L 102-113,240,34,78,.436,24,53,.453,10,25,.400,24,32,.750,102
14733,2013-10-30,GSW,,LAL,W 125-94,240,46,86,.535,31,59,.525,15,27,.556,18,23,.783,125
14734,2013-10-30,LAL,@,GSW,L 94-125,240,35,89,.393,27,71,.380,8,18,.444,16,21,.762,94
14735,2013-10-30,CHA,@,HOU,L 83-96,240,33,90,.367,29,80,.363,4,10,.400,13,20,.650,83
14736,2013-10-30,HOU,,CHA,W 96-83,240,36,76,.474,27,51,.529,9,25,.360,15,24,.625,96
14737,2013-10-30,MIN,,ORL,W 120-115 (OT),265,42,100,.420,34,75,.453,8,25,.320,28,34,.824,120
14738,2013-10-30,ORL,@,MIN,L 115-120 (OT),265,47,100,.470,37,73,.507,10,27,.370,11,18,.611,115
14739,2013-10-30,IND,@,NOP,W 95-90,240,30,70,.429,20,47,.426,10,23,.435,25,30,.833,95
14740,2013-10-30,NOP,,IND,L 90-95,240,34,85,.400,29,74,.392,5,11,.455,17,21,.810,90
14741,2013-10-30,MIL,@,NYK,L 83-90,240,34,74,.459,29,58,.500,5,16,.313,10,12,.833,83
14742,2013-10-30,NYK,,MIL,W 90-83,240,36,71,.507,33,58,.569,3,13,.231,15,17,.882,90
14743,2013-10-30,MIA,@,PHI,L 110-114,240,42,85,.494,26,45,.578,16,40,.400,10,13,.769,110
14744,2013-10-30,PHI,,MIA,W 114-110,240,43,80,.538,35,59,.593,8,21,.381,20,24,.833,114
14745,2013-10-30,PHO,,POR,W 104-91,240,43,83,.518,39,64,.609,4,19,.211,14,18,.778,104
14746,2013-10-30,POR,@,PHO,L 91-104,240,33,81,.407,25,55,.455,8,26,.308,17,24,.708,91
14747,2013-10-30,DEN,@,SAC,L 88-90,240,34,79,.430,29,64,.453,5,15,.333,15,17,.882,88
14748,2013-10-30,SAC,,DEN,W 90-88,240,33,81,.407,25,60,.417,8,21,.381,16,23,.696,90
14749,2013-10-30,MEM,@,SAS,L 94-101,240,39,93,.419,31,78,.397,8,15,.533,8,15,.533,94
14750,2013-10-30,SAS,,MEM,W 101-94,240,40,76,.526,29,56,.518,11,20,.550,10,16,.625,101
14751,2013-10-30,BOS,@,TOR,L 87-93,240,32,66,.485,29,53,.547,3,13,.231,20,29,.690,87
14752,2013-10-30,TOR,,BOS,W 93-87,240,38,86,.442,33,69,.478,5,17,.294,12,23,.522,93
14753,2013-10-30,OKC,@,UTA,W 101-98,240,33,81,.407,27,62,.435,6,19,.316,29,33,.879,101
14754,2013-10-30,UTA,,OKC,L 98-101,240,36,79,.456,30,57,.526,6,22,.273,20,30,.667,98
14755,2013-10-29,IND,,ORL,W 97-87,240,34,71,.479,27,54,.500,7,17,.412,22,32,.688,97
14756,2013-10-29,ORL,@,IND,L 87-97,240,36,93,.387,27,74,.365,9,19,.474,6,10,.600,87
14757,2013-10-29,LAC,@,LAL,L 103-116,240,41,83,.494,33,62,.532,8,21,.381,13,23,.565,103
14758,2013-10-29,LAL,,LAC,W 116-103,240,42,93,.452,28,64,.438,14,29,.483,18,28,.643,116
14759,2013-10-29,CHI,@,MIA,L 95-107,240,35,83,.422,28,57,.491,7,26,.269,18,23,.783,95
14760,2013-10-29,MIA,,CHI,W 107-95,240,37,72,.514,26,52,.500,11,20,.550,22,29,.759,107
14761,2013-04-17,BRK,,DET,W 103-99,240,39,81,.481,31,57,.544,8,24,.333,17,23,.739,103
14762,2013-04-17,DET,@,BRK,L 99-103,240,37,78,.474,36,65,.554,1,13,.077,24,32,.750,99
14763,2013-04-17,CHA,,CLE,W 105-98,240,37,73,.507,29,53,.547,8,20,.400,23,30,.767,105
14764,2013-04-17,CLE,@,CHA,L 98-105,240,39,80,.488,31,57,.544,8,23,.348,12,18,.667,98
14765,2013-04-17,CHI,,WAS,W 95-92,240,37,78,.474,30,60,.500,7,18,.389,14,19,.737,95
14766,2013-04-17,WAS,@,CHI,L 92-95,240,36,85,.424,29,69,.420,7,16,.438,13,17,.765,92
14767,2013-04-17,DAL,,NOH,W 99-87,240,42,82,.512,36,66,.545,6,16,.375,9,11,.818,99
14768,2013-04-17,NOP,@,DAL,L 87-99,240,31,84,.369,27,73,.370,4,11,.364,21,28,.750,87
14769,2013-04-17,DEN,,PHO,W 118-98,240,49,93,.527,45,77,.584,4,16,.250,16,20,.800,118
14770,2013-04-17,PHO,@,DEN,L 98-118,240,40,104,.385,33,79,.418,7,25,.280,11,17,.647,98
14771,2013-04-17,IND,,PHI,L 95-105,240,36,80,.450,30,54,.556,6,26,.231,17,27,.630,95
14772,2013-04-17,PHI,@,IND,W 105-95,240,43,85,.506,35,66,.530,8,19,.421,11,14,.786,105
14773,2013-04-17,HOU,@,LAL,L 95-99 (OT),265,35,84,.417,27,51,.529,8,33,.242,17,24,.708,95
14774,2013-04-17,LAL,,HOU,W 99-95 (OT),265,33,90,.367,23,58,.397,10,32,.313,23,34,.676,99
14775,2013-04-17,MEM,,UTA,W 86-70,240,34,84,.405,30,71,.423,4,13,.308,14,20,.700,86
14776,2013-04-17,UTA,@,MEM,L 70-86,240,25,78,.321,22,67,.328,3,11,.273,17,26,.654,70
14777,2013-04-17,MIA,,ORL,W 105-93,240,42,78,.538,30,49,.612,12,29,.414,9,19,.474,105
14778,2013-04-17,ORL,@,MIA,L 93-105,240,40,77,.519,38,63,.603,2,14,.143,11,25,.440,93
14779,2013-04-17,ATL,@,NYK,L 92-98,240,37,90,.411,35,69,.507,2,21,.095,16,17,.941,92
14780,2013-04-17,NYK,,ATL,W 98-92,240,39,91,.429,30,67,.448,9,24,.375,11,16,.688,98
14781,2013-04-17,MIL,@,OKC,W 95-89,240,36,85,.424,26,58,.448,10,27,.370,13,18,.722,95
14782,2013-04-17,OKC,,MIL,L 89-95,240,37,89,.416,34,68,.500,3,21,.143,12,14,.857,89
14783,2013-04-17,GSW,@,POR,W 99-88,240,40,93,.430,31,72,.431,9,21,.429,10,13,.769,99
14784,2013-04-17,POR,,GSW,L 88-99,240,35,82,.427,29,70,.414,6,12,.500,12,14,.857,88
14785,2013-04-17,LAC,@,SAC,W 112-108,240,44,88,.500,32,64,.500,12,24,.500,12,18,.667,112
14786,2013-04-17,SAC,,LAC,L 108-112,240,40,89,.449,31,63,.492,9,26,.346,19,25,.760,108
14787,2013-04-17,MIN,@,SAS,W 108-95,240,42,91,.462,30,62,.484,12,29,.414,12,16,.750,108
14788,2013-04-17,SAS,,MIN,L 95-108,240,33,79,.418,26,61,.426,7,18,.389,22,22,1.000,95
14789,2013-04-17,BOS,@,TOR,L 90-114,240,37,84,.440,30,67,.448,7,17,.412,9,13,.692,90
14790,2013-04-17,TOR,,BOS,W 114-90,240,40,80,.500,28,59,.475,12,21,.571,22,28,.786,114
14791,2013-04-16,ATL,,TOR,L 96-113,240,35,88,.398,26,60,.433,9,28,.321,17,23,.739,96
14792,2013-04-16,TOR,@,ATL,W 113-96,240,40,78,.513,30,51,.588,10,27,.370,23,27,.852,113
14793,2013-04-16,LAC,,POR,W 93-77,240,37,79,.468,30,52,.577,7,27,.259,12,15,.800,93
14794,2013-04-16,POR,@,LAC,L 77-93,240,30,73,.411,23,52,.442,7,21,.333,10,15,.667,77
14795,2013-04-15,BRK,,WAS,W 106-101,240,43,92,.467,36,77,.468,7,15,.467,13,27,.481,106
14796,2013-04-15,WAS,@,BRK,L 101-106,240,41,77,.532,37,66,.561,4,11,.364,15,20,.750,101
14797,2013-04-15,CHA,,NYK,W 106-95,240,43,74,.581,36,56,.643,7,18,.389,13,14,.929,106
14798,2013-04-15,NYK,@,CHA,L 95-106,240,34,79,.430,20,42,.476,14,37,.378,13,13,1.000,95
14799,2013-04-15,CLE,,MIA,L 95-96,240,39,86,.453,34,73,.466,5,13,.385,12,19,.632,95
14800,2013-04-15,MIA,@,CLE,W 96-95,240,33,66,.500,20,38,.526,13,28,.464,17,27,.630,96
14801,2013-04-15,DAL,,MEM,L 97-103,240,34,76,.447,25,57,.439,9,19,.474,20,25,.800,97
14802,2013-04-15,MEM,@,DAL,W 103-97,240,38,80,.475,31,59,.525,7,21,.333,20,25,.800,103
14803,2013-04-15,DET,,PHI,W 109-101,240,41,83,.494,32,58,.552,9,25,.360,18,22,.818,109
14804,2013-04-15,PHI,@,DET,L 101-109,240,39,87,.448,33,65,.508,6,22,.273,17,21,.810,101
14805,2013-04-15,GSW,,SAS,W 116-106,240,46,85,.541,37,65,.569,9,20,.450,15,18,.833,116
14806,2013-04-15,SAS,@,GSW,L 106-116,240,45,98,.459,37,74,.500,8,24,.333,8,13,.615,106
14807,2013-04-15,DEN,@,MIL,W 112-111,240,37,85,.435,31,71,.437,6,14,.429,32,46,.696,112
14808,2013-04-15,MIL,,DEN,L 111-112,240,42,100,.420,30,65,.462,12,35,.343,15,23,.652,111
14809,2013-04-15,MIN,,UTA,L 80-96,240,32,75,.427,30,58,.517,2,17,.118,14,18,.778,80
14810,2013-04-15,UTA,@,MIN,W 96-80,240,36,77,.468,33,67,.493,3,10,.300,21,23,.913,96
14811,2013-04-15,OKC,,SAC,W 104-95,240,42,92,.457,37,69,.536,5,23,.217,15,20,.750,104
14812,2013-04-15,SAC,@,OKC,L 95-104,240,38,87,.437,31,60,.517,7,27,.259,12,21,.571,95
14813,2013-04-15,CHI,@,ORL,W 102-84,240,42,75,.560,33,58,.569,9,17,.529,9,13,.692,102
14814,2013-04-15,ORL,,CHI,L 84-102,240,31,74,.419,29,64,.453,2,10,.200,20,33,.606,84
14815,2013-04-15,HOU,@,PHO,L 112-119,240,43,92,.467,32,63,.508,11,29,.379,15,23,.652,112
14816,2013-04-15,PHO,,HOU,W 119-112,240,47,95,.495,40,72,.556,7,23,.304,18,23,.783,119
14817,2013-04-14,DEN,,POR,W 118-109,240,43,81,.531,35,59,.593,8,22,.364,24,27,.889,118
14818,2013-04-14,POR,@,DEN,L 109-118,240,38,82,.463,26,50,.520,12,32,.375,21,26,.808,109
14819,2013-04-14,HOU,,SAC,W 121-100,240,45,83,.542,32,56,.571,13,27,.481,18,24,.750,121
14820,2013-04-14,SAC,@,HOU,L 100-121,240,39,100,.390,31,75,.413,8,25,.320,14,17,.824,100
14821,2013-04-14,LAL,,SAS,W 91-86,240,31,85,.365,22,58,.379,9,27,.333,20,31,.645,91
14822,2013-04-14,SAS,@,LAL,L 86-91,240,33,89,.371,27,71,.380,6,18,.333,14,19,.737,86
14823,2013-04-14,CHI,@,MIA,L 93-105,240,29,82,.354,18,56,.321,11,26,.423,24,31,.774,93
14824,2013-04-14,MIA,,CHI,W 105-93,240,36,70,.514,30,53,.566,6,17,.353,27,41,.659,105
14825,2013-04-14,DAL,@,NOH,W 107-89,240,45,86,.523,36,65,.554,9,21,.429,8,8,1.000,107
14826,2013-04-14,NOP,,DAL,L 89-107,240,33,87,.379,24,65,.369,9,22,.409,14,18,.778,89
14827,2013-04-14,IND,@,NYK,L 80-90,240,28,65,.431,20,37,.541,8,28,.286,16,26,.615,80
14828,2013-04-14,NYK,,IND,W 90-80,240,35,82,.427,24,51,.471,11,31,.355,9,11,.818,90
14829,2013-04-14,CLE,@,PHI,L 77-91,240,31,85,.365,26,69,.377,5,16,.313,10,15,.667,77
14830,2013-04-14,PHI,,CLE,W 91-77,240,38,86,.442,30,65,.462,8,21,.381,7,11,.636,91
14831,2013-04-14,BRK,@,TOR,L 87-93,240,34,84,.405,26,54,.481,8,30,.267,11,19,.579,87
14832,2013-04-14,TOR,,BRK,W 93-87,240,36,82,.439,30,67,.448,6,15,.400,15,21,.714,93
14833,2013-04-13,CHA,,MIL,W 95-85,240,37,80,.463,33,71,.465,4,9,.444,17,24,.708,95
14834,2013-04-13,MIL,@,CHA,L 85-95,240,34,87,.391,25,58,.431,9,29,.310,8,12,.667,85
14835,2013-04-13,LAC,@,MEM,W 91-87,240,37,80,.463,31,64,.484,6,16,.375,11,18,.611,91
14836,2013-04-13,MEM,,LAC,L 87-91,240,34,83,.410,28,70,.400,6,13,.462,13,20,.650,87
14837,2013-04-13,MIN,,PHO,W 105-93,240,41,83,.494,35,68,.515,6,15,.400,17,19,.895,105
14838,2013-04-13,PHO,@,MIN,L 93-105,240,37,73,.507,28,53,.528,9,20,.450,10,14,.714,93
14839,2013-04-13,BOS,@,ORL,W 120-88,240,48,81,.593,38,65,.585,10,16,.625,14,19,.737,120
14840,2013-04-13,ORL,,BOS,L 88-120,240,35,83,.422,30,69,.435,5,14,.357,13,15,.867,88
14841,2013-04-12,ATL,,MIL,W 109-104,240,43,85,.506,37,65,.569,6,20,.300,17,25,.680,109
14842,2013-04-12,MIL,@,ATL,L 104-109,240,38,92,.413,21,59,.356,17,33,.515,11,16,.688,104
14843,2013-04-12,CLE,,NYK,L 91-101,240,34,79,.430,28,57,.491,6,22,.273,17,24,.708,91
14844,2013-04-12,NYK,@,CLE,W 101-91,240,40,79,.506,30,51,.588,10,28,.357,11,17,.647,101
14845,2013-04-12,DAL,,DEN,W 108-105 (OT),265,43,95,.453,32,72,.444,11,23,.478,11,19,.579,108
14846,2013-04-12,DEN,@,DAL,L 105-108 (OT),265,41,93,.441,33,69,.478,8,24,.333,15,21,.714,105
14847,2013-04-12,CHA,@,DET,L 93-113,240,35,78,.449,26,54,.481,9,24,.375,14,17,.824,93
14848,2013-04-12,DET,,CHA,W 113-93,240,43,83,.518,31,65,.477,12,18,.667,15,20,.750,113
14849,2013-04-12,HOU,,MEM,L 78-82,240,23,74,.311,12,42,.286,11,32,.344,21,28,.750,78
14850,2013-04-12,MEM,@,HOU,W 82-78,240,29,83,.349,24,66,.364,5,17,.294,19,28,.679,82
14851,2013-04-12,BRK,@,IND,W 117-109,240,42,82,.512,30,57,.526,12,25,.480,21,26,.808,117
14852,2013-04-12,IND,,BRK,L 109-117,240,40,80,.500,32,61,.525,8,19,.421,21,26,.808,109
14853,2013-04-12,GSW,@,LAL,L 116-118,240,46,97,.474,35,71,.493,11,26,.423,13,16,.813,116
14854,2013-04-12,LAL,,GSW,W 118-116,240,34,66,.515,22,41,.537,12,25,.480,38,50,.760,118
14855,2013-04-12,BOS,@,MIA,L 101-109,240,41,85,.482,35,62,.565,6,23,.261,13,13,1.000,101
14856,2013-04-12,MIA,,BOS,W 109-101,240,39,71,.549,27,48,.563,12,23,.522,19,28,.679,109
14857,2013-04-12,LAC,@,NOH,W 96-93,240,35,78,.449,28,52,.538,7,26,.269,19,28,.679,96
14858,2013-04-12,NOP,,LAC,L 93-96,240,35,83,.422,29,64,.453,6,19,.316,17,32,.531,93
14859,2013-04-12,OKC,@,POR,W 106-90,240,40,77,.519,31,55,.564,9,22,.409,17,21,.810,106
14860,2013-04-12,POR,,OKC,L 90-106,240,36,88,.409,30,68,.441,6,20,.300,12,18,.667,90
14861,2013-04-12,SAC,@,SAS,L 101-108,240,39,89,.438,28,69,.406,11,20,.550,12,15,.800,101
14862,2013-04-12,SAS,,SAC,W 108-101,240,42,77,.545,36,60,.600,6,17,.353,18,21,.857,108
14863,2013-04-12,CHI,@,TOR,L 88-97,240,34,77,.442,25,59,.424,9,18,.500,11,14,.786,88
14864,2013-04-12,TOR,,CHI,W 97-88,240,34,72,.472,32,64,.500,2,8,.250,27,33,.818,97
14865,2013-04-12,MIN,@,UTA,L 100-107,240,36,78,.462,28,56,.500,8,22,.364,20,21,.952,100
14866,2013-04-12,UTA,,MIN,W 107-100,240,42,72,.583,34,59,.576,8,13,.615,15,17,.882,107
14867,2013-04-12,PHI,@,WAS,W 97-86,240,40,93,.430,33,71,.465,7,22,.318,10,11,.909,97
14868,2013-04-12,WAS,,PHI,L 86-97,240,36,87,.414,35,74,.473,1,13,.077,13,21,.619,86
14869,2013-04-11,CHI,,NYK,W 118-111 (OT),265,39,87,.448,29,60,.483,10,27,.370,30,37,.811,118
14870,2013-04-11,NYK,@,CHI,L 111-118 (OT),265,42,104,.404,32,74,.432,10,30,.333,17,22,.773,111
14871,2013-04-11,GSW,,OKC,L 97-116,240,37,84,.440,30,68,.441,7,16,.438,16,26,.615,97
14872,2013-04-11,OKC,@,GSW,W 116-97,240,42,83,.506,30,56,.536,12,27,.444,20,23,.870,116
14873,2013-04-10,BOS,,BRK,L 93-101,240,37,81,.457,31,65,.477,6,16,.375,13,17,.765,93
14874,2013-04-10,BRK,@,BOS,W 101-93,240,34,74,.459,26,55,.473,8,19,.421,25,28,.893,101
14875,2013-04-10,CLE,,DET,L 104-111,240,40,82,.488,37,67,.552,3,15,.200,21,26,.808,104
14876,2013-04-10,DET,@,CLE,W 111-104,240,40,80,.500,36,64,.563,4,16,.250,27,42,.643,111
14877,2013-04-10,DAL,,PHO,L 91-102,240,34,85,.400,28,68,.412,6,17,.353,17,21,.810,91
14878,2013-04-10,PHO,@,DAL,W 102-91,240,37,89,.416,25,62,.403,12,27,.444,16,17,.941,102
14879,2013-04-10,DEN,,SAS,W 96-86,240,39,86,.453,33,71,.465,6,15,.400,12,21,.571,96
14880,2013-04-10,SAS,@,DEN,L 86-96,240,35,87,.402,31,66,.470,4,21,.190,12,17,.706,86
14881,2013-04-10,LAC,,MIN,W 111-95,240,44,77,.571,33,56,.589,11,21,.524,12,16,.750,111
14882,2013-04-10,MIN,@,LAC,L 95-111,240,35,90,.389,29,67,.433,6,23,.261,19,22,.864,95
14883,2013-04-10,MIL,@,ORL,L 103-113 (OT),265,39,101,.386,31,73,.425,8,28,.286,17,26,.654,103
14884,2013-04-10,ORL,,MIL,W 113-103 (OT),265,51,109,.468,43,94,.457,8,15,.533,3,8,.375,113
14885,2013-04-10,ATL,@,PHI,W 124-101,240,49,91,.538,41,69,.594,8,22,.364,18,19,.947,124
14886,2013-04-10,PHI,,ATL,L 101-124,240,37,88,.420,30,67,.448,7,21,.333,20,22,.909,101
14887,2013-04-10,LAL,@,POR,W 113-106,240,43,73,.589,37,54,.685,6,19,.316,21,24,.875,113
14888,2013-04-10,POR,,LAL,L 106-113,240,38,85,.447,26,59,.441,12,26,.462,18,20,.900,106
14889,2013-04-10,NOP,@,SAC,L 110-121,240,38,78,.487,32,60,.533,6,18,.333,28,35,.800,110
14890,2013-04-10,SAC,,NOH,W 121-110,240,47,85,.553,37,65,.569,10,20,.500,17,23,.739,121
14891,2013-04-10,MIA,@,WAS,W 103-98,240,33,75,.440,16,34,.471,17,41,.415,20,23,.870,103
14892,2013-04-10,WAS,,MIA,L 98-103,240,36,80,.450,25,57,.439,11,23,.478,15,21,.714,98
14893,2013-04-09,BRK,,PHI,W 104-83,240,42,93,.452,37,73,.507,5,20,.250,15,23,.652,104
14894,2013-04-09,PHI,@,BRK,L 83-104,240,30,80,.375,23,66,.348,7,14,.500,16,20,.800,83
14895,2013-04-09,CHI,,TOR,L 98-101,240,37,86,.430,27,69,.391,10,17,.588,14,20,.700,98
14896,2013-04-09,TOR,@,CHI,W 101-98,240,37,72,.514,30,54,.556,7,18,.389,20,24,.833,101
14897,2013-04-09,GSW,,MIN,W 105-89,240,39,91,.429,29,67,.433,10,24,.417,17,22,.773,105
14898,2013-04-09,MIN,@,GSW,L 89-105,240,33,90,.367,26,71,.366,7,19,.368,16,20,.800,89
14899,2013-04-09,HOU,,PHO,W 101-98,240,37,86,.430,31,56,.554,6,30,.200,21,24,.875,101
14900,2013-04-09,PHO,@,HOU,L 98-101,240,38,86,.442,31,74,.419,7,12,.583,15,19,.789,98
14901,2013-04-09,CLE,@,IND,L 94-99,240,39,85,.459,36,75,.480,3,10,.300,13,15,.867,94
14902,2013-04-09,IND,,CLE,W 99-94,240,32,79,.405,28,63,.444,4,16,.250,31,46,.674,99
14903,2013-04-09,LAL,,NOH,W 104-96,240,40,79,.506,33,54,.611,7,25,.280,17,22,.773,104
14904,2013-04-09,NOP,@,LAL,L 96-104,240,37,84,.440,32,64,.500,5,20,.250,17,18,.944,96
14905,2013-04-09,CHA,@,MEM,L 75-94,240,30,80,.375,28,66,.424,2,14,.143,13,18,.722,75
14906,2013-04-09,MEM,,CHA,W 94-75,240,39,82,.476,36,69,.522,3,13,.231,13,20,.650,94
14907,2013-04-09,MIA,,MIL,W 94-83,240,38,88,.432,30,53,.566,8,35,.229,10,10,1.000,94
14908,2013-04-09,MIL,@,MIA,L 83-94,240,33,75,.440,24,50,.480,9,25,.360,8,14,.571,83
14909,2013-04-09,NYK,,WAS,W 120-99,240,45,80,.563,25,44,.568,20,36,.556,10,14,.714,120
14910,2013-04-09,WAS,@,NYK,L 99-120,240,35,77,.455,27,57,.474,8,20,.400,21,30,.700,99
14911,2013-04-09,OKC,@,UTA,W 90-80,240,32,81,.395,23,60,.383,9,21,.429,17,18,.944,90
14912,2013-04-09,UTA,,OKC,L 80-90,240,31,79,.392,24,54,.444,7,25,.280,11,14,.786,80
14913,2013-04-07,BOS,,WAS,W 107-96,240,43,77,.558,39,66,.591,4,11,.364,17,21,.810,107
14914,2013-04-07,WAS,@,BOS,L 96-107,240,39,88,.443,29,62,.468,10,26,.385,8,12,.667,96
14915,2013-04-07,CLE,,ORL,W 91-85,240,32,89,.360,25,72,.347,7,17,.412,20,24,.833,91
14916,2013-04-07,ORL,@,CLE,L 85-91,240,34,90,.378,33,77,.429,1,13,.077,16,22,.727,85
14917,2013-04-07,CHI,@,DET,L 85-99,240,33,73,.452,30,58,.517,3,15,.200,16,25,.640,85
14918,2013-04-07,DET,,CHI,W 99-85,240,39,73,.534,30,55,.545,9,18,.500,12,17,.706,99
14919,2013-04-07,GSW,,UTA,L 90-97,240,35,74,.473,28,57,.491,7,17,.412,13,18,.722,90
14920,2013-04-07,UTA,@,GSW,W 97-90,240,40,88,.455,29,63,.460,11,25,.440,6,7,.857,97
14921,2013-04-07,LAC,,LAL,W 109-95,240,42,84,.500,34,63,.540,8,21,.381,17,21,.810,109
14922,2013-04-07,LAL,@,LAC,L 95-109,240,33,76,.434,26,52,.500,7,24,.292,22,30,.733,95
14923,2013-04-07,NYK,@,OKC,W 125-120,240,46,93,.495,31,59,.525,15,34,.441,18,24,.750,125
14924,2013-04-07,OKC,,NYK,L 120-125,240,45,78,.577,36,61,.590,9,17,.529,21,25,.840,120
14925,2013-04-07,NOP,@,PHO,W 95-92,240,32,80,.400,28,65,.431,4,15,.267,27,29,.931,95
14926,2013-04-07,PHO,,NOH,L 92-95,240,34,80,.425,27,59,.458,7,21,.333,17,19,.895,92
14927,2013-04-07,DAL,@,POR,W 96-91,240,42,90,.467,39,77,.506,3,13,.231,9,12,.750,96
14928,2013-04-07,POR,,DAL,L 91-96,240,37,80,.463,33,58,.569,4,22,.182,13,16,.813,91
14929,2013-04-07,MEM,@,SAC,W 89-87,240,32,73,.438,29,66,.439,3,7,.429,22,29,.759,89
14930,2013-04-07,SAC,,MEM,L 87-89,240,29,81,.358,22,56,.393,7,25,.280,22,28,.786,87
14931,2013-04-06,BRK,,CHA,W 105-96,240,39,80,.488,34,59,.576,5,21,.238,22,30,.733,105
14932,2013-04-06,CHA,@,BRK,L 96-105,240,36,80,.450,29,59,.492,7,21,.333,17,23,.739,96
14933,2013-04-06,DEN,,HOU,W 132-114,240,54,99,.545,43,74,.581,11,25,.440,13,21,.619,132
14934,2013-04-06,HOU,@,DEN,L 114-132,240,39,83,.470,25,49,.510,14,34,.412,22,32,.688,114
14935,2013-04-06,MIA,,PHI,W 106-87,240,40,83,.482,26,58,.448,14,25,.560,12,14,.857,106
14936,2013-04-06,PHI,@,MIA,L 87-106,240,33,82,.402,27,62,.435,6,20,.300,15,20,.750,87
14937,2013-04-06,MIL,,TOR,W 100-83,240,36,76,.474,30,57,.526,6,19,.316,22,29,.759,100
14938,2013-04-06,TOR,@,MIL,L 83-100,240,30,83,.361,27,73,.370,3,10,.300,20,23,.870,83
14939,2013-04-06,DET,@,MIN,L 101-107,240,40,75,.533,34,60,.567,6,15,.400,15,21,.714,101
14940,2013-04-06,MIN,,DET,W 107-101,240,36,83,.434,30,69,.435,6,14,.429,29,38,.763,107
14941,2013-04-06,ATL,@,SAS,L 97-99,240,35,83,.422,30,71,.423,5,12,.417,22,25,.880,97
14942,2013-04-06,SAS,,ATL,W 99-97,240,36,80,.450,33,65,.508,3,15,.200,24,29,.828,99
14943,2013-04-06,IND,@,WAS,L 85-104,240,35,86,.407,32,66,.485,3,20,.150,12,15,.800,85
14944,2013-04-06,WAS,,IND,W 104-85,240,39,79,.494,35,67,.522,4,12,.333,22,31,.710,104
14945,2013-04-05,ATL,,PHI,L 90-101,240,34,73,.466,29,56,.518,5,17,.294,17,27,.630,90
14946,2013-04-05,PHI,@,ATL,W 101-90,240,37,80,.463,28,64,.438,9,16,.563,18,24,.750,101
14947,2013-04-05,BOS,,CLE,L 91-97,240,36,89,.404,30,67,.448,6,22,.273,13,22,.591,91
14948,2013-04-05,CLE,@,BOS,W 97-91,240,36,89,.404,33,76,.434,3,13,.231,22,26,.846,97
14949,2013-04-05,CHA,,MIA,L 79-89,240,28,88,.318,25,72,.347,3,16,.188,20,22,.909,79
14950,2013-04-05,MIA,@,CHA,W 89-79,240,31,69,.449,18,36,.500,13,33,.394,14,17,.824,89
14951,2013-04-05,CHI,,ORL,W 87-86,240,33,82,.402,25,62,.403,8,20,.400,13,14,.929,87
14952,2013-04-05,ORL,@,CHI,L 86-87,240,34,80,.425,30,70,.429,4,10,.400,14,17,.824,86
14953,2013-04-05,IND,,OKC,L 75-97,240,27,72,.375,25,51,.490,2,21,.095,19,24,.792,75
14954,2013-04-05,OKC,@,IND,W 97-75,240,37,78,.474,33,66,.500,4,12,.333,19,23,.826,97
14955,2013-04-05,LAL,,MEM,W 86-84,240,34,74,.459,29,54,.537,5,20,.250,13,18,.722,86
14956,2013-04-05,MEM,@,LAL,L 84-86,240,38,86,.442,35,72,.486,3,14,.214,5,7,.714,84
14957,2013-04-05,MIN,,TOR,L 93-95,240,30,67,.448,27,52,.519,3,15,.200,30,40,.750,93
14958,2013-04-05,TOR,@,MIN,W 95-93,240,40,85,.471,36,70,.514,4,15,.267,11,16,.688,95
14959,2013-04-05,MIL,@,NYK,L 83-101,240,29,76,.382,17,46,.370,12,30,.400,13,18,.722,83
14960,2013-04-05,NYK,,MIL,W 101-83,240,41,89,.461,29,53,.547,12,36,.333,7,8,.875,101
14961,2013-04-05,GSW,@,PHO,W 111-107,240,44,86,.512,35,70,.500,9,16,.563,14,16,.875,111
14962,2013-04-05,PHO,,GSW,L 107-111,240,44,72,.611,39,58,.672,5,14,.357,14,17,.824,107
14963,2013-04-05,HOU,@,POR,W 116-98,240,39,76,.513,27,48,.563,12,28,.429,26,35,.743,116
14964,2013-04-05,POR,,HOU,L 98-116,240,38,91,.418,36,71,.507,2,20,.100,20,24,.833,98
14965,2013-04-05,DAL,@,SAC,W 117-108,240,46,90,.511,40,70,.571,6,20,.300,19,19,1.000,117
14966,2013-04-05,SAC,,DAL,L 108-117,240,39,87,.448,33,61,.541,6,26,.231,24,31,.774,108
14967,2013-04-05,NOP,@,UTA,L 83-95,240,32,77,.416,30,65,.462,2,12,.167,17,20,.850,83
14968,2013-04-05,UTA,,NOH,W 95-83,240,39,77,.506,28,51,.549,11,26,.423,6,11,.545,95
14969,2013-04-04,BRK,,CHI,L 90-92,240,31,70,.443,26,57,.456,5,13,.385,23,30,.767,90
14970,2013-04-04,CHI,@,BRK,W 92-90,240,38,82,.463,34,71,.479,4,11,.364,12,19,.632,92
14971,2013-04-04,DAL,@,DEN,L 94-95,240,41,88,.466,37,70,.529,4,18,.222,8,10,.800,94
14972,2013-04-04,DEN,,DAL,W 95-94,240,35,89,.393,29,72,.403,6,17,.353,19,30,.633,95
14973,2013-04-04,OKC,,SAS,W 100-88,240,38,82,.463,26,58,.448,12,24,.500,12,13,.923,100
14974,2013-04-04,SAS,@,OKC,L 88-100,240,33,83,.398,25,62,.403,8,21,.381,14,17,.824,88
14975,2013-04-03,ATL,,NYK,L 82-95,240,32,66,.485,23,40,.575,9,26,.346,9,19,.474,82
14976,2013-04-03,NYK,@,ATL,W 95-82,240,40,77,.519,33,55,.600,7,22,.318,8,12,.667,95
14977,2013-04-03,BOS,,DET,W 98-93,240,36,71,.507,29,51,.569,7,20,.350,19,22,.864,98
14978,2013-04-03,DET,@,BOS,L 93-98,240,34,93,.366,30,69,.435,4,24,.167,21,30,.700,93
14979,2013-04-03,CHA,,PHI,W 88-83,240,35,81,.432,31,67,.463,4,14,.286,14,16,.875,88
14980,2013-04-03,PHI,@,CHA,L 83-88,240,33,94,.351,29,78,.372,4,16,.250,13,16,.813,83
14981,2013-04-03,BRK,@,CLE,W 113-95,240,43,76,.566,33,55,.600,10,21,.476,17,22,.773,113
14982,2013-04-03,CLE,,BRK,L 95-113,240,34,89,.382,30,75,.400,4,14,.286,23,26,.885,95
14983,2013-04-03,GSW,,NOH,W 98-88,240,36,78,.462,29,59,.492,7,19,.368,19,22,.864,98
14984,2013-04-03,NOP,@,GSW,L 88-98,240,33,83,.398,29,68,.426,4,15,.267,18,23,.783,88
14985,2013-04-03,LAC,,PHO,W 126-101,240,52,93,.559,43,72,.597,9,21,.429,13,18,.722,126
14986,2013-04-03,PHO,@,LAC,L 101-126,240,35,77,.455,28,60,.467,7,17,.412,24,25,.960,101
14987,2013-04-03,MIL,,MIN,L 98-107,240,42,96,.438,34,73,.466,8,23,.348,6,9,.667,98
14988,2013-04-03,MIN,@,MIL,W 107-98,240,44,84,.524,36,71,.507,8,13,.615,11,16,.688,107
14989,2013-04-03,MEM,@,POR,W 94-76,240,34,67,.507,30,55,.545,4,12,.333,22,28,.786,94
14990,2013-04-03,POR,,MEM,L 76-94,240,33,80,.413,29,51,.569,4,29,.138,6,10,.600,76
14991,2013-04-03,HOU,@,SAC,W 112-102,240,42,86,.488,32,56,.571,10,30,.333,18,21,.857,112
14992,2013-04-03,SAC,,HOU,L 102-112,240,34,87,.391,28,66,.424,6,21,.286,28,34,.824,102
14993,2013-04-03,ORL,@,SAS,L 84-98,240,35,90,.389,29,73,.397,6,17,.353,8,9,.889,84
14994,2013-04-03,SAS,,ORL,W 98-84,240,40,90,.444,30,61,.492,10,29,.345,8,13,.615,98
14995,2013-04-03,TOR,,WAS,W 88-78,240,30,66,.455,29,58,.500,1,8,.125,27,36,.750,88
14996,2013-04-03,WAS,@,TOR,L 78-88,240,26,80,.325,21,61,.344,5,19,.263,21,29,.724,78
14997,2013-04-03,DEN,@,UTA,W 113-96,240,41,73,.562,34,55,.618,7,18,.389,24,32,.750,113
14998,2013-04-03,UTA,,DEN,L 96-113,240,39,84,.464,33,64,.516,6,20,.300,12,18,.667,96
14999,2013-04-02,DAL,@,LAL,L 81-101,240,34,81,.420,27,62,.435,7,19,.368,6,12,.500,81
15000,2013-04-02,LAL,,DAL,W 101-81,240,36,81,.444,28,57,.491,8,24,.333,21,33,.636,101
15001,2013-04-02,MIA,,NYK,L 90-102,240,30,60,.500,22,40,.550,8,20,.400,22,27,.815,90
15002,2013-04-02,NYK,@,MIA,W 102-90,240,37,71,.521,23,44,.523,14,27,.519,14,20,.700,102
15003,2013-04-02,CHI,@,WAS,L 86-90,240,35,89,.393,30,66,.455,5,23,.217,11,16,.688,86
15004,2013-04-02,WAS,,CHI,W 90-86,240,33,78,.423,27,65,.415,6,13,.462,18,26,.692,90
15005,2013-04-01,ATL,,CLE,W 102-94,240,37,81,.457,28,51,.549,9,30,.300,19,26,.731,102
15006,2013-04-01,CLE,@,ATL,L 94-102,240,41,81,.506,38,69,.551,3,12,.250,9,15,.600,94
15007,2013-04-01,HOU,,ORL,W 111-103,240,44,98,.449,35,69,.507,9,29,.310,14,22,.636,111
15008,2013-04-01,ORL,@,HOU,L 103-111,240,39,93,.419,33,78,.423,6,15,.400,19,21,.905,103
15009,2013-04-01,IND,@,LAC,W 109-106,240,39,71,.549,29,48,.604,10,23,.435,21,28,.750,109
15010,2013-04-01,LAC,,IND,L 106-109,240,39,80,.488,34,64,.531,5,16,.313,23,26,.885,106
15011,2013-04-01,MEM,,SAS,W 92-90,240,36,79,.456,34,72,.472,2,7,.286,18,24,.750,92
15012,2013-04-01,SAS,@,MEM,L 90-92,240,36,75,.480,28,52,.538,8,23,.348,10,11,.909,90
15013,2013-04-01,CHA,@,MIL,L 102-131,240,37,73,.507,31,54,.574,6,19,.316,22,28,.786,102
15014,2013-04-01,MIL,,CHA,W 131-102,240,51,100,.510,37,73,.507,14,27,.519,15,17,.882,131
15015,2013-04-01,BOS,@,MIN,L 100-110,240,42,81,.519,35,65,.538,7,16,.438,9,14,.643,100
15016,2013-04-01,MIN,,BOS,W 110-100,240,40,83,.482,35,65,.538,5,18,.278,25,27,.926,110
15017,2013-04-01,DET,@,TOR,W 108-98,240,43,77,.558,36,62,.581,7,15,.467,15,21,.714,108
15018,2013-04-01,TOR,,DET,L 98-108,240,41,81,.506,33,60,.550,8,21,.381,8,10,.800,98
15019,2013-04-01,POR,@,UTA,L 102-112,240,39,67,.582,26,44,.591,13,23,.565,11,17,.647,102
15020,2013-04-01,UTA,,POR,W 112-102,240,45,83,.542,36,61,.590,9,22,.409,13,18,.722,112
15021,2013-03-31,CHI,,DET,W 95-94,240,30,76,.395,22,53,.415,8,23,.348,27,40,.675,95
15022,2013-03-31,DET,@,CHI,L 94-95,240,36,72,.500,29,56,.518,7,16,.438,15,22,.682,94
15023,2013-03-31,CLE,@,NOH,L 92-112,240,38,82,.463,31,64,.484,7,18,.389,9,12,.750,92
15024,2013-03-31,NOP,,CLE,W 112-92,240,40,74,.541,28,53,.528,12,21,.571,20,29,.690,112
15025,2013-03-31,BOS,@,NYK,L 89-108,240,32,74,.432,25,49,.510,7,25,.280,18,23,.783,89
15026,2013-03-31,NYK,,BOS,W 108-89,240,35,72,.486,21,45,.467,14,27,.519,24,31,.774,108
15027,2013-03-31,MIA,@,SAS,W 88-86,240,33,71,.465,21,43,.488,12,28,.429,10,15,.667,88
15028,2013-03-31,SAS,,MIA,L 86-88,240,35,79,.443,28,55,.509,7,24,.292,9,16,.563,86
15029,2013-03-31,TOR,@,WAS,L 92-109,240,32,81,.395,25,62,.403,7,19,.368,21,26,.808,92
15030,2013-03-31,WAS,,TOR,W 109-92,240,41,85,.482,32,68,.471,9,17,.529,18,28,.643,109
15031,2013-03-30,ATL,,ORL,W 97-88,240,34,78,.436,28,57,.491,6,21,.286,23,31,.742,97
15032,2013-03-30,ORL,@,ATL,L 88-97,240,34,87,.391,30,74,.405,4,13,.308,16,27,.593,88
15033,2013-03-30,CHI,@,DAL,L 98-100,240,38,80,.475,26,59,.441,12,21,.571,10,18,.556,98
15034,2013-03-30,DAL,,CHI,W 100-98,240,40,79,.506,34,61,.557,6,18,.333,14,18,.778,100
15035,2013-03-30,GSW,,POR,W 125-98,240,47,87,.540,38,67,.567,9,20,.450,22,27,.815,125
15036,2013-03-30,POR,@,GSW,L 98-125,240,33,86,.384,25,63,.397,8,23,.348,24,29,.828,98
15037,2013-03-30,HOU,,LAC,W 98-81,240,35,80,.438,26,56,.464,9,24,.375,19,27,.704,98
15038,2013-03-30,LAC,@,HOU,L 81-98,240,31,78,.397,24,56,.429,7,22,.318,12,14,.857,81
15039,2013-03-30,MIL,,OKC,L 99-109,240,37,98,.378,25,69,.362,12,29,.414,13,15,.867,99
15040,2013-03-30,OKC,@,MIL,W 109-99,240,40,75,.533,36,59,.610,4,16,.250,25,32,.781,109
15041,2013-03-30,MEM,@,MIN,W 99-86,240,37,73,.507,31,63,.492,6,10,.600,19,27,.704,99
15042,2013-03-30,MIN,,MEM,L 86-99,240,29,67,.433,24,51,.471,5,16,.313,23,34,.676,86
15043,2013-03-30,CHA,@,PHI,L 92-100,240,38,76,.500,36,68,.529,2,8,.250,14,23,.609,92
15044,2013-03-30,PHI,,CHA,W 100-92,240,38,73,.521,33,57,.579,5,16,.313,19,27,.704,100
15045,2013-03-30,IND,@,PHO,W 112-104,240,37,80,.463,33,65,.508,4,15,.267,34,46,.739,112
15046,2013-03-30,PHO,,IND,L 104-112,240,40,82,.488,34,70,.486,6,12,.500,18,19,.947,104
15047,2013-03-30,LAL,@,SAC,W 103-98,240,38,82,.463,28,52,.538,10,30,.333,17,26,.654,103
15048,2013-03-30,SAC,,LAL,L 98-103,240,39,86,.453,32,62,.516,7,24,.292,13,16,.813,98
15049,2013-03-30,BRK,@,UTA,L 107-116,240,42,81,.519,34,58,.586,8,23,.348,15,19,.789,107
15050,2013-03-30,UTA,,BRK,W 116-107,240,45,81,.556,35,64,.547,10,17,.588,16,24,.667,116
15051,2013-03-29,ATL,@,BOS,L 107-118,240,40,88,.455,32,68,.471,8,20,.400,19,24,.792,107
15052,2013-03-29,BOS,,ATL,W 118-107,240,45,83,.542,34,60,.567,11,23,.478,17,21,.810,118
15053,2013-03-29,CLE,,PHI,L 87-97,240,37,86,.430,33,68,.485,4,18,.222,9,15,.600,87
15054,2013-03-29,PHI,@,CLE,W 97-87,240,42,86,.488,35,68,.515,7,18,.389,6,10,.600,97
15055,2013-03-29,BRK,@,DEN,L 87-109,240,32,79,.405,27,59,.458,5,20,.250,18,36,.500,87
15056,2013-03-29,DEN,,BRK,W 109-87,240,42,74,.568,38,60,.633,4,14,.286,21,31,.677,109
15057,2013-03-29,DET,,TOR,L 82-99,240,31,76,.408,26,58,.448,5,18,.278,15,23,.652,82
15058,2013-03-29,TOR,@,DET,W 99-82,240,44,82,.537,40,69,.580,4,13,.308,7,9,.778,99
15059,2013-03-29,HOU,@,MEM,L 94-103,240,34,81,.420,25,54,.463,9,27,.333,17,21,.810,94
15060,2013-03-29,MEM,,HOU,W 103-94,240,40,79,.506,36,68,.529,4,11,.364,19,21,.905,103
15061,2013-03-29,MIN,,OKC,W 101-93,240,37,83,.446,32,68,.471,5,15,.333,22,27,.815,101
15062,2013-03-29,OKC,@,MIN,L 93-101,240,36,79,.456,31,63,.492,5,16,.313,16,20,.800,93
15063,2013-03-29,MIA,@,NOH,W 108-89,240,42,69,.609,28,42,.667,14,27,.519,10,16,.625,108
15064,2013-03-29,NOP,,MIA,L 89-108,240,34,74,.459,29,56,.518,5,18,.278,16,18,.889,89
15065,2013-03-29,CHA,@,NYK,L 102-111,240,34,73,.466,24,47,.511,10,26,.385,24,31,.774,102
15066,2013-03-29,NYK,,CHA,W 111-102,240,38,77,.494,29,58,.500,9,19,.474,26,30,.867,111
15067,2013-03-29,ORL,,WAS,W 97-92,240,37,86,.430,32,71,.451,5,15,.333,18,22,.818,97
15068,2013-03-29,WAS,@,ORL,L 92-97,240,30,81,.370,26,61,.426,4,20,.200,28,32,.875,92
15069,2013-03-29,POR,,UTA,L 95-105,240,33,67,.493,27,54,.500,6,13,.462,23,32,.719,95
15070,2013-03-29,UTA,@,POR,W 105-95,240,43,86,.500,39,67,.582,4,19,.211,15,18,.833,105
15071,2013-03-29,LAC,@,SAS,L 102-104,240,41,81,.506,33,62,.532,8,19,.421,12,21,.571,102
15072,2013-03-29,SAS,,LAC,W 104-102,240,39,74,.527,33,59,.559,6,15,.400,20,21,.952,104
15073,2013-03-28,DAL,,IND,L 78-103,240,32,83,.386,28,69,.406,4,14,.286,10,14,.714,78
15074,2013-03-28,IND,@,DAL,W 103-78,240,40,84,.476,33,69,.478,7,15,.467,16,26,.615,103
15075,2013-03-28,LAL,@,MIL,L 103-113,240,34,77,.442,29,57,.509,5,20,.250,30,39,.769,103
15076,2013-03-28,MIL,,LAL,W 113-103,240,45,93,.484,38,74,.514,7,19,.368,16,22,.727,113
15077,2013-03-28,PHO,,SAC,L 103-117,240,42,94,.447,35,74,.473,7,20,.350,12,23,.522,103
15078,2013-03-28,SAC,@,PHO,W 117-103,240,44,83,.530,37,65,.569,7,18,.389,22,24,.917,117
15079,2013-03-27,CHA,,ORL,W 114-108,240,44,85,.518,38,65,.585,6,20,.300,20,28,.714,114
15080,2013-03-27,ORL,@,CHA,L 108-114,240,44,84,.524,37,65,.569,7,19,.368,13,18,.722,108
15081,2013-03-27,CHI,,MIA,W 101-97,240,40,85,.471,32,63,.508,8,22,.364,13,18,.722,101
15082,2013-03-27,MIA,@,CHI,L 97-101,240,37,77,.481,30,57,.526,7,20,.350,16,23,.696,97
15083,2013-03-27,BOS,@,CLE,W 93-92,240,34,76,.447,29,62,.468,5,14,.357,20,28,.714,93
15084,2013-03-27,CLE,,BOS,L 92-93,240,38,86,.442,31,69,.449,7,17,.412,9,14,.643,92
15085,2013-03-27,GSW,,SAC,L 98-105,240,41,90,.456,36,66,.545,5,24,.208,11,13,.846,98
15086,2013-03-27,SAC,@,GSW,W 105-98,240,41,90,.456,30,62,.484,11,28,.393,12,21,.571,105
15087,2013-03-27,HOU,,IND,L 91-100,240,32,83,.386,26,62,.419,6,21,.286,21,26,.808,91
15088,2013-03-27,IND,@,HOU,W 100-91,240,35,78,.449,29,60,.483,6,18,.333,24,28,.857,100
15089,2013-03-27,LAL,@,MIN,W 120-117,240,44,82,.537,34,60,.567,10,22,.455,22,38,.579,120
15090,2013-03-27,MIN,,LAL,L 117-120,240,45,97,.464,40,80,.500,5,17,.294,22,30,.733,117
15091,2013-03-27,LAC,@,NOH,W 105-91,240,34,73,.466,21,44,.477,13,29,.448,24,28,.857,105
15092,2013-03-27,NOP,,LAC,L 91-105,240,35,71,.493,31,57,.544,4,14,.286,17,24,.708,91
15093,2013-03-27,MEM,@,NYK,L 101-108,240,33,70,.471,27,49,.551,6,21,.286,29,35,.829,101
15094,2013-03-27,NYK,,MEM,W 108-101,240,38,74,.514,25,43,.581,13,31,.419,19,22,.864,108
15095,2013-03-27,OKC,,WAS,W 103-80,240,29,63,.460,21,49,.429,8,14,.571,37,41,.902,103
15096,2013-03-27,WAS,@,OKC,L 80-103,240,27,84,.321,22,64,.344,5,20,.250,21,29,.724,80
15097,2013-03-27,MIL,@,PHI,L 92-100,240,37,89,.416,31,65,.477,6,24,.250,12,13,.923,92
15098,2013-03-27,PHI,,MIL,W 100-92,240,42,89,.472,34,73,.466,8,16,.500,8,9,.889,100
15099,2013-03-27,BRK,@,POR,W 111-93,240,46,95,.484,41,75,.547,5,20,.250,14,25,.560,111
15100,2013-03-27,POR,,BRK,L 93-111,240,36,82,.439,28,64,.438,8,18,.444,13,21,.619,93
15101,2013-03-27,DEN,@,SAS,L 99-100,240,42,88,.477,42,78,.538,0,10,.000,15,17,.882,99
15102,2013-03-27,SAS,,DEN,W 100-99,240,35,76,.461,25,61,.410,10,15,.667,20,27,.741,100
15103,2013-03-27,ATL,@,TOR,W 107-88,240,40,81,.494,30,60,.500,10,21,.476,17,20,.850,107
15104,2013-03-27,TOR,,ATL,L 88-107,240,35,78,.449,31,61,.508,4,17,.235,14,20,.700,88
15105,2013-03-27,PHO,@,UTA,L 88-103,240,34,76,.447,28,60,.467,6,16,.375,14,19,.737,88
15106,2013-03-27,UTA,,PHO,W 103-88,240,44,85,.518,38,70,.543,6,15,.400,9,13,.692,103
15107,2013-03-26,BOS,,NYK,L 85-100,240,31,69,.449,25,49,.510,6,20,.300,17,22,.773,85
15108,2013-03-26,NYK,@,BOS,W 100-85,240,39,90,.433,31,62,.500,8,28,.286,14,18,.778,100
15109,2013-03-26,DAL,,LAC,W 109-102 (OT),265,40,82,.488,34,59,.576,6,23,.261,23,27,.852,109
15110,2013-03-26,LAC,@,DAL,L 102-109 (OT),265,38,85,.447,28,52,.538,10,33,.303,16,25,.640,102
15111,2013-03-26,DET,,MIN,L 82-105,240,32,79,.405,25,59,.424,7,20,.350,11,13,.846,82
15112,2013-03-26,MIN,@,DET,W 105-82,240,42,79,.532,28,53,.528,14,26,.538,7,8,.875,105
15113,2013-03-25,GSW,,LAL,W 109-103,240,43,90,.478,33,67,.493,10,23,.435,13,19,.684,109
15114,2013-03-25,LAL,@,GSW,L 103-109,240,36,91,.396,30,65,.462,6,26,.231,25,36,.694,103
15115,2013-03-25,ATL,@,IND,L 94-100,240,36,80,.450,29,59,.492,7,21,.333,15,25,.600,94
15116,2013-03-25,IND,,ATL,W 100-94,240,40,84,.476,32,61,.525,8,23,.348,12,15,.800,100
15117,2013-03-25,DEN,@,NOH,L 86-110,240,25,66,.379,20,50,.400,5,16,.313,31,39,.795,86
15118,2013-03-25,NOP,,DEN,W 110-86,240,41,85,.482,27,60,.450,14,25,.560,14,15,.933,110
15119,2013-03-25,MIA,@,ORL,W 108-94,240,37,78,.474,22,50,.440,15,28,.536,19,29,.655,108
15120,2013-03-25,ORL,,MIA,L 94-108,240,37,86,.430,28,62,.452,9,24,.375,11,18,.611,94
15121,2013-03-25,PHI,@,UTA,L 91-107,240,32,83,.386,28,69,.406,4,14,.286,23,28,.821,91
15122,2013-03-25,UTA,,PHI,W 107-91,240,41,84,.488,34,70,.486,7,14,.500,18,21,.857,107
15123,2013-03-25,MEM,@,WAS,L 94-107,240,34,77,.442,28,61,.459,6,16,.375,20,22,.909,94
15124,2013-03-25,WAS,,MEM,W 107-94,240,36,72,.500,31,59,.525,5,13,.385,30,44,.682,107
15125,2013-03-24,DAL,,UTA,W 113-108,240,38,70,.543,29,52,.558,9,18,.500,28,33,.848,113
15126,2013-03-24,UTA,@,DAL,L 108-113,240,42,82,.512,35,65,.538,7,17,.412,17,21,.810,108
15127,2013-03-24,HOU,,SAS,W 96-95,240,32,80,.400,23,54,.426,9,26,.346,23,27,.852,96
15128,2013-03-24,SAS,@,HOU,L 95-96,240,33,78,.423,23,56,.411,10,22,.455,19,21,.905,95
15129,2013-03-24,CHA,@,MIA,L 77-109,240,30,89,.337,25,64,.391,5,25,.200,12,18,.667,77
15130,2013-03-24,MIA,,CHA,W 109-77,240,38,76,.500,25,46,.543,13,30,.433,20,23,.870,109
15131,2013-03-24,ATL,@,MIL,W 104-99,240,39,78,.500,29,52,.558,10,26,.385,16,21,.762,104
15132,2013-03-24,MIL,,ATL,L 99-104,240,42,92,.457,37,71,.521,5,21,.238,10,18,.556,99
15133,2013-03-24,CHI,@,MIN,W 104-97,240,41,89,.461,31,63,.492,10,26,.385,12,17,.706,104
15134,2013-03-24,MIN,,CHI,L 97-104,240,39,78,.500,33,66,.500,6,12,.500,13,19,.684,97
15135,2013-03-24,OKC,,POR,W 103-83,240,43,82,.524,39,71,.549,4,11,.364,13,18,.722,103
15136,2013-03-24,POR,@,OKC,L 83-103,240,32,79,.405,22,53,.415,10,26,.385,9,13,.692,83
15137,2013-03-24,BRK,@,PHO,W 102-100,240,35,76,.461,31,62,.500,4,14,.286,28,31,.903,102
15138,2013-03-24,PHO,,BRK,L 100-102,240,41,99,.414,35,78,.449,6,21,.286,12,17,.706,100
15139,2013-03-24,PHI,@,SAC,W 117-103,240,47,96,.490,39,75,.520,8,21,.381,15,21,.714,117
15140,2013-03-24,SAC,,PHI,L 103-117,240,42,85,.494,33,61,.541,9,24,.375,10,12,.833,103
15141,2013-03-23,CHA,,DET,L 91-92,240,32,75,.427,28,58,.483,4,17,.235,23,25,.920,91
15142,2013-03-23,DET,@,CHA,W 92-91,240,36,79,.456,26,53,.491,10,26,.385,10,14,.714,92
15143,2013-03-23,CHI,,IND,W 87-84,240,35,81,.432,32,70,.457,3,11,.273,14,22,.636,87
15144,2013-03-23,IND,@,CHI,L 84-87,240,30,78,.385,25,64,.391,5,14,.357,19,24,.792,84
15145,2013-03-23,DEN,,SAC,W 101-95,240,37,85,.435,33,71,.465,4,14,.286,23,32,.719,101
15146,2013-03-23,SAC,@,DEN,L 95-101,240,39,86,.453,31,58,.534,8,28,.286,9,17,.529,95
15147,2013-03-23,GSW,,WAS,W 101-92,240,37,75,.493,27,55,.491,10,20,.500,17,22,.773,101
15148,2013-03-23,WAS,@,GSW,L 92-101,240,36,88,.409,29,71,.408,7,17,.412,13,16,.813,92
15149,2013-03-23,BRK,@,LAC,L 95-101,240,34,74,.459,25,49,.510,9,25,.360,18,24,.750,95
15150,2013-03-23,LAC,,BRK,W 101-95,240,37,79,.468,28,53,.528,9,26,.346,18,24,.750,101
15151,2013-03-23,BOS,@,MEM,L 106-110,240,38,74,.514,29,54,.537,9,20,.450,21,28,.750,106
15152,2013-03-23,MEM,,BOS,W 110-106,240,43,94,.457,39,83,.470,4,11,.364,20,24,.833,110
15153,2013-03-23,NYK,,TOR,W 110-84,240,41,79,.519,34,60,.567,7,19,.368,21,23,.913,110
15154,2013-03-23,TOR,@,NYK,L 84-110,240,34,76,.447,30,53,.566,4,23,.174,12,18,.667,84
15155,2013-03-22,ATL,,POR,L 93-104,240,37,83,.446,30,59,.508,7,24,.292,12,16,.750,93
15156,2013-03-22,POR,@,ATL,W 104-93,240,41,87,.471,31,69,.449,10,18,.556,12,16,.750,104
15157,2013-03-22,BOS,@,DAL,L 94-104,240,32,77,.416,27,60,.450,5,17,.294,25,27,.926,94
15158,2013-03-22,DAL,,BOS,W 104-94,240,38,82,.463,32,63,.508,6,19,.316,22,28,.786,104
15159,2013-03-22,CLE,@,HOU,L 78-116,240,31,86,.360,27,66,.409,4,20,.200,12,15,.800,78
15160,2013-03-22,HOU,,CLE,W 116-78,240,44,77,.571,34,48,.708,10,29,.345,18,27,.667,116
15161,2013-03-22,IND,,MIL,W 102-78,240,38,79,.481,35,67,.522,3,12,.250,23,30,.767,102
15162,2013-03-22,MIL,@,IND,L 78-102,240,31,101,.307,28,82,.341,3,19,.158,13,22,.591,78
15163,2013-03-22,LAL,,WAS,L 100-103,240,39,81,.481,28,58,.483,11,23,.478,11,17,.647,100
15164,2013-03-22,WAS,@,LAL,W 103-100,240,40,87,.460,29,61,.475,11,26,.423,12,16,.750,103
15165,2013-03-22,DET,@,MIA,L 89-103,240,34,83,.410,27,61,.443,7,22,.318,14,18,.778,89
15166,2013-03-22,MIA,,DET,W 103-89,240,38,68,.559,30,53,.566,8,15,.533,19,26,.731,103
15167,2013-03-22,MEM,@,NOH,L 83-90,240,30,73,.411,27,63,.429,3,10,.300,20,25,.800,83
15168,2013-03-22,NOP,,MEM,W 90-83,240,36,76,.474,32,62,.516,4,14,.286,14,18,.778,90
15169,2013-03-22,OKC,@,ORL,W 97-89,240,34,80,.425,29,59,.492,5,21,.238,24,33,.727,97
15170,2013-03-22,ORL,,OKC,L 89-97,240,38,92,.413,33,76,.434,5,16,.313,8,10,.800,89
15171,2013-03-22,MIN,@,PHO,W 117-86,240,42,79,.532,40,67,.597,2,12,.167,31,40,.775,117
15172,2013-03-22,PHO,,MIN,L 86-117,240,36,95,.379,32,73,.438,4,22,.182,10,21,.476,86
15173,2013-03-22,SAS,,UTA,W 104-97 (OT),265,39,84,.464,31,64,.484,8,20,.400,18,24,.750,104
15174,2013-03-22,UTA,@,SAS,L 97-104 (OT),265,41,96,.427,33,79,.418,8,17,.471,7,12,.583,97
15175,2013-03-22,NYK,@,TOR,W 99-94,240,38,71,.535,28,49,.571,10,22,.455,13,24,.542,99
15176,2013-03-22,TOR,,NYK,L 94-99,240,36,79,.456,25,47,.532,11,32,.344,11,14,.786,94
15177,2013-03-21,CHI,,POR,L 89-99,240,39,89,.438,35,75,.467,4,14,.286,7,11,.636,89
15178,2013-03-21,POR,@,CHI,W 99-89,240,41,84,.488,31,63,.492,10,21,.476,7,10,.700,99
15179,2013-03-21,DEN,,PHI,W 101-100,240,37,76,.487,30,65,.462,7,11,.636,20,27,.741,101
15180,2013-03-21,PHI,@,DEN,L 100-101,240,43,78,.551,36,60,.600,7,18,.389,7,11,.636,100
15181,2013-03-21,MIN,@,SAC,L 98-101,240,41,98,.418,40,79,.506,1,19,.053,15,18,.833,98
15182,2013-03-21,SAC,,MIN,W 101-98,240,40,75,.533,34,57,.596,6,18,.333,15,18,.833,101
15183,2013-03-20,ATL,,MIL,W 98-90,240,38,79,.481,30,61,.492,8,18,.444,14,17,.824,98
15184,2013-03-20,MIL,@,ATL,L 90-98,240,37,99,.374,29,80,.363,8,19,.421,8,11,.727,90
15185,2013-03-20,CHA,,TOR,W 107-101,240,35,75,.467,27,59,.458,8,16,.500,29,40,.725,107
15186,2013-03-20,TOR,@,CHA,L 101-107,240,35,83,.422,30,61,.492,5,22,.227,26,26,1.000,101
15187,2013-03-20,CLE,,MIA,L 95-98,240,37,81,.457,30,60,.500,7,21,.333,14,17,.824,95
15188,2013-03-20,MIA,@,CLE,W 98-95,240,32,72,.444,20,43,.465,12,29,.414,22,30,.733,98
15189,2013-03-20,BRK,@,DAL,W 113-96,240,45,89,.506,38,68,.559,7,21,.333,16,21,.762,113
15190,2013-03-20,DAL,,BRK,L 96-113,240,40,80,.500,33,61,.541,7,19,.368,9,15,.600,96
15191,2013-03-20,HOU,,UTA,W 100-93,240,34,76,.447,28,53,.528,6,23,.261,26,32,.813,100
15192,2013-03-20,UTA,@,HOU,L 93-100,240,36,79,.456,31,62,.500,5,17,.294,16,20,.800,93
15193,2013-03-20,LAC,,PHI,W 101-72,240,41,78,.526,35,58,.603,6,20,.300,13,19,.684,101
15194,2013-03-20,PHI,@,LAC,L 72-101,240,29,79,.367,23,59,.390,6,20,.300,8,10,.800,72
15195,2013-03-20,MEM,,OKC,W 90-89 (OT),265,32,89,.360,26,74,.351,6,15,.400,20,24,.833,90
15196,2013-03-20,OKC,@,MEM,L 89-90 (OT),265,30,84,.357,28,66,.424,2,18,.111,27,32,.844,89
15197,2013-03-20,BOS,@,NOH,L 86-87,240,33,72,.458,29,58,.500,4,14,.286,16,17,.941,86
15198,2013-03-20,NOP,,BOS,W 87-86,240,31,71,.437,26,55,.473,5,16,.313,20,26,.769,87
15199,2013-03-20,NYK,,ORL,W 106-94,240,40,76,.526,25,42,.595,15,34,.441,11,16,.688,106
15200,2013-03-20,ORL,@,NYK,L 94-106,240,38,79,.481,33,62,.532,5,17,.294,13,18,.722,94
15201,2013-03-20,PHO,,WAS,L 79-88,240,28,83,.337,25,68,.368,3,15,.200,20,22,.909,79
15202,2013-03-20,WAS,@,PHO,W 88-79,240,33,68,.485,27,53,.509,6,15,.400,16,25,.640,88
15203,2013-03-20,GSW,@,SAS,L 93-104,240,37,84,.440,31,72,.431,6,12,.500,13,15,.867,93
15204,2013-03-20,SAS,,GSW,W 104-93,240,41,85,.482,33,59,.559,8,26,.308,14,15,.933,104
15205,2013-03-19,IND,,ORL,W 95-73,240,34,87,.391,28,64,.438,6,23,.261,21,24,.875,95
15206,2013-03-19,ORL,@,IND,L 73-95,240,28,88,.318,25,73,.342,3,15,.200,14,21,.667,73
15207,2013-03-19,MIL,,POR,W 102-95,240,42,87,.483,33,68,.485,9,19,.474,9,13,.692,102
15208,2013-03-19,POR,@,MIL,L 95-102,240,36,83,.434,23,57,.404,13,26,.500,10,13,.769,95
15209,2013-03-19,DEN,@,OKC,W 114-104,240,43,96,.448,39,75,.520,4,21,.190,24,29,.828,114
15210,2013-03-19,OKC,,DEN,L 104-114,240,37,85,.435,33,60,.550,4,25,.160,26,31,.839,104
15211,2013-03-19,LAC,@,SAC,L 101-116,240,36,80,.450,27,54,.500,9,26,.346,20,26,.769,101
15212,2013-03-19,SAC,,LAC,W 116-101,240,37,73,.507,23,45,.511,14,28,.500,28,34,.824,116
15213,2013-03-18,ATL,,DAL,L 113-127,240,42,75,.560,34,54,.630,8,21,.381,21,29,.724,113
15214,2013-03-18,DAL,@,ATL,W 127-113,240,51,89,.573,38,67,.567,13,22,.591,12,14,.857,127
15215,2013-03-18,BOS,,MIA,L 103-105,240,39,72,.542,29,51,.569,10,21,.476,15,24,.625,103
15216,2013-03-18,MIA,@,BOS,W 105-103,240,42,85,.494,35,65,.538,7,20,.350,14,21,.667,105
15217,2013-03-18,CHA,,WAS,W 119-114,240,42,79,.532,33,57,.579,9,22,.409,26,33,.788,119
15218,2013-03-18,WAS,@,CHA,L 114-119,240,43,81,.531,37,66,.561,6,15,.400,22,29,.759,114
15219,2013-03-18,CHI,,DEN,L 118-119 (OT),265,47,96,.490,39,75,.520,8,21,.381,16,19,.842,118
15220,2013-03-18,DEN,@,CHI,W 119-118 (OT),265,46,100,.460,39,80,.488,7,20,.350,20,27,.741,119
15221,2013-03-18,CLE,,IND,L 90-111,240,35,92,.380,29,68,.426,6,24,.250,14,21,.667,90
15222,2013-03-18,IND,@,CLE,W 111-90,240,39,88,.443,31,66,.470,8,22,.364,25,29,.862,111
15223,2013-03-18,BRK,@,DET,W 119-82,240,45,83,.542,36,62,.581,9,21,.429,20,23,.870,119
15224,2013-03-18,DET,,BRK,L 82-119,240,34,78,.436,33,60,.550,1,18,.056,13,15,.867,82
15225,2013-03-18,MEM,,MIN,W 92-77,240,40,82,.488,35,66,.530,5,16,.313,7,11,.636,92
15226,2013-03-18,MIN,@,MEM,L 77-92,240,29,86,.337,23,62,.371,6,24,.250,13,18,.722,77
15227,2013-03-18,GSW,@,NOH,W 93-72,240,35,70,.500,25,51,.490,10,19,.526,13,15,.867,93
15228,2013-03-18,NOP,,GSW,L 72-93,240,28,83,.337,25,66,.379,3,17,.176,13,13,1.000,72
15229,2013-03-18,PHI,,POR,W 101-100,240,43,86,.500,38,70,.543,5,16,.313,10,13,.769,101
15230,2013-03-18,POR,@,PHI,L 100-101,240,38,90,.422,26,62,.419,12,28,.429,12,14,.857,100
15231,2013-03-18,LAL,@,PHO,L 76-99,240,29,87,.333,24,65,.369,5,22,.227,13,16,.813,76
15232,2013-03-18,PHO,,LAL,W 99-76,240,42,87,.483,34,67,.507,8,20,.400,7,15,.467,99
15233,2013-03-18,NYK,@,UTA,W 90-83,240,32,69,.464,24,46,.522,8,23,.348,18,25,.720,90
15234,2013-03-18,UTA,,NYK,L 83-90,240,29,76,.382,20,57,.351,9,19,.474,16,24,.667,83
15235,2013-03-17,ATL,@,BRK,W 105-93,240,44,84,.524,36,63,.571,8,21,.381,9,13,.692,105
15236,2013-03-17,BRK,,ATL,L 93-105,240,36,86,.419,28,63,.444,8,23,.348,13,16,.813,93
15237,2013-03-17,DAL,,OKC,L 101-107,240,38,83,.458,29,62,.468,9,21,.429,16,16,1.000,101
15238,2013-03-17,OKC,@,DAL,W 107-101,240,39,80,.488,34,59,.576,5,21,.238,24,30,.800,107
15239,2013-03-17,GSW,@,HOU,W 108-78,240,44,96,.458,31,70,.443,13,26,.500,7,9,.778,108
15240,2013-03-17,HOU,,GSW,L 78-108,240,28,86,.326,19,51,.373,9,35,.257,13,16,.813,78
15241,2013-03-17,LAC,,NYK,W 93-80,240,34,75,.453,26,47,.553,8,28,.286,17,31,.548,93
15242,2013-03-17,NYK,@,LAC,L 80-93,240,29,81,.358,17,55,.309,12,26,.462,10,14,.714,80
15243,2013-03-17,LAL,,SAC,W 113-102,240,41,72,.569,29,44,.659,12,28,.429,19,29,.655,113
15244,2013-03-17,SAC,@,LAL,L 102-113,240,42,96,.438,32,65,.492,10,31,.323,8,8,1.000,102
15245,2013-03-17,MIL,,ORL,W 115-109,240,40,90,.444,28,63,.444,12,27,.444,23,26,.885,115
15246,2013-03-17,ORL,@,MIL,L 109-115,240,47,93,.505,42,72,.583,5,21,.238,10,15,.667,109
15247,2013-03-17,MIN,,NOH,W 97-95,240,36,64,.563,31,49,.633,5,15,.333,20,27,.741,97
15248,2013-03-17,NOP,@,MIN,L 95-97,240,39,85,.459,34,72,.472,5,13,.385,12,16,.750,95
15249,2013-03-17,MIA,@,TOR,W 108-91,240,39,67,.582,29,45,.644,10,22,.455,20,29,.690,108
15250,2013-03-17,TOR,,MIA,L 91-108,240,39,94,.415,37,74,.500,2,20,.100,11,12,.917,91
15251,2013-03-16,BOS,,CHA,W 105-88,240,41,79,.519,31,64,.484,10,15,.667,13,20,.650,105
15252,2013-03-16,CHA,@,BOS,L 88-105,240,34,76,.447,27,56,.482,7,20,.350,13,21,.619,88
15253,2013-03-16,IND,@,PHI,L 91-98,240,34,88,.386,28,72,.389,6,16,.375,17,21,.810,91
15254,2013-03-16,PHI,,IND,W 98-91,240,39,79,.494,33,66,.500,6,13,.462,14,19,.737,98
15255,2013-03-16,DET,@,POR,L 101-112,240,40,76,.526,35,59,.593,5,17,.294,16,24,.667,101
15256,2013-03-16,POR,,DET,W 112-101,240,41,86,.477,34,67,.507,7,19,.368,23,24,.958,112
15257,2013-03-16,CLE,@,SAS,L 113-119,240,43,85,.506,36,70,.514,7,15,.467,20,31,.645,113
15258,2013-03-16,SAS,,CLE,W 119-113,240,45,78,.577,39,61,.639,6,17,.353,23,29,.793,119
15259,2013-03-16,MEM,@,UTA,L 84-90,240,33,77,.429,29,65,.446,4,12,.333,14,22,.636,84
15260,2013-03-16,UTA,,MEM,W 90-84,240,31,71,.437,26,55,.473,5,16,.313,23,31,.742,90
15261,2013-03-16,PHO,@,WAS,L 105-127,240,42,88,.477,36,67,.537,6,21,.286,15,20,.750,105
15262,2013-03-16,WAS,,PHO,W 127-105,240,48,93,.516,34,72,.472,14,21,.667,17,20,.850,127
15263,2013-03-15,ATL,,PHO,W 107-94,240,41,84,.488,29,61,.475,12,23,.522,13,16,.813,107
15264,2013-03-15,PHO,@,ATL,L 94-107,240,35,79,.443,32,60,.533,3,19,.158,21,31,.677,94
15265,2013-03-15,CLE,@,DAL,L 86-96,240,34,78,.436,27,62,.435,7,16,.438,11,18,.611,86
15266,2013-03-15,DAL,,CLE,W 96-86,240,41,82,.500,34,61,.557,7,21,.333,7,11,.636,96
15267,2013-03-15,DEN,,MEM,W 87-80,240,35,77,.455,34,65,.523,1,12,.083,16,22,.727,87
15268,2013-03-15,MEM,@,DEN,L 80-87,240,30,85,.353,26,73,.356,4,12,.333,16,19,.842,80
15269,2013-03-15,CHI,@,GSW,W 113-95,240,43,83,.518,35,67,.522,8,16,.500,19,22,.864,113
15270,2013-03-15,GSW,,CHI,L 95-113,240,34,76,.447,31,62,.500,3,14,.214,24,30,.800,95
15271,2013-03-15,HOU,,MIN,W 108-100,240,36,74,.486,25,43,.581,11,31,.355,25,31,.806,108
15272,2013-03-15,MIN,@,HOU,L 100-108,240,39,81,.481,33,57,.579,6,24,.250,16,20,.800,100
15273,2013-03-15,IND,,LAL,L 93-99,240,37,99,.374,25,72,.347,12,27,.444,7,9,.778,93
15274,2013-03-15,LAL,@,IND,W 99-93,240,33,78,.423,20,52,.385,13,26,.500,20,30,.667,99
15275,2013-03-15,MIA,@,MIL,W 107-94,240,41,79,.519,34,64,.531,7,15,.467,18,22,.818,107
15276,2013-03-15,MIL,,MIA,L 94-107,240,33,89,.371,24,64,.375,9,25,.360,19,21,.905,94
15277,2013-03-15,OKC,,ORL,W 117-104,240,42,76,.553,38,63,.603,4,13,.308,29,43,.674,117
15278,2013-03-15,ORL,@,OKC,L 104-117,240,40,92,.435,33,65,.508,7,27,.259,17,21,.810,104
15279,2013-03-15,CHA,@,TOR,L 78-92,240,26,80,.325,20,58,.345,6,22,.273,20,29,.690,78
15280,2013-03-15,TOR,,CHA,W 92-78,240,33,68,.485,30,58,.517,3,10,.300,23,27,.852,92
15281,2013-03-15,NOP,@,WAS,L 87-96,240,35,80,.438,32,61,.525,3,19,.158,14,19,.737,87
15282,2013-03-15,WAS,,NOH,W 96-87,240,36,72,.500,27,52,.519,9,20,.450,15,19,.789,96
15283,2013-03-14,NYK,@,POR,L 90-105,240,36,82,.439,29,57,.509,7,25,.280,11,17,.647,90
15284,2013-03-14,POR,,NYK,W 105-90,240,40,78,.513,30,50,.600,10,28,.357,15,21,.714,105
15285,2013-03-14,DAL,@,SAS,L 91-92,240,37,83,.446,29,64,.453,8,19,.421,9,10,.900,91
15286,2013-03-14,SAS,,DAL,W 92-91,240,37,84,.440,32,71,.451,5,13,.385,13,17,.765,92
15287,2013-03-13,ATL,,LAL,W 96-92,240,37,79,.468,29,57,.509,8,22,.364,14,21,.667,96
15288,2013-03-13,LAL,@,ATL,L 92-96,240,36,92,.391,28,63,.444,8,29,.276,12,16,.750,92
15289,2013-03-13,BOS,,TOR,W 112-88,240,39,76,.513,33,61,.541,6,15,.400,28,35,.800,112
15290,2013-03-13,TOR,@,BOS,L 88-112,240,34,79,.430,31,66,.470,3,13,.231,17,19,.895,88
15291,2013-03-13,DEN,,NYK,W 117-94,240,41,84,.488,32,63,.508,9,21,.429,26,37,.703,117
15292,2013-03-13,NYK,@,DEN,L 94-117,240,34,79,.430,23,51,.451,11,28,.393,15,22,.682,94
15293,2013-03-13,DET,@,GSW,L 97-105,240,40,89,.449,35,72,.486,5,17,.294,12,14,.857,97
15294,2013-03-13,GSW,,DET,W 105-97,240,41,72,.569,33,54,.611,8,18,.444,15,25,.600,105
15295,2013-03-13,HOU,,PHO,W 111-81,240,39,76,.513,29,55,.527,10,21,.476,23,30,.767,111
15296,2013-03-13,PHO,@,HOU,L 81-111,240,34,81,.420,28,60,.467,6,21,.286,7,10,.700,81
15297,2013-03-13,IND,,MIN,W 107-91,240,41,82,.500,32,57,.561,9,25,.360,16,26,.615,107
15298,2013-03-13,MIN,@,IND,L 91-107,240,35,80,.438,29,61,.475,6,19,.316,15,18,.833,91
15299,2013-03-13,LAC,,MEM,L 85-96,240,31,72,.431,25,46,.543,6,26,.231,17,18,.944,85
15300,2013-03-13,MEM,@,LAC,W 96-85,240,37,68,.544,31,56,.554,6,12,.500,16,21,.762,96
15301,2013-03-13,OKC,,UTA,W 110-87,240,37,69,.536,30,53,.566,7,16,.438,29,33,.879,110
15302,2013-03-13,UTA,@,OKC,L 87-110,240,28,80,.350,23,65,.354,5,15,.333,26,33,.788,87
15303,2013-03-13,MIA,@,PHI,W 98-94,240,35,75,.467,30,55,.545,5,20,.250,23,27,.852,98
15304,2013-03-13,PHI,,MIA,L 94-98,240,40,85,.471,33,67,.493,7,18,.389,7,12,.583,94
15305,2013-03-13,CHI,@,SAC,L 79-121,240,32,83,.386,30,62,.484,2,21,.095,13,15,.867,79
15306,2013-03-13,SAC,,CHI,W 121-79,240,45,83,.542,36,60,.600,9,23,.391,22,26,.846,121
15307,2013-03-13,MIL,@,WAS,L 93-106,240,39,85,.459,33,67,.493,6,18,.333,9,12,.750,93
15308,2013-03-13,WAS,,MIL,W 106-93,240,43,86,.500,35,70,.500,8,16,.500,12,24,.500,106
15309,2013-03-12,BRK,,NOH,W 108-98,240,40,80,.500,35,64,.547,5,16,.313,23,31,.742,108
15310,2013-03-12,NOP,@,BRK,L 98-108,240,40,78,.513,35,62,.565,5,16,.313,13,15,.867,98
15311,2013-03-12,BOS,@,CHA,L 74-100,240,27,66,.409,23,53,.434,4,13,.308,16,25,.640,74
15312,2013-03-12,CHA,,BOS,W 100-74,240,35,77,.455,29,60,.483,6,17,.353,24,30,.800,100
15313,2013-03-12,CLE,,WAS,W 95-90,240,34,83,.410,26,57,.456,8,26,.308,19,25,.760,95
15314,2013-03-12,WAS,@,CLE,L 90-95,240,31,76,.408,26,59,.441,5,17,.294,23,28,.821,90
15315,2013-03-12,ATL,@,MIA,L 81-98,240,33,78,.423,28,56,.500,5,22,.227,10,14,.714,81
15316,2013-03-12,MIA,,ATL,W 98-81,240,35,82,.427,29,62,.468,6,20,.300,22,30,.733,98
15317,2013-03-12,DAL,@,MIL,W 115-108,240,41,82,.500,30,53,.566,11,29,.379,22,27,.815,115
15318,2013-03-12,MIL,,DAL,L 108-115,240,43,89,.483,35,68,.515,8,21,.381,14,17,.824,108
15319,2013-03-12,MIN,,SAS,W 107-83,240,44,82,.537,32,62,.516,12,20,.600,7,18,.389,107
15320,2013-03-12,SAS,@,MIN,L 83-107,240,29,82,.354,20,53,.377,9,29,.310,16,18,.889,83
15321,2013-03-12,LAL,@,ORL,W 106-97,240,34,73,.466,25,48,.521,9,25,.360,29,47,.617,106
15322,2013-03-12,ORL,,LAL,L 97-106,240,37,93,.398,27,61,.443,10,32,.313,13,17,.765,97
15323,2013-03-12,MEM,@,POR,W 102-97,240,39,76,.513,36,65,.554,3,11,.273,21,31,.677,102
15324,2013-03-12,POR,,MEM,L 97-102,240,32,79,.405,27,63,.429,5,16,.313,28,29,.966,97
15325,2013-03-11,GSW,,NYK,W 92-63,240,32,78,.410,21,58,.362,11,20,.550,17,24,.708,92
15326,2013-03-11,NYK,@,GSW,L 63-92,240,20,73,.274,15,46,.326,5,27,.185,18,28,.643,63
15327,2013-03-11,BRK,@,PHI,L 97-106,240,40,81,.494,34,62,.548,6,19,.316,11,16,.688,97
15328,2013-03-11,PHI,,BRK,W 106-97,240,40,76,.526,32,61,.525,8,15,.533,18,27,.667,106
15329,2013-03-11,DEN,@,PHO,W 108-93,240,44,86,.512,41,74,.554,3,12,.250,17,25,.680,108
15330,2013-03-11,PHO,,DEN,L 93-108,240,35,84,.417,29,64,.453,6,20,.300,17,22,.773,93
15331,2013-03-11,OKC,@,SAS,L 93-105,240,33,77,.429,27,60,.450,6,17,.353,21,24,.875,93
15332,2013-03-11,SAS,,OKC,W 105-93,240,43,82,.524,35,61,.574,8,21,.381,11,14,.786,105
15333,2013-03-11,DET,@,UTA,L 90-103,240,34,80,.425,27,60,.450,7,20,.350,15,18,.833,90
15334,2013-03-11,UTA,,DET,W 103-90,240,42,81,.519,36,65,.554,6,16,.375,13,15,.867,103
15335,2013-03-10,DET,@,LAC,L 97-129,240,30,64,.469,19,41,.463,11,23,.478,26,42,.619,97
15336,2013-03-10,LAC,,DET,W 129-97,240,50,80,.625,36,52,.692,14,28,.500,15,25,.600,129
15337,2013-03-10,CHI,@,LAL,L 81-90,240,33,89,.371,29,73,.397,4,16,.250,11,12,.917,81
15338,2013-03-10,LAL,,CHI,W 90-81,240,39,86,.453,34,60,.567,5,26,.192,7,14,.500,90
15339,2013-03-10,IND,@,MIA,L 91-105,240,26,63,.413,16,36,.444,10,27,.370,29,34,.853,91
15340,2013-03-10,MIA,,IND,W 105-91,240,38,68,.559,31,54,.574,7,14,.500,22,31,.710,105
15341,2013-03-10,DAL,@,MIN,W 100-77,240,42,92,.457,34,71,.479,8,21,.381,8,10,.800,100
15342,2013-03-10,MIN,,DAL,L 77-100,240,32,88,.364,30,70,.429,2,18,.111,11,14,.786,77
15343,2013-03-10,NOP,,POR,W 98-96,240,40,86,.465,29,66,.439,11,20,.550,7,9,.778,98
15344,2013-03-10,POR,@,NOH,L 96-98,240,37,76,.487,26,51,.510,11,25,.440,11,12,.917,96
15345,2013-03-10,BOS,@,OKC,L 79-91,240,29,77,.377,22,57,.386,7,20,.350,14,20,.700,79
15346,2013-03-10,OKC,,BOS,W 91-79,240,30,68,.441,26,52,.500,4,16,.250,27,33,.818,91
15347,2013-03-10,ORL,,PHI,W 99-91,240,41,83,.494,29,56,.518,12,27,.444,5,7,.714,99
15348,2013-03-10,PHI,@,ORL,L 91-99,240,40,86,.465,35,74,.473,5,12,.417,6,10,.600,91
15349,2013-03-10,MIL,@,SAC,W 115-113,240,40,87,.460,33,68,.485,7,19,.368,28,38,.737,115
15350,2013-03-10,SAC,,MIL,L 113-115,240,44,94,.468,38,72,.528,6,22,.273,19,25,.760,113
15351,2013-03-10,CLE,@,TOR,L 96-100,240,36,86,.419,29,65,.446,7,21,.333,17,27,.630,96
15352,2013-03-10,TOR,,CLE,W 100-96,240,33,84,.393,25,61,.410,8,23,.348,26,34,.765,100
15353,2013-03-09,ATL,,BRK,L 80-93,240,32,77,.416,27,59,.458,5,18,.278,11,16,.688,80
15354,2013-03-09,BRK,@,ATL,W 93-80,240,36,83,.434,30,60,.500,6,23,.261,15,22,.682,93
15355,2013-03-09,DEN,,MIN,W 111-88,240,42,78,.538,33,61,.541,9,17,.529,18,22,.818,111
15356,2013-03-09,MIN,@,DEN,L 88-111,240,35,84,.417,30,66,.455,5,18,.278,13,19,.684,88
15357,2013-03-09,GSW,,MIL,L 93-103,240,37,82,.451,31,67,.463,6,15,.400,13,20,.650,93
15358,2013-03-09,MIL,@,GSW,W 103-93,240,38,78,.487,25,50,.500,13,28,.464,14,19,.737,103
15359,2013-03-09,MEM,,NOH,W 96-85,240,38,81,.469,34,68,.500,4,13,.308,16,20,.800,96
15360,2013-03-09,NOP,@,MEM,L 85-96,240,34,79,.430,32,67,.478,2,12,.167,15,17,.882,85
15361,2013-03-09,NYK,,UTA,W 113-84,240,38,75,.507,25,43,.581,13,32,.406,24,30,.800,113
15362,2013-03-09,UTA,@,NYK,L 84-113,240,30,78,.385,22,52,.423,8,26,.308,16,21,.762,84
15363,2013-03-09,HOU,@,PHO,L 105-107,240,37,86,.430,18,45,.400,19,41,.463,12,18,.667,105
15364,2013-03-09,PHO,,HOU,W 107-105,240,37,82,.451,29,64,.453,8,18,.444,25,39,.641,107
15365,2013-03-09,CHA,@,WAS,L 87-104,240,32,79,.405,27,64,.422,5,15,.333,18,23,.783,87
15366,2013-03-09,WAS,,CHA,W 104-87,240,35,70,.500,25,52,.481,10,18,.556,24,32,.750,104
15367,2013-03-08,ATL,@,BOS,L 102-107 (OT),265,40,88,.455,31,61,.508,9,27,.333,13,17,.765,102
15368,2013-03-08,BOS,,ATL,W 107-102 (OT),265,40,78,.513,30,58,.517,10,20,.500,17,20,.850,107
15369,2013-03-08,BRK,,WAS,W 95-78,240,32,81,.395,20,54,.370,12,27,.444,19,33,.576,95
15370,2013-03-08,WAS,@,BRK,L 78-95,240,32,90,.356,29,73,.397,3,17,.176,11,17,.647,78
15371,2013-03-08,CHA,,OKC,L 94-116,240,35,85,.412,28,62,.452,7,23,.304,17,25,.680,94
15372,2013-03-08,OKC,@,CHA,W 116-94,240,46,81,.568,34,57,.596,12,24,.500,12,16,.750,116
15373,2013-03-08,CHI,,UTA,W 89-88,240,30,81,.370,26,64,.406,4,17,.235,25,30,.833,89
15374,2013-03-08,UTA,@,CHI,L 88-89,240,37,81,.457,35,71,.493,2,10,.200,12,18,.667,88
15375,2013-03-08,CLE,,MEM,L 92-103,240,33,72,.458,27,58,.466,6,14,.429,20,26,.769,92
15376,2013-03-08,MEM,@,CLE,W 103-92,240,45,86,.523,41,75,.547,4,11,.364,9,11,.818,103
15377,2013-03-08,DAL,@,DET,W 102-99,240,41,78,.526,30,56,.536,11,22,.500,9,15,.600,102
15378,2013-03-08,DET,,DAL,L 99-102,240,39,96,.406,30,66,.455,9,30,.300,12,19,.632,99
15379,2013-03-08,GSW,,HOU,L 88-94,240,33,87,.379,24,66,.364,9,21,.429,13,20,.650,88
15380,2013-03-08,HOU,@,GSW,W 94-88,240,27,74,.365,12,39,.308,15,35,.429,25,34,.735,94
15381,2013-03-08,LAL,,TOR,W 118-116 (OT),265,39,91,.429,25,52,.481,14,39,.359,26,36,.722,118
15382,2013-03-08,TOR,@,LAL,L 116-118 (OT),265,48,93,.516,40,71,.563,8,22,.364,12,16,.750,116
15383,2013-03-08,MIA,,PHI,W 102-93,240,42,79,.532,34,58,.586,8,21,.381,10,13,.769,102
15384,2013-03-08,PHI,@,MIA,L 93-102,240,37,77,.481,27,56,.482,10,21,.476,9,11,.818,93
15385,2013-03-08,IND,@,ORL,W 115-86,240,43,83,.518,32,64,.500,11,19,.579,18,23,.783,115
15386,2013-03-08,ORL,,IND,L 86-115,240,32,82,.390,27,67,.403,5,15,.333,17,19,.895,86
15387,2013-03-08,PHO,@,SAC,L 112-121,240,43,90,.478,36,67,.537,7,23,.304,19,23,.826,112
15388,2013-03-08,SAC,,PHO,W 121-112,240,45,82,.549,32,55,.582,13,27,.481,18,21,.857,121
15389,2013-03-08,POR,@,SAS,W 136-106,240,53,86,.616,40,65,.615,13,21,.619,17,21,.810,136
15390,2013-03-08,SAS,,POR,L 106-136,240,44,84,.524,38,65,.585,6,19,.316,12,15,.800,106
15391,2013-03-07,DEN,,LAC,W 107-92,240,43,77,.558,32,54,.593,11,23,.478,10,12,.833,107
15392,2013-03-07,LAC,@,DEN,L 92-107,240,36,85,.424,29,63,.460,7,22,.318,13,16,.813,92
15393,2013-03-07,NYK,,OKC,L 94-95,240,35,86,.407,25,55,.455,10,31,.323,14,14,1.000,94
15394,2013-03-07,OKC,@,NYK,W 95-94,240,31,70,.443,23,49,.469,8,21,.381,25,29,.862,95
15395,2013-03-06,ATL,,PHI,W 107-96,240,43,80,.538,32,56,.571,11,24,.458,10,17,.588,107
15396,2013-03-06,PHI,@,ATL,L 96-107,240,37,86,.430,31,69,.449,6,17,.353,16,21,.762,96
15397,2013-03-06,BRK,@,CHA,W 99-78,240,34,67,.507,21,40,.525,13,27,.481,18,22,.818,99
15398,2013-03-06,CHA,,BRK,L 78-99,240,32,84,.381,28,66,.424,4,18,.222,10,15,.667,78
15399,2013-03-06,CLE,,UTA,W 104-101,240,37,90,.411,30,74,.405,7,16,.438,23,29,.793,104
15400,2013-03-06,UTA,@,CLE,L 101-104,240,38,87,.437,29,68,.426,9,19,.474,16,19,.842,101
15401,2013-03-06,DAL,,HOU,W 112-108,240,45,83,.542,34,57,.596,11,26,.423,11,14,.786,112
15402,2013-03-06,HOU,@,DAL,L 108-112,240,35,78,.449,23,46,.500,12,32,.375,26,33,.788,108
15403,2013-03-06,DET,,NYK,L 77-87,240,32,74,.432,25,54,.463,7,20,.350,6,10,.600,77
15404,2013-03-06,NYK,@,DET,W 87-77,240,31,75,.413,18,40,.450,13,35,.371,12,15,.800,87
15405,2013-03-06,GSW,,SAC,W 87-83,240,27,75,.360,19,52,.365,8,23,.348,25,29,.862,87
15406,2013-03-06,SAC,@,GSW,L 83-87,240,33,83,.398,25,59,.424,8,24,.333,9,12,.750,83
15407,2013-03-06,BOS,@,IND,W 83-81,240,34,83,.410,27,66,.409,7,17,.412,8,9,.889,83
15408,2013-03-06,IND,,BOS,L 81-83,240,32,88,.364,26,61,.426,6,27,.222,11,14,.786,81
15409,2013-03-06,LAC,,MIL,W 117-101,240,47,87,.540,35,58,.603,12,29,.414,11,14,.786,117
15410,2013-03-06,MIL,@,LAC,L 101-117,240,38,79,.481,25,50,.500,13,29,.448,12,15,.800,101
15411,2013-03-06,MEM,,POR,W 91-85,240,38,87,.437,34,75,.453,4,12,.333,11,18,.611,91
15412,2013-03-06,POR,@,MEM,L 85-91,240,31,76,.408,25,56,.446,6,20,.300,17,28,.607,85
15413,2013-03-06,MIA,,ORL,W 97-96,240,32,74,.432,26,46,.565,6,28,.214,27,31,.871,97
15414,2013-03-06,ORL,@,MIA,L 96-97,240,40,89,.449,34,61,.557,6,28,.214,10,12,.833,96
15415,2013-03-06,MIN,,WAS,W 87-82,240,31,76,.408,27,62,.435,4,14,.286,21,31,.677,87
15416,2013-03-06,WAS,@,MIN,L 82-87,240,29,65,.446,23,46,.500,6,19,.316,18,22,.818,82
15417,2013-03-06,LAL,@,NOH,W 108-102,240,38,78,.487,27,50,.540,11,28,.393,21,29,.724,108
15418,2013-03-06,NOP,,LAL,L 102-108,240,38,88,.432,29,64,.453,9,24,.375,17,20,.850,102
15419,2013-03-06,PHO,,TOR,L 71-98,240,28,74,.378,21,51,.412,7,23,.304,8,15,.533,71
15420,2013-03-06,TOR,@,PHO,W 98-71,240,37,77,.481,26,53,.491,11,24,.458,13,15,.867,98
15421,2013-03-06,CHI,@,SAS,L 83-101,240,33,90,.367,24,70,.343,9,20,.450,8,8,1.000,83
15422,2013-03-06,SAS,,CHI,W 101-83,240,40,74,.541,32,60,.533,8,14,.571,13,18,.722,101
15423,2013-03-05,LAL,@,OKC,L 105-122,240,31,77,.403,19,48,.396,12,29,.414,31,40,.775,105
15424,2013-03-05,OKC,,LAL,W 122-105,240,46,96,.479,38,73,.521,8,23,.348,22,24,.917,122
15425,2013-03-05,BOS,@,PHI,W 109-101,240,42,83,.506,31,64,.484,11,19,.579,14,16,.875,109
15426,2013-03-05,PHI,,BOS,L 101-109,240,41,100,.410,36,79,.456,5,21,.238,14,18,.778,101
15427,2013-03-05,DEN,@,SAC,W 120-113,240,46,85,.541,38,69,.551,8,16,.500,20,32,.625,120
15428,2013-03-05,SAC,,DEN,L 113-120,240,39,85,.459,27,54,.500,12,31,.387,23,28,.821,113
15429,2013-03-04,CLE,,NYK,L 97-102,240,37,73,.507,31,53,.585,6,20,.300,17,24,.708,97
15430,2013-03-04,NYK,@,CLE,W 102-97,240,36,78,.462,24,48,.500,12,30,.400,18,21,.857,102
15431,2013-03-04,ATL,@,DEN,L 88-104,240,36,89,.404,29,65,.446,7,24,.292,9,11,.818,88
15432,2013-03-04,DEN,,ATL,W 104-88,240,46,86,.535,41,71,.577,5,15,.333,7,9,.778,104
15433,2013-03-04,GSW,,TOR,W 125-118,240,47,82,.573,39,65,.600,8,17,.471,23,28,.821,125
15434,2013-03-04,TOR,@,GSW,L 118-125,240,41,94,.436,32,68,.471,9,26,.346,27,35,.771,118
15435,2013-03-04,MIL,,UTA,W 109-108 (OT),265,45,95,.474,35,71,.493,10,24,.417,9,13,.692,109
15436,2013-03-04,UTA,@,MIL,L 108-109 (OT),265,40,99,.404,36,86,.419,4,13,.308,24,31,.774,108
15437,2013-03-04,MIA,@,MIN,W 97-81,240,38,74,.514,33,53,.623,5,21,.238,16,19,.842,97
15438,2013-03-04,MIN,,MIA,L 81-97,240,33,88,.375,28,68,.412,5,20,.250,10,15,.667,81
15439,2013-03-04,NOP,,ORL,L 102-105,240,37,80,.463,29,59,.492,8,21,.381,20,26,.769,102
15440,2013-03-04,ORL,@,NOH,W 105-102,240,43,87,.494,36,66,.545,7,21,.333,12,16,.750,105
15441,2013-03-04,CHA,@,POR,L 105-122,240,45,97,.464,44,87,.506,1,10,.100,14,18,.778,105
15442,2013-03-04,POR,,CHA,W 122-105,240,49,82,.598,37,58,.638,12,24,.500,12,17,.706,122
15443,2013-03-03,DAL,@,HOU,L 103-136,240,38,80,.475,26,53,.491,12,27,.444,15,24,.625,103
15444,2013-03-03,HOU,,DAL,W 136-103,240,46,80,.575,32,46,.696,14,34,.412,30,40,.750,136
15445,2013-03-03,CHI,@,IND,L 92-97,240,35,81,.432,27,62,.435,8,19,.421,14,18,.778,92
15446,2013-03-03,IND,,CHI,W 97-92,240,33,71,.465,27,58,.466,6,13,.462,25,33,.758,97
15447,2013-03-03,LAC,,OKC,L 104-108,240,38,82,.463,29,58,.500,9,24,.375,19,22,.864,104
15448,2013-03-03,OKC,@,LAC,W 108-104,240,38,80,.475,31,59,.525,7,21,.333,25,34,.735,108
15449,2013-03-03,ATL,@,LAL,L 98-99,240,41,82,.500,33,60,.550,8,22,.364,8,15,.533,98
15450,2013-03-03,LAL,,ATL,W 99-98,240,38,78,.487,28,57,.491,10,21,.476,13,18,.722,99
15451,2013-03-03,MIA,@,NYK,W 99-93,240,39,84,.464,31,64,.484,8,20,.400,13,19,.684,99
15452,2013-03-03,NYK,,MIA,L 93-99,240,32,74,.432,24,45,.533,8,29,.276,21,26,.808,93
15453,2013-03-03,MEM,@,ORL,W 108-82,240,44,83,.530,33,59,.559,11,24,.458,9,15,.600,108
15454,2013-03-03,ORL,,MEM,L 82-108,240,29,73,.397,27,58,.466,2,15,.133,22,26,.846,82
15455,2013-03-03,CHA,@,SAC,L 83-119,240,28,77,.364,22,54,.407,6,23,.261,21,27,.778,83
15456,2013-03-03,SAC,,CHA,W 119-83,240,42,90,.467,29,57,.509,13,33,.394,22,27,.815,119
15457,2013-03-03,DET,@,SAS,L 75-114,240,28,86,.326,22,67,.328,6,19,.316,13,18,.722,75
15458,2013-03-03,SAS,,DET,W 114-75,240,45,89,.506,36,69,.522,9,20,.450,15,20,.750,114
15459,2013-03-03,PHI,@,WAS,L 87-90,240,33,85,.388,27,66,.409,6,19,.316,15,20,.750,87
15460,2013-03-03,WAS,,PHI,W 90-87,240,34,80,.425,28,65,.431,6,15,.400,16,21,.762,90
15461,2013-03-02,BRK,@,CHI,L 85-96,240,32,72,.444,27,57,.474,5,15,.333,16,23,.696,85
15462,2013-03-02,CHI,,BRK,W 96-85,240,38,73,.521,32,58,.552,6,15,.400,14,14,1.000,96
15463,2013-03-02,MIL,,TOR,W 122-114 (OT),265,46,92,.500,41,78,.526,5,14,.357,25,30,.833,122
15464,2013-03-02,TOR,@,MIL,L 114-122 (OT),265,46,100,.460,38,78,.487,8,22,.364,14,18,.778,114
15465,2013-03-02,GSW,@,PHI,L 97-104,240,36,86,.419,26,60,.433,10,26,.385,15,19,.789,97
15466,2013-03-02,PHI,,GSW,W 104-97,240,44,85,.518,32,67,.478,12,18,.667,4,9,.444,104
15467,2013-03-02,MIN,@,POR,L 94-109,240,34,87,.391,33,75,.440,1,12,.083,25,36,.694,94
15468,2013-03-02,POR,,MIN,W 109-94,240,44,90,.489,37,70,.529,7,20,.350,14,22,.636,109
15469,2013-03-01,BOS,,GSW,W 94-86,240,36,75,.480,33,60,.550,3,15,.200,19,28,.679,94
15470,2013-03-01,GSW,@,BOS,L 86-94,240,32,94,.340,27,71,.380,5,23,.217,17,22,.773,86
15471,2013-03-01,BRK,,DAL,L 90-98,240,36,78,.462,29,55,.527,7,23,.304,11,14,.786,90
15472,2013-03-01,DAL,@,BRK,W 98-90,240,39,78,.500,30,57,.526,9,21,.429,11,14,.786,98
15473,2013-03-01,CLE,,LAC,L 89-105,240,33,74,.446,28,58,.483,5,16,.313,18,28,.643,89
15474,2013-03-01,LAC,@,CLE,W 105-89,240,43,83,.518,36,58,.621,7,25,.280,12,20,.600,105
15475,2013-03-01,DEN,,OKC,W 105-103,240,43,95,.453,36,74,.486,7,21,.333,12,17,.706,105
15476,2013-03-01,OKC,@,DEN,L 103-105,240,36,83,.434,29,63,.460,7,20,.350,24,34,.706,103
15477,2013-03-01,MEM,@,MIA,L 91-98,240,33,77,.429,29,64,.453,4,13,.308,21,27,.778,91
15478,2013-03-01,MIA,,MEM,W 98-91,240,34,73,.466,24,54,.444,10,19,.526,20,27,.741,98
15479,2013-03-01,DET,@,NOH,L 95-100,240,39,78,.500,32,59,.542,7,19,.368,10,16,.625,95
15480,2013-03-01,NOP,,DET,W 100-95,240,35,81,.432,28,61,.459,7,20,.350,23,31,.742,100
15481,2013-03-01,HOU,@,ORL,W 118-110,240,42,77,.545,27,45,.600,15,32,.469,19,28,.679,118
15482,2013-03-01,ORL,,HOU,L 110-118,240,44,78,.564,35,56,.625,9,22,.409,13,16,.813,110
15483,2013-03-01,ATL,@,PHO,L 87-92,240,31,73,.425,23,50,.460,8,23,.348,17,22,.773,87
15484,2013-03-01,PHO,,ATL,W 92-87,240,36,81,.444,26,59,.441,10,22,.455,10,12,.833,92
15485,2013-03-01,SAC,@,SAS,L 102-130,240,39,85,.459,32,64,.500,7,21,.333,17,19,.895,102
15486,2013-03-01,SAS,,SAC,W 130-102,240,51,84,.607,42,64,.656,9,20,.450,19,23,.826,130
15487,2013-03-01,IND,@,TOR,W 93-81,240,34,70,.486,27,50,.540,7,20,.350,18,22,.818,93
15488,2013-03-01,TOR,,IND,L 81-93,240,29,72,.403,26,61,.426,3,11,.273,20,25,.800,81
15489,2013-03-01,CHA,@,UTA,L 68-98,240,28,81,.346,23,63,.365,5,18,.278,7,12,.583,68
15490,2013-03-01,UTA,,CHA,W 98-68,240,38,78,.487,33,62,.532,5,16,.313,17,23,.739,98
15491,2013-03-01,NYK,@,WAS,W 96-88,240,35,81,.432,27,53,.509,8,28,.286,18,21,.857,96
15492,2013-03-01,WAS,,NYK,L 88-96,240,31,74,.419,24,58,.414,7,16,.438,19,29,.655,88
15493,2013-02-28,CHI,,PHI,W 93-82,240,32,83,.386,29,69,.420,3,14,.214,26,33,.788,93
15494,2013-02-28,PHI,@,CHI,L 82-93,240,33,85,.388,29,74,.392,4,11,.364,12,21,.571,82
15495,2013-02-28,IND,,LAC,L 91-99,240,32,75,.427,23,50,.460,9,25,.360,18,25,.720,91
15496,2013-02-28,LAC,@,IND,W 99-91,240,39,80,.488,35,57,.614,4,23,.174,17,21,.810,99
15497,2013-02-28,LAL,,MIN,W 116-94,240,44,83,.530,28,51,.549,16,32,.500,12,21,.571,116
15498,2013-02-28,MIN,@,LAL,L 94-116,240,37,81,.457,30,60,.500,7,21,.333,13,15,.867,94
15499,2013-02-27,CLE,,TOR,W 103-92,240,34,82,.415,29,69,.420,5,13,.385,30,32,.938,103
15500,2013-02-27,TOR,@,CLE,L 92-103,240,35,78,.449,33,58,.569,2,20,.100,20,25,.800,92
15501,2013-02-27,HOU,,MIL,L 107-110,240,42,89,.472,35,66,.530,7,23,.304,16,25,.640,107
15502,2013-02-27,MIL,@,HOU,W 110-107,240,43,89,.483,34,65,.523,9,24,.375,15,20,.750,110
15503,2013-02-27,DAL,@,MEM,L 84-90,240,33,76,.434,30,64,.469,3,12,.250,15,19,.789,84
15504,2013-02-27,MEM,,DAL,W 90-84,240,29,78,.372,24,64,.375,5,14,.357,27,34,.794,90
15505,2013-02-27,GSW,@,NYK,L 105-109,240,36,72,.500,21,45,.467,15,27,.556,18,21,.857,105
15506,2013-02-27,NYK,,GSW,W 109-105,240,36,87,.414,25,53,.472,11,34,.324,26,33,.788,109
15507,2013-02-27,NOP,@,OKC,L 74-119,240,27,77,.351,21,56,.375,6,21,.286,14,18,.778,74
15508,2013-02-27,OKC,,NOH,W 119-74,240,42,76,.553,34,58,.586,8,18,.444,27,28,.964,119
15509,2013-02-27,ORL,,SAC,L 101-125,240,37,83,.446,31,64,.484,6,19,.316,21,25,.840,101
15510,2013-02-27,SAC,@,ORL,W 125-101,240,46,84,.548,36,62,.581,10,22,.455,23,29,.793,125
15511,2013-02-27,DEN,@,POR,W 111-109,240,45,87,.517,42,73,.575,3,14,.214,18,31,.581,111
15512,2013-02-27,POR,,DEN,L 109-111,240,38,85,.447,28,60,.467,10,25,.400,23,27,.852,109
15513,2013-02-27,PHO,@,SAS,W 105-101 (OT),265,44,95,.463,41,83,.494,3,12,.250,14,21,.667,105
15514,2013-02-27,SAS,,PHO,L 101-105 (OT),265,35,81,.432,29,64,.453,6,17,.353,25,35,.714,101
15515,2013-02-27,ATL,@,UTA,W 102-91,240,38,78,.487,33,61,.541,5,17,.294,21,26,.808,102
15516,2013-02-27,UTA,,ATL,L 91-102,240,37,83,.446,33,68,.485,4,15,.267,13,23,.565,91
15517,2013-02-27,DET,@,WAS,W 96-95,240,39,72,.542,30,57,.526,9,15,.600,9,16,.563,96
15518,2013-02-27,WAS,,DET,L 95-96,240,40,84,.476,32,65,.492,8,19,.421,7,10,.700,95
15519,2013-02-26,CHI,,CLE,L 98-101,240,39,78,.500,30,57,.526,9,21,.429,11,15,.733,98
15520,2013-02-26,CLE,@,CHI,W 101-98,240,40,81,.494,35,64,.547,5,17,.294,16,19,.842,101
15521,2013-02-26,DAL,,MIL,L 90-95,240,36,85,.424,35,68,.515,1,17,.059,17,21,.810,90
15522,2013-02-26,MIL,@,DAL,W 95-90,240,34,82,.415,27,64,.422,7,18,.389,20,26,.769,95
15523,2013-02-26,GSW,@,IND,L 97-108,240,33,76,.434,21,55,.382,12,21,.571,19,24,.792,97
15524,2013-02-26,IND,,GSW,W 108-97,240,41,84,.488,35,63,.556,6,21,.286,20,27,.741,108
15525,2013-02-26,CHA,@,LAC,L 84-106,240,33,81,.407,27,65,.415,6,16,.375,12,14,.857,84
15526,2013-02-26,LAC,,CHA,W 106-84,240,41,76,.539,29,54,.537,12,22,.545,12,26,.462,106
15527,2013-02-26,MIA,,SAC,W 141-129 (2OT),290,56,101,.554,46,78,.590,10,23,.435,19,24,.792,141
15528,2013-02-26,SAC,@,MIA,L 129-141 (2OT),290,48,93,.516,34,66,.515,14,27,.519,19,26,.731,129
15529,2013-02-26,BRK,@,NOH,W 101-97,240,37,76,.487,25,56,.446,12,20,.600,15,18,.833,101
15530,2013-02-26,NOP,,BRK,L 97-101,240,40,87,.460,35,73,.479,5,14,.357,12,15,.800,97
15531,2013-02-26,ORL,@,PHI,W 98-84,240,41,76,.539,36,63,.571,5,13,.385,11,16,.688,98
15532,2013-02-26,PHI,,ORL,L 84-98,240,32,81,.395,25,60,.417,7,21,.333,13,18,.722,84
15533,2013-02-26,MIN,@,PHO,L 83-84 (OT),265,31,90,.344,26,71,.366,5,19,.263,16,25,.640,83
15534,2013-02-26,PHO,,MIN,W 84-83 (OT),265,37,91,.407,32,78,.410,5,13,.385,5,14,.357,84
15535,2013-02-25,DEN,,LAL,W 119-108,240,49,88,.557,44,70,.629,5,18,.278,16,27,.593,119
15536,2013-02-25,LAL,@,DEN,L 108-119,240,43,78,.551,35,59,.593,8,19,.421,14,31,.452,108
15537,2013-02-25,ATL,@,DET,W 114-103,240,40,79,.506,26,46,.565,14,33,.424,20,24,.833,114
15538,2013-02-25,DET,,ATL,L 103-114,240,41,84,.488,38,70,.543,3,14,.214,18,22,.818,103
15539,2013-02-25,TOR,,WAS,L 84-90,240,29,79,.367,24,60,.400,5,19,.263,21,27,.778,84
15540,2013-02-25,WAS,@,TOR,W 90-84,240,34,81,.420,27,69,.391,7,12,.583,15,17,.882,90
15541,2013-02-25,BOS,@,UTA,W 110-107 (OT),265,41,86,.477,31,59,.525,10,27,.370,18,20,.900,110
15542,2013-02-25,UTA,,BOS,L 107-110 (OT),265,39,88,.443,31,71,.437,8,17,.471,21,24,.875,107
15543,2013-02-24,BRK,,MEM,L 72-76,240,29,77,.377,20,56,.357,9,21,.429,5,13,.385,72
15544,2013-02-24,MEM,@,BRK,W 76-72,240,32,71,.451,30,64,.469,2,7,.286,10,12,.833,76
15545,2013-02-24,DAL,,LAL,L 99-103,240,39,87,.448,31,69,.449,8,18,.444,13,19,.684,99
15546,2013-02-24,LAL,@,DAL,W 103-99,240,34,72,.472,21,47,.447,13,25,.520,22,31,.710,103
15547,2013-02-24,CLE,@,MIA,L 105-109,240,39,78,.500,31,58,.534,8,20,.400,19,24,.792,105
15548,2013-02-24,MIA,,CLE,W 109-105,240,39,75,.520,27,56,.482,12,19,.632,19,24,.792,109
15549,2013-02-24,GSW,@,MIN,W 100-99,240,37,81,.457,30,64,.469,7,17,.412,19,23,.826,100
15550,2013-02-24,MIN,,GSW,L 99-100,240,37,85,.435,36,74,.486,1,11,.091,24,31,.774,99
15551,2013-02-24,NOP,,SAC,W 110-95,240,45,89,.506,39,73,.534,6,16,.375,14,15,.933,110
15552,2013-02-24,SAC,@,NOH,L 95-110,240,35,83,.422,23,64,.359,12,19,.632,13,13,1.000,95
15553,2013-02-24,NYK,,PHI,W 99-93,240,32,75,.427,24,42,.571,8,33,.242,27,35,.771,99
15554,2013-02-24,PHI,@,NYK,L 93-99,240,36,85,.424,32,72,.444,4,13,.308,17,20,.850,93
15555,2013-02-24,CHI,@,OKC,L 72-102,240,25,86,.291,21,68,.309,4,18,.222,18,24,.750,72
15556,2013-02-24,OKC,,CHI,W 102-72,240,36,79,.456,30,62,.484,6,17,.353,24,27,.889,102
15557,2013-02-24,PHO,,SAS,L 87-97,240,30,81,.370,27,72,.375,3,9,.333,24,33,.727,87
15558,2013-02-24,SAS,@,PHO,W 97-87,240,32,72,.444,27,55,.491,5,17,.294,28,35,.800,97
15559,2013-02-24,BOS,@,POR,L 86-92,240,36,85,.424,34,72,.472,2,13,.154,12,15,.800,86
15560,2013-02-24,POR,,BOS,W 92-86,240,35,79,.443,28,58,.483,7,21,.333,15,19,.789,92
15561,2013-02-23,CHA,,DEN,L 99-113,240,37,82,.451,35,71,.493,2,11,.182,23,30,.767,99
15562,2013-02-23,DEN,@,CHA,W 113-99,240,44,83,.530,37,64,.578,7,19,.368,18,22,.818,113
15563,2013-02-23,DET,,IND,L 72-90,240,26,77,.338,24,63,.381,2,14,.143,18,24,.750,72
15564,2013-02-23,IND,@,DET,W 90-72,240,34,75,.453,26,53,.491,8,22,.364,14,19,.737,90
15565,2013-02-23,LAC,,UTA,W 107-94,240,40,78,.513,32,58,.552,8,20,.400,19,24,.792,107
15566,2013-02-23,UTA,@,LAC,L 94-107,240,35,84,.417,34,69,.493,1,15,.067,23,28,.821,94
15567,2013-02-23,ATL,@,MIL,W 103-102,240,39,91,.429,25,63,.397,14,28,.500,11,14,.786,103
15568,2013-02-23,MIL,,ATL,L 102-103,240,41,89,.461,37,77,.481,4,12,.333,16,20,.800,102
15569,2013-02-23,CLE,@,ORL,W 118-94,240,43,87,.494,34,66,.515,9,21,.429,23,28,.821,118
15570,2013-02-23,ORL,,CLE,L 94-118,240,38,79,.481,34,65,.523,4,14,.286,14,22,.636,94
15571,2013-02-23,MIA,@,PHI,W 114-90,240,45,77,.584,36,56,.643,9,21,.429,15,18,.833,114
15572,2013-02-23,PHI,,MIA,L 90-114,240,35,78,.449,24,50,.480,11,28,.393,9,10,.900,90
15573,2013-02-23,HOU,@,WAS,L 103-105,240,38,84,.452,19,38,.500,19,46,.413,8,14,.571,103
15574,2013-02-23,WAS,,HOU,W 105-103,240,41,80,.513,34,64,.531,7,16,.438,16,19,.842,105
15575,2013-02-22,ATL,,SAC,W 122-108,240,49,92,.533,37,65,.569,12,27,.444,12,19,.632,122
15576,2013-02-22,SAC,@,ATL,L 108-122,240,38,88,.432,26,66,.394,12,22,.545,20,25,.800,108
15577,2013-02-22,BRK,,HOU,L 96-106,240,40,91,.440,30,61,.492,10,30,.333,6,11,.545,96
15578,2013-02-22,HOU,@,BRK,W 106-96,240,41,77,.532,25,47,.532,16,30,.533,8,12,.667,106
15579,2013-02-22,CHA,,CHI,L 75-105,240,25,75,.333,21,59,.356,4,16,.250,21,35,.600,75
15580,2013-02-22,CHI,@,CHA,W 105-75,240,42,83,.506,37,69,.536,5,14,.357,16,20,.800,105
15581,2013-02-22,GSW,,SAS,W 107-101 (OT),265,39,94,.415,34,73,.466,5,21,.238,24,30,.800,107
15582,2013-02-22,SAS,@,GSW,L 101-107 (OT),265,37,95,.389,33,73,.452,4,22,.182,23,32,.719,101
15583,2013-02-22,DET,@,IND,L 82-114,240,29,82,.354,26,63,.413,3,19,.158,21,37,.568,82
15584,2013-02-22,IND,,DET,W 114-82,240,41,73,.562,31,59,.525,10,14,.714,22,33,.667,114
15585,2013-02-22,LAL,,POR,W 111-107,240,40,85,.471,34,67,.507,6,18,.333,25,34,.735,111
15586,2013-02-22,POR,@,LAL,L 107-111,240,46,94,.489,38,74,.514,8,20,.400,7,12,.583,107
15587,2013-02-22,MEM,,ORL,W 88-82,240,34,76,.447,31,60,.517,3,16,.188,17,29,.586,88
15588,2013-02-22,ORL,@,MEM,L 82-88,240,35,84,.417,30,69,.435,5,15,.333,7,9,.778,82
15589,2013-02-22,DAL,@,NOH,W 104-100,240,40,84,.476,32,64,.500,8,20,.400,16,19,.842,104
15590,2013-02-22,NOP,,DAL,L 100-104,240,37,91,.407,32,74,.432,5,17,.294,21,24,.875,100
15591,2013-02-22,MIN,@,OKC,L 111-127,240,41,85,.482,35,68,.515,6,17,.353,23,29,.793,111
15592,2013-02-22,OKC,,MIN,W 127-111,240,48,83,.578,39,69,.565,9,14,.643,22,22,1.000,127
15593,2013-02-22,BOS,@,PHO,W 113-88,240,44,79,.557,34,57,.596,10,22,.455,15,23,.652,113
15594,2013-02-22,PHO,,BOS,L 88-113,240,35,84,.417,31,65,.477,4,19,.211,14,23,.609,88
15595,2013-02-22,NYK,@,TOR,L 98-100,240,35,75,.467,25,47,.532,10,28,.357,18,23,.783,98
15596,2013-02-22,TOR,,NYK,W 100-98,240,35,80,.438,28,62,.452,7,18,.389,23,28,.821,100
15597,2013-02-22,DEN,@,WAS,L 113-119,240,39,81,.481,35,59,.593,4,22,.182,31,37,.838,113
15598,2013-02-22,WAS,,DEN,W 119-113,240,42,88,.477,31,64,.484,11,24,.458,24,33,.727,119
15599,2013-02-21,CHI,,MIA,L 67-86,240,28,75,.373,26,65,.400,2,10,.200,9,11,.818,67
15600,2013-02-21,MIA,@,CHI,W 86-67,240,37,73,.507,34,60,.567,3,13,.231,9,14,.643,86
15601,2013-02-21,LAC,,SAS,L 90-116,240,32,76,.421,27,60,.450,5,16,.313,21,25,.840,90
15602,2013-02-21,SAS,@,LAC,W 116-90,240,43,73,.589,35,56,.625,8,17,.471,22,28,.786,116
15603,2013-02-20,ATL,,MIA,L 90-103,240,36,72,.500,29,46,.630,7,26,.269,11,16,.688,90
15604,2013-02-20,MIA,@,ATL,W 103-90,240,37,78,.474,27,55,.491,10,23,.435,19,25,.760,103
15605,2013-02-20,CHA,,DET,L 99-105,240,36,89,.404,25,64,.391,11,25,.440,16,21,.762,99
15606,2013-02-20,DET,@,CHA,W 105-99,240,40,81,.494,32,64,.500,8,17,.471,17,23,.739,105
15607,2013-02-20,CLE,,NOH,W 105-100,240,38,77,.494,33,63,.524,5,14,.357,24,34,.706,105
15608,2013-02-20,NOP,@,CLE,L 100-105,240,37,76,.487,30,61,.492,7,15,.467,19,22,.864,100
15609,2013-02-20,DAL,,ORL,W 111-96,240,42,88,.477,31,59,.525,11,29,.379,16,18,.889,111
15610,2013-02-20,ORL,@,DAL,L 96-111,240,39,85,.459,34,69,.493,5,16,.313,13,22,.591,96
15611,2013-02-20,GSW,,PHO,W 108-98,240,42,87,.483,32,67,.478,10,20,.500,14,17,.824,108
15612,2013-02-20,PHO,@,GSW,L 98-108,240,40,84,.476,31,67,.463,9,17,.529,9,14,.643,98
15613,2013-02-20,HOU,,OKC,W 122-119,240,44,92,.478,29,59,.492,15,33,.455,19,23,.826,122
15614,2013-02-20,OKC,@,HOU,L 119-122,240,42,87,.483,31,59,.525,11,28,.393,24,27,.889,119
15615,2013-02-20,IND,,NYK,W 125-91,240,42,79,.532,31,55,.564,11,24,.458,30,39,.769,125
15616,2013-02-20,NYK,@,IND,L 91-125,240,29,86,.337,24,58,.414,5,28,.179,28,36,.778,91
15617,2013-02-20,BOS,@,LAL,L 99-113,240,39,82,.476,30,62,.484,9,20,.450,12,20,.600,99
15618,2013-02-20,LAL,,BOS,W 113-99,240,42,83,.506,35,61,.574,7,22,.318,22,31,.710,113
15619,2013-02-20,BRK,@,MIL,W 97-94,240,34,85,.400,25,59,.424,9,26,.346,20,26,.769,97
15620,2013-02-20,MIL,,BRK,L 94-97,240,35,75,.467,29,61,.475,6,14,.429,18,31,.581,94
15621,2013-02-20,MIN,,PHI,W 94-87,240,28,70,.400,23,57,.404,5,13,.385,33,44,.750,94
15622,2013-02-20,PHI,@,MIN,L 87-94,240,31,81,.383,27,68,.397,4,13,.308,21,32,.656,87
15623,2013-02-20,MEM,@,TOR,W 88-82,240,29,80,.363,23,67,.343,6,13,.462,24,34,.706,88
15624,2013-02-20,TOR,,MEM,L 82-88,240,26,71,.366,18,53,.340,8,18,.444,22,26,.846,82
15625,2013-02-19,BRK,,MIL,W 113-111 (OT),265,43,91,.473,33,72,.458,10,19,.526,17,23,.739,113
15626,2013-02-19,MIL,@,BRK,L 111-113 (OT),265,46,96,.479,39,76,.513,7,20,.350,12,18,.667,111
15627,2013-02-19,BOS,@,DEN,L 90-97,240,35,79,.443,28,59,.475,7,20,.350,13,16,.813,90
15628,2013-02-19,DEN,,BOS,W 97-90,240,33,77,.429,26,57,.456,7,20,.350,24,36,.667,97
15629,2013-02-19,DET,,MEM,L 91-105,240,38,82,.463,29,62,.468,9,20,.450,6,10,.600,91
15630,2013-02-19,MEM,@,DET,W 105-91,240,45,80,.563,42,71,.592,3,9,.333,12,20,.600,105
15631,2013-02-19,CHI,@,NOH,W 96-87,240,39,84,.464,34,71,.479,5,13,.385,13,17,.765,96
15632,2013-02-19,NOP,,CHI,L 87-96,240,35,84,.417,31,67,.463,4,17,.235,13,20,.650,87
15633,2013-02-19,CHA,@,ORL,W 105-92,240,38,81,.469,29,57,.509,9,24,.375,20,27,.741,105
15634,2013-02-19,ORL,,CHA,L 92-105,240,37,89,.416,33,64,.516,4,25,.160,14,17,.824,92
15635,2013-02-19,PHO,@,POR,W 102-98,240,41,82,.500,38,69,.551,3,13,.231,17,20,.850,102
15636,2013-02-19,POR,,PHO,L 98-102,240,33,80,.413,27,60,.450,6,20,.300,26,32,.813,98
15637,2013-02-19,SAC,,SAS,L 102-108,240,34,90,.378,25,65,.385,9,25,.360,25,29,.862,102
15638,2013-02-19,SAS,@,SAC,W 108-102,240,35,75,.467,25,45,.556,10,30,.333,28,35,.800,108
15639,2013-02-19,GSW,@,UTA,L 101-115,240,39,83,.470,34,66,.515,5,17,.294,18,24,.750,101
15640,2013-02-19,UTA,,GSW,W 115-101,240,39,78,.500,29,57,.509,10,21,.476,27,33,.818,115
15641,2013-02-19,TOR,@,WAS,W 96-88,240,35,78,.449,27,58,.466,8,20,.400,18,20,.900,96
15642,2013-02-19,WAS,,TOR,L 88-96,240,30,78,.385,24,63,.381,6,15,.400,22,27,.815,88
15643,2013-02-14,LAC,@,LAL,W 125-101,240,46,89,.517,30,59,.508,16,30,.533,17,22,.773,125
15644,2013-02-14,LAL,,LAC,L 101-125,240,38,75,.507,32,55,.582,6,20,.300,19,27,.704,101
15645,2013-02-14,MIA,@,OKC,W 110-100,240,41,88,.466,30,59,.508,11,29,.379,17,22,.773,110
15646,2013-02-14,OKC,,MIA,L 100-110,240,32,73,.438,29,60,.483,3,13,.231,33,34,.971,100
15647,2013-02-13,BOS,,CHI,W 71-69,240,28,76,.368,23,61,.377,5,15,.333,10,12,.833,71
15648,2013-02-13,CHI,@,BOS,L 69-71,240,27,74,.365,24,57,.421,3,17,.176,12,17,.706,69
15649,2013-02-13,BRK,,DEN,W 119-108,240,41,75,.547,25,48,.521,16,27,.593,21,30,.700,119
15650,2013-02-13,DEN,@,BRK,L 108-119,240,42,79,.532,30,62,.484,12,17,.706,12,22,.545,108
15651,2013-02-13,CLE,,SAS,L 95-96,240,40,97,.412,38,86,.442,2,11,.182,13,15,.867,95
15652,2013-02-13,SAS,@,CLE,W 96-95,240,38,84,.452,33,65,.508,5,19,.263,15,18,.833,96
15653,2013-02-13,DAL,,SAC,W 123-100,240,43,92,.467,30,58,.517,13,34,.382,24,26,.923,123
15654,2013-02-13,SAC,@,DAL,L 100-123,240,33,80,.413,29,64,.453,4,16,.250,30,36,.833,100
15655,2013-02-13,DET,,WAS,W 96-85,240,35,79,.443,26,61,.426,9,18,.500,17,25,.680,96
15656,2013-02-13,WAS,@,DET,L 85-96,240,34,70,.486,31,59,.525,3,11,.273,14,22,.636,85
15657,2013-02-13,CHA,@,IND,L 77-101,240,26,82,.317,21,66,.318,5,16,.313,20,28,.714,77
15658,2013-02-13,IND,,CHA,W 101-77,240,41,95,.432,35,76,.461,6,19,.316,13,19,.684,101
15659,2013-02-13,HOU,@,LAC,L 96-106,240,36,82,.439,31,58,.534,5,24,.208,19,22,.864,96
15660,2013-02-13,LAC,,HOU,W 106-96,240,37,75,.493,24,43,.558,13,32,.406,19,26,.731,106
15661,2013-02-13,MIL,,PHI,W 94-92,240,37,88,.420,33,70,.471,4,18,.222,16,21,.762,94
15662,2013-02-13,PHI,@,MIL,L 92-94,240,34,76,.447,30,63,.476,4,13,.308,20,24,.833,92
15663,2013-02-13,MIN,,UTA,L 93-97,240,29,85,.341,24,63,.381,5,22,.227,30,38,.789,93
15664,2013-02-13,UTA,@,MIN,W 97-93,240,38,87,.437,36,76,.474,2,11,.182,19,25,.760,97
15665,2013-02-13,NOP,,POR,W 99-63,240,41,87,.471,36,75,.480,5,12,.417,12,18,.667,99
15666,2013-02-13,POR,@,NOH,L 63-99,240,24,74,.324,22,57,.386,2,17,.118,13,13,1.000,63
15667,2013-02-13,NYK,,TOR,L 88-92,240,28,79,.354,19,54,.352,9,25,.360,23,32,.719,88
15668,2013-02-13,TOR,@,NYK,W 92-88,240,31,73,.425,22,52,.423,9,21,.429,21,24,.875,92
15669,2013-02-13,ATL,@,ORL,W 108-76,240,41,92,.446,31,58,.534,10,34,.294,16,23,.696,108
15670,2013-02-13,ORL,,ATL,L 76-108,240,34,82,.415,31,68,.456,3,14,.214,5,9,.556,76
15671,2013-02-12,GSW,,HOU,L 107-116,240,38,84,.452,30,64,.469,8,20,.400,23,31,.742,107
15672,2013-02-12,HOU,@,GSW,W 116-107,240,43,91,.473,33,57,.579,10,34,.294,20,25,.800,116
15673,2013-02-12,LAL,,PHO,W 91-85,240,36,83,.434,29,62,.468,7,21,.333,12,18,.667,91
15674,2013-02-12,PHO,@,LAL,L 85-91,240,35,85,.412,32,72,.444,3,13,.231,12,17,.706,85
15675,2013-02-12,MEM,,SAC,W 108-101,240,41,75,.547,35,62,.565,6,13,.462,20,24,.833,108
15676,2013-02-12,SAC,@,MEM,L 101-108,240,40,86,.465,36,70,.514,4,16,.250,17,24,.708,101
15677,2013-02-12,MIA,,POR,W 117-104,240,43,74,.581,35,55,.636,8,19,.421,23,27,.852,117
15678,2013-02-12,POR,@,MIA,L 104-117,240,39,73,.534,31,49,.633,8,24,.333,18,20,.900,104
15679,2013-02-12,DEN,@,TOR,L 108-109,240,44,85,.518,38,69,.551,6,16,.375,14,20,.700,108
15680,2013-02-12,TOR,,DEN,W 109-108,240,39,83,.470,29,62,.468,10,21,.476,21,23,.913,109
15681,2013-02-12,OKC,@,UTA,L 94-109,240,38,68,.559,33,53,.623,5,15,.333,13,23,.565,94
15682,2013-02-12,UTA,,OKC,W 109-94,240,42,87,.483,35,68,.515,7,19,.368,18,22,.818,109
15683,2013-02-11,BOS,@,CHA,L 91-94,240,32,77,.416,26,63,.413,6,14,.429,21,26,.808,91
15684,2013-02-11,CHA,,BOS,W 94-91,240,33,77,.429,25,59,.424,8,18,.444,20,30,.667,94
15685,2013-02-11,CHI,,SAS,L 89-103,240,37,78,.474,35,66,.530,2,12,.167,13,20,.650,89
15686,2013-02-11,SAS,@,CHI,W 103-89,240,39,75,.520,31,59,.525,8,16,.500,17,20,.850,103
15687,2013-02-11,CLE,,MIN,L 92-100,240,40,79,.506,35,61,.574,5,18,.278,7,11,.636,92
15688,2013-02-11,MIN,@,CLE,W 100-92,240,39,75,.520,31,61,.508,8,14,.571,14,17,.824,100
15689,2013-02-11,ATL,@,DAL,W 105-101,240,40,77,.519,31,51,.608,9,26,.346,16,23,.696,105
15690,2013-02-11,DAL,,ATL,L 101-105,240,38,89,.427,29,68,.426,9,21,.429,16,20,.800,101
15691,2013-02-11,DET,,NOH,L 86-105,240,29,81,.358,24,62,.387,5,19,.263,23,33,.697,86
15692,2013-02-11,NOP,@,DET,W 105-86,240,41,83,.494,31,62,.500,10,21,.476,13,14,.929,105
15693,2013-02-11,BRK,@,IND,W 89-84 (OT),265,31,80,.388,27,68,.397,4,12,.333,23,32,.719,89
15694,2013-02-11,IND,,BRK,L 84-89 (OT),265,33,96,.344,28,74,.378,5,22,.227,13,18,.722,84
15695,2013-02-11,MIL,,WAS,L 90-102,240,36,95,.379,31,72,.431,5,23,.217,13,22,.591,90
15696,2013-02-11,WAS,@,MIL,W 102-90,240,42,74,.568,38,62,.613,4,12,.333,14,17,.824,102
15697,2013-02-11,LAC,@,PHI,W 107-90,240,44,75,.587,36,56,.643,8,19,.421,11,22,.500,107
15698,2013-02-11,PHI,,LAC,L 90-107,240,35,84,.417,26,66,.394,9,18,.500,11,16,.688,90
15699,2013-02-10,BOS,,DEN,W 118-114 (3OT),315,43,108,.398,30,78,.385,13,30,.433,19,24,.792,118
15700,2013-02-10,DEN,@,BOS,L 114-118 (3OT),315,48,113,.425,40,87,.460,8,26,.308,10,17,.588,114
15701,2013-02-10,BRK,,SAS,L 86-111,240,34,72,.472,28,53,.528,6,19,.316,12,17,.706,86
15702,2013-02-10,SAS,@,BRK,W 111-86,240,43,73,.589,31,54,.574,12,19,.632,13,20,.650,111
15703,2013-02-10,MEM,,MIN,W 105-88,240,41,79,.519,35,66,.530,6,13,.462,17,22,.773,105
15704,2013-02-10,MIN,@,MEM,L 88-105,240,34,69,.493,30,53,.566,4,16,.250,16,25,.640,88
15705,2013-02-10,LAL,@,MIA,L 97-107,240,35,70,.500,28,58,.483,7,12,.583,20,26,.769,97
15706,2013-02-10,MIA,,LAL,W 107-97,240,44,80,.550,38,64,.594,6,16,.375,13,14,.929,107
15707,2013-02-10,LAC,@,NYK,W 102-88,240,41,80,.513,31,52,.596,10,28,.357,10,16,.625,102
15708,2013-02-10,NYK,,LAC,L 88-102,240,33,74,.446,26,51,.510,7,23,.304,15,18,.833,88
15709,2013-02-10,ORL,,POR,W 110-104,240,47,93,.505,42,78,.538,5,15,.333,11,18,.611,110
15710,2013-02-10,POR,@,ORL,L 104-110,240,42,83,.506,32,56,.571,10,27,.370,10,12,.833,104
15711,2013-02-10,OKC,@,PHO,W 97-69,240,34,76,.447,25,59,.424,9,17,.529,20,27,.741,97
15712,2013-02-10,PHO,,OKC,L 69-97,240,30,91,.330,26,77,.338,4,14,.286,5,5,1.000,69
15713,2013-02-10,HOU,@,SAC,L 111-117,240,44,89,.494,34,56,.607,10,33,.303,13,17,.765,111
15714,2013-02-10,SAC,,HOU,W 117-111,240,40,87,.460,29,67,.433,11,20,.550,26,27,.963,117
15715,2013-02-10,NOP,@,TOR,L 89-102,240,34,69,.493,29,56,.518,5,13,.385,16,25,.640,89
15716,2013-02-10,TOR,,NOH,W 102-89,240,40,78,.513,32,62,.516,8,16,.500,14,18,.778,102
15717,2013-02-09,CLE,,DEN,L 103-111,240,37,84,.440,28,64,.438,9,20,.450,20,26,.769,103
15718,2013-02-09,DEN,@,CLE,W 111-103,240,40,80,.500,34,63,.540,6,17,.353,25,34,.735,111
15719,2013-02-09,DAL,,GSW,W 116-91,240,38,77,.494,27,57,.474,11,20,.550,29,38,.763,116
15720,2013-02-09,GSW,@,DAL,L 91-116,240,34,89,.382,28,73,.384,6,16,.375,17,24,.708,91
15721,2013-02-09,DET,@,MIL,W 105-100,240,41,83,.494,33,66,.500,8,17,.471,15,19,.789,105
15722,2013-02-09,MIL,,DET,L 100-105,240,34,86,.395,27,69,.391,7,17,.412,25,28,.893,100
15723,2013-02-09,CHA,@,PHI,L 76-87,240,27,88,.307,25,72,.347,2,16,.125,20,23,.870,76
15724,2013-02-09,PHI,,CHA,W 87-76,240,39,93,.419,37,77,.481,2,16,.125,7,10,.700,87
15725,2013-02-09,SAC,,UTA,W 120-109,240,44,85,.518,36,66,.545,8,19,.421,24,35,.686,120
15726,2013-02-09,UTA,@,SAC,L 109-120,240,40,82,.488,36,67,.537,4,15,.267,25,26,.962,109
15727,2013-02-08,ATL,,NOH,L 100-111,240,35,74,.473,22,50,.440,13,24,.542,17,23,.739,100
15728,2013-02-08,NOP,@,ATL,W 111-100,240,45,86,.523,36,70,.514,9,16,.563,12,18,.667,111
15729,2013-02-08,CHA,,LAL,L 93-100,240,38,89,.427,34,75,.453,4,14,.286,13,19,.684,93
15730,2013-02-08,LAL,@,CHA,W 100-93,240,36,80,.450,28,54,.519,8,26,.308,20,25,.800,100
15731,2013-02-08,CLE,,ORL,W 119-108,240,39,80,.488,32,66,.485,7,14,.500,34,41,.829,119
15732,2013-02-08,ORL,@,CLE,L 108-119,240,45,86,.523,37,65,.569,8,21,.381,10,13,.769,108
15733,2013-02-08,DET,,SAS,W 119-109,240,46,89,.517,36,67,.537,10,22,.455,17,20,.850,119
15734,2013-02-08,SAS,@,DET,L 109-119,240,37,81,.457,27,57,.474,10,24,.417,25,30,.833,109
15735,2013-02-08,HOU,,POR,W 118-103,240,47,79,.595,35,53,.660,12,26,.462,12,16,.750,118
15736,2013-02-08,POR,@,HOU,L 103-118,240,40,88,.455,32,62,.516,8,26,.308,15,20,.750,103
15737,2013-02-08,IND,,TOR,L 98-100 (OT),265,35,78,.449,26,56,.464,9,22,.409,19,28,.679,98
15738,2013-02-08,TOR,@,IND,W 100-98 (OT),265,42,96,.438,40,87,.460,2,9,.222,14,19,.737,100
15739,2013-02-08,GSW,@,MEM,L 93-99,240,36,74,.486,30,57,.526,6,17,.353,15,20,.750,93
15740,2013-02-08,MEM,,GSW,W 99-93,240,36,79,.456,28,59,.475,8,20,.400,19,23,.826,99
15741,2013-02-08,LAC,@,MIA,L 89-111,240,34,77,.442,27,61,.443,7,16,.438,14,19,.737,89
15742,2013-02-08,MIA,,LAC,W 111-89,240,36,68,.529,21,41,.512,15,27,.556,24,32,.750,111
15743,2013-02-08,MIN,,NYK,L 94-100,240,37,80,.463,36,67,.537,1,13,.077,19,27,.704,94
15744,2013-02-08,NYK,@,MIN,W 100-94,240,38,81,.469,30,55,.545,8,26,.308,16,20,.800,100
15745,2013-02-08,OKC,,PHO,W 127-96,240,50,87,.575,36,66,.545,14,21,.667,13,18,.722,127
15746,2013-02-08,PHO,@,OKC,L 96-127,240,39,83,.470,32,65,.492,7,18,.389,11,15,.733,96
15747,2013-02-08,CHI,@,UTA,W 93-89,240,36,79,.456,31,67,.463,5,12,.417,16,18,.889,93
15748,2013-02-08,UTA,,CHI,L 89-93,240,37,78,.474,33,62,.532,4,16,.250,11,17,.647,89
15749,2013-02-08,BRK,@,WAS,L 74-89,240,25,76,.329,20,58,.345,5,18,.278,19,32,.594,74
15750,2013-02-08,WAS,,BRK,W 89-74,240,36,80,.450,29,64,.453,7,16,.438,10,11,.909,89
15751,2013-02-07,BOS,,LAL,W 116-95,240,46,87,.529,41,76,.539,5,11,.455,19,25,.760,116
15752,2013-02-07,LAL,@,BOS,L 95-116,240,36,87,.414,31,64,.484,5,23,.217,18,30,.600,95
15753,2013-02-07,CHI,@,DEN,L 96-128,240,38,91,.418,28,64,.438,10,27,.370,10,14,.714,96
15754,2013-02-07,DEN,,CHI,W 128-96,240,50,86,.581,41,67,.612,9,19,.474,19,23,.826,128
15755,2013-02-06,ATL,,MEM,W 103-92,240,38,74,.514,28,50,.560,10,24,.417,17,23,.739,103
15756,2013-02-06,MEM,@,ATL,L 92-103,240,38,84,.452,33,72,.458,5,12,.417,11,16,.688,92
15757,2013-02-06,CHA,@,CLE,L 95-122,240,37,79,.468,31,64,.484,6,15,.400,15,25,.600,95
15758,2013-02-06,CLE,,CHA,W 122-95,240,52,92,.565,43,68,.632,9,24,.375,9,13,.692,122
15759,2013-02-06,DAL,,POR,W 105-99,240,41,86,.477,31,66,.470,10,20,.500,13,19,.684,105
15760,2013-02-06,POR,@,DAL,L 99-105,240,36,84,.429,26,54,.481,10,30,.333,17,19,.895,99
15761,2013-02-06,BRK,@,DET,W 93-90,240,34,82,.415,28,66,.424,6,16,.375,19,25,.760,93
15762,2013-02-06,DET,,BRK,L 90-93,240,36,83,.434,33,66,.500,3,17,.176,15,21,.714,90
15763,2013-02-06,HOU,@,MIA,L 108-114,240,39,80,.488,30,55,.545,9,25,.360,21,25,.840,108
15764,2013-02-06,MIA,,HOU,W 114-108,240,40,82,.488,30,59,.508,10,23,.435,24,28,.857,114
15765,2013-02-06,MIN,,SAS,L 94-104,240,33,81,.407,25,63,.397,8,18,.444,20,23,.870,94
15766,2013-02-06,SAS,@,MIN,W 104-94,240,37,81,.457,27,56,.482,10,25,.400,20,21,.952,104
15767,2013-02-06,NOP,,PHO,W 93-84,240,39,75,.520,35,61,.574,4,14,.286,11,17,.647,93
15768,2013-02-06,PHO,@,NOH,L 84-93,240,35,78,.449,34,63,.540,1,15,.067,13,15,.867,84
15769,2013-02-06,GSW,@,OKC,L 98-119,240,38,93,.409,28,73,.384,10,20,.500,12,16,.750,98
15770,2013-02-06,OKC,,GSW,W 119-98,240,48,95,.505,40,72,.556,8,23,.348,15,20,.750,119
15771,2013-02-06,LAC,@,ORL,W 86-76,240,33,82,.402,27,64,.422,6,18,.333,14,22,.636,86
15772,2013-02-06,ORL,,LAC,L 76-86,240,30,87,.345,24,67,.358,6,20,.300,10,14,.714,76
15773,2013-02-06,IND,@,PHI,W 88-69,240,32,81,.395,27,64,.422,5,17,.294,19,25,.760,88
15774,2013-02-06,PHI,,IND,L 69-88,240,31,89,.348,29,81,.358,2,8,.250,5,7,.714,69
15775,2013-02-06,BOS,@,TOR,W 99-95,240,35,73,.479,31,54,.574,4,19,.211,25,30,.833,99
15776,2013-02-06,TOR,,BOS,L 95-99,240,34,82,.415,30,64,.469,4,18,.222,23,26,.885,95
15777,2013-02-06,MIL,@,UTA,L 86-100,240,29,82,.354,23,63,.365,6,19,.316,22,29,.759,86
15778,2013-02-06,UTA,,MIL,W 100-86,240,39,81,.481,34,71,.479,5,10,.500,17,26,.654,100
15779,2013-02-06,NYK,@,WAS,L 96-106,240,34,84,.405,25,56,.446,9,28,.321,19,23,.826,96
15780,2013-02-06,WAS,,NYK,W 106-96,240,42,79,.532,31,59,.525,11,20,.550,11,14,.786,106
15781,2013-02-05,BRK,,LAL,L 83-92,240,31,89,.348,25,66,.379,6,23,.261,15,19,.789,83
15782,2013-02-05,LAL,@,BRK,W 92-83,240,37,82,.451,34,69,.493,3,13,.231,15,18,.833,92
15783,2013-02-05,DEN,,MIL,W 112-104,240,40,91,.440,35,75,.467,5,16,.313,27,37,.730,112
15784,2013-02-05,MIL,@,DEN,L 104-112,240,48,100,.480,45,84,.536,3,16,.188,5,11,.455,104
15785,2013-02-05,GSW,@,HOU,L 109-140,240,41,86,.477,38,71,.535,3,15,.200,24,30,.800,109
15786,2013-02-05,HOU,,GSW,W 140-109,240,46,91,.505,23,51,.451,23,40,.575,25,35,.714,140
15787,2013-02-05,ATL,@,IND,L 103-114,240,36,81,.444,28,60,.467,8,21,.381,23,28,.821,103
15788,2013-02-05,IND,,ATL,W 114-103,240,36,75,.480,25,50,.500,11,25,.440,31,40,.775,114
15789,2013-02-05,MEM,,PHO,L 90-96,240,36,82,.439,33,73,.452,3,9,.333,15,17,.882,90
15790,2013-02-05,PHO,@,MEM,W 96-90,240,37,73,.507,33,63,.524,4,10,.400,18,22,.818,96
15791,2013-02-04,CHI,@,IND,L 101-111,240,39,88,.443,35,72,.486,4,16,.250,19,22,.864,101
15792,2013-02-04,IND,,CHI,W 111-101,240,39,74,.527,33,60,.550,6,14,.429,27,34,.794,111
15793,2013-02-04,CHA,@,MIA,L 94-99,240,34,80,.425,26,55,.473,8,25,.320,18,20,.900,94
15794,2013-02-04,MIA,,CHA,W 99-94,240,41,81,.506,40,69,.580,1,12,.083,16,24,.667,99
15795,2013-02-04,MIN,,POR,L 98-100,240,40,85,.471,37,72,.514,3,13,.231,15,19,.789,98
15796,2013-02-04,POR,@,MIN,W 100-98,240,41,70,.586,34,52,.654,7,18,.389,11,16,.688,100
15797,2013-02-04,DET,@,NYK,L 85-99,240,38,90,.422,35,77,.455,3,13,.231,6,12,.500,85
15798,2013-02-04,NYK,,DET,W 99-85,240,36,79,.456,22,45,.489,14,34,.412,13,16,.813,99
15799,2013-02-04,DAL,@,OKC,L 91-112,240,36,87,.414,33,71,.465,3,16,.188,16,20,.800,91
15800,2013-02-04,OKC,,DAL,W 112-91,240,41,87,.471,31,62,.500,10,25,.400,20,27,.741,112
15801,2013-02-04,ORL,@,PHI,L 61-78,240,27,80,.338,26,68,.382,1,12,.083,6,8,.750,61
15802,2013-02-04,PHI,,ORL,W 78-61,240,36,79,.456,33,59,.559,3,20,.150,3,5,.600,78
15803,2013-02-04,SAC,@,UTA,L 91-98 (OT),265,35,87,.402,32,67,.478,3,20,.150,18,25,.720,91
15804,2013-02-04,UTA,,SAC,W 98-91 (OT),265,38,72,.528,31,60,.517,7,12,.583,15,18,.833,98
15805,2013-02-04,LAC,@,WAS,L 90-98,240,37,79,.468,33,62,.532,4,17,.235,12,15,.800,90
15806,2013-02-04,WAS,,LAC,W 98-90,240,37,84,.440,30,72,.417,7,12,.583,17,27,.630,98
15807,2013-02-03,BOS,,LAC,W 106-104,240,36,72,.500,25,54,.463,11,18,.611,23,27,.852,106
15808,2013-02-03,LAC,@,BOS,L 104-106,240,40,79,.506,31,58,.534,9,21,.429,15,21,.714,104
15809,2013-02-03,DET,,LAL,L 97-98,240,41,92,.446,36,78,.462,5,14,.357,10,15,.667,97
15810,2013-02-03,LAL,@,DET,W 98-97,240,39,83,.470,33,63,.524,6,20,.300,14,22,.636,98
15811,2013-02-03,MIA,@,TOR,W 100-85,240,40,75,.533,37,63,.587,3,12,.250,17,23,.739,100
15812,2013-02-03,TOR,,MIA,L 85-100,240,28,75,.373,24,57,.421,4,18,.222,25,32,.781,85
15813,2013-02-02,ATL,,CHI,L 76-93,240,31,79,.392,25,60,.417,6,19,.316,8,15,.533,76
15814,2013-02-02,CHI,@,ATL,W 93-76,240,38,93,.409,30,73,.411,8,20,.400,9,13,.692,93
15815,2013-02-02,CLE,,OKC,W 115-110,240,43,90,.478,34,72,.472,9,18,.500,20,23,.870,115
15816,2013-02-02,OKC,@,CLE,L 110-115,240,41,83,.494,34,62,.548,7,21,.333,21,26,.808,110
15817,2013-02-02,GSW,,PHO,W 113-93,240,45,89,.506,36,70,.514,9,19,.474,14,20,.700,113
15818,2013-02-02,PHO,@,GSW,L 93-113,240,35,86,.407,30,71,.423,5,15,.333,18,24,.750,93
15819,2013-02-02,CHA,@,HOU,L 95-109,240,33,79,.418,25,60,.417,8,19,.421,21,24,.875,95
15820,2013-02-02,HOU,,CHA,W 109-95,240,42,82,.512,35,62,.565,7,20,.350,18,23,.783,109
15821,2013-02-02,MIL,,ORL,W 107-98,240,42,90,.467,33,66,.500,9,24,.375,14,20,.700,107
15822,2013-02-02,ORL,@,MIL,L 98-107,240,41,94,.436,36,75,.480,5,19,.263,11,22,.500,98
15823,2013-02-02,MIN,,NOH,W 115-86,240,45,77,.584,40,62,.645,5,15,.333,20,29,.690,115
15824,2013-02-02,NOP,@,MIN,L 86-115,240,28,70,.400,25,56,.446,3,14,.214,27,33,.818,86
15825,2013-02-02,NYK,,SAC,W 120-81,240,47,86,.547,28,43,.651,19,43,.442,7,13,.538,120
15826,2013-02-02,SAC,@,NYK,L 81-120,240,32,76,.421,26,55,.473,6,21,.286,11,15,.733,81
15827,2013-02-02,POR,,UTA,W 105-99,240,38,75,.507,28,57,.491,10,18,.556,19,28,.679,105
15828,2013-02-02,UTA,@,POR,L 99-105,240,39,90,.433,31,71,.437,8,19,.421,13,16,.813,99
15829,2013-02-02,SAS,,WAS,W 96-86,240,38,78,.487,33,58,.569,5,20,.250,15,16,.938,96
15830,2013-02-02,WAS,@,SAS,L 86-96,240,36,88,.409,30,66,.455,6,22,.273,8,17,.471,86
15831,2013-02-01,BOS,,ORL,W 97-84,240,42,84,.500,38,66,.576,4,18,.222,9,14,.643,97
15832,2013-02-01,ORL,@,BOS,L 84-97,240,36,95,.379,33,76,.434,3,19,.158,9,9,1.000,84
15833,2013-02-01,BRK,,CHI,W 93-89,240,39,75,.520,34,64,.531,5,11,.455,10,20,.500,93
15834,2013-02-01,CHI,@,BRK,L 89-93,240,34,78,.436,33,64,.516,1,14,.071,20,22,.909,89
15835,2013-02-01,DEN,,NOH,W 113-98,240,44,84,.524,37,62,.597,7,22,.318,18,22,.818,113
15836,2013-02-01,NOP,@,DEN,L 98-113,240,38,72,.528,34,59,.576,4,13,.308,18,21,.857,98
15837,2013-02-01,CLE,@,DET,L 99-117,240,35,88,.398,29,68,.426,6,20,.300,23,26,.885,99
15838,2013-02-01,DET,,CLE,W 117-99,240,45,83,.542,41,69,.594,4,14,.286,23,43,.535,117
15839,2013-02-01,IND,,MIA,W 102-89,240,39,70,.557,32,53,.604,7,17,.412,17,24,.708,102
15840,2013-02-01,MIA,@,IND,L 89-102,240,33,70,.471,28,56,.500,5,14,.357,18,24,.750,89
15841,2013-02-01,MEM,,WAS,W 85-76,240,35,78,.449,34,71,.479,1,7,.143,14,17,.824,85
15842,2013-02-01,WAS,@,MEM,L 76-85,240,34,83,.410,29,63,.460,5,20,.250,3,3,1.000,76
15843,2013-02-01,LAL,@,MIN,W 111-100,240,39,92,.424,27,60,.450,12,32,.375,21,25,.840,111
15844,2013-02-01,MIN,,LAL,L 100-111,240,41,89,.461,31,67,.463,10,22,.455,8,18,.444,100
15845,2013-02-01,MIL,@,NYK,L 86-96,240,33,83,.398,25,63,.397,8,20,.400,12,17,.706,86
15846,2013-02-01,NYK,,MIL,W 96-86,240,32,76,.421,19,41,.463,13,35,.371,19,26,.731,96
15847,2013-02-01,PHI,,SAC,W 89-80,240,36,76,.474,33,62,.532,3,14,.214,14,19,.737,89
15848,2013-02-01,SAC,@,PHI,L 80-89,240,30,79,.380,29,69,.420,1,10,.100,19,25,.760,80
15849,2013-02-01,DAL,@,PHO,W 109-99,240,40,88,.455,32,67,.478,8,21,.381,21,25,.840,109
15850,2013-02-01,PHO,,DAL,L 99-109,240,38,89,.427,34,74,.459,4,15,.267,19,25,.760,99
15851,2013-02-01,LAC,@,TOR,L 73-98,240,25,72,.347,22,53,.415,3,19,.158,20,31,.645,73
15852,2013-02-01,TOR,,LAC,W 98-73,240,38,81,.469,26,55,.473,12,26,.462,10,17,.588,98
15853,2013-02-01,POR,@,UTA,L 77-86,240,29,79,.367,22,59,.373,7,20,.350,12,16,.750,77
15854,2013-02-01,UTA,,POR,W 86-77,240,35,81,.432,31,66,.470,4,15,.267,12,17,.706,86
15855,2013-01-31,DAL,@,GSW,L 97-100,240,36,81,.444,28,56,.500,8,25,.320,17,24,.708,97
15856,2013-01-31,GSW,,DAL,W 100-97,240,36,84,.429,29,64,.453,7,20,.350,21,25,.840,100
15857,2013-01-31,MEM,@,OKC,L 89-106,240,34,98,.347,28,73,.384,6,25,.240,15,19,.789,89
15858,2013-01-31,OKC,,MEM,W 106-89,240,40,72,.556,35,58,.603,5,14,.357,21,25,.840,106
15859,2013-01-30,ATL,,TOR,W 93-92,240,36,75,.480,26,49,.531,10,26,.385,11,18,.611,93
15860,2013-01-30,TOR,@,ATL,L 92-93,240,33,85,.388,24,63,.381,9,22,.409,17,23,.739,92
15861,2013-01-30,BOS,,SAC,W 99-81,240,39,73,.534,34,57,.596,5,16,.313,16,20,.800,99
15862,2013-01-30,SAC,@,BOS,L 81-99,240,29,73,.397,23,56,.411,6,17,.353,17,26,.654,81
15863,2013-01-30,BRK,,MIA,L 85-105,240,31,69,.449,26,52,.500,5,17,.294,18,24,.750,85
15864,2013-01-30,MIA,@,BRK,W 105-85,240,43,83,.518,32,64,.500,11,19,.579,8,14,.571,105
15865,2013-01-30,DEN,,HOU,W 118-110,240,42,82,.512,34,54,.630,8,28,.286,26,36,.722,118
15866,2013-01-30,HOU,@,DEN,L 110-118,240,39,81,.481,31,54,.574,8,27,.296,24,35,.686,110
15867,2013-01-30,DET,@,IND,L 79-98,240,32,88,.364,29,70,.414,3,18,.167,12,27,.444,79
15868,2013-01-30,IND,,DET,W 98-79,240,36,81,.444,29,67,.433,7,14,.500,19,21,.905,98
15869,2013-01-30,CHI,@,MIL,W 104-88,240,45,91,.495,41,78,.526,4,13,.308,10,13,.769,104
15870,2013-01-30,MIL,,CHI,L 88-104,240,34,82,.415,28,68,.412,6,14,.429,14,19,.737,88
15871,2013-01-30,LAC,@,MIN,W 96-90,240,35,76,.461,32,67,.478,3,9,.333,23,36,.639,96
15872,2013-01-30,MIN,,LAC,L 90-96,240,33,76,.434,28,57,.491,5,19,.263,19,27,.704,90
15873,2013-01-30,NYK,,ORL,W 113-97,240,47,82,.573,33,48,.688,14,34,.412,5,8,.625,113
15874,2013-01-30,ORL,@,NYK,L 97-113,240,38,77,.494,31,51,.608,7,26,.269,14,16,.875,97
15875,2013-01-30,PHI,,WAS,W 92-84,240,40,95,.421,34,82,.415,6,13,.462,6,10,.600,92
15876,2013-01-30,WAS,@,PHI,L 84-92,240,30,75,.400,23,53,.434,7,22,.318,17,21,.810,84
15877,2013-01-30,LAL,@,PHO,L 86-92,240,33,78,.423,25,51,.490,8,27,.296,12,19,.632,86
15878,2013-01-30,PHO,,LAL,W 92-86,240,38,83,.458,35,71,.493,3,12,.250,13,15,.867,92
15879,2013-01-30,CHA,@,SAS,L 78-102,240,30,73,.411,26,54,.481,4,19,.211,14,17,.824,78
15880,2013-01-30,SAS,,CHA,W 102-78,240,38,69,.551,29,53,.547,9,16,.563,17,21,.810,102
15881,2013-01-30,NOP,@,UTA,L 99-104,240,37,78,.474,29,56,.518,8,22,.364,17,28,.607,99
15882,2013-01-30,UTA,,NOH,W 104-99,240,34,68,.500,30,56,.536,4,12,.333,32,46,.696,104
15883,2013-01-29,CLE,,GSW,L 95-108,240,36,84,.429,32,66,.485,4,18,.222,19,25,.760,95
15884,2013-01-29,GSW,@,CLE,W 108-95,240,45,84,.536,34,68,.500,11,16,.688,7,10,.700,108
15885,2013-01-29,DET,,MIL,L 90-117,240,34,84,.405,32,73,.438,2,11,.182,20,28,.714,90
15886,2013-01-29,MIL,@,DET,W 117-90,240,46,98,.469,35,75,.467,11,23,.478,14,22,.636,117
15887,2013-01-29,LAL,,NOH,W 111-106,240,39,79,.494,27,46,.587,12,33,.364,21,33,.636,111
15888,2013-01-29,NOP,@,LAL,L 106-111,240,39,92,.424,30,73,.411,9,19,.474,19,21,.905,106
15889,2013-01-29,DAL,@,POR,L 104-106,240,42,84,.500,34,69,.493,8,15,.533,12,15,.800,104
15890,2013-01-29,POR,,DAL,W 106-104,240,39,86,.453,29,58,.500,10,28,.357,18,23,.783,106
15891,2013-01-28,BRK,,ORL,W 97-77,240,37,74,.500,24,45,.533,13,29,.448,10,12,.833,97
15892,2013-01-28,ORL,@,BRK,L 77-97,240,32,79,.405,26,52,.500,6,27,.222,7,9,.778,77
15893,2013-01-28,CHA,@,CHI,L 85-93,240,32,81,.395,26,69,.377,6,12,.500,15,21,.714,85
15894,2013-01-28,CHI,,CHA,W 93-85,240,35,78,.449,28,60,.467,7,18,.389,16,25,.640,93
15895,2013-01-28,DEN,,IND,W 102-101,240,37,78,.474,30,64,.469,7,14,.500,21,30,.700,102
15896,2013-01-28,IND,@,DEN,L 101-102,240,39,85,.459,28,62,.452,11,23,.478,12,17,.706,101
15897,2013-01-28,MEM,@,PHI,W 103-100,240,40,73,.548,32,60,.533,8,13,.615,15,19,.789,103
15898,2013-01-28,PHI,,MEM,L 100-103,240,45,83,.542,41,74,.554,4,9,.444,6,9,.667,100
15899,2013-01-28,GSW,@,TOR,W 114-102,240,46,86,.535,40,71,.563,6,15,.400,16,20,.800,114
15900,2013-01-28,TOR,,GSW,L 102-114,240,38,87,.437,32,68,.471,6,19,.316,20,23,.870,102
15901,2013-01-28,HOU,@,UTA,W 125-80,240,47,89,.528,31,55,.564,16,34,.471,15,18,.833,125
15902,2013-01-28,UTA,,HOU,L 80-125,240,32,81,.395,27,63,.429,5,18,.278,11,19,.579,80
15903,2013-01-28,SAC,@,WAS,W 96-94,240,36,82,.439,27,59,.458,9,23,.391,15,25,.600,96
15904,2013-01-28,WAS,,SAC,L 94-96,240,37,77,.481,34,66,.515,3,11,.273,17,21,.810,94
15905,2013-01-27,BOS,,MIA,W 100-98 (2OT),290,36,88,.409,31,68,.456,5,20,.250,23,27,.852,100
15906,2013-01-27,MIA,@,BOS,L 98-100 (2OT),290,39,96,.406,34,73,.466,5,23,.217,15,20,.750,98
15907,2013-01-27,DAL,,PHO,W 110-95,240,45,88,.511,40,77,.519,5,11,.455,15,18,.833,110
15908,2013-01-27,PHO,@,DAL,L 95-110,240,34,77,.442,30,60,.500,4,17,.235,23,28,.821,95
15909,2013-01-27,LAC,,POR,W 96-83,240,42,82,.512,36,65,.554,6,17,.353,6,9,.667,96
15910,2013-01-27,POR,@,LAC,L 83-96,240,29,66,.439,26,51,.510,3,15,.200,22,29,.759,83
15911,2013-01-27,LAL,,OKC,W 105-96,240,41,74,.554,34,57,.596,7,17,.412,16,29,.552,105
15912,2013-01-27,OKC,@,LAL,L 96-105,240,36,81,.444,32,65,.492,4,16,.250,20,26,.769,96
15913,2013-01-27,MEM,,NOH,L 83-91,240,32,88,.364,29,72,.403,3,16,.188,16,18,.889,83
15914,2013-01-27,NOP,@,MEM,W 91-83,240,33,77,.429,24,57,.421,9,20,.450,16,23,.696,91
15915,2013-01-27,ATL,@,NYK,L 104-106,240,39,65,.600,29,42,.690,10,23,.435,16,20,.800,104
15916,2013-01-27,NYK,,ATL,W 106-104,240,39,72,.542,23,45,.511,16,27,.593,12,17,.706,106
15917,2013-01-27,DET,@,ORL,W 104-102,240,40,79,.506,29,56,.518,11,23,.478,13,18,.722,104
15918,2013-01-27,ORL,,DET,L 102-104,240,40,90,.444,30,67,.448,10,23,.435,12,16,.750,102
15919,2013-01-26,CHA,,MIN,W 102-101,240,37,73,.507,32,62,.516,5,11,.455,23,26,.885,102
15920,2013-01-26,MIN,@,CHA,L 101-102,240,37,77,.481,27,57,.474,10,20,.500,17,23,.739,101
15921,2013-01-26,DEN,,SAC,W 121-93,240,47,89,.528,34,58,.586,13,31,.419,14,17,.824,121
15922,2013-01-26,SAC,@,DEN,L 93-121,240,37,88,.420,29,66,.439,8,22,.364,11,22,.500,93
15923,2013-01-26,BRK,@,HOU,L 106-119,240,36,80,.450,20,44,.455,16,36,.444,18,21,.857,106
15924,2013-01-26,HOU,,BRK,W 119-106,240,43,87,.494,31,59,.525,12,28,.429,21,27,.778,119
15925,2013-01-26,GSW,@,MIL,L 102-109,240,39,93,.419,26,65,.400,13,28,.464,11,11,1.000,102
15926,2013-01-26,MIL,,GSW,W 109-102,240,41,101,.406,28,71,.394,13,30,.433,14,20,.700,109
15927,2013-01-26,NYK,@,PHI,L 80-97,240,28,81,.346,24,54,.444,4,27,.148,20,23,.870,80
15928,2013-01-26,PHI,,NYK,W 97-80,240,38,75,.507,32,56,.571,6,19,.316,15,22,.682,97
15929,2013-01-26,LAC,@,POR,L 100-101,240,40,81,.494,33,65,.508,7,16,.438,13,17,.765,100
15930,2013-01-26,POR,,LAC,W 101-100,240,35,75,.467,24,50,.480,11,25,.440,20,21,.952,101
15931,2013-01-26,PHO,@,SAS,L 99-108,240,41,81,.506,35,69,.507,6,12,.500,11,14,.786,99
15932,2013-01-26,SAS,,PHO,W 108-99,240,41,83,.494,34,59,.576,7,24,.292,19,23,.826,108
15933,2013-01-26,CLE,@,TOR,W 99-98,240,37,78,.474,31,67,.463,6,11,.545,19,22,.864,99
15934,2013-01-26,TOR,,CLE,L 98-99,240,40,82,.488,35,65,.538,5,17,.294,13,18,.722,98
15935,2013-01-26,IND,@,UTA,L 110-114 (OT),265,44,82,.537,37,61,.607,7,21,.333,15,18,.833,110
15936,2013-01-26,UTA,,IND,W 114-110 (OT),265,44,83,.530,41,73,.562,3,10,.300,23,26,.885,114
15937,2013-01-26,CHI,@,WAS,L 73-86,240,29,71,.408,25,56,.446,4,15,.267,11,12,.917,73
15938,2013-01-26,WAS,,CHI,W 86-73,240,34,79,.430,31,69,.449,3,10,.300,15,19,.789,86
15939,2013-01-25,ATL,,BOS,W 123-111 (2OT),290,42,94,.447,30,58,.517,12,36,.333,27,36,.750,123
15940,2013-01-25,BOS,@,ATL,L 111-123 (2OT),290,42,93,.452,35,74,.473,7,19,.368,20,20,1.000,111
15941,2013-01-25,CHI,,GSW,W 103-87,240,41,88,.466,32,68,.471,9,20,.450,12,18,.667,103
15942,2013-01-25,GSW,@,CHI,L 87-103,240,27,78,.346,23,59,.390,4,19,.211,29,33,.879,87
15943,2013-01-25,CLE,,MIL,W 113-108,240,45,86,.523,39,71,.549,6,15,.400,17,22,.773,113
15944,2013-01-25,MIL,@,CLE,L 108-113,240,43,92,.467,29,64,.453,14,28,.500,8,13,.615,108
15945,2013-01-25,DAL,,SAS,L 107-113,240,42,91,.462,36,73,.493,6,18,.333,17,18,.944,107
15946,2013-01-25,SAS,@,DAL,W 113-107,240,43,89,.483,34,66,.515,9,23,.391,18,24,.750,113
15947,2013-01-25,LAL,,UTA,W 102-84,240,43,80,.538,34,59,.576,9,21,.429,7,13,.538,102
15948,2013-01-25,UTA,@,LAL,L 84-102,240,34,81,.420,31,67,.463,3,14,.214,13,16,.813,84
15949,2013-01-25,BRK,@,MEM,L 77-101,240,29,71,.408,26,54,.481,3,17,.176,16,25,.640,77
15950,2013-01-25,MEM,,BRK,W 101-77,240,47,90,.522,43,81,.531,4,9,.444,3,8,.375,101
15951,2013-01-25,DET,@,MIA,L 88-110,240,34,72,.472,30,60,.500,4,12,.333,16,23,.696,88
15952,2013-01-25,MIA,,DET,W 110-88,240,43,77,.558,38,60,.633,5,17,.294,19,23,.826,110
15953,2013-01-25,HOU,@,NOH,W 100-82,240,34,71,.479,23,50,.460,11,21,.524,21,26,.808,100
15954,2013-01-25,NOP,,HOU,L 82-100,240,31,80,.388,28,60,.467,3,20,.150,17,20,.850,82
15955,2013-01-25,OKC,@,SAC,W 105-95,240,37,76,.487,31,53,.585,6,23,.261,25,30,.833,105
15956,2013-01-25,SAC,,OKC,L 95-105,240,36,86,.419,28,71,.394,8,15,.533,15,21,.714,95
15957,2013-01-25,MIN,@,WAS,L 101-114,240,39,88,.443,36,74,.486,3,14,.214,20,33,.606,101
15958,2013-01-25,WAS,,MIN,W 114-101,240,48,83,.578,40,66,.606,8,17,.471,10,17,.588,114
15959,2013-01-24,BOS,,NYK,L 86-89,240,31,76,.408,28,58,.483,3,18,.167,21,28,.750,86
15960,2013-01-24,NYK,@,BOS,W 89-86,240,32,83,.386,24,55,.436,8,28,.286,17,20,.850,89
15961,2013-01-24,ORL,,TOR,L 95-97,240,35,81,.432,27,63,.429,8,18,.444,17,20,.850,95
15962,2013-01-24,TOR,@,ORL,W 97-95,240,39,78,.500,35,62,.565,4,16,.250,15,19,.789,97
15963,2013-01-24,LAC,@,PHO,L 88-93,240,33,83,.398,27,65,.415,6,18,.333,16,26,.615,88
15964,2013-01-24,PHO,,LAC,W 93-88,240,30,71,.423,25,55,.455,5,16,.313,28,37,.757,93
15965,2013-01-23,ATL,@,CHA,W 104-92,240,43,87,.494,31,62,.500,12,25,.480,6,12,.500,104
15966,2013-01-23,CHA,,ATL,L 92-104,240,31,76,.408,25,61,.410,6,15,.400,24,29,.828,92
15967,2013-01-23,CHI,,DET,W 85-82,240,31,71,.437,28,57,.491,3,14,.214,20,26,.769,85
15968,2013-01-23,DET,@,CHI,L 82-85,240,34,82,.415,30,69,.435,4,13,.308,10,14,.714,82
15969,2013-01-23,GSW,,OKC,W 104-99,240,37,84,.440,31,61,.508,6,23,.261,24,27,.889,104
15970,2013-01-23,OKC,@,GSW,L 99-104,240,36,78,.462,31,62,.500,5,16,.313,22,27,.815,99
15971,2013-01-23,DEN,@,HOU,W 105-95,240,40,86,.465,32,65,.492,8,21,.381,17,25,.680,105
15972,2013-01-23,HOU,,DEN,L 95-105,240,37,83,.446,26,49,.531,11,34,.324,10,13,.769,95
15973,2013-01-23,LAL,@,MEM,L 93-106,240,31,73,.425,24,56,.429,7,17,.412,24,32,.750,93
15974,2013-01-23,MEM,,LAL,W 106-93,240,47,96,.490,43,83,.518,4,13,.308,8,10,.800,106
15975,2013-01-23,MIA,,TOR,W 123-116 (OT),265,45,82,.549,36,60,.600,9,22,.409,24,38,.632,123
15976,2013-01-23,TOR,@,MIA,L 116-123 (OT),265,44,88,.500,30,57,.526,14,31,.452,14,18,.778,116
15977,2013-01-23,BRK,@,MIN,W 91-83,240,37,84,.440,31,64,.484,6,20,.300,11,16,.688,91
15978,2013-01-23,MIN,,BRK,L 83-91,240,38,83,.458,35,68,.515,3,15,.200,4,6,.667,83
15979,2013-01-23,IND,@,POR,L 80-100,240,30,80,.375,24,57,.421,6,23,.261,14,17,.824,80
15980,2013-01-23,POR,,IND,W 100-80,240,44,78,.564,42,67,.627,2,11,.182,10,12,.833,100
15981,2013-01-23,PHO,@,SAC,W 106-96,240,43,90,.478,37,71,.521,6,19,.316,14,16,.875,106
15982,2013-01-23,SAC,,PHO,L 96-106,240,38,79,.481,33,68,.485,5,11,.455,15,24,.625,96
15983,2013-01-23,NOP,@,SAS,L 102-106,240,38,81,.469,28,64,.438,10,17,.588,16,23,.696,102
15984,2013-01-23,SAS,,NOH,W 106-102,240,43,80,.538,35,55,.636,8,25,.320,12,23,.522,106
15985,2013-01-23,UTA,,WAS,W 92-88,240,38,85,.447,35,73,.479,3,12,.250,13,19,.684,92
15986,2013-01-23,WAS,@,UTA,L 88-92,240,31,86,.360,24,68,.353,7,18,.389,19,26,.731,88
15987,2013-01-22,BOS,@,CLE,L 90-95,240,32,84,.381,25,67,.373,7,17,.412,19,22,.864,90
15988,2013-01-22,CLE,,BOS,W 95-90,240,37,82,.451,35,70,.500,2,12,.167,19,22,.864,95
15989,2013-01-22,DET,,ORL,W 105-90,240,42,91,.462,35,68,.515,7,23,.304,14,21,.667,105
15990,2013-01-22,ORL,@,DET,L 90-105,240,38,84,.452,30,64,.469,8,20,.400,6,8,.750,90
15991,2013-01-22,LAC,,OKC,L 97-109,240,39,84,.464,35,68,.515,4,16,.250,15,21,.714,97
15992,2013-01-22,OKC,@,LAC,W 109-97,240,41,78,.526,26,51,.510,15,27,.556,12,14,.857,109
15993,2013-01-22,MIL,,PHI,W 110-102,240,41,79,.519,34,63,.540,7,16,.438,21,33,.636,110
15994,2013-01-22,PHI,@,MIL,L 102-110,240,42,95,.442,34,79,.430,8,16,.500,10,13,.769,102
15995,2013-01-21,ATL,,MIN,W 104-96,240,41,71,.577,31,55,.564,10,16,.625,12,21,.571,104
15996,2013-01-21,MIN,@,ATL,L 96-104,240,36,74,.486,31,60,.517,5,14,.357,19,26,.731,96
15997,2013-01-21,CHA,,HOU,L 94-100,240,34,81,.420,28,66,.424,6,15,.400,20,24,.833,94
15998,2013-01-21,HOU,@,CHA,W 100-94,240,29,74,.392,19,45,.422,10,29,.345,32,41,.780,100
15999,2013-01-21,CHI,,LAL,W 95-83,240,39,93,.419,30,76,.395,9,17,.529,8,12,.667,95
16000,2013-01-21,LAL,@,CHI,L 83-95,240,32,81,.395,29,64,.453,3,17,.176,16,23,.696,83
16001,2013-01-21,GSW,,LAC,W 106-99,240,39,75,.520,27,53,.509,12,22,.545,16,18,.889,106
16002,2013-01-21,LAC,@,GSW,L 99-106,240,38,83,.458,27,53,.509,11,30,.367,12,22,.545,99
16003,2013-01-21,IND,@,MEM,W 82-81,240,34,69,.493,26,52,.500,8,17,.471,6,11,.545,82
16004,2013-01-21,MEM,,IND,L 81-82,240,35,83,.422,31,73,.425,4,10,.400,7,7,1.000,81
16005,2013-01-21,NOP,,SAC,W 114-105,240,43,89,.483,31,64,.484,12,25,.480,16,21,.762,114
16006,2013-01-21,SAC,@,NOH,L 105-114,240,38,81,.469,35,66,.530,3,15,.200,26,32,.813,105
16007,2013-01-21,BRK,@,NYK,W 88-85,240,31,74,.419,19,50,.380,12,24,.500,14,20,.700,88
16008,2013-01-21,NYK,,BRK,L 85-88,240,34,84,.405,28,63,.444,6,21,.286,11,17,.647,85
16009,2013-01-21,PHI,,SAS,L 85-90,240,37,84,.440,33,70,.471,4,14,.286,7,11,.636,85
16010,2013-01-21,SAS,@,PHI,W 90-85,240,34,81,.420,31,63,.492,3,18,.167,19,26,.731,90
16011,2013-01-21,POR,,WAS,L 95-98,240,37,81,.457,30,57,.526,7,24,.292,14,18,.778,95
16012,2013-01-21,WAS,@,POR,W 98-95,240,39,84,.464,31,65,.477,8,19,.421,12,17,.706,98
16013,2013-01-20,DEN,,OKC,W 121-118 (OT),265,45,93,.484,37,75,.493,8,18,.444,23,34,.676,121
16014,2013-01-20,OKC,@,DEN,L 118-121 (OT),265,35,76,.461,27,52,.519,8,24,.333,40,48,.833,118
16015,2013-01-20,BOS,@,DET,L 88-103,240,33,83,.398,29,68,.426,4,15,.267,18,25,.720,88
16016,2013-01-20,DET,,BOS,W 103-88,240,36,78,.462,27,59,.458,9,19,.474,22,31,.710,103
16017,2013-01-20,DAL,@,ORL,W 111-105,240,45,90,.500,37,75,.493,8,15,.533,13,15,.867,111
16018,2013-01-20,ORL,,DAL,L 105-111,240,40,79,.506,31,58,.534,9,21,.429,16,20,.800,105
16019,2013-01-20,LAL,@,TOR,L 103-108,240,38,88,.432,29,61,.475,9,27,.333,18,21,.857,103
16020,2013-01-20,TOR,,LAL,W 108-103,240,46,84,.548,40,64,.625,6,20,.300,10,17,.588,108
16021,2013-01-19,ATL,,SAS,L 93-98,240,35,85,.412,27,64,.422,8,21,.381,15,22,.682,93
16022,2013-01-19,SAS,@,ATL,W 98-93,240,41,86,.477,33,62,.532,8,24,.333,8,11,.727,98
16023,2013-01-19,CHA,,SAC,L 93-97,240,31,72,.431,26,57,.456,5,15,.333,26,38,.684,93
16024,2013-01-19,SAC,@,CHA,W 97-93,240,37,81,.457,32,63,.508,5,18,.278,18,21,.857,97
16025,2013-01-19,CHI,,MEM,L 82-85 (OT),265,31,85,.365,28,71,.394,3,14,.214,17,21,.810,82
16026,2013-01-19,MEM,@,CHI,W 85-82 (OT),265,34,84,.405,34,79,.430,0,5,.000,17,28,.607,85
16027,2013-01-19,LAC,,WAS,W 94-87,240,34,93,.366,29,72,.403,5,21,.238,21,31,.677,94
16028,2013-01-19,WAS,@,LAC,L 87-94,240,32,77,.416,24,57,.421,8,20,.400,15,27,.556,87
16029,2013-01-19,HOU,@,MIN,L 79-92,240,25,78,.321,17,47,.362,8,31,.258,21,28,.750,79
16030,2013-01-19,MIN,,HOU,W 92-79,240,30,64,.469,27,50,.540,3,14,.214,29,36,.806,92
16031,2013-01-19,GSW,@,NOH,W 116-112,240,38,77,.494,28,55,.509,10,22,.455,30,35,.857,116
16032,2013-01-19,NOP,,GSW,L 112-116,240,45,79,.570,36,55,.655,9,24,.375,13,23,.565,112
16033,2013-01-19,MIL,@,POR,W 110-104,240,39,88,.443,33,70,.471,6,18,.333,26,32,.813,110
16034,2013-01-19,POR,,MIL,L 104-110,240,34,81,.420,26,53,.491,8,28,.286,28,32,.875,104
16035,2013-01-19,CLE,@,UTA,L 98-109,240,34,83,.410,28,62,.452,6,21,.286,24,30,.800,98
16036,2013-01-19,UTA,,CLE,W 109-98,240,45,90,.500,39,74,.527,6,16,.375,13,17,.765,109
16037,2013-01-18,BOS,,CHI,L 99-100 (OT),265,38,91,.418,35,77,.455,3,14,.214,20,28,.714,99
16038,2013-01-18,CHI,@,BOS,W 100-99 (OT),265,36,75,.480,31,60,.517,5,15,.333,23,32,.719,100
16039,2013-01-18,ATL,@,BRK,L 89-94,240,35,80,.438,26,59,.441,9,21,.429,10,14,.714,89
16040,2013-01-18,BRK,,ATL,W 94-89,240,30,74,.405,21,48,.438,9,26,.346,25,38,.658,94
16041,2013-01-18,DAL,,OKC,L 114-117 (OT),265,41,91,.451,34,71,.479,7,20,.350,25,30,.833,114
16042,2013-01-18,OKC,@,DAL,W 117-114 (OT),265,39,95,.411,33,75,.440,6,20,.300,33,36,.917,117
16043,2013-01-18,DEN,,WAS,L 108-112,240,41,84,.488,34,68,.500,7,16,.438,19,31,.613,108
16044,2013-01-18,WAS,@,DEN,W 112-108,240,41,80,.513,30,57,.526,11,23,.478,19,28,.679,112
16045,2013-01-18,HOU,@,IND,L 95-105,240,34,83,.410,21,53,.396,13,30,.433,14,16,.875,95
16046,2013-01-18,IND,,HOU,W 105-95,240,40,87,.460,29,68,.426,11,19,.579,14,17,.824,105
16047,2013-01-18,MEM,,SAC,W 85-69,240,34,78,.436,31,71,.437,3,7,.429,14,20,.700,85
16048,2013-01-18,SAC,@,MEM,L 69-85,240,29,85,.341,27,75,.360,2,10,.200,9,15,.600,69
16049,2013-01-18,CHA,@,ORL,W 106-100,240,37,79,.468,33,67,.493,4,12,.333,28,38,.737,106
16050,2013-01-18,ORL,,CHA,L 100-106,240,37,79,.468,26,48,.542,11,31,.355,15,21,.714,100
16051,2013-01-18,PHI,,TOR,W 108-101 (OT),265,47,91,.516,43,72,.597,4,19,.211,10,14,.714,108
16052,2013-01-18,TOR,@,PHI,L 101-108 (OT),265,40,88,.455,29,63,.460,11,25,.440,10,13,.769,101
16053,2013-01-18,GSW,@,SAS,L 88-95,240,36,84,.429,32,68,.471,4,16,.250,12,14,.857,88
16054,2013-01-18,SAS,,GSW,W 95-88,240,36,80,.450,31,58,.534,5,22,.227,18,20,.900,95
16055,2013-01-17,DET,,NYK,L 87-102,240,35,79,.443,29,62,.468,6,17,.353,11,22,.500,87
16056,2013-01-17,NYK,@,DET,W 102-87,240,33,72,.458,22,41,.537,11,31,.355,25,31,.806,102
16057,2013-01-17,LAL,,MIA,L 90-99,240,31,72,.431,21,50,.420,10,22,.455,18,28,.643,90
16058,2013-01-17,MIA,@,LAL,W 99-90,240,40,83,.482,38,70,.543,2,13,.154,17,23,.739,99
16059,2013-01-17,LAC,@,MIN,W 90-77,240,35,77,.455,30,64,.469,5,13,.385,15,23,.652,90
16060,2013-01-17,MIN,,LAC,L 77-90,240,30,84,.357,26,65,.400,4,19,.211,13,20,.650,77
16061,2013-01-17,MIL,@,PHO,W 98-94,240,39,92,.424,33,76,.434,6,16,.375,14,20,.700,98
16062,2013-01-17,PHO,,MIL,L 94-98,240,34,89,.382,30,75,.400,4,14,.286,22,29,.759,94
16063,2013-01-16,ATL,,BRK,W 109-95,240,45,78,.577,37,57,.649,8,21,.381,11,17,.647,109
16064,2013-01-16,BRK,@,ATL,L 95-109,240,37,87,.425,33,61,.541,4,26,.154,17,17,1.000,95
16065,2013-01-16,BOS,,NOH,L 78-90,240,34,74,.459,30,56,.536,4,18,.222,6,16,.375,78
16066,2013-01-16,NOP,@,BOS,W 90-78,240,31,71,.437,29,54,.537,2,17,.118,26,31,.839,90
16067,2013-01-16,DAL,,HOU,W 105-100,240,33,86,.384,28,64,.438,5,22,.227,34,43,.791,105
16068,2013-01-16,HOU,@,DAL,L 100-105,240,33,84,.393,22,57,.386,11,27,.407,23,30,.767,100
16069,2013-01-16,GSW,,MIA,L 75-92,240,29,80,.363,26,68,.382,3,12,.250,14,18,.778,75
16070,2013-01-16,MIA,@,GSW,W 92-75,240,36,90,.400,28,61,.459,8,29,.276,12,18,.667,92
16071,2013-01-16,DEN,@,OKC,L 97-117,240,33,73,.452,31,58,.534,2,15,.133,29,37,.784,97
16072,2013-01-16,OKC,,DEN,W 117-97,240,44,85,.518,35,66,.530,9,19,.474,20,26,.769,117
16073,2013-01-16,IND,@,ORL,L 86-97,240,37,85,.435,35,68,.515,2,17,.118,10,12,.833,86
16074,2013-01-16,ORL,,IND,W 97-86,240,40,86,.465,28,65,.431,12,21,.571,5,5,1.000,97
16075,2013-01-16,CLE,@,POR,W 93-88,240,32,83,.386,28,66,.424,4,17,.235,25,32,.781,93
16076,2013-01-16,POR,,CLE,L 88-93,240,31,79,.392,22,50,.440,9,29,.310,17,26,.654,88
16077,2013-01-16,SAC,,WAS,W 95-94,240,41,85,.482,36,74,.486,5,11,.455,8,13,.615,95
16078,2013-01-16,WAS,@,SAC,L 94-95,240,39,86,.453,31,69,.449,8,17,.471,8,11,.727,94
16079,2013-01-16,MEM,@,SAS,L 82-103,240,29,69,.420,28,60,.467,1,9,.111,23,28,.821,82
16080,2013-01-16,SAS,,MEM,W 103-82,240,44,76,.579,35,58,.603,9,18,.500,6,10,.600,103
16081,2013-01-16,CHI,@,TOR,W 107-105 (OT),265,39,86,.453,36,75,.480,3,11,.273,26,36,.722,107
16082,2013-01-16,TOR,,CHI,L 105-107 (OT),265,38,85,.447,32,69,.464,6,16,.375,23,32,.719,105
16083,2013-01-15,BRK,,TOR,W 113-106,240,40,81,.494,32,60,.533,8,21,.381,25,28,.893,113
16084,2013-01-15,TOR,@,BRK,L 106-113,240,40,82,.488,33,69,.478,7,13,.538,19,23,.826,106
16085,2013-01-15,CHA,,IND,L 76-103,240,25,72,.347,22,63,.349,3,9,.333,23,30,.767,76
16086,2013-01-15,IND,@,CHA,W 103-76,240,36,87,.414,28,65,.431,8,22,.364,23,28,.821,103
16087,2013-01-15,DEN,,POR,W 115-111 (OT),265,47,99,.475,38,74,.514,9,25,.360,12,19,.632,115
16088,2013-01-15,POR,@,DEN,L 111-115 (OT),265,42,88,.477,34,61,.557,8,27,.296,19,23,.826,111
16089,2013-01-15,HOU,,LAC,L 109-117,240,41,82,.500,28,45,.622,13,37,.351,14,25,.560,109
16090,2013-01-15,LAC,@,HOU,W 117-109,240,42,78,.538,31,59,.525,11,19,.579,22,26,.846,117
16091,2013-01-15,LAL,,MIL,W 104-88,240,42,84,.500,32,55,.582,10,29,.345,10,18,.556,104
16092,2013-01-15,MIL,@,LAL,L 88-104,240,34,95,.358,27,67,.403,7,28,.250,13,22,.591,88
16093,2013-01-15,NOP,@,PHI,W 111-99,240,44,83,.530,34,65,.523,10,18,.556,13,18,.722,111
16094,2013-01-15,PHI,,NOH,L 99-111,240,39,82,.476,28,61,.459,11,21,.524,10,13,.769,99
16095,2013-01-14,BOS,,CHA,W 100-89,240,39,80,.488,31,59,.525,8,21,.381,14,20,.700,100
16096,2013-01-14,CHA,@,BOS,L 89-100,240,33,79,.418,27,64,.422,6,15,.400,17,24,.708,89
16097,2013-01-14,ATL,@,CHI,L 58-97,240,24,82,.293,22,68,.324,2,14,.143,8,10,.800,58
16098,2013-01-14,CHI,,ATL,W 97-58,240,33,79,.418,27,65,.415,6,14,.429,25,33,.758,97
16099,2013-01-14,DAL,,MIN,W 113-98,240,46,77,.597,40,64,.625,6,13,.462,15,16,.938,113
16100,2013-01-14,MIN,@,DAL,L 98-113,240,35,85,.412,29,65,.446,6,20,.300,22,29,.759,98
16101,2013-01-14,LAC,@,MEM,W 99-73,240,35,76,.461,30,62,.484,5,14,.357,24,32,.750,99
16102,2013-01-14,MEM,,LAC,L 73-99,240,27,89,.303,21,69,.304,6,20,.300,13,17,.765,73
16103,2013-01-14,OKC,@,PHO,W 102-90,240,40,84,.476,35,67,.522,5,17,.294,17,22,.773,102
16104,2013-01-14,PHO,,OKC,L 90-102,240,35,84,.417,26,59,.441,9,25,.360,11,18,.611,90
16105,2013-01-14,CLE,@,SAC,L 118-124,240,44,92,.478,36,76,.474,8,16,.500,22,30,.733,118
16106,2013-01-14,SAC,,CLE,W 124-118,240,43,84,.512,34,65,.523,9,19,.474,29,33,.879,124
16107,2013-01-14,MIA,@,UTA,L 97-104,240,39,72,.542,30,49,.612,9,23,.391,10,16,.625,97
16108,2013-01-14,UTA,,MIA,W 104-97,240,36,76,.474,28,58,.483,8,18,.444,24,28,.857,104
16109,2013-01-14,ORL,@,WAS,L 91-120,240,37,87,.425,32,69,.464,5,18,.278,12,15,.800,91
16110,2013-01-14,WAS,,ORL,W 120-91,240,46,82,.561,39,71,.549,7,11,.636,21,25,.840,120
16111,2013-01-13,BRK,,IND,W 97-86,240,33,81,.407,27,67,.403,6,14,.429,25,31,.806,97
16112,2013-01-13,IND,@,BRK,L 86-97,240,35,83,.422,29,59,.492,6,24,.250,10,12,.833,86
16113,2013-01-13,DEN,,GSW,W 116-105,240,43,90,.478,34,63,.540,9,27,.333,21,27,.778,116
16114,2013-01-13,GSW,@,DEN,L 105-116,240,43,83,.518,30,59,.508,13,24,.542,6,8,.750,105
16115,2013-01-13,CLE,@,LAL,L 93-113,240,39,95,.411,35,74,.473,4,21,.190,11,12,.917,93
16116,2013-01-13,LAL,,CLE,W 113-93,240,40,69,.580,27,44,.614,13,25,.520,20,27,.741,113
16117,2013-01-13,NOP,@,NYK,L 87-100,240,33,82,.402,29,59,.492,4,23,.174,17,22,.773,87
16118,2013-01-13,NYK,,NOH,W 100-87,240,35,81,.432,24,51,.471,11,30,.367,19,25,.760,100
16119,2013-01-13,OKC,@,POR,W 87-83,240,32,71,.451,26,48,.542,6,23,.261,17,22,.773,87
16120,2013-01-13,POR,,OKC,L 83-87,240,31,86,.360,25,65,.385,6,21,.286,15,18,.833,83
16121,2013-01-13,MIN,@,SAS,L 88-106,240,33,89,.371,29,73,.397,4,16,.250,18,23,.783,88
16122,2013-01-13,SAS,,MIN,W 106-88,240,45,80,.563,37,59,.627,8,21,.381,8,11,.727,106
16123,2013-01-13,MIL,@,TOR,W 107-96,240,40,77,.519,32,58,.552,8,19,.421,19,23,.826,107
16124,2013-01-13,TOR,,MIL,L 96-107,240,36,85,.424,33,72,.458,3,13,.231,21,27,.778,96
16125,2013-01-12,CHI,,PHO,L 81-97,240,32,88,.364,30,77,.390,2,11,.182,15,21,.714,81
16126,2013-01-12,PHO,@,CHI,W 97-81,240,36,73,.493,30,59,.508,6,14,.429,19,25,.760,97
16127,2013-01-12,DAL,,MEM,W 104-83,240,39,80,.488,28,63,.444,11,17,.647,15,21,.714,104
16128,2013-01-12,MEM,@,DAL,L 83-104,240,32,84,.381,29,76,.382,3,8,.375,16,26,.615,83
16129,2013-01-12,DET,,UTA,L 87-90,240,34,65,.523,28,49,.571,6,16,.375,13,21,.619,87
16130,2013-01-12,UTA,@,DET,W 90-87,240,36,71,.507,31,61,.508,5,10,.500,13,18,.722,90
16131,2013-01-12,CHA,@,IND,L 88-96,240,36,78,.462,33,71,.465,3,7,.429,13,16,.813,88
16132,2013-01-12,IND,,CHA,W 96-88,240,38,89,.427,27,61,.443,11,28,.393,9,12,.750,96
16133,2013-01-12,LAC,,ORL,L 101-104,240,43,88,.489,34,66,.515,9,22,.409,6,6,1.000,101
16134,2013-01-12,ORL,@,LAC,W 104-101,240,39,81,.481,28,56,.500,11,25,.440,15,19,.789,104
16135,2013-01-12,HOU,@,PHI,L 100-107,240,37,84,.440,29,52,.558,8,32,.250,18,22,.818,100
16136,2013-01-12,PHI,,HOU,W 107-100,240,43,87,.494,37,69,.536,6,18,.333,15,19,.789,107
16137,2013-01-12,MIA,@,SAC,W 128-99,240,45,80,.563,28,43,.651,17,37,.459,21,24,.875,128
16138,2013-01-12,SAC,,MIA,L 99-128,240,38,87,.437,29,69,.420,9,18,.500,14,19,.737,99
16139,2013-01-12,ATL,@,WAS,L 83-93,240,30,78,.385,23,54,.426,7,24,.292,16,25,.640,83
16140,2013-01-12,WAS,,ATL,W 93-83,240,36,79,.456,34,68,.500,2,11,.182,19,27,.704,93
16141,2013-01-11,ATL,,UTA,W 103-95,240,40,72,.556,31,53,.585,9,19,.474,14,23,.609,103
16142,2013-01-11,UTA,@,ATL,L 95-103,240,36,76,.474,28,56,.500,8,20,.400,15,19,.789,95
16143,2013-01-11,BOS,,HOU,W 103-91,240,41,79,.519,32,56,.571,9,23,.391,12,16,.750,103
16144,2013-01-11,HOU,@,BOS,L 91-103,240,35,80,.438,26,47,.553,9,33,.273,12,29,.414,91
16145,2013-01-11,BRK,,PHO,W 99-79,240,34,75,.453,28,62,.452,6,13,.462,25,32,.781,99
16146,2013-01-11,PHO,@,BRK,L 79-99,240,31,79,.392,24,65,.369,7,14,.500,10,16,.625,79
16147,2013-01-11,CLE,@,DEN,L 91-98,240,37,85,.435,32,61,.525,5,24,.208,12,16,.750,91
16148,2013-01-11,DEN,,CLE,W 98-91,240,36,82,.439,32,66,.485,4,16,.250,22,31,.710,98
16149,2013-01-11,GSW,,POR,W 103-97,240,41,86,.477,35,71,.493,6,15,.400,15,18,.833,103
16150,2013-01-11,POR,@,GSW,L 97-103,240,35,92,.380,20,49,.408,15,43,.349,12,19,.632,97
16151,2013-01-11,LAL,,OKC,L 101-116,240,39,98,.398,33,70,.471,6,28,.214,17,22,.773,101
16152,2013-01-11,OKC,@,LAL,W 116-101,240,44,87,.506,35,58,.603,9,29,.310,19,28,.679,116
16153,2013-01-11,MEM,,SAS,W 101-98 (OT),265,40,85,.471,37,73,.507,3,12,.250,18,21,.857,101
16154,2013-01-11,SAS,@,MEM,L 98-101 (OT),265,35,76,.461,25,51,.490,10,25,.400,18,22,.818,98
16155,2013-01-11,DET,@,MIL,W 103-87,240,39,90,.433,31,68,.456,8,22,.364,17,25,.680,103
16156,2013-01-11,MIL,,DET,L 87-103,240,36,91,.396,35,75,.467,1,16,.063,14,19,.737,87
16157,2013-01-11,MIN,@,NOH,L 92-104,240,31,69,.449,27,51,.529,4,18,.222,26,33,.788,92
16158,2013-01-11,NOP,,MIN,W 104-92,240,44,84,.524,36,62,.581,8,22,.364,8,9,.889,104
16159,2013-01-11,CHI,@,NYK,W 108-101,240,39,68,.574,34,57,.596,5,11,.455,25,34,.735,108
16160,2013-01-11,NYK,,CHI,L 101-108,240,37,90,.411,26,68,.382,11,22,.500,16,23,.696,101
16161,2013-01-11,CHA,@,TOR,L 78-99,240,28,75,.373,25,63,.397,3,12,.250,19,22,.864,78
16162,2013-01-11,TOR,,CHA,W 99-78,240,39,86,.453,27,59,.458,12,27,.444,9,11,.818,99
16163,2013-01-10,IND,,NYK,W 81-76,240,31,79,.392,26,58,.448,5,21,.238,14,16,.875,81
16164,2013-01-10,NYK,@,IND,L 76-81,240,31,89,.348,27,69,.391,4,20,.200,10,13,.769,76
16165,2013-01-10,MIA,@,POR,L 90-92,240,35,77,.455,29,58,.500,6,19,.316,14,20,.700,90
16166,2013-01-10,POR,,MIA,W 92-90,240,30,80,.375,21,53,.396,9,27,.333,23,30,.767,92
16167,2013-01-10,DAL,@,SAC,W 117-112 (OT),265,41,96,.427,36,75,.480,5,21,.238,30,35,.857,117
16168,2013-01-10,SAC,,DAL,L 112-117 (OT),265,40,81,.494,33,54,.611,7,27,.259,25,32,.781,112
16169,2013-01-09,BOS,,PHO,W 87-79,240,37,81,.457,34,67,.507,3,14,.214,10,12,.833,87
16170,2013-01-09,PHO,@,BOS,L 79-87,240,33,84,.393,31,72,.431,2,12,.167,11,18,.611,79
16171,2013-01-09,CHA,,UTA,L 102-112,240,42,88,.477,38,80,.475,4,8,.500,14,22,.636,102
16172,2013-01-09,UTA,@,CHA,W 112-102,240,44,82,.537,34,60,.567,10,22,.455,14,21,.667,112
16173,2013-01-09,CHI,,MIL,L 96-104,240,39,95,.411,35,85,.412,4,10,.400,14,20,.700,96
16174,2013-01-09,MIL,@,CHI,W 104-96,240,39,84,.464,29,62,.468,10,22,.455,16,21,.762,104
16175,2013-01-09,ATL,@,CLE,L 83-99,240,37,84,.440,30,62,.484,7,22,.318,2,5,.400,83
16176,2013-01-09,CLE,,ATL,W 99-83,240,37,81,.457,25,58,.431,12,23,.522,13,20,.650,99
16177,2013-01-09,DEN,,ORL,W 108-105,240,41,94,.436,37,82,.451,4,12,.333,22,36,.611,108
16178,2013-01-09,ORL,@,DEN,L 105-108,240,44,93,.473,36,69,.522,8,24,.333,9,10,.900,105
16179,2013-01-09,GSW,,MEM,L 87-94,240,33,71,.465,26,54,.481,7,17,.412,14,20,.700,87
16180,2013-01-09,MEM,@,GSW,W 94-87,240,40,88,.455,38,71,.535,2,17,.118,12,16,.750,94
16181,2013-01-09,DAL,@,LAC,L 93-99,240,36,84,.429,30,66,.455,6,18,.333,15,18,.833,93
16182,2013-01-09,LAC,,DAL,W 99-93,240,38,79,.481,28,55,.509,10,24,.417,13,21,.619,99
16183,2013-01-09,HOU,@,NOH,L 79-88,240,30,75,.400,21,48,.438,9,27,.333,10,13,.769,79
16184,2013-01-09,NOP,,HOU,W 88-79,240,35,84,.417,30,65,.462,5,19,.263,13,16,.813,88
16185,2013-01-09,MIN,@,OKC,L 84-106,240,31,72,.431,28,60,.467,3,12,.250,19,24,.792,84
16186,2013-01-09,OKC,,MIN,W 106-84,240,36,76,.474,25,56,.446,11,20,.550,23,27,.852,106
16187,2013-01-09,LAL,@,SAS,L 105-108,240,44,95,.463,36,68,.529,8,27,.296,9,15,.600,105
16188,2013-01-09,SAS,,LAL,W 108-105,240,41,84,.488,29,59,.492,12,25,.480,14,16,.875,108
16189,2013-01-09,PHI,@,TOR,L 72-90,240,29,74,.392,27,64,.422,2,10,.200,12,19,.632,72
16190,2013-01-09,TOR,,PHI,W 90-72,240,39,80,.488,38,69,.551,1,11,.091,11,13,.846,90
16191,2013-01-08,HOU,,LAL,W 125-112,240,48,87,.552,37,62,.597,11,25,.440,18,23,.783,125
16192,2013-01-08,LAL,@,HOU,L 112-125,240,43,91,.473,29,60,.483,14,31,.452,12,13,.923,112
16193,2013-01-08,IND,,MIA,W 87-77,240,33,91,.363,24,69,.348,9,22,.409,12,19,.632,87
16194,2013-01-08,MIA,@,IND,L 77-87,240,28,68,.412,20,49,.408,8,19,.421,13,18,.722,77
16195,2013-01-08,MIL,,PHO,W 108-99,240,42,91,.462,33,74,.446,9,17,.529,15,19,.789,108
16196,2013-01-08,PHO,@,MIL,L 99-108,240,37,90,.411,33,70,.471,4,20,.200,21,26,.808,99
16197,2013-01-08,ATL,@,MIN,L 103-108,240,38,77,.494,28,55,.509,10,22,.455,17,21,.810,103
16198,2013-01-08,MIN,,ATL,W 108-103,240,40,87,.460,32,72,.444,8,15,.533,20,26,.769,108
16199,2013-01-08,BRK,@,PHI,W 109-89,240,40,83,.482,30,59,.508,10,24,.417,19,22,.864,109
16200,2013-01-08,PHI,,BRK,L 89-109,240,38,79,.481,31,62,.500,7,17,.412,6,10,.600,89
16201,2013-01-07,CHI,,CLE,W 118-92,240,44,82,.537,34,68,.500,10,14,.714,20,24,.833,118
16202,2013-01-07,CLE,@,CHI,L 92-118,240,33,78,.423,26,64,.406,7,14,.500,19,23,.826,92
16203,2013-01-07,NOP,,SAS,W 95-88,240,40,83,.482,35,70,.500,5,13,.385,10,12,.833,95
16204,2013-01-07,SAS,@,NOH,L 88-95,240,33,73,.452,27,52,.519,6,21,.286,16,20,.800,88
16205,2013-01-07,BOS,@,NYK,W 102-96,240,39,74,.527,33,56,.589,6,18,.333,18,20,.900,102
16206,2013-01-07,NYK,,BOS,L 96-102,240,31,76,.408,17,44,.386,14,32,.438,20,26,.769,96
16207,2013-01-07,ORL,@,POR,L 119-125 (OT),265,46,93,.495,35,63,.556,11,30,.367,16,18,.889,119
16208,2013-01-07,POR,,ORL,W 125-119 (OT),265,48,94,.511,40,70,.571,8,24,.333,21,24,.875,125
16209,2013-01-07,MEM,@,SAC,W 113-81,240,39,80,.488,28,60,.467,11,20,.550,24,27,.889,113
16210,2013-01-07,SAC,,MEM,L 81-113,240,28,76,.368,23,55,.418,5,21,.238,20,23,.870,81
16211,2013-01-07,DAL,@,UTA,L 94-100,240,35,81,.432,29,62,.468,6,19,.316,18,20,.900,94
16212,2013-01-07,UTA,,DAL,W 100-94,240,31,78,.397,21,59,.356,10,19,.526,28,36,.778,100
16213,2013-01-07,OKC,@,WAS,L 99-101,240,34,80,.425,28,55,.509,6,25,.240,25,30,.833,99
16214,2013-01-07,WAS,,OKC,W 101-99,240,38,87,.437,28,69,.406,10,18,.556,15,18,.833,101
16215,2013-01-06,CHA,@,DET,W 108-101 (OT),265,40,92,.435,37,79,.468,3,13,.231,25,29,.862,108
16216,2013-01-06,DET,,CHA,L 101-108 (OT),265,40,80,.500,32,54,.593,8,26,.308,13,19,.684,101
16217,2013-01-06,DEN,@,LAL,W 112-105,240,44,101,.436,35,77,.455,9,24,.375,15,23,.652,112
16218,2013-01-06,LAL,,DEN,L 105-112,240,38,82,.463,28,52,.538,10,30,.333,19,27,.704,105
16219,2013-01-06,MIA,,WAS,W 99-71,240,38,82,.463,30,61,.492,8,21,.381,15,16,.938,99
16220,2013-01-06,WAS,@,MIA,L 71-99,240,29,81,.358,23,60,.383,6,21,.286,7,14,.500,71
16221,2013-01-06,MEM,@,PHO,W 92-81,240,37,69,.536,35,61,.574,2,8,.250,16,20,.800,92
16222,2013-01-06,PHO,,MEM,L 81-92,240,31,79,.392,26,65,.400,5,14,.357,14,18,.778,81
16223,2013-01-06,OKC,@,TOR,W 104-92,240,38,77,.494,32,55,.582,6,22,.273,22,24,.917,104
16224,2013-01-06,TOR,,OKC,L 92-104,240,34,76,.447,26,53,.491,8,23,.348,16,21,.762,92
16225,2013-01-05,ATL,,BOS,L 81-89,240,28,68,.412,18,39,.462,10,29,.345,15,19,.789,81
16226,2013-01-05,BOS,@,ATL,W 89-81,240,39,85,.459,36,69,.522,3,16,.188,8,12,.667,89
16227,2013-01-05,BRK,,SAC,W 113-93,240,44,85,.518,37,61,.607,7,24,.292,18,21,.857,113
16228,2013-01-05,SAC,@,BRK,L 93-113,240,36,90,.400,30,71,.423,6,19,.316,15,23,.652,93
16229,2013-01-05,CLE,,HOU,L 104-112,240,36,91,.396,29,68,.426,7,23,.304,25,28,.893,104
16230,2013-01-05,HOU,@,CLE,W 112-104,240,37,79,.468,25,45,.556,12,34,.353,26,36,.722,112
16231,2013-01-05,DAL,,NOH,L 96-99 (OT),265,39,85,.459,32,66,.485,7,19,.368,11,13,.846,96
16232,2013-01-05,NOP,@,DAL,W 99-96 (OT),265,39,86,.453,31,65,.477,8,21,.381,13,16,.813,99
16233,2013-01-05,DEN,,UTA,W 110-91,240,39,76,.513,35,65,.538,4,11,.364,28,39,.718,110
16234,2013-01-05,UTA,@,DEN,L 91-110,240,28,78,.359,19,53,.358,9,25,.360,26,35,.743,91
16235,2013-01-05,IND,,MIL,W 95-80,240,40,92,.435,37,72,.514,3,20,.150,12,20,.600,95
16236,2013-01-05,MIL,@,IND,L 80-95,240,31,82,.378,26,64,.406,5,18,.278,13,18,.722,80
16237,2013-01-05,GSW,@,LAC,L 89-115,240,32,72,.444,27,52,.519,5,20,.250,20,26,.769,89
16238,2013-01-05,LAC,,GSW,W 115-89,240,47,90,.522,37,62,.597,10,28,.357,11,15,.733,115
16239,2013-01-05,MIN,,POR,L 97-102,240,38,91,.418,33,75,.440,5,16,.313,16,18,.889,97
16240,2013-01-05,POR,@,MIN,W 102-97,240,37,86,.430,21,62,.339,16,24,.667,12,13,.923,102
16241,2013-01-05,NYK,@,ORL,W 114-106,240,42,88,.477,30,55,.545,12,33,.364,18,22,.818,114
16242,2013-01-05,ORL,,NYK,L 106-114,240,41,85,.482,31,59,.525,10,26,.385,14,18,.778,106
16243,2013-01-05,PHI,@,SAS,L 86-109,240,35,84,.417,32,67,.478,3,17,.176,13,20,.650,86
16244,2013-01-05,SAS,,PHI,W 109-86,240,41,85,.482,33,60,.550,8,25,.320,19,23,.826,109
16245,2013-01-04,BOS,,IND,W 94-75,240,40,89,.449,36,80,.450,4,9,.444,10,18,.556,94
16246,2013-01-04,IND,@,BOS,L 75-94,240,27,85,.318,23,68,.338,4,17,.235,17,28,.607,75
16247,2013-01-04,CHA,,CLE,L 104-106,240,37,82,.451,29,65,.446,8,17,.471,22,28,.786,104
16248,2013-01-04,CLE,@,CHA,W 106-104,240,39,78,.500,32,62,.516,7,16,.438,21,29,.724,106
16249,2013-01-04,ATL,@,DET,L 84-85,240,31,75,.413,21,46,.457,10,29,.345,12,20,.600,84
16250,2013-01-04,DET,,ATL,W 85-84,240,35,85,.412,32,70,.457,3,15,.200,12,21,.571,85
16251,2013-01-04,LAC,,LAL,W 107-102,240,41,82,.500,35,68,.515,6,14,.429,19,25,.760,107
16252,2013-01-04,LAL,@,LAC,L 102-107,240,35,76,.461,29,51,.569,6,25,.240,26,36,.722,102
16253,2013-01-04,MEM,,POR,L 84-86,240,32,81,.395,30,76,.395,2,5,.400,18,18,1.000,84
16254,2013-01-04,POR,@,MEM,W 86-84,240,33,81,.407,23,54,.426,10,27,.370,10,15,.667,86
16255,2013-01-04,CHI,@,MIA,W 96-89,240,36,80,.450,31,66,.470,5,14,.357,19,24,.792,96
16256,2013-01-04,MIA,,CHI,L 89-96,240,30,65,.462,25,45,.556,5,20,.250,24,31,.774,89
16257,2013-01-04,HOU,@,MIL,W 115-101,240,45,83,.542,32,50,.640,13,33,.394,12,19,.632,115
16258,2013-01-04,MIL,,HOU,L 101-115,240,39,87,.448,33,73,.452,6,14,.429,17,23,.739,101
16259,2013-01-04,OKC,,PHI,W 109-85,240,39,75,.520,29,58,.500,10,17,.588,21,27,.778,109
16260,2013-01-04,PHI,@,OKC,L 85-109,240,34,84,.405,23,60,.383,11,24,.458,6,8,.750,85
16261,2013-01-04,PHO,,UTA,L 80-87,240,34,75,.453,30,60,.500,4,15,.267,8,11,.727,80
16262,2013-01-04,UTA,@,PHO,W 87-80,240,40,89,.449,39,80,.488,1,9,.111,6,9,.667,87
16263,2013-01-04,SAC,@,TOR,W 105-96,240,40,76,.526,36,64,.563,4,12,.333,21,30,.700,105
16264,2013-01-04,TOR,,SAC,L 96-105,240,30,79,.380,19,46,.413,11,33,.333,25,37,.676,96
16265,2013-01-04,BRK,@,WAS,W 115-113 (2OT),290,41,89,.461,33,65,.508,8,24,.333,25,36,.694,115
16266,2013-01-04,WAS,,BRK,L 113-115 (2OT),290,43,91,.473,34,73,.466,9,18,.500,18,31,.581,113
16267,2013-01-03,DEN,,MIN,L 97-101,240,40,86,.465,34,64,.531,6,22,.273,11,20,.550,97
16268,2013-01-03,MIN,@,DEN,W 101-97,240,37,83,.446,31,67,.463,6,16,.375,21,30,.700,101
16269,2013-01-03,NYK,,SAS,W 100-83,240,39,82,.476,27,55,.491,12,27,.444,10,16,.625,100
16270,2013-01-03,SAS,@,NYK,L 83-100,240,28,77,.364,19,43,.442,9,34,.265,18,21,.857,83
16271,2013-01-02,BOS,,MEM,L 83-93,240,32,71,.451,24,49,.490,8,22,.364,11,16,.688,83
16272,2013-01-02,MEM,@,BOS,W 93-83,240,34,71,.479,26,53,.491,8,18,.444,17,22,.773,93
16273,2013-01-02,CLE,,SAC,L 94-97,240,34,87,.391,29,66,.439,5,21,.238,21,24,.875,94
16274,2013-01-02,SAC,@,CLE,W 97-94,240,38,88,.432,35,72,.486,3,16,.188,18,23,.783,97
16275,2013-01-02,GSW,,LAC,W 115-94,240,42,84,.500,30,61,.492,12,23,.522,19,22,.864,115
16276,2013-01-02,LAC,@,GSW,L 94-115,240,29,80,.363,21,51,.412,8,29,.276,28,39,.718,94
16277,2013-01-02,HOU,,NOH,W 104-92,240,41,83,.494,36,59,.610,5,24,.208,17,23,.739,104
16278,2013-01-02,NOP,@,HOU,L 92-104,240,38,90,.422,33,74,.446,5,16,.313,11,20,.550,92
16279,2013-01-02,IND,,WAS,W 89-81,240,29,77,.377,24,61,.393,5,16,.313,26,31,.839,89
16280,2013-01-02,WAS,@,IND,L 81-89,240,35,83,.422,32,70,.457,3,13,.231,8,10,.800,81
16281,2013-01-02,DAL,@,MIA,L 109-119 (OT),265,41,94,.436,31,66,.470,10,28,.357,17,20,.850,109
16282,2013-01-02,MIA,,DAL,W 119-109 (OT),265,42,89,.472,32,63,.508,10,26,.385,25,31,.806,119
16283,2013-01-02,MIL,,SAS,L 110-117,240,43,88,.489,38,71,.535,5,17,.294,19,24,.792,110
16284,2013-01-02,SAS,@,MIL,W 117-110,240,46,89,.517,37,72,.514,9,17,.529,16,23,.696,117
16285,2013-01-02,BRK,@,OKC,W 110-93,240,38,76,.500,29,59,.492,9,17,.529,25,29,.862,110
16286,2013-01-02,OKC,,BRK,L 93-110,240,36,73,.493,28,54,.519,8,19,.421,13,17,.765,93
16287,2013-01-02,CHI,@,ORL,W 96-94,240,36,77,.468,31,65,.477,5,12,.417,19,25,.760,96
16288,2013-01-02,ORL,,CHI,L 94-96,240,37,78,.474,28,54,.519,9,24,.375,11,14,.786,94
16289,2013-01-02,PHI,@,PHO,L 89-95,240,37,84,.440,32,70,.457,5,14,.357,10,12,.833,89
16290,2013-01-02,PHO,,PHI,W 95-89,240,39,85,.459,36,72,.500,3,13,.231,14,20,.700,95
16291,2013-01-02,POR,@,TOR,L 79-102,240,31,70,.443,27,48,.563,4,22,.182,13,16,.813,79
16292,2013-01-02,TOR,,POR,W 102-79,240,41,77,.532,33,54,.611,8,23,.348,12,17,.706,102
16293,2013-01-02,MIN,@,UTA,L 84-106,240,29,84,.345,27,67,.403,2,17,.118,24,30,.800,84
16294,2013-01-02,UTA,,MIN,W 106-84,240,43,87,.494,39,75,.520,4,12,.333,16,19,.842,106
16295,2013-01-01,DEN,,LAC,W 92-78,240,37,82,.451,30,59,.508,7,23,.304,11,21,.524,92
16296,2013-01-01,LAC,@,DEN,L 78-92,240,30,78,.385,25,49,.510,5,29,.172,13,29,.448,78
16297,2013-01-01,DET,,SAC,W 103-97,240,39,75,.520,31,55,.564,8,20,.400,17,22,.773,103
16298,2013-01-01,SAC,@,DET,L 97-103,240,36,86,.419,27,60,.450,9,26,.346,16,21,.762,97
16299,2013-01-01,LAL,,PHI,L 99-103,240,37,94,.394,34,72,.472,3,22,.136,22,33,.667,99
16300,2013-01-01,PHI,@,LAL,W 103-99,240,41,86,.477,33,64,.516,8,22,.364,13,20,.650,103
16301,2013-01-01,ATL,@,NOH,W 95-86,240,41,83,.494,32,61,.525,9,22,.409,4,8,.500,95
16302,2013-01-01,NOP,,ATL,L 86-95,240,36,82,.439,26,62,.419,10,20,.500,4,12,.333,86
16303,2013-01-01,NYK,,POR,L 100-105,240,36,84,.429,26,47,.553,10,37,.270,18,24,.750,100
16304,2013-01-01,POR,@,NYK,W 105-100,240,41,81,.506,30,48,.625,11,33,.333,12,18,.667,105
16305,2013-01-01,DAL,@,WAS,W 103-94,240,41,82,.500,31,60,.517,10,22,.455,11,17,.647,103
16306,2013-01-01,WAS,,DAL,L 94-103,240,32,79,.405,22,53,.415,10,26,.385,20,26,.769,94
16307,2012-12-31,CHA,@,CHI,W 91-81,240,33,70,.471,29,60,.483,4,10,.400,21,38,.553,91
16308,2012-12-31,CHI,,CHA,L 81-91,240,33,94,.351,29,78,.372,4,16,.250,11,18,.611,81
16309,2012-12-31,ATL,@,HOU,L 104-123,240,43,90,.478,31,67,.463,12,23,.522,6,7,.857,104
16310,2012-12-31,HOU,,ATL,W 123-104,240,45,84,.536,29,55,.527,16,29,.552,17,22,.773,123
16311,2012-12-31,IND,,MEM,W 88-83,240,28,70,.400,16,45,.356,12,25,.480,20,24,.833,88
16312,2012-12-31,MEM,@,IND,L 83-88,240,31,82,.378,28,71,.394,3,11,.273,18,24,.750,83
16313,2012-12-31,OKC,,PHO,W 114-96,240,44,87,.506,39,72,.542,5,15,.333,21,24,.875,114
16314,2012-12-31,PHO,@,OKC,L 96-114,240,37,78,.474,29,54,.537,8,24,.333,14,17,.824,96
16315,2012-12-31,MIA,@,ORL,W 112-110 (OT),265,40,85,.471,34,64,.531,6,21,.286,26,35,.743,112
16316,2012-12-31,ORL,,MIA,L 110-112 (OT),265,42,88,.477,34,65,.523,8,23,.348,18,22,.818,110
16317,2012-12-31,BRK,@,SAS,L 73-104,240,28,74,.378,24,57,.421,4,17,.235,13,17,.765,73
16318,2012-12-31,SAS,,BRK,W 104-73,240,43,73,.589,37,59,.627,6,14,.429,12,16,.750,104
16319,2012-12-30,DAL,,SAS,L 86-111,240,38,95,.400,37,79,.468,1,16,.063,9,10,.900,86
16320,2012-12-30,SAS,@,DAL,W 111-86,240,41,81,.506,33,62,.532,8,19,.421,21,24,.875,111
16321,2012-12-30,DET,,MIL,W 96-94,240,39,82,.476,33,64,.516,6,18,.333,12,15,.800,96
16322,2012-12-30,MIL,@,DET,L 94-96,240,36,77,.468,26,54,.481,10,23,.435,12,17,.706,94
16323,2012-12-30,LAC,,UTA,W 107-96,240,39,78,.500,31,60,.517,8,18,.444,21,29,.724,107
16324,2012-12-30,UTA,@,LAC,L 96-107,240,33,80,.413,28,67,.418,5,13,.385,25,34,.735,96
16325,2012-12-30,BOS,@,SAC,L 96-118,240,36,86,.419,29,64,.453,7,22,.318,17,19,.895,96
16326,2012-12-30,SAC,,BOS,W 118-96,240,44,82,.537,34,62,.548,10,20,.500,20,25,.800,118
16327,2012-12-29,ATL,,IND,W 109-100,240,44,80,.550,34,60,.567,10,20,.500,11,14,.786,109
16328,2012-12-29,IND,@,ATL,L 100-109,240,38,80,.475,33,65,.508,5,15,.333,19,22,.864,100
16329,2012-12-29,BRK,,CLE,W 103-100,240,35,75,.467,31,60,.517,4,15,.267,29,39,.744,103
16330,2012-12-29,CLE,@,BRK,L 100-103,240,38,82,.463,29,62,.468,9,20,.450,15,19,.789,100
16331,2012-12-29,CHA,,NOH,L 95-98,240,39,79,.494,35,69,.507,4,10,.400,13,20,.650,95
16332,2012-12-29,NOP,@,CHA,W 98-95,240,35,82,.427,24,58,.414,11,24,.458,17,23,.739,98
16333,2012-12-29,CHI,,WAS,W 87-77,240,34,87,.391,27,71,.380,7,16,.438,12,18,.667,87
16334,2012-12-29,WAS,@,CHI,L 77-87,240,31,85,.365,28,75,.373,3,10,.300,12,18,.667,77
16335,2012-12-29,BOS,@,GSW,L 83-101,240,31,86,.360,26,64,.406,5,22,.227,16,21,.762,83
16336,2012-12-29,GSW,,BOS,W 101-83,240,38,73,.521,26,54,.481,12,19,.632,13,16,.813,101
16337,2012-12-29,HOU,,OKC,L 94-124,240,33,83,.398,25,53,.472,8,30,.267,20,27,.741,94
16338,2012-12-29,OKC,@,HOU,W 124-94,240,45,94,.479,32,65,.492,13,29,.448,21,23,.913,124
16339,2012-12-29,DEN,@,MEM,L 72-81,240,29,68,.426,26,52,.500,3,16,.188,11,18,.611,72
16340,2012-12-29,MEM,,DEN,W 81-72,240,36,89,.404,31,70,.443,5,19,.263,4,7,.571,81
16341,2012-12-29,MIA,@,MIL,L 85-104,240,33,76,.434,29,63,.460,4,13,.308,15,24,.625,85
16342,2012-12-29,MIL,,MIA,W 104-85,240,40,98,.408,32,77,.416,8,21,.381,16,17,.941,104
16343,2012-12-29,MIN,,PHO,W 111-107,240,45,89,.506,40,71,.563,5,18,.278,16,26,.615,111
16344,2012-12-29,PHO,@,MIN,L 107-111,240,45,97,.464,43,80,.538,2,17,.118,15,24,.625,107
16345,2012-12-29,ORL,,TOR,L 88-123,240,36,81,.444,31,63,.492,5,18,.278,11,22,.500,88
16346,2012-12-29,TOR,@,ORL,W 123-88,240,46,82,.561,31,55,.564,15,27,.556,16,21,.762,123
16347,2012-12-29,PHI,@,POR,L 85-89,240,36,85,.424,32,68,.471,4,17,.235,9,11,.818,85
16348,2012-12-29,POR,,PHI,W 89-85,240,34,76,.447,26,53,.491,8,23,.348,13,16,.813,89
16349,2012-12-28,BRK,,CHA,W 97-81,240,34,76,.447,25,49,.510,9,27,.333,20,26,.769,97
16350,2012-12-28,CHA,@,BRK,L 81-97,240,28,73,.384,25,63,.397,3,10,.300,22,32,.688,81
16351,2012-12-28,ATL,@,CLE,W 102-94,240,38,78,.487,25,54,.463,13,24,.542,13,16,.813,102
16352,2012-12-28,CLE,,ATL,L 94-102,240,36,86,.419,28,65,.431,8,21,.381,14,14,1.000,94
16353,2012-12-28,DAL,,DEN,L 85-106,240,33,88,.375,28,63,.444,5,25,.200,14,21,.667,85
16354,2012-12-28,DEN,@,DAL,W 106-85,240,43,94,.457,31,66,.470,12,28,.429,8,14,.571,106
16355,2012-12-28,DET,,MIA,W 109-99,240,43,74,.581,31,55,.564,12,19,.632,11,17,.647,109
16356,2012-12-28,MIA,@,DET,L 99-109,240,39,77,.506,30,48,.625,9,29,.310,12,16,.750,99
16357,2012-12-28,GSW,,PHI,W 96-89,240,34,80,.425,27,63,.429,7,17,.412,21,26,.808,96
16358,2012-12-28,PHI,@,GSW,L 89-96,240,35,87,.402,30,67,.448,5,20,.250,14,23,.609,89
16359,2012-12-28,IND,,PHO,W 97-91,240,34,77,.442,26,61,.426,8,16,.500,21,29,.724,97
16360,2012-12-28,PHO,@,IND,L 91-97,240,38,82,.463,36,68,.529,2,14,.143,13,16,.813,91
16361,2012-12-28,LAL,,POR,W 104-87,240,40,86,.465,33,62,.532,7,24,.292,17,28,.607,104
16362,2012-12-28,POR,@,LAL,L 87-104,240,36,87,.414,33,68,.485,3,19,.158,12,16,.750,87
16363,2012-12-28,NOP,,TOR,L 97-104 (OT),265,37,82,.451,32,69,.464,5,13,.385,18,24,.750,97
16364,2012-12-28,TOR,@,NOH,W 104-97 (OT),265,37,85,.435,32,61,.525,5,24,.208,25,32,.781,104
16365,2012-12-28,NYK,@,SAC,L 105-106,240,41,83,.494,30,53,.566,11,30,.367,12,20,.600,105
16366,2012-12-28,SAC,,NYK,W 106-105,240,39,86,.453,24,56,.429,15,30,.500,13,17,.765,106
16367,2012-12-28,HOU,@,SAS,L 116-122,240,45,86,.523,34,54,.630,11,32,.344,15,26,.577,116
16368,2012-12-28,SAS,,HOU,W 122-116,240,44,77,.571,32,54,.593,12,23,.522,22,24,.917,122
16369,2012-12-28,LAC,@,UTA,W 116-114,240,38,77,.494,31,54,.574,7,23,.304,33,41,.805,116
16370,2012-12-28,UTA,,LAC,L 114-116,240,34,71,.479,25,56,.446,9,15,.600,37,40,.925,114
16371,2012-12-28,ORL,@,WAS,L 97-105,240,39,86,.453,29,58,.500,10,28,.357,9,11,.818,97
16372,2012-12-28,WAS,,ORL,W 105-97,240,42,88,.477,36,68,.529,6,20,.300,15,17,.882,105
16373,2012-12-27,BOS,@,LAC,L 77-106,240,29,72,.403,23,56,.411,6,16,.375,13,15,.867,77
16374,2012-12-27,LAC,,BOS,W 106-77,240,41,85,.482,29,55,.527,12,30,.400,12,24,.500,106
16375,2012-12-27,DAL,@,OKC,L 105-111 (OT),265,40,95,.421,29,71,.408,11,24,.458,14,16,.875,105
16376,2012-12-27,OKC,,DAL,W 111-105 (OT),265,39,93,.419,29,68,.426,10,25,.400,23,28,.821,111
16377,2012-12-26,ATL,,DET,W 126-119 (2OT),290,46,98,.469,35,65,.538,11,33,.333,23,31,.742,126
16378,2012-12-26,DET,@,ATL,L 119-126 (2OT),290,48,109,.440,34,82,.415,14,27,.519,9,15,.600,119
16379,2012-12-26,CHA,,MIA,L 92-105,240,34,78,.436,29,64,.453,5,14,.357,19,28,.679,92
16380,2012-12-26,MIA,@,CHA,W 105-92,240,37,81,.457,25,58,.431,12,23,.522,19,25,.760,105
16381,2012-12-26,DEN,,LAL,W 126-114,240,45,94,.479,33,72,.458,12,22,.545,24,32,.750,126
16382,2012-12-26,LAL,@,DEN,L 114-126,240,41,83,.494,30,54,.556,11,29,.379,21,30,.700,114
16383,2012-12-26,MEM,,PHI,L 89-99,240,35,90,.389,30,75,.400,5,15,.333,14,17,.824,89
16384,2012-12-26,PHI,@,MEM,W 99-89,240,37,71,.521,28,55,.509,9,16,.563,16,23,.696,99
16385,2012-12-26,BRK,@,MIL,L 93-108,240,34,88,.386,30,67,.448,4,21,.190,21,24,.875,93
16386,2012-12-26,MIL,,BRK,W 108-93,240,40,84,.476,30,67,.448,10,17,.588,18,19,.947,108
16387,2012-12-26,HOU,@,MIN,W 87-84,240,33,81,.407,24,50,.480,9,31,.290,12,15,.800,87
16388,2012-12-26,MIN,,HOU,L 84-87,240,32,84,.381,25,56,.446,7,28,.250,13,17,.765,84
16389,2012-12-26,NOP,@,ORL,W 97-94,240,38,76,.500,36,64,.563,2,12,.167,19,20,.950,97
16390,2012-12-26,ORL,,NOH,L 94-97,240,36,79,.456,25,49,.510,11,30,.367,11,13,.846,94
16391,2012-12-26,NYK,@,PHO,W 99-97,240,40,88,.455,31,66,.470,9,22,.409,10,14,.714,99
16392,2012-12-26,PHO,,NYK,L 97-99,240,38,83,.458,30,62,.484,8,21,.381,13,16,.813,97
16393,2012-12-26,POR,,SAC,W 109-91,240,44,87,.506,38,66,.576,6,21,.286,15,20,.750,109
16394,2012-12-26,SAC,@,POR,L 91-109,240,35,86,.407,26,62,.419,9,24,.375,12,16,.750,91
16395,2012-12-26,SAS,,TOR,W 100-80,240,34,71,.479,26,52,.500,8,19,.421,24,29,.828,100
16396,2012-12-26,TOR,@,SAS,L 80-100,240,33,78,.423,26,60,.433,7,18,.389,7,12,.583,80
16397,2012-12-26,GSW,@,UTA,W 94-83,240,33,82,.402,24,64,.375,9,18,.500,19,20,.950,94
16398,2012-12-26,UTA,,GSW,L 83-94,240,32,83,.386,28,66,.424,4,17,.235,15,22,.682,83
16399,2012-12-26,CLE,@,WAS,W 87-84,240,31,82,.378,21,55,.382,10,27,.370,15,23,.652,87
16400,2012-12-26,WAS,,CLE,L 84-87,240,35,76,.461,31,58,.534,4,18,.222,10,14,.714,84
16401,2012-12-25,BOS,@,BRK,W 93-76,240,38,77,.494,32,67,.478,6,10,.600,11,13,.846,93
16402,2012-12-25,BRK,,BOS,L 76-93,240,26,64,.406,19,44,.432,7,20,.350,17,29,.586,76
16403,2012-12-25,CHI,,HOU,L 97-120,240,37,83,.446,31,63,.492,6,20,.300,17,20,.850,97
16404,2012-12-25,HOU,@,CHI,W 120-97,240,46,82,.561,38,62,.613,8,20,.400,20,24,.833,120
16405,2012-12-25,DEN,@,LAC,L 100-112,240,40,80,.500,37,67,.552,3,13,.231,17,24,.708,100
16406,2012-12-25,LAC,,DEN,W 112-100,240,45,93,.484,34,68,.500,11,25,.440,11,19,.579,112
16407,2012-12-25,LAL,,NYK,W 100-94,240,37,77,.481,32,56,.571,5,21,.238,21,31,.677,100
16408,2012-12-25,NYK,@,LAL,L 94-100,240,38,89,.427,29,63,.460,9,26,.346,9,16,.563,94
16409,2012-12-25,MIA,,OKC,W 103-97,240,38,80,.475,30,52,.577,8,28,.286,19,19,1.000,103
16410,2012-12-25,OKC,@,MIA,L 97-103,240,30,71,.423,25,55,.455,5,16,.313,32,38,.842,97
16411,2012-12-23,BRK,,PHI,W 95-92,240,33,74,.446,25,52,.481,8,22,.364,21,30,.700,95
16412,2012-12-23,PHI,@,BRK,L 92-95,240,38,88,.432,30,70,.429,8,18,.444,8,10,.800,92
16413,2012-12-23,MIN,@,NYK,L 91-94,240,34,84,.405,27,62,.435,7,22,.318,16,18,.889,91
16414,2012-12-23,NYK,,MIN,W 94-91,240,32,72,.444,26,46,.565,6,26,.231,24,28,.857,94
16415,2012-12-23,ORL,,UTA,L 93-97,240,38,76,.500,29,56,.518,9,20,.450,8,15,.533,93
16416,2012-12-23,UTA,@,ORL,W 97-93,240,36,83,.434,29,65,.446,7,18,.389,18,25,.720,97
16417,2012-12-23,LAC,@,PHO,W 103-77,240,38,71,.535,27,50,.540,11,21,.524,16,29,.552,103
16418,2012-12-23,PHO,,LAC,L 77-103,240,29,80,.363,26,63,.413,3,17,.176,16,24,.667,77
16419,2012-12-23,POR,@,SAC,L 96-108,240,37,85,.435,30,61,.492,7,24,.292,15,17,.882,96
16420,2012-12-23,SAC,,POR,W 108-96,240,45,81,.556,36,62,.581,9,19,.474,9,11,.818,108
16421,2012-12-23,DAL,@,SAS,L 91-129,240,34,74,.459,29,60,.483,5,14,.357,18,29,.621,91
16422,2012-12-23,SAS,,DAL,W 129-91,240,47,84,.560,27,54,.500,20,30,.667,15,19,.789,129
16423,2012-12-22,ATL,,CHI,W 92-75,240,38,77,.494,31,58,.534,7,19,.368,9,10,.900,92
16424,2012-12-22,CHI,@,ATL,L 75-92,240,32,76,.421,27,62,.435,5,14,.357,6,8,.750,75
16425,2012-12-22,CHA,@,DEN,L 88-110,240,33,87,.379,30,67,.448,3,20,.150,19,30,.633,88
16426,2012-12-22,DEN,,CHA,W 110-88,240,47,92,.511,41,72,.569,6,20,.300,10,15,.667,110
16427,2012-12-22,GSW,,LAL,L 115-118 (OT),265,46,103,.447,36,74,.486,10,29,.345,13,15,.867,115
16428,2012-12-22,LAL,@,GSW,W 118-115 (OT),265,49,107,.458,40,80,.500,9,27,.333,11,14,.786,118
16429,2012-12-22,HOU,,MEM,W 121-96,240,44,82,.537,32,54,.593,12,28,.429,21,26,.808,121
16430,2012-12-22,MEM,@,HOU,L 96-121,240,42,79,.532,40,66,.606,2,13,.154,10,14,.714,96
16431,2012-12-22,MIA,,UTA,W 105-89,240,38,73,.521,27,49,.551,11,24,.458,18,22,.818,105
16432,2012-12-22,UTA,@,MIA,L 89-105,240,30,73,.411,23,57,.404,7,16,.438,22,26,.846,89
16433,2012-12-22,CLE,@,MIL,W 94-82,240,38,88,.432,33,71,.465,5,17,.294,13,16,.813,94
16434,2012-12-22,MIL,,CLE,L 82-94,240,31,79,.392,27,59,.458,4,20,.200,16,23,.696,82
16435,2012-12-22,IND,@,NOH,W 81-75,240,33,77,.429,29,60,.483,4,17,.235,11,18,.611,81
16436,2012-12-22,NOP,,IND,L 75-81,240,33,82,.402,29,71,.408,4,11,.364,5,7,.714,75
16437,2012-12-22,PHO,@,POR,L 93-96,240,40,89,.449,35,70,.500,5,19,.263,8,11,.727,93
16438,2012-12-22,POR,,PHO,W 96-93,240,33,69,.478,26,49,.531,7,20,.350,23,28,.821,96
16439,2012-12-22,DET,@,WAS,W 96-87,240,36,88,.409,28,69,.406,8,19,.421,16,20,.800,96
16440,2012-12-22,WAS,,DET,L 87-96,240,29,77,.377,25,56,.446,4,21,.190,25,32,.781,87
16441,2012-12-21,BOS,,MIL,L 94-99 (OT),265,36,94,.383,31,70,.443,5,24,.208,17,20,.850,94
16442,2012-12-21,MIL,@,BOS,W 99-94 (OT),265,36,83,.434,31,67,.463,5,16,.313,22,36,.611,99
16443,2012-12-21,CLE,,IND,L 89-99,240,32,80,.400,27,64,.422,5,16,.313,20,26,.769,89
16444,2012-12-21,IND,@,CLE,W 99-89,240,39,80,.488,34,64,.531,5,16,.313,16,25,.640,99
16445,2012-12-21,DET,,WAS,W 100-68,240,38,90,.422,28,66,.424,10,24,.417,14,21,.667,100
16446,2012-12-21,WAS,@,DET,L 68-100,240,28,85,.329,26,73,.356,2,12,.167,10,13,.769,68
16447,2012-12-21,CHA,@,GSW,L 100-115,240,33,90,.367,25,69,.362,8,21,.381,26,35,.743,100
16448,2012-12-21,GSW,,CHA,W 115-100,240,44,85,.518,30,58,.517,14,27,.519,13,16,.813,115
16449,2012-12-21,LAC,,SAC,W 97-85,240,37,87,.425,30,64,.469,7,23,.304,16,24,.667,97
16450,2012-12-21,SAC,@,LAC,L 85-97,240,33,79,.418,25,57,.439,8,22,.364,11,16,.688,85
16451,2012-12-21,DAL,@,MEM,L 82-92,240,31,76,.408,25,55,.455,6,21,.286,14,17,.824,82
16452,2012-12-21,MEM,,DAL,W 92-82,240,36,89,.404,33,76,.434,3,13,.231,17,20,.850,92
16453,2012-12-21,CHI,@,NYK,W 110-106,240,37,83,.446,29,65,.446,8,18,.444,28,33,.848,110
16454,2012-12-21,NYK,,CHI,L 106-110,240,38,91,.418,30,65,.462,8,26,.308,22,25,.880,106
16455,2012-12-21,ATL,@,PHI,L 80-99,240,31,79,.392,22,54,.407,9,25,.360,9,12,.750,80
16456,2012-12-21,PHI,,ATL,W 99-80,240,44,86,.512,36,67,.537,8,19,.421,3,7,.429,99
16457,2012-12-21,NOP,@,SAS,L 94-99,240,39,86,.453,37,70,.529,2,16,.125,14,16,.875,94
16458,2012-12-21,SAS,,NOH,W 99-94,240,39,76,.513,35,58,.603,4,18,.222,17,23,.739,99
16459,2012-12-21,ORL,@,TOR,L 90-93,240,35,70,.500,31,56,.554,4,14,.286,16,19,.842,90
16460,2012-12-21,TOR,,ORL,W 93-90,240,33,81,.407,25,62,.403,8,19,.421,19,21,.905,93
16461,2012-12-20,DAL,,MIA,L 95-110,240,37,96,.385,34,74,.459,3,22,.136,18,21,.857,95
16462,2012-12-20,MIA,@,DAL,W 110-95,240,42,78,.538,32,50,.640,10,28,.357,16,18,.889,110
16463,2012-12-20,MIN,,OKC,W 99-93,240,37,84,.440,28,64,.438,9,20,.450,16,23,.696,99
16464,2012-12-20,OKC,@,MIN,L 93-99,240,33,82,.402,28,62,.452,5,20,.250,22,26,.846,93
16465,2012-12-20,DEN,@,POR,L 93-101,240,38,98,.388,38,76,.500,0,22,.000,17,24,.708,93
16466,2012-12-20,POR,,DEN,W 101-93,240,33,92,.359,19,56,.339,14,36,.389,21,26,.808,101
16467,2012-12-19,ATL,,OKC,L 92-100,240,36,94,.383,27,70,.386,9,24,.375,11,17,.647,92
16468,2012-12-19,OKC,@,ATL,W 100-92,240,36,84,.429,27,59,.458,9,25,.360,19,20,.950,100
16469,2012-12-19,BOS,,CLE,W 103-91,240,37,62,.597,28,45,.622,9,17,.529,20,27,.741,103
16470,2012-12-19,CLE,@,BOS,L 91-103,240,36,88,.409,31,70,.443,5,18,.278,14,21,.667,91
16471,2012-12-19,HOU,,PHI,W 125-103,240,42,75,.560,31,48,.646,11,27,.407,30,36,.833,125
16472,2012-12-19,PHI,@,HOU,L 103-125,240,40,89,.449,34,72,.472,6,17,.353,17,24,.708,103
16473,2012-12-19,IND,,UTA,W 104-84,240,41,80,.513,32,64,.500,9,16,.563,13,18,.722,104
16474,2012-12-19,UTA,@,IND,L 84-104,240,32,86,.372,30,71,.423,2,15,.133,18,25,.720,84
16475,2012-12-19,LAC,,NOH,W 93-77,240,37,74,.500,33,54,.611,4,20,.200,15,19,.789,93
16476,2012-12-19,NOP,@,LAC,L 77-93,240,29,75,.387,27,56,.482,2,19,.105,17,22,.773,77
16477,2012-12-19,MEM,,MIL,W 90-80,240,36,88,.409,33,80,.413,3,8,.375,15,19,.789,90
16478,2012-12-19,MIL,@,MEM,L 80-90,240,30,85,.353,25,65,.385,5,20,.250,15,19,.789,80
16479,2012-12-19,BRK,@,NYK,L 86-100,240,35,78,.449,25,53,.472,10,25,.400,6,9,.667,86
16480,2012-12-19,NYK,,BRK,W 100-86,240,38,83,.458,27,54,.500,11,29,.379,13,17,.765,100
16481,2012-12-19,ORL,,WAS,W 90-83,240,34,81,.420,26,61,.426,8,20,.400,14,17,.824,90
16482,2012-12-19,WAS,@,ORL,L 83-90,240,34,77,.442,25,60,.417,9,17,.529,6,8,.750,83
16483,2012-12-19,CHA,@,PHO,L 104-121,240,40,86,.465,34,76,.447,6,10,.600,18,22,.818,104
16484,2012-12-19,PHO,,CHA,W 121-104,240,47,85,.553,30,57,.526,17,28,.607,10,11,.909,121
16485,2012-12-19,GSW,@,SAC,L 127-131,240,46,92,.500,33,66,.500,13,26,.500,22,25,.880,127
16486,2012-12-19,SAC,,GSW,W 131-127,240,43,86,.500,32,67,.478,11,19,.579,34,42,.810,131
16487,2012-12-19,DET,@,TOR,L 91-97,240,35,84,.417,32,72,.444,3,12,.250,18,30,.600,91
16488,2012-12-19,TOR,,DET,W 97-91,240,35,72,.486,25,43,.581,10,29,.345,17,22,.773,97
16489,2012-12-18,BRK,,UTA,L 90-92,240,33,77,.429,26,60,.433,7,17,.412,17,22,.773,90
16490,2012-12-18,UTA,@,BRK,W 92-90,240,37,83,.446,32,63,.508,5,20,.250,13,16,.813,92
16491,2012-12-18,BOS,@,CHI,L 89-100,240,35,81,.432,30,71,.423,5,10,.500,14,19,.737,89
16492,2012-12-18,CHI,,BOS,W 100-89,240,37,74,.500,32,65,.492,5,9,.556,21,24,.875,100
16493,2012-12-18,CLE,,TOR,L 99-113,240,36,70,.514,29,54,.537,7,16,.438,20,30,.667,99
16494,2012-12-18,TOR,@,CLE,W 113-99,240,39,75,.520,27,51,.529,12,24,.500,23,27,.852,113
16495,2012-12-18,DAL,,PHI,W 107-100,240,39,72,.542,35,61,.574,4,11,.364,25,29,.862,107
16496,2012-12-18,PHI,@,DAL,L 100-107,240,37,86,.430,24,51,.471,13,35,.371,13,15,.867,100
16497,2012-12-18,DEN,,SAS,W 112-106,240,38,87,.437,31,68,.456,7,19,.368,29,42,.690,112
16498,2012-12-18,SAS,@,DEN,L 106-112,240,38,95,.400,24,59,.407,14,36,.389,16,18,.889,106
16499,2012-12-18,GSW,,NOH,W 103-96,240,34,78,.436,28,60,.467,6,18,.333,29,34,.853,103
16500,2012-12-18,NOP,@,GSW,L 96-103,240,35,75,.467,26,48,.542,9,27,.333,17,17,1.000,96
16501,2012-12-18,CHA,@,LAL,L 100-101,240,38,95,.400,28,71,.394,10,24,.417,14,22,.636,100
16502,2012-12-18,LAL,,CHA,W 101-100,240,35,88,.398,25,57,.439,10,31,.323,21,27,.778,101
16503,2012-12-18,MIA,,MIN,W 103-92,240,36,77,.468,23,52,.442,13,25,.520,18,23,.783,103
16504,2012-12-18,MIN,@,MIA,L 92-103,240,37,86,.430,33,69,.478,4,17,.235,14,19,.737,92
16505,2012-12-18,IND,@,MIL,L 93-98,240,32,80,.400,30,72,.417,2,8,.250,27,34,.794,93
16506,2012-12-18,MIL,,IND,W 98-93,240,37,86,.430,31,72,.431,6,14,.429,18,26,.692,98
16507,2012-12-18,ATL,@,WAS,W 100-95 (OT),265,34,78,.436,25,54,.463,9,24,.375,23,34,.676,100
16508,2012-12-18,WAS,,ATL,L 95-100 (OT),265,36,95,.379,30,77,.390,6,18,.333,17,22,.773,95
16509,2012-12-17,DET,,LAC,L 76-88,240,29,71,.408,22,51,.431,7,20,.350,11,19,.579,76
16510,2012-12-17,LAC,@,DET,W 88-76,240,35,78,.449,30,56,.536,5,22,.227,13,17,.765,88
16511,2012-12-17,CHI,@,MEM,L 71-80,240,28,75,.373,26,64,.406,2,11,.182,13,20,.650,71
16512,2012-12-17,MEM,,CHI,W 80-71,240,30,80,.375,24,69,.348,6,11,.545,14,19,.737,80
16513,2012-12-17,HOU,@,NYK,W 109-96,240,40,78,.513,30,49,.612,10,29,.345,19,24,.792,109
16514,2012-12-17,NYK,,HOU,L 96-109,240,39,90,.433,30,59,.508,9,31,.290,9,16,.563,96
16515,2012-12-17,OKC,,SAS,W 107-93,240,38,85,.447,34,71,.479,4,14,.286,27,30,.900,107
16516,2012-12-17,SAS,@,OKC,L 93-107,240,36,79,.456,30,59,.508,6,20,.300,15,21,.714,93
16517,2012-12-17,MIN,@,ORL,L 93-102,240,39,96,.406,32,71,.451,7,25,.280,8,12,.667,93
16518,2012-12-17,ORL,,MIN,W 102-93,240,44,82,.537,38,68,.559,6,14,.429,8,8,1.000,102
16519,2012-12-17,PHO,,SAC,W 101-90,240,41,85,.482,33,63,.524,8,22,.364,11,15,.733,101
16520,2012-12-17,SAC,@,PHO,L 90-101,240,34,83,.410,31,70,.443,3,13,.231,19,24,.792,90
16521,2012-12-16,LAL,@,PHI,W 111-98,240,39,80,.488,25,46,.543,14,34,.412,19,24,.792,111
16522,2012-12-16,PHI,,LAL,L 98-111,240,41,83,.494,31,58,.534,10,25,.400,6,11,.545,98
16523,2012-12-16,NOP,@,POR,L 94-95,240,36,80,.450,25,60,.417,11,20,.550,11,15,.733,94
16524,2012-12-16,POR,,NOH,W 95-94,240,37,80,.463,26,51,.510,11,29,.379,10,12,.833,95
16525,2012-12-16,DEN,@,SAC,W 122-97,240,46,85,.541,38,67,.567,8,18,.444,22,29,.759,122
16526,2012-12-16,SAC,,DEN,L 97-122,240,31,91,.341,25,67,.373,6,24,.250,29,34,.853,97
16527,2012-12-16,HOU,@,TOR,L 96-103,240,32,78,.410,25,55,.455,7,23,.304,25,32,.781,96
16528,2012-12-16,TOR,,HOU,W 103-96,240,39,85,.459,31,55,.564,8,30,.267,17,20,.850,103
16529,2012-12-15,ATL,,GSW,L 93-115,240,31,84,.369,26,58,.448,5,26,.192,26,36,.722,93
16530,2012-12-15,GSW,@,ATL,W 115-93,240,49,99,.495,39,75,.520,10,24,.417,7,8,.875,115
16531,2012-12-15,CHA,,ORL,L 98-107,240,36,78,.462,32,66,.485,4,12,.333,22,29,.759,98
16532,2012-12-15,ORL,@,CHA,W 107-98,240,43,79,.544,38,62,.613,5,17,.294,16,19,.842,107
16533,2012-12-15,BRK,@,CHI,L 82-83,240,29,75,.387,22,56,.393,7,19,.368,17,22,.773,82
16534,2012-12-15,CHI,,BRK,W 83-82,240,33,75,.440,31,65,.477,2,10,.200,15,19,.789,83
16535,2012-12-15,DET,,IND,L 77-88,240,32,83,.386,29,70,.414,3,13,.231,10,15,.667,77
16536,2012-12-15,IND,@,DET,W 88-77,240,35,72,.486,28,48,.583,7,24,.292,11,16,.688,88
16537,2012-12-15,MIA,,WAS,W 102-72,240,40,79,.506,32,52,.615,8,27,.296,14,21,.667,102
16538,2012-12-15,WAS,@,MIA,L 72-102,240,27,72,.375,20,52,.385,7,20,.350,11,15,.733,72
16539,2012-12-15,LAC,@,MIL,W 111-85,240,44,82,.537,39,71,.549,5,11,.455,18,24,.750,111
16540,2012-12-15,MIL,,LAC,L 85-111,240,30,83,.361,23,62,.371,7,21,.333,18,25,.720,85
16541,2012-12-15,DAL,@,MIN,L 106-114 (OT),265,39,84,.464,32,70,.457,7,14,.500,21,25,.840,106
16542,2012-12-15,MIN,,DAL,W 114-106 (OT),265,41,94,.436,35,71,.493,6,23,.261,26,32,.813,114
16543,2012-12-15,CLE,@,NYK,L 102-103,240,40,82,.488,31,58,.534,9,24,.375,13,17,.765,102
16544,2012-12-15,NYK,,CLE,W 103-102,240,37,85,.435,24,50,.480,13,35,.371,16,23,.696,103
16545,2012-12-15,BOS,@,SAS,L 88-103,240,38,81,.469,32,65,.492,6,16,.375,6,8,.750,88
16546,2012-12-15,SAS,,BOS,W 103-88,240,38,81,.469,26,56,.464,12,25,.480,15,20,.750,103
16547,2012-12-15,MEM,@,UTA,W 99-86,240,38,85,.447,34,74,.459,4,11,.364,19,24,.792,99
16548,2012-12-15,UTA,,MEM,L 86-99,240,31,74,.419,26,57,.456,5,17,.294,19,24,.792,86
16549,2012-12-14,BRK,,DET,W 107-105 (2OT),290,42,93,.452,32,67,.478,10,26,.385,13,16,.813,107
16550,2012-12-14,DET,@,BRK,L 105-107 (2OT),290,40,99,.404,35,83,.422,5,16,.313,20,26,.769,105
16551,2012-12-14,CLE,,MIL,L 86-90,240,32,81,.395,23,63,.365,9,18,.500,13,14,.929,86
16552,2012-12-14,MIL,@,CLE,W 90-86,240,33,83,.398,28,68,.412,5,15,.333,19,27,.704,90
16553,2012-12-14,DEN,,MEM,W 99-94,240,36,69,.522,32,59,.542,4,10,.400,23,26,.885,99
16554,2012-12-14,MEM,@,DEN,L 94-99,240,39,94,.415,32,75,.427,7,19,.368,9,10,.900,94
16555,2012-12-14,BOS,@,HOU,L 89-101,240,34,85,.400,26,65,.400,8,20,.400,13,17,.765,89
16556,2012-12-14,HOU,,BOS,W 101-89,240,37,76,.487,27,49,.551,10,27,.370,17,23,.739,101
16557,2012-12-14,IND,,PHI,W 95-85,240,35,77,.455,27,63,.429,8,14,.571,17,27,.630,95
16558,2012-12-14,PHI,@,IND,L 85-95,240,35,81,.432,32,69,.464,3,12,.250,12,16,.750,85
16559,2012-12-14,MIN,@,NOH,W 113-102,240,47,88,.534,40,71,.563,7,17,.412,12,17,.706,113
16560,2012-12-14,NOP,,MIN,L 102-113,240,42,78,.538,31,54,.574,11,24,.458,7,10,.700,102
16561,2012-12-14,OKC,,SAC,W 113-103,240,41,83,.494,32,62,.516,9,21,.429,22,22,1.000,113
16562,2012-12-14,SAC,@,OKC,L 103-113,240,34,75,.453,27,56,.482,7,19,.368,28,31,.903,103
16563,2012-12-14,GSW,@,ORL,L 85-99,240,34,92,.370,27,72,.375,7,20,.350,10,11,.909,85
16564,2012-12-14,ORL,,GSW,W 99-85,240,41,86,.477,32,65,.492,9,21,.429,8,11,.727,99
16565,2012-12-14,PHO,,UTA,W 99-84,240,38,83,.458,32,70,.457,6,13,.462,17,22,.773,99
16566,2012-12-14,UTA,@,PHO,L 84-99,240,33,82,.402,30,71,.423,3,11,.273,15,21,.714,84
16567,2012-12-14,DAL,@,TOR,L 74-95,240,27,69,.391,27,56,.482,0,13,.000,20,23,.870,74
16568,2012-12-14,TOR,,DAL,W 95-74,240,34,84,.405,22,48,.458,12,36,.333,15,22,.682,95
16569,2012-12-14,LAL,@,WAS,W 102-96,240,37,82,.451,29,53,.547,8,29,.276,20,28,.714,102
16570,2012-12-14,WAS,,LAL,L 96-102,240,36,83,.434,28,62,.452,8,21,.381,16,20,.800,96
16571,2012-12-13,ATL,,CHA,W 113-90,240,43,75,.573,29,46,.630,14,29,.483,13,23,.565,113
16572,2012-12-13,CHA,@,ATL,L 90-113,240,34,79,.430,28,58,.483,6,21,.286,16,20,.800,90
16573,2012-12-13,LAL,@,NYK,L 107-116,240,35,84,.417,23,47,.489,12,37,.324,25,29,.862,107
16574,2012-12-13,NYK,,LAL,W 116-107,240,42,79,.532,30,54,.556,12,25,.480,20,30,.667,116
16575,2012-12-13,POR,,SAS,W 98-90,240,40,88,.455,33,61,.541,7,27,.259,11,12,.917,98
16576,2012-12-13,SAS,@,POR,L 90-98,240,33,72,.458,27,53,.509,6,19,.316,18,25,.720,90
16577,2012-12-12,BOS,,DAL,W 117-115 (2OT),290,43,100,.430,37,78,.474,6,22,.273,25,30,.833,117
16578,2012-12-12,DAL,@,BOS,L 115-117 (2OT),290,47,92,.511,39,69,.565,8,23,.348,13,17,.765,115
16579,2012-12-12,CHA,,LAC,L 94-100,240,35,82,.427,30,66,.455,5,16,.313,19,24,.792,94
16580,2012-12-12,LAC,@,CHA,W 100-94,240,37,85,.435,28,62,.452,9,23,.391,17,25,.680,100
16581,2012-12-12,HOU,,WAS,W 99-93,240,34,76,.447,25,52,.481,9,24,.375,22,30,.733,99
16582,2012-12-12,WAS,@,HOU,L 93-99,240,35,89,.393,28,64,.438,7,25,.280,16,20,.800,93
16583,2012-12-12,CLE,@,IND,L 81-96,240,27,81,.333,18,59,.305,9,22,.409,18,25,.720,81
16584,2012-12-12,IND,,CLE,W 96-81,240,34,83,.410,29,65,.446,5,18,.278,23,28,.821,96
16585,2012-12-12,GSW,@,MIA,W 97-95,240,38,82,.463,29,58,.500,9,24,.375,12,14,.857,97
16586,2012-12-12,MIA,,GSW,L 95-97,240,38,80,.475,31,58,.534,7,22,.318,12,15,.800,95
16587,2012-12-12,MIL,,SAC,W 98-85,240,39,96,.406,33,79,.418,6,17,.353,14,24,.583,98
16588,2012-12-12,SAC,@,MIL,L 85-98,240,32,86,.372,29,67,.433,3,19,.158,18,21,.857,85
16589,2012-12-12,DEN,@,MIN,L 105-108,240,42,83,.506,35,67,.522,7,16,.438,14,24,.583,105
16590,2012-12-12,MIN,,DEN,W 108-105,240,38,87,.437,36,73,.493,2,14,.143,30,37,.811,108
16591,2012-12-12,NOP,@,OKC,L 88-92,240,33,83,.398,24,61,.393,9,22,.409,13,16,.813,88
16592,2012-12-12,OKC,,NOH,W 92-88,240,31,71,.437,26,56,.464,5,15,.333,25,32,.781,92
16593,2012-12-12,ATL,@,ORL,W 86-80,240,35,80,.438,29,58,.500,6,22,.273,10,16,.625,86
16594,2012-12-12,ORL,,ATL,L 80-86,240,31,81,.383,24,59,.407,7,22,.318,11,11,1.000,80
16595,2012-12-12,CHI,@,PHI,W 96-89,240,34,78,.436,30,67,.448,4,11,.364,24,26,.923,96
16596,2012-12-12,PHI,,CHI,L 89-96,240,41,91,.451,39,77,.506,2,14,.143,5,11,.455,89
16597,2012-12-12,MEM,@,PHO,L 80-82,240,33,73,.452,31,63,.492,2,10,.200,12,12,1.000,80
16598,2012-12-12,PHO,,MEM,W 82-80,240,34,89,.382,29,67,.433,5,22,.227,9,11,.818,82
16599,2012-12-12,BRK,@,TOR,W 94-88,240,29,64,.453,19,45,.422,10,19,.526,26,35,.743,94
16600,2012-12-12,TOR,,BRK,L 88-94,240,37,75,.493,33,57,.579,4,18,.222,10,17,.588,88
16601,2012-12-12,SAS,@,UTA,L 96-99,240,37,87,.425,29,68,.426,8,19,.421,14,18,.778,96
16602,2012-12-12,UTA,,SAS,W 99-96,240,41,84,.488,33,65,.508,8,19,.421,9,15,.600,99
16603,2012-12-11,BRK,,NYK,L 97-100,240,36,68,.529,32,50,.640,4,18,.222,21,28,.750,97
16604,2012-12-11,NYK,@,BRK,W 100-97,240,36,78,.462,22,50,.440,14,28,.500,14,18,.778,100
16605,2012-12-11,CHI,,LAC,L 89-94,240,35,87,.402,25,67,.373,10,20,.500,9,12,.750,89
16606,2012-12-11,LAC,@,CHI,W 94-89,240,37,80,.463,33,69,.478,4,11,.364,16,23,.696,94
16607,2012-12-11,CLE,,LAL,W 100-94,240,37,84,.440,26,57,.456,11,27,.407,15,26,.577,100
16608,2012-12-11,LAL,@,CLE,L 94-100,240,31,75,.413,24,48,.500,7,27,.259,25,40,.625,94
16609,2012-12-11,DEN,@,DET,W 101-94,240,37,80,.463,31,63,.492,6,17,.353,21,34,.618,101
16610,2012-12-11,DET,,DEN,L 94-101,240,34,81,.420,29,68,.426,5,13,.385,21,31,.677,94
16611,2012-12-11,NOP,,WAS,L 70-77,240,26,80,.325,22,64,.344,4,16,.250,14,22,.636,70
16612,2012-12-11,WAS,@,NOH,W 77-70,240,27,82,.329,22,63,.349,5,19,.263,18,23,.783,77
16613,2012-12-10,CHA,,GSW,L 96-104,240,31,83,.373,22,57,.386,9,26,.346,25,32,.781,96
16614,2012-12-10,GSW,@,CHA,W 104-96,240,38,84,.452,30,64,.469,8,20,.400,20,23,.870,104
16615,2012-12-10,DAL,,SAC,W 119-96,240,48,87,.552,41,67,.612,7,20,.350,16,21,.762,119
16616,2012-12-10,SAC,@,DAL,L 96-119,240,37,84,.440,25,57,.439,12,27,.444,10,16,.625,96
16617,2012-12-10,HOU,,SAS,L 126-134 (OT),265,41,97,.423,25,67,.373,16,30,.533,28,36,.778,126
16618,2012-12-10,SAS,@,HOU,W 134-126 (OT),265,48,92,.522,34,62,.548,14,30,.467,24,26,.923,134
16619,2012-12-10,ATL,@,MIA,L 92-101,240,32,75,.427,23,47,.489,9,28,.321,19,20,.950,92
16620,2012-12-10,MIA,,ATL,W 101-92,240,39,67,.582,30,46,.652,9,21,.429,14,22,.636,101
16621,2012-12-10,DET,@,PHI,L 97-104,240,32,81,.395,27,63,.429,5,18,.278,28,33,.848,97
16622,2012-12-10,PHI,,DET,W 104-97,240,44,82,.537,40,71,.563,4,11,.364,12,23,.522,104
16623,2012-12-10,POR,,TOR,W 92-74,240,36,89,.404,36,69,.522,0,20,.000,20,22,.909,92
16624,2012-12-10,TOR,@,POR,L 74-92,240,26,74,.351,23,53,.434,3,21,.143,19,21,.905,74
16625,2012-12-09,BRK,,MIL,L 88-97,240,32,79,.405,25,54,.463,7,25,.280,17,23,.739,88
16626,2012-12-09,MIL,@,BRK,W 97-88,240,33,71,.465,26,55,.473,7,16,.438,24,30,.800,97
16627,2012-12-09,LAC,,TOR,W 102-83,240,36,79,.456,30,60,.500,6,19,.316,24,34,.706,102
16628,2012-12-09,TOR,@,LAC,L 83-102,240,30,77,.390,20,51,.392,10,26,.385,13,17,.765,83
16629,2012-12-09,LAL,,UTA,L 110-117,240,40,85,.471,25,57,.439,15,28,.536,15,18,.833,110
16630,2012-12-09,UTA,@,LAL,W 117-110,240,45,83,.542,39,65,.600,6,18,.333,21,27,.778,117
16631,2012-12-09,DEN,@,NYK,L 106-112,240,40,72,.556,35,55,.636,5,17,.294,21,29,.724,106
16632,2012-12-09,NYK,,DEN,W 112-106,240,37,86,.430,25,56,.446,12,30,.400,26,37,.703,112
16633,2012-12-09,IND,@,OKC,L 93-104,240,38,82,.463,32,65,.492,6,17,.353,11,13,.846,93
16634,2012-12-09,OKC,,IND,W 104-93,240,37,76,.487,32,57,.561,5,19,.263,25,30,.833,104
16635,2012-12-09,ORL,@,PHO,W 98-90,240,40,77,.519,35,62,.565,5,15,.333,13,18,.722,98
16636,2012-12-09,PHO,,ORL,L 90-98,240,36,78,.462,31,58,.534,5,20,.250,13,18,.722,90
16637,2012-12-08,BOS,,PHI,W 92-79,240,40,75,.533,36,61,.590,4,14,.286,8,12,.667,92
16638,2012-12-08,PHI,@,BOS,L 79-92,240,31,79,.392,27,62,.435,4,17,.235,13,16,.813,79
16639,2012-12-08,CHA,,SAS,L 102-132,240,37,79,.468,31,64,.484,6,15,.400,22,31,.710,102
16640,2012-12-08,SAS,@,CHA,W 132-102,240,50,90,.556,31,56,.554,19,34,.559,13,15,.867,132
16641,2012-12-08,CHI,,NYK,W 93-85,240,34,78,.436,27,65,.415,7,13,.538,18,18,1.000,93
16642,2012-12-08,NYK,@,CHI,L 85-93,240,27,84,.321,19,61,.311,8,23,.348,23,28,.821,85
16643,2012-12-08,CLE,,DET,L 97-104,240,39,91,.429,33,64,.516,6,27,.222,13,17,.765,97
16644,2012-12-08,DET,@,CLE,W 104-97,240,35,75,.467,26,60,.433,9,15,.600,25,33,.758,104
16645,2012-12-08,DAL,@,HOU,W 116-109,240,43,91,.473,33,67,.493,10,24,.417,20,25,.800,116
16646,2012-12-08,HOU,,DAL,L 109-116,240,35,72,.486,23,37,.622,12,35,.343,27,38,.711,109
16647,2012-12-08,LAC,,PHO,W 117-99,240,48,93,.516,41,70,.586,7,23,.304,14,24,.583,117
16648,2012-12-08,PHO,@,LAC,L 99-117,240,36,78,.462,27,54,.500,9,24,.375,18,20,.900,99
16649,2012-12-08,ATL,@,MEM,W 93-83,240,34,77,.442,27,60,.450,7,17,.412,18,25,.720,93
16650,2012-12-08,MEM,,ATL,L 83-93,240,33,77,.429,27,61,.443,6,16,.375,11,18,.611,83
16651,2012-12-08,MIA,,NOH,W 106-90,240,40,69,.580,33,58,.569,7,11,.636,19,24,.792,106
16652,2012-12-08,NOP,@,MIA,L 90-106,240,35,78,.449,27,60,.450,8,18,.444,12,13,.923,90
16653,2012-12-08,POR,,SAC,L 80-99,240,29,75,.387,21,54,.389,8,21,.381,14,18,.778,80
16654,2012-12-08,SAC,@,POR,W 99-80,240,36,86,.419,27,67,.403,9,19,.474,18,22,.818,99
16655,2012-12-08,GSW,@,WAS,W 101-97,240,35,81,.432,26,59,.441,9,22,.409,22,27,.815,101
16656,2012-12-08,WAS,,GSW,L 97-101,240,37,87,.425,28,62,.452,9,25,.360,14,23,.609,97
16657,2012-12-07,ATL,,WAS,W 104-95,240,41,85,.482,31,59,.525,10,26,.385,12,19,.632,104
16658,2012-12-07,WAS,@,ATL,L 95-104,240,36,79,.456,29,63,.460,7,16,.438,16,20,.800,95
16659,2012-12-07,BRK,,GSW,L 102-109,240,37,87,.425,26,54,.481,11,33,.333,17,23,.739,102
16660,2012-12-07,GSW,@,BRK,W 109-102,240,46,90,.511,37,71,.521,9,19,.474,8,10,.800,109
16661,2012-12-07,CHI,@,DET,W 108-104,240,43,82,.524,38,68,.559,5,14,.357,17,21,.810,108
16662,2012-12-07,DET,,CHI,L 104-108,240,36,70,.514,28,56,.500,8,14,.571,24,31,.774,104
16663,2012-12-07,DEN,@,IND,W 92-89,240,38,86,.442,35,69,.507,3,17,.176,13,20,.650,92
16664,2012-12-07,IND,,DEN,L 89-92,240,34,76,.447,24,53,.453,10,23,.435,11,18,.611,89
16665,2012-12-07,CHA,@,MIL,L 93-108,240,36,81,.444,33,68,.485,3,13,.231,18,32,.563,93
16666,2012-12-07,MIL,,CHA,W 108-93,240,38,94,.404,32,80,.400,6,14,.429,26,32,.813,108
16667,2012-12-07,CLE,@,MIN,L 73-91,240,30,87,.345,23,63,.365,7,24,.292,6,9,.667,73
16668,2012-12-07,MIN,,CLE,W 91-73,240,30,70,.429,26,51,.510,4,19,.211,27,35,.771,91
16669,2012-12-07,MEM,@,NOH,W 96-89,240,36,72,.500,28,55,.509,8,17,.471,16,22,.727,96
16670,2012-12-07,NOP,,MEM,L 89-96,240,36,75,.480,28,59,.475,8,16,.500,9,12,.750,89
16671,2012-12-07,LAL,@,OKC,L 108-114,240,36,84,.429,25,56,.446,11,28,.393,25,31,.806,108
16672,2012-12-07,OKC,,LAL,W 114-108,240,41,84,.488,32,67,.478,9,17,.529,23,28,.821,114
16673,2012-12-07,BOS,@,PHI,L 94-95 (OT),265,35,81,.432,29,59,.492,6,22,.273,18,25,.720,94
16674,2012-12-07,PHI,,BOS,W 95-94 (OT),265,37,99,.374,35,88,.398,2,11,.182,19,26,.731,95
16675,2012-12-07,ORL,@,SAC,L 82-91,240,30,80,.375,26,65,.400,4,15,.267,18,21,.857,82
16676,2012-12-07,SAC,,ORL,W 91-82,240,32,79,.405,28,58,.483,4,21,.190,23,28,.821,91
16677,2012-12-07,HOU,@,SAS,L 92-114,240,37,95,.389,26,62,.419,11,33,.333,7,8,.875,92
16678,2012-12-07,SAS,,HOU,W 114-92,240,48,87,.552,42,67,.627,6,20,.300,12,13,.923,114
16679,2012-12-07,TOR,@,UTA,L 99-131,240,33,82,.402,26,58,.448,7,24,.292,26,31,.839,99
16680,2012-12-07,UTA,,TOR,W 131-99,240,45,91,.495,32,68,.471,13,23,.565,28,35,.800,131
16681,2012-12-06,MIA,,NYK,L 92-112,240,32,76,.421,26,60,.433,6,16,.375,22,28,.786,92
16682,2012-12-06,NYK,@,MIA,W 112-92,240,41,91,.451,23,47,.489,18,44,.409,12,19,.632,112
16683,2012-12-06,DAL,@,PHO,W 97-94,240,37,78,.474,33,66,.500,4,12,.333,19,24,.792,97
16684,2012-12-06,PHO,,DAL,L 94-97,240,34,85,.400,26,64,.406,8,21,.381,18,25,.720,94
16685,2012-12-05,ATL,,DEN,W 108-104,240,42,95,.442,34,73,.466,8,22,.364,16,19,.842,108
16686,2012-12-05,DEN,@,ATL,L 104-108,240,38,79,.481,31,62,.500,7,17,.412,21,25,.840,104
16687,2012-12-05,BOS,,MIN,W 104-94,240,41,78,.526,37,61,.607,4,17,.235,18,26,.692,104
16688,2012-12-05,MIN,@,BOS,L 94-104,240,37,84,.440,31,65,.477,6,19,.316,14,30,.467,94
16689,2012-12-05,CHA,,NYK,L 98-100,240,39,83,.470,32,67,.478,7,16,.438,13,15,.867,98
16690,2012-12-05,NYK,@,CHA,W 100-98,240,39,92,.424,26,51,.510,13,41,.317,9,13,.692,100
16691,2012-12-05,CHI,@,CLE,W 95-85,240,34,72,.472,30,57,.526,4,15,.267,23,27,.852,95
16692,2012-12-05,CLE,,CHI,L 85-95,240,31,85,.365,26,69,.377,5,16,.313,18,25,.720,85
16693,2012-12-05,DET,,GSW,L 97-104,240,35,79,.443,29,58,.500,6,21,.286,21,31,.677,97
16694,2012-12-05,GSW,@,DET,W 104-97,240,34,75,.453,25,51,.490,9,24,.375,27,34,.794,104
16695,2012-12-05,IND,,POR,W 99-92,240,36,80,.450,27,54,.500,9,26,.346,18,19,.947,99
16696,2012-12-05,POR,@,IND,L 92-99,240,34,79,.430,28,57,.491,6,22,.273,18,22,.818,92
16697,2012-12-05,DAL,@,LAC,L 90-112,240,34,84,.405,29,65,.446,5,19,.263,17,19,.895,90
16698,2012-12-05,LAC,,DAL,W 112-90,240,45,90,.500,39,70,.557,6,20,.300,16,21,.762,112
16699,2012-12-05,LAL,@,NOH,W 103-87,240,37,80,.463,24,52,.462,13,28,.464,16,22,.727,103
16700,2012-12-05,NOP,,LAL,L 87-103,240,35,85,.412,28,66,.424,7,19,.368,10,18,.556,87
16701,2012-12-05,SAC,,TOR,W 107-100,240,38,82,.463,32,67,.478,6,15,.400,25,34,.735,107
16702,2012-12-05,TOR,@,SAC,L 100-107,240,35,86,.407,29,63,.460,6,23,.261,24,28,.857,100
16703,2012-12-05,MIL,@,SAS,L 99-110,240,35,84,.417,30,72,.417,5,12,.417,24,29,.828,99
16704,2012-12-05,SAS,,MIL,W 110-99,240,40,85,.471,34,64,.531,6,21,.286,24,28,.857,110
16705,2012-12-05,ORL,@,UTA,L 81-87,240,34,77,.442,33,62,.532,1,15,.067,12,17,.706,81
16706,2012-12-05,UTA,,ORL,W 87-81,240,32,77,.416,31,67,.463,1,10,.100,22,27,.815,87
16707,2012-12-04,BRK,,OKC,L 111-117,240,39,91,.429,25,57,.439,14,34,.412,19,23,.826,111
16708,2012-12-04,OKC,@,BRK,W 117-111,240,40,66,.606,33,52,.635,7,14,.500,30,34,.882,117
16709,2012-12-04,CHI,,IND,L 76-80,240,28,73,.384,24,61,.393,4,12,.333,16,20,.800,76
16710,2012-12-04,IND,@,CHI,W 80-76,240,29,80,.363,27,70,.386,2,10,.200,20,27,.741,80
16711,2012-12-04,HOU,,LAL,W 107-105,240,38,101,.376,31,67,.463,7,34,.206,24,31,.774,107
16712,2012-12-04,LAL,@,HOU,L 105-107,240,38,83,.458,31,62,.500,7,21,.333,22,34,.647,105
16713,2012-12-04,MEM,,PHO,W 108-98 (OT),265,40,85,.471,36,66,.545,4,19,.211,24,31,.774,108
16714,2012-12-04,PHO,@,MEM,L 98-108 (OT),265,38,82,.463,32,68,.471,6,14,.429,16,22,.727,98
16715,2012-12-04,MIN,@,PHI,W 105-88,240,41,77,.532,28,52,.538,13,25,.520,10,17,.588,105
16716,2012-12-04,PHI,,MIN,L 88-105,240,35,83,.422,30,63,.476,5,20,.250,13,23,.565,88
16717,2012-12-04,MIA,@,WAS,L 101-105,240,41,89,.461,33,61,.541,8,28,.286,11,16,.688,101
16718,2012-12-04,WAS,,MIA,W 105-101,240,38,79,.481,31,60,.517,7,19,.368,22,29,.759,105
16719,2012-12-03,CHA,,POR,L 112-118 (OT),265,41,88,.466,28,61,.459,13,27,.481,17,22,.773,112
16720,2012-12-03,POR,@,CHA,W 118-112 (OT),265,43,92,.467,31,57,.544,12,35,.343,20,26,.769,118
16721,2012-12-03,DEN,,TOR,W 113-110,240,40,85,.471,34,70,.486,6,15,.400,27,43,.628,113
16722,2012-12-03,TOR,@,DEN,L 110-113,240,42,86,.488,33,58,.569,9,28,.321,17,19,.895,110
16723,2012-12-03,CLE,@,DET,L 79-89,240,32,95,.337,29,75,.387,3,20,.150,12,17,.706,79
16724,2012-12-03,DET,,CLE,W 89-79,240,36,84,.429,32,66,.485,4,18,.222,13,19,.684,89
16725,2012-12-03,GSW,,ORL,L 94-102,240,37,81,.457,30,64,.469,7,17,.412,13,18,.722,94
16726,2012-12-03,ORL,@,GSW,W 102-94,240,40,92,.435,32,69,.464,8,23,.348,14,16,.875,102
16727,2012-12-03,MIL,@,NOH,L 81-102,240,29,76,.382,21,57,.368,8,19,.421,15,23,.652,81
16728,2012-12-03,NOP,,MIL,W 102-81,240,43,82,.524,38,70,.543,5,12,.417,11,11,1.000,102
16729,2012-12-03,LAC,@,UTA,W 105-104,240,42,89,.472,38,68,.559,4,21,.190,17,24,.708,105
16730,2012-12-03,UTA,,LAC,L 104-105,240,42,74,.568,33,54,.611,9,20,.450,11,15,.733,104
16731,2012-12-02,LAL,,ORL,L 103-113,240,36,86,.419,30,69,.435,6,17,.353,25,39,.641,103
16732,2012-12-02,ORL,@,LAL,W 113-103,240,43,86,.500,35,63,.556,8,23,.348,19,20,.950,113
16733,2012-12-02,NYK,,PHO,W 106-99,240,40,90,.444,28,61,.459,12,29,.414,14,17,.824,106
16734,2012-12-02,PHO,@,NYK,L 99-106,240,39,80,.488,31,57,.544,8,23,.348,13,19,.684,99
16735,2012-12-01,CHI,,PHI,W 93-88,240,38,81,.469,34,74,.459,4,7,.571,13,21,.619,93
16736,2012-12-01,PHI,@,CHI,L 88-93,240,36,82,.439,33,70,.471,3,12,.250,13,18,.722,88
16737,2012-12-01,CLE,,POR,L 117-118 (2OT),290,43,99,.434,30,64,.469,13,35,.371,18,22,.818,117
16738,2012-12-01,POR,@,CLE,W 118-117 (2OT),290,46,94,.489,37,69,.536,9,25,.360,17,21,.810,118
16739,2012-12-01,DAL,,DET,W 92-77,240,38,93,.409,27,68,.397,11,25,.440,5,8,.625,92
16740,2012-12-01,DET,@,DAL,L 77-92,240,29,85,.341,24,64,.375,5,21,.238,14,18,.778,77
16741,2012-12-01,GSW,,IND,W 103-92,240,38,80,.475,29,60,.483,9,20,.450,18,19,.947,103
16742,2012-12-01,IND,@,GSW,L 92-103,240,34,74,.459,26,52,.500,8,22,.364,16,20,.800,92
16743,2012-12-01,HOU,,UTA,W 124-116,240,46,83,.554,35,61,.574,11,22,.500,21,26,.808,124
16744,2012-12-01,UTA,@,HOU,L 116-124,240,48,94,.511,37,74,.500,11,20,.550,9,11,.818,116
16745,2012-12-01,LAC,,SAC,W 116-81,240,47,86,.547,35,62,.565,12,24,.500,10,16,.625,116
16746,2012-12-01,SAC,@,LAC,L 81-116,240,29,76,.382,20,53,.377,9,23,.391,14,18,.778,81
16747,2012-12-01,BRK,@,MIA,L 89-102,240,33,75,.440,27,47,.574,6,28,.214,17,27,.630,89
16748,2012-12-01,MIA,,BRK,W 102-89,240,40,78,.513,33,58,.569,7,20,.350,15,19,.789,102
16749,2012-12-01,BOS,@,MIL,L 88-91,240,34,82,.415,28,63,.444,6,19,.316,14,17,.824,88
16750,2012-12-01,MIL,,BOS,W 91-88,240,36,79,.456,32,66,.485,4,13,.308,15,20,.750,91
16751,2012-12-01,NOP,,OKC,L 79-100,240,30,81,.370,24,57,.421,6,24,.250,13,18,.722,79
16752,2012-12-01,OKC,@,NOH,W 100-79,240,40,79,.506,33,63,.524,7,16,.438,13,17,.765,100
16753,2012-12-01,MEM,@,SAS,L 95-99 (OT),265,36,99,.364,32,84,.381,4,15,.267,19,22,.864,95
16754,2012-12-01,SAS,,MEM,W 99-95 (OT),265,37,89,.416,30,60,.500,7,29,.241,18,24,.750,99
16755,2012-11-30,ATL,,CLE,L 111-113,240,38,78,.487,26,58,.448,12,20,.600,23,32,.719,111
16756,2012-11-30,CLE,@,ATL,W 113-111,240,41,85,.482,31,62,.500,10,23,.435,21,22,.955,113
16757,2012-11-30,BOS,,POR,W 96-78,240,36,73,.493,30,57,.526,6,16,.375,18,20,.900,96
16758,2012-11-30,POR,@,BOS,L 78-96,240,24,69,.348,21,54,.389,3,15,.200,27,37,.730,78
16759,2012-11-30,CHA,,PHI,L 98-104,240,39,83,.470,31,66,.470,8,17,.471,12,18,.667,98
16760,2012-11-30,PHI,@,CHA,W 104-98,240,44,86,.512,36,69,.522,8,17,.471,8,10,.800,104
16761,2012-11-30,DEN,@,LAL,L 103-122,240,40,86,.465,32,62,.516,8,24,.333,15,22,.682,103
16762,2012-11-30,LAL,,DEN,W 122-103,240,47,87,.540,30,54,.556,17,33,.515,11,17,.647,122
16763,2012-11-30,DET,@,MEM,L 78-90,240,29,72,.403,25,56,.446,4,16,.250,16,20,.800,78
16764,2012-11-30,MEM,,DET,W 90-78,240,34,85,.400,30,73,.411,4,12,.333,18,21,.857,90
16765,2012-11-30,MIL,@,MIN,L 85-95,240,34,93,.366,29,75,.387,5,18,.278,12,16,.750,85
16766,2012-11-30,MIN,,MIL,W 95-85,240,34,87,.391,26,68,.382,8,19,.421,19,27,.704,95
16767,2012-11-30,NYK,,WAS,W 108-87,240,43,81,.531,31,52,.596,12,29,.414,10,15,.667,108
16768,2012-11-30,WAS,@,NYK,L 87-108,240,35,78,.449,30,60,.500,5,18,.278,12,21,.571,87
16769,2012-11-30,OKC,,UTA,W 106-94,240,39,75,.520,35,66,.530,4,9,.444,24,33,.727,106
16770,2012-11-30,UTA,@,OKC,L 94-106,240,38,92,.413,31,69,.449,7,23,.304,11,12,.917,94
16771,2012-11-30,BRK,@,ORL,W 98-86,240,38,83,.458,27,63,.429,11,20,.550,11,13,.846,98
16772,2012-11-30,ORL,,BRK,L 86-98,240,35,78,.449,34,67,.507,1,11,.091,15,19,.789,86
16773,2012-11-30,IND,@,SAC,W 97-92,240,37,85,.435,28,59,.475,9,26,.346,14,19,.737,97
16774,2012-11-30,SAC,,IND,L 92-97,240,32,75,.427,26,58,.448,6,17,.353,22,25,.880,92
16775,2012-11-30,PHO,@,TOR,L 97-101,240,37,77,.481,31,61,.508,6,16,.375,17,19,.895,97
16776,2012-11-30,TOR,,PHO,W 101-97,240,39,81,.481,31,67,.463,8,14,.571,15,22,.682,101
16777,2012-11-29,DEN,@,GSW,L 105-106,240,38,84,.452,28,63,.444,10,21,.476,19,24,.792,105
16778,2012-11-29,GSW,,DEN,W 106-105,240,44,86,.512,36,68,.529,8,18,.444,10,13,.769,106
16779,2012-11-29,MIA,,SAS,W 105-100,240,42,86,.488,37,73,.507,5,13,.385,16,19,.842,105
16780,2012-11-29,SAS,@,MIA,L 100-105,240,36,80,.450,26,50,.520,10,30,.333,18,24,.750,100
16781,2012-11-28,ATL,,CHA,W 94-91,240,36,90,.400,24,58,.414,12,32,.375,10,15,.667,94
16782,2012-11-28,CHA,@,ATL,L 91-94,240,30,76,.395,18,52,.346,12,24,.500,19,23,.826,91
16783,2012-11-28,BOS,,BRK,L 83-95,240,32,75,.427,31,68,.456,1,7,.143,18,24,.750,83
16784,2012-11-28,BRK,@,BOS,W 95-83,240,33,82,.402,23,58,.397,10,24,.417,19,29,.655,95
16785,2012-11-28,CHI,,DAL,W 101-78,240,34,69,.493,28,59,.475,6,10,.600,27,33,.818,101
16786,2012-11-28,DAL,@,CHI,L 78-101,240,28,81,.346,24,63,.381,4,18,.222,18,20,.900,78
16787,2012-11-28,DET,,PHO,W 117-77,240,40,76,.526,28,60,.467,12,16,.750,25,35,.714,117
16788,2012-11-28,PHO,@,DET,L 77-117,240,28,82,.341,22,61,.361,6,21,.286,15,20,.750,77
16789,2012-11-28,LAC,,MIN,W 101-95,240,37,81,.457,33,62,.532,4,19,.211,23,26,.885,101
16790,2012-11-28,MIN,@,LAC,L 95-101,240,31,82,.378,25,60,.417,6,22,.273,27,35,.771,95
16791,2012-11-28,MEM,,TOR,W 103-82,240,38,80,.475,30,62,.484,8,18,.444,19,28,.679,103
16792,2012-11-28,TOR,@,MEM,L 82-103,240,29,74,.392,24,57,.421,5,17,.294,19,24,.792,82
16793,2012-11-28,MIL,,NYK,L 88-102,240,33,72,.458,28,59,.475,5,13,.385,17,21,.810,88
16794,2012-11-28,NYK,@,MIL,W 102-88,240,35,73,.479,24,52,.462,11,21,.524,21,25,.840,102
16795,2012-11-28,NOP,,UTA,L 84-96,240,31,73,.425,26,52,.500,5,21,.238,17,21,.810,84
16796,2012-11-28,UTA,@,NOH,W 96-84,240,31,63,.492,25,52,.481,6,11,.545,28,38,.737,96
16797,2012-11-28,HOU,@,OKC,L 98-120,240,36,87,.414,28,66,.424,8,21,.381,18,30,.600,98
16798,2012-11-28,OKC,,HOU,W 120-98,240,47,87,.540,38,65,.585,9,22,.409,17,22,.773,120
16799,2012-11-28,ORL,,SAS,L 89-110,240,41,95,.432,39,80,.488,2,15,.133,5,8,.625,89
16800,2012-11-28,SAS,@,ORL,W 110-89,240,44,84,.524,33,59,.559,11,25,.440,11,15,.733,110
16801,2012-11-28,POR,@,WAS,L 82-84,240,30,86,.349,20,55,.364,10,31,.323,12,18,.667,82
16802,2012-11-28,WAS,,POR,W 84-82,240,31,71,.437,26,59,.441,5,12,.417,17,19,.895,84
16803,2012-11-27,CLE,,PHO,L 78-91,240,30,84,.357,28,69,.406,2,15,.133,16,22,.727,78
16804,2012-11-27,PHO,@,CLE,W 91-78,240,37,79,.468,31,62,.500,6,17,.353,11,18,.611,91
16805,2012-11-27,HOU,,TOR,W 117-101,240,44,83,.530,31,57,.544,13,26,.500,16,21,.762,117
16806,2012-11-27,TOR,@,HOU,L 101-117,240,42,86,.488,34,63,.540,8,23,.348,9,12,.750,101
16807,2012-11-27,IND,@,LAL,W 79-77,240,29,79,.367,25,60,.417,4,19,.211,17,27,.630,79
16808,2012-11-27,LAL,,IND,L 77-79,240,24,76,.316,18,48,.375,6,28,.214,23,43,.535,77
16809,2012-11-27,DAL,@,PHI,L 98-100,240,37,81,.457,32,62,.516,5,19,.263,19,22,.864,98
16810,2012-11-27,PHI,,DAL,W 100-98,240,35,75,.467,29,61,.475,6,14,.429,24,32,.750,100
16811,2012-11-27,MIN,@,SAC,W 97-89,240,38,83,.458,32,61,.525,6,22,.273,15,18,.833,97
16812,2012-11-27,SAC,,MIN,L 89-97,240,37,84,.440,31,67,.463,6,17,.353,9,14,.643,89
16813,2012-11-26,BRK,,NYK,W 96-89 (OT),265,37,91,.407,28,63,.444,9,28,.321,13,19,.684,96
16814,2012-11-26,NYK,@,BRK,L 89-96 (OT),265,33,85,.388,27,64,.422,6,21,.286,17,24,.708,89
16815,2012-11-26,CHI,,MIL,L 92-93,240,35,80,.438,30,69,.435,5,11,.455,17,19,.895,92
16816,2012-11-26,MIL,@,CHI,W 93-92,240,39,85,.459,36,70,.514,3,15,.200,12,19,.632,93
16817,2012-11-26,DET,,POR,W 108-101,240,42,80,.525,33,65,.508,9,15,.600,15,22,.682,108
16818,2012-11-26,POR,@,DET,L 101-108,240,36,85,.424,30,66,.455,6,19,.316,23,31,.742,101
16819,2012-11-26,LAC,,NOH,L 98-105,240,37,79,.468,19,42,.452,18,37,.486,6,11,.545,98
16820,2012-11-26,NOP,@,LAC,W 105-98,240,36,71,.507,21,46,.457,15,25,.600,18,23,.783,105
16821,2012-11-26,CLE,@,MEM,L 78-84,240,31,76,.408,27,60,.450,4,16,.250,12,15,.800,78
16822,2012-11-26,MEM,,CLE,W 84-78,240,33,71,.465,29,60,.483,4,11,.364,14,18,.778,84
16823,2012-11-26,CHA,@,OKC,L 69-114,240,23,79,.291,17,57,.298,6,22,.273,17,22,.773,69
16824,2012-11-26,OKC,,CHA,W 114-69,240,40,78,.513,27,51,.529,13,27,.481,21,23,.913,114
16825,2012-11-26,DEN,@,UTA,L 103-105,240,40,73,.548,35,59,.593,5,14,.357,18,32,.563,103
16826,2012-11-26,UTA,,DEN,W 105-103,240,36,78,.462,28,56,.500,8,22,.364,25,34,.735,105
16827,2012-11-26,SAS,@,WAS,W 118-92,240,45,80,.563,32,57,.561,13,23,.565,15,20,.750,118
16828,2012-11-26,WAS,,SAS,L 92-118,240,37,90,.411,33,76,.434,4,14,.286,14,17,.824,92
16829,2012-11-25,BRK,,POR,W 98-85,240,39,92,.424,34,75,.453,5,17,.294,15,21,.714,98
16830,2012-11-25,POR,@,BRK,L 85-98,240,34,78,.436,27,61,.443,7,17,.412,10,13,.769,85
16831,2012-11-25,DEN,,NOH,W 102-84,240,40,75,.533,35,62,.565,5,13,.385,17,21,.810,102
16832,2012-11-25,NOP,@,DEN,L 84-102,240,33,85,.388,27,72,.375,6,13,.462,12,20,.600,84
16833,2012-11-25,DET,@,NYK,L 100-121,240,37,78,.474,28,58,.483,9,20,.450,17,22,.773,100
16834,2012-11-25,NYK,,DET,W 121-100,240,38,79,.481,21,46,.457,17,33,.515,28,31,.903,121
16835,2012-11-25,BOS,@,ORL,W 116-110 (OT),265,47,105,.448,40,87,.460,7,18,.389,15,19,.789,116
16836,2012-11-25,ORL,,BOS,L 110-116 (OT),265,41,90,.456,30,64,.469,11,26,.423,17,19,.895,110
16837,2012-11-25,PHI,,PHO,W 104-101,240,39,81,.481,30,62,.484,9,19,.474,17,23,.739,104
16838,2012-11-25,PHO,@,PHI,L 101-104,240,39,83,.470,35,72,.486,4,11,.364,19,20,.950,101
16839,2012-11-25,SAS,@,TOR,W 111-106 (2OT),290,44,103,.427,36,76,.474,8,27,.296,15,19,.789,111
16840,2012-11-25,TOR,,SAS,L 106-111 (2OT),290,40,110,.364,34,86,.395,6,24,.250,20,24,.833,106
16841,2012-11-24,ATL,,LAC,W 104-93,240,38,75,.507,31,58,.534,7,17,.412,21,26,.808,104
16842,2012-11-24,LAC,@,ATL,L 93-104,240,32,75,.427,24,56,.429,8,19,.421,21,25,.840,93
16843,2012-11-24,DAL,,LAL,L 89-115,240,34,92,.370,24,64,.375,10,28,.357,11,20,.550,89
16844,2012-11-24,LAL,@,DAL,W 115-89,240,40,82,.488,28,60,.467,12,22,.545,23,34,.676,115
16845,2012-11-24,GSW,,MIN,W 96-85,240,33,78,.423,27,57,.474,6,21,.286,24,29,.828,96
16846,2012-11-24,MIN,@,GSW,L 85-96,240,33,86,.384,28,59,.475,5,27,.185,14,19,.737,85
16847,2012-11-24,CLE,@,MIA,L 108-110,240,35,79,.443,21,48,.438,14,31,.452,24,33,.727,108
16848,2012-11-24,MIA,,CLE,W 110-108,240,36,69,.522,27,50,.540,9,19,.474,29,37,.784,110
16849,2012-11-24,CHI,@,MIL,W 93-86,240,32,82,.390,28,66,.424,4,16,.250,25,26,.962,93
16850,2012-11-24,MIL,,CHI,L 86-93,240,38,88,.432,35,71,.493,3,17,.176,7,10,.700,86
16851,2012-11-24,OKC,@,PHI,W 116-109 (OT),265,39,88,.443,33,67,.493,6,21,.286,32,37,.865,116
16852,2012-11-24,PHI,,OKC,L 109-116 (OT),265,45,91,.495,38,71,.535,7,20,.350,12,17,.706,109
16853,2012-11-24,SAC,,UTA,W 108-97,240,40,74,.541,34,58,.586,6,16,.375,22,32,.688,108
16854,2012-11-24,UTA,@,SAC,L 97-108,240,32,79,.405,21,54,.389,11,25,.440,22,30,.733,97
16855,2012-11-24,CHA,@,WAS,W 108-106 (2OT),290,34,83,.410,22,55,.400,12,28,.429,28,36,.778,108
16856,2012-11-24,WAS,,CHA,L 106-108 (2OT),290,34,93,.366,28,66,.424,6,27,.222,32,39,.821,106
16857,2012-11-23,BOS,,OKC,W 108-100,240,39,80,.488,30,63,.476,9,17,.529,21,24,.875,108
16858,2012-11-23,OKC,@,BOS,L 100-108,240,37,79,.468,31,55,.564,6,24,.250,20,24,.833,100
16859,2012-11-23,BRK,,LAC,W 86-76,240,34,73,.466,29,60,.483,5,13,.385,13,19,.684,86
16860,2012-11-23,LAC,@,BRK,L 76-86,240,29,72,.403,25,55,.455,4,17,.235,14,22,.636,76
16861,2012-11-23,ATL,@,CHA,W 101-91,240,42,78,.538,31,56,.554,11,22,.500,6,14,.429,101
16862,2012-11-23,CHA,,ATL,L 91-101,240,31,83,.373,23,61,.377,8,22,.364,21,26,.808,91
16863,2012-11-23,DEN,,GSW,W 102-91,240,40,84,.476,35,65,.538,5,19,.263,17,30,.567,102
16864,2012-11-23,GSW,@,DEN,L 91-102,240,35,80,.438,28,63,.444,7,17,.412,14,18,.778,91
16865,2012-11-23,DET,,TOR,W 91-90,240,36,78,.462,32,65,.492,4,13,.308,15,26,.577,91
16866,2012-11-23,TOR,@,DET,L 90-91,240,32,78,.410,26,60,.433,6,18,.333,20,25,.800,90
16867,2012-11-23,HOU,,NYK,W 131-103,240,46,89,.517,32,64,.500,14,25,.560,25,28,.893,131
16868,2012-11-23,NYK,@,HOU,L 103-131,240,37,86,.430,20,47,.426,17,39,.436,12,14,.857,103
16869,2012-11-23,IND,,SAS,L 97-104,240,38,92,.413,31,76,.408,7,16,.438,14,21,.667,97
16870,2012-11-23,SAS,@,IND,W 104-97,240,41,83,.494,39,66,.591,2,17,.118,20,22,.909,104
16871,2012-11-23,LAL,@,MEM,L 98-106,240,33,74,.446,21,47,.447,12,27,.444,20,24,.833,98
16872,2012-11-23,MEM,,LAL,W 106-98,240,38,75,.507,32,64,.500,6,11,.545,24,30,.800,106
16873,2012-11-23,CLE,@,ORL,L 104-108,240,37,87,.425,29,61,.475,8,26,.308,22,30,.733,104
16874,2012-11-23,ORL,,CLE,W 108-104,240,40,80,.500,29,59,.492,11,21,.524,17,20,.850,108
16875,2012-11-23,NOP,@,PHO,L 108-111 (OT),265,40,78,.513,27,52,.519,13,26,.500,15,18,.833,108
16876,2012-11-23,PHO,,NOH,W 111-108 (OT),265,44,90,.489,33,65,.508,11,25,.440,12,19,.632,111
16877,2012-11-23,MIN,@,POR,L 95-103,240,32,78,.410,29,60,.483,3,18,.167,28,37,.757,95
16878,2012-11-23,POR,,MIN,W 103-95,240,42,78,.538,31,53,.585,11,25,.440,8,18,.444,103
16879,2012-11-23,SAC,@,UTA,L 102-104,240,40,80,.500,30,63,.476,10,17,.588,12,16,.750,102
16880,2012-11-23,UTA,,SAC,W 104-102,240,36,83,.434,33,68,.485,3,15,.200,29,33,.879,104
16881,2012-11-21,ATL,,WAS,W 101-100 (OT),265,40,92,.435,31,67,.463,9,25,.360,12,21,.571,101
16882,2012-11-21,WAS,@,ATL,L 100-101 (OT),265,38,89,.427,31,69,.449,7,20,.350,17,24,.708,100
16883,2012-11-21,BOS,,SAS,L 100-112,240,41,77,.532,38,69,.551,3,8,.375,15,17,.882,100
16884,2012-11-21,SAS,@,BOS,W 112-100,240,45,77,.584,37,61,.607,8,16,.500,14,19,.737,112
16885,2012-11-21,CHA,,TOR,W 98-97,240,36,86,.419,33,67,.493,3,19,.158,23,28,.821,98
16886,2012-11-21,TOR,@,CHA,L 97-98,240,37,80,.463,28,57,.491,9,23,.391,14,20,.700,97
16887,2012-11-21,CLE,,PHI,W 92-83,240,35,86,.407,22,63,.349,13,23,.565,9,14,.643,92
16888,2012-11-21,PHI,@,CLE,L 83-92,240,31,86,.360,27,69,.391,4,17,.235,17,22,.773,83
16889,2012-11-21,DAL,,NYK,W 114-111,240,42,85,.494,29,56,.518,13,29,.448,17,21,.810,114
16890,2012-11-21,NYK,@,DAL,L 111-114,240,39,77,.506,24,46,.522,15,31,.484,18,22,.818,111
16891,2012-11-21,BRK,@,GSW,L 93-102,240,38,83,.458,32,60,.533,6,23,.261,11,15,.733,93
16892,2012-11-21,GSW,,BRK,W 102-93,240,40,75,.533,33,60,.550,7,15,.467,15,19,.789,102
16893,2012-11-21,CHI,@,HOU,L 89-93,240,38,95,.400,36,79,.456,2,16,.125,11,19,.579,89
16894,2012-11-21,HOU,,CHI,W 93-89,240,32,74,.432,25,55,.455,7,19,.368,22,31,.710,93
16895,2012-11-21,IND,,NOH,W 115-107 (OT),265,40,92,.435,25,65,.385,15,27,.556,20,28,.714,115
16896,2012-11-21,NOP,@,IND,L 107-115 (OT),265,39,92,.424,33,82,.402,6,10,.600,23,27,.852,107
16897,2012-11-21,MIA,,MIL,W 113-106 (OT),265,41,86,.477,33,68,.485,8,18,.444,23,33,.697,113
16898,2012-11-21,MIL,@,MIA,L 106-113 (OT),265,46,109,.422,41,80,.513,5,29,.172,9,12,.750,106
16899,2012-11-21,DEN,@,MIN,W 101-94,240,35,79,.443,26,58,.448,9,21,.429,22,26,.846,101
16900,2012-11-21,MIN,,DEN,L 94-101,240,34,89,.382,24,61,.393,10,28,.357,16,25,.640,94
16901,2012-11-21,LAC,@,OKC,L 111-117 (OT),265,40,93,.430,33,73,.452,7,20,.350,24,33,.727,111
16902,2012-11-21,OKC,,LAC,W 117-111 (OT),265,36,79,.456,25,56,.446,11,23,.478,34,39,.872,117
16903,2012-11-21,DET,@,ORL,L 74-90,240,28,85,.329,25,68,.368,3,17,.176,15,22,.682,74
16904,2012-11-21,ORL,,DET,W 90-74,240,36,83,.434,31,63,.492,5,20,.250,13,18,.722,90
16905,2012-11-21,PHO,,POR,W 114-87,240,46,77,.597,39,60,.650,7,17,.412,15,18,.833,114
16906,2012-11-21,POR,@,PHO,L 87-114,240,31,77,.403,26,58,.448,5,19,.263,20,26,.769,87
16907,2012-11-21,LAL,@,SAC,L 97-113,240,29,65,.446,17,39,.436,12,26,.462,27,39,.692,97
16908,2012-11-21,SAC,,LAL,W 113-97,240,44,81,.543,37,66,.561,7,15,.467,18,22,.818,113
16909,2012-11-20,BRK,@,LAL,L 90-95,240,34,82,.415,27,59,.458,7,23,.304,15,21,.714,90
16910,2012-11-20,LAL,,BRK,W 95-90,240,35,73,.479,29,52,.558,6,21,.286,19,37,.514,95
16911,2012-11-20,NOP,,NYK,L 80-102,240,29,69,.420,21,51,.412,8,18,.444,14,21,.667,80
16912,2012-11-20,NYK,@,NOH,W 102-80,240,37,83,.446,23,47,.489,14,36,.389,14,19,.737,102
16913,2012-11-20,PHI,,TOR,W 106-98,240,40,85,.471,31,61,.508,9,24,.375,17,19,.895,106
16914,2012-11-20,TOR,@,PHI,L 98-106,240,37,82,.451,33,66,.500,4,16,.250,20,29,.690,98
16915,2012-11-19,ATL,,ORL,W 81-72,240,34,89,.382,29,64,.453,5,25,.200,8,13,.615,81
16916,2012-11-19,ORL,@,ATL,L 72-81,240,31,82,.378,29,72,.403,2,10,.200,8,14,.571,72
16917,2012-11-19,CHA,,MIL,W 102-98,240,36,82,.439,33,71,.465,3,11,.273,27,30,.900,102
16918,2012-11-19,MIL,@,CHA,L 98-102,240,44,93,.473,42,77,.545,2,16,.125,8,11,.727,98
16919,2012-11-19,DAL,,GSW,L 101-105 (OT),265,37,86,.430,27,65,.415,10,21,.476,17,24,.708,101
16920,2012-11-19,GSW,@,DAL,W 105-101 (OT),265,37,91,.407,28,67,.418,9,24,.375,22,30,.733,105
16921,2012-11-19,DEN,@,MEM,W 97-92,240,36,81,.444,31,66,.470,5,15,.333,20,28,.714,97
16922,2012-11-19,MEM,,DEN,L 92-97,240,36,78,.462,30,61,.492,6,17,.353,14,17,.824,92
16923,2012-11-19,LAC,@,SAS,W 92-87,240,40,85,.471,39,73,.534,1,12,.083,11,19,.579,92
16924,2012-11-19,SAS,,LAC,L 87-92,240,29,82,.354,23,62,.371,6,20,.300,23,28,.821,87
16925,2012-11-19,HOU,@,UTA,L 91-102,240,30,86,.349,23,65,.354,7,21,.333,24,31,.774,91
16926,2012-11-19,UTA,,HOU,W 102-91,240,37,92,.402,28,71,.394,9,21,.429,19,23,.826,102
16927,2012-11-19,IND,@,WAS,W 96-89,240,34,70,.486,31,51,.608,3,19,.158,25,29,.862,96
16928,2012-11-19,WAS,,IND,L 89-96,240,31,87,.356,27,70,.386,4,17,.235,23,31,.742,89
16929,2012-11-18,BOS,@,DET,L 83-103,240,32,71,.451,28,54,.519,4,17,.235,15,19,.789,83
16930,2012-11-18,DET,,BOS,W 103-83,240,39,72,.542,35,61,.574,4,11,.364,21,26,.808,103
16931,2012-11-18,HOU,@,LAL,L 108-119,240,44,90,.489,35,67,.522,9,23,.391,11,18,.611,108
16932,2012-11-18,LAL,,HOU,W 119-108,240,46,85,.541,37,65,.569,9,20,.450,18,28,.643,119
16933,2012-11-18,IND,@,NYK,L 76-88,240,28,71,.394,20,51,.392,8,20,.400,12,18,.667,76
16934,2012-11-18,NYK,,IND,W 88-76,240,33,90,.367,26,65,.400,7,25,.280,15,19,.789,88
16935,2012-11-18,GSW,@,OKC,L 109-119,240,43,82,.524,38,66,.576,5,16,.313,18,22,.818,109
16936,2012-11-18,OKC,,GSW,W 119-109,240,42,83,.506,29,63,.460,13,20,.650,22,26,.846,119
16937,2012-11-18,CLE,@,PHI,L 79-86,240,30,84,.357,25,64,.391,5,20,.250,14,15,.933,79
16938,2012-11-18,PHI,,CLE,W 86-79,240,34,80,.425,25,60,.417,9,20,.450,9,12,.750,86
16939,2012-11-18,CHI,@,POR,L 94-102,240,37,75,.493,33,59,.559,4,16,.250,16,18,.889,94
16940,2012-11-18,POR,,CHI,W 102-94,240,39,79,.494,30,57,.526,9,22,.409,15,20,.750,102
16941,2012-11-18,BRK,@,SAC,W 99-90,240,36,75,.480,31,58,.534,5,17,.294,22,25,.880,99
16942,2012-11-18,SAC,,BRK,L 90-99,240,37,80,.463,31,62,.500,6,18,.333,10,19,.526,90
16943,2012-11-18,ORL,@,TOR,L 86-97,240,32,80,.400,28,67,.418,4,13,.308,18,21,.857,86
16944,2012-11-18,TOR,,ORL,W 97-86,240,38,80,.475,31,62,.500,7,18,.389,14,23,.609,97
16945,2012-11-17,BOS,,TOR,W 107-89,240,43,76,.566,37,61,.607,6,15,.400,15,19,.789,107
16946,2012-11-17,TOR,@,BOS,L 89-107,240,30,70,.429,22,48,.458,8,22,.364,21,31,.677,89
16947,2012-11-17,CHA,,MEM,L 87-94,240,32,85,.376,28,72,.389,4,13,.308,19,28,.679,87
16948,2012-11-17,MEM,@,CHA,W 94-87,240,31,80,.388,29,66,.439,2,14,.143,30,34,.882,94
16949,2012-11-17,CLE,,DAL,L 95-103,240,36,96,.375,28,71,.394,8,25,.320,15,20,.750,95
16950,2012-11-17,DAL,@,CLE,W 103-95,240,38,74,.514,28,51,.549,10,23,.435,17,20,.850,103
16951,2012-11-17,CHI,@,LAC,L 80-101,240,30,89,.337,28,75,.373,2,14,.143,18,22,.818,80
16952,2012-11-17,LAC,,CHI,W 101-80,240,37,75,.493,32,59,.542,5,16,.313,22,30,.733,101
16953,2012-11-17,MIL,,NOH,W 117-113,240,43,93,.462,30,68,.441,13,25,.520,18,24,.750,117
16954,2012-11-17,NOP,@,MIL,L 113-117,240,41,77,.532,31,56,.554,10,21,.476,21,22,.955,113
16955,2012-11-17,MIA,@,PHO,W 97-88,240,38,71,.535,30,52,.577,8,19,.421,13,19,.684,97
16956,2012-11-17,PHO,,MIA,L 88-97,240,34,79,.430,29,61,.475,5,18,.278,15,21,.714,88
16957,2012-11-17,DEN,@,SAS,L 100-126,240,39,78,.500,35,67,.522,4,11,.364,18,26,.692,100
16958,2012-11-17,SAS,,DEN,W 126-100,240,47,88,.534,31,61,.508,16,27,.593,16,20,.800,126
16959,2012-11-17,UTA,@,WAS,W 83-76,240,31,82,.378,29,73,.397,2,9,.222,19,27,.704,83
16960,2012-11-17,WAS,,UTA,L 76-83,240,31,85,.365,26,69,.377,5,16,.313,9,12,.750,76
16961,2012-11-16,DET,,ORL,L 106-110,240,44,82,.537,42,74,.568,2,8,.250,16,20,.800,106
16962,2012-11-16,ORL,@,DET,W 110-106,240,44,89,.494,37,72,.514,7,17,.412,15,17,.882,110
16963,2012-11-16,DAL,@,IND,L 83-103,240,30,81,.370,28,68,.412,2,13,.154,21,25,.840,83
16964,2012-11-16,IND,,DAL,W 103-83,240,39,83,.470,33,67,.493,6,16,.375,19,31,.613,103
16965,2012-11-16,LAL,,PHO,W 114-102,240,42,89,.472,34,68,.500,8,21,.381,22,28,.786,114
16966,2012-11-16,PHO,@,LAL,L 102-114,240,45,92,.489,40,78,.513,5,14,.357,7,15,.467,102
16967,2012-11-16,MEM,,NYK,W 105-95,240,37,76,.487,32,61,.525,5,15,.333,26,32,.813,105
16968,2012-11-16,NYK,@,MEM,L 95-105,240,37,72,.514,32,53,.604,5,19,.263,16,21,.762,95
16969,2012-11-16,GSW,@,MIN,W 106-98,240,43,85,.506,41,70,.586,2,15,.133,18,26,.692,106
16970,2012-11-16,MIN,,GSW,L 98-106,240,34,79,.430,27,61,.443,7,18,.389,23,29,.793,98
16971,2012-11-16,NOP,,OKC,L 95-110,240,33,78,.423,26,66,.394,7,12,.583,22,28,.786,95
16972,2012-11-16,OKC,@,NOH,W 110-95,240,40,74,.541,26,45,.578,14,29,.483,16,20,.800,110
16973,2012-11-16,PHI,,UTA,W 99-93,240,40,87,.460,30,69,.435,10,18,.556,9,10,.900,99
16974,2012-11-16,UTA,@,PHI,L 93-99,240,36,81,.444,29,59,.492,7,22,.318,14,18,.778,93
16975,2012-11-16,HOU,@,POR,L 117-119 (OT),265,41,88,.466,32,63,.508,9,25,.360,26,31,.839,117
16976,2012-11-16,POR,,HOU,W 119-117 (OT),265,44,86,.512,34,61,.557,10,25,.400,21,29,.724,119
16977,2012-11-16,ATL,@,SAC,W 112-96,240,42,76,.553,34,61,.557,8,15,.533,20,27,.741,112
16978,2012-11-16,SAC,,ATL,L 96-112,240,39,85,.459,31,65,.477,8,20,.400,10,14,.714,96
16979,2012-11-15,BOS,@,BRK,L 97-102,240,35,75,.467,28,62,.452,7,13,.538,20,25,.800,97
16980,2012-11-15,BRK,,BOS,W 102-97,240,36,85,.424,28,63,.444,8,22,.364,22,28,.786,102
16981,2012-11-15,DEN,,MIA,L 93-98,240,37,88,.420,31,68,.456,6,20,.300,13,19,.684,93
16982,2012-11-15,MIA,@,DEN,W 98-93,240,36,77,.468,23,50,.460,13,27,.481,13,16,.813,98
16983,2012-11-15,NYK,@,SAS,W 104-100,240,39,86,.453,28,60,.467,11,26,.423,15,23,.652,104
16984,2012-11-15,SAS,,NYK,L 100-104,240,38,87,.437,30,58,.517,8,29,.276,16,21,.762,100
16985,2012-11-14,BOS,,UTA,W 98-93,240,36,72,.500,32,62,.516,4,10,.400,22,29,.759,98
16986,2012-11-14,UTA,@,BOS,L 93-98,240,33,82,.402,26,67,.388,7,15,.467,20,28,.714,93
16987,2012-11-14,DAL,,WAS,W 107-101,240,39,78,.500,36,67,.537,3,11,.273,26,33,.788,107
16988,2012-11-14,WAS,@,DAL,L 101-107,240,39,81,.481,26,54,.481,13,27,.481,10,11,.909,101
16989,2012-11-14,ATL,@,GSW,L 88-92,240,34,78,.436,27,55,.491,7,23,.304,13,18,.722,88
16990,2012-11-14,GSW,,ATL,W 92-88,240,33,71,.465,28,53,.528,5,18,.278,21,25,.840,92
16991,2012-11-14,HOU,,NOH,W 100-96,240,36,80,.450,26,51,.510,10,29,.345,18,22,.818,100
16992,2012-11-14,NOP,@,HOU,L 96-100,240,34,84,.405,26,60,.433,8,24,.333,20,21,.952,96
16993,2012-11-14,LAC,,MIA,W 107-100,240,35,72,.486,25,51,.490,10,21,.476,27,32,.844,107
16994,2012-11-14,MIA,@,LAC,L 100-107,240,35,77,.455,26,56,.464,9,21,.429,21,29,.724,100
16995,2012-11-14,IND,@,MIL,L 85-99,240,30,80,.375,25,60,.417,5,20,.250,20,31,.645,85
16996,2012-11-14,MIL,,IND,W 99-85,240,38,91,.418,35,75,.467,3,16,.188,20,25,.800,99
16997,2012-11-14,CHA,@,MIN,W 89-87,240,38,84,.452,34,68,.500,4,16,.250,9,14,.643,89
16998,2012-11-14,MIN,,CHA,L 87-89,240,31,81,.383,26,62,.419,5,19,.263,20,37,.541,87
16999,2012-11-14,MEM,@,OKC,W 107-97,240,44,93,.473,37,76,.487,7,17,.412,12,14,.857,107
17000,2012-11-14,OKC,,MEM,L 97-107,240,35,72,.486,29,59,.492,6,13,.462,21,26,.808,97
17001,2012-11-14,DET,@,PHI,W 94-76,240,35,73,.479,32,66,.485,3,7,.429,21,31,.677,94
17002,2012-11-14,PHI,,DET,L 76-94,240,25,84,.298,20,68,.294,5,16,.313,21,32,.656,76
17003,2012-11-14,CHI,@,PHO,W 112-106 (OT),265,44,88,.500,38,76,.500,6,12,.500,18,25,.720,112
17004,2012-11-14,PHO,,CHI,L 106-112 (OT),265,42,105,.400,36,84,.429,6,21,.286,16,17,.941,106
17005,2012-11-13,BRK,,CLE,W 114-101,240,42,77,.545,37,55,.673,5,22,.227,25,31,.806,114
17006,2012-11-13,CLE,@,BRK,L 101-114,240,38,87,.437,35,73,.479,3,14,.214,22,26,.846,101
17007,2012-11-13,CHA,,WAS,W 92-76,240,31,78,.397,28,65,.431,3,13,.231,27,32,.844,92
17008,2012-11-13,WAS,@,CHA,L 76-92,240,25,84,.298,20,53,.377,5,31,.161,21,32,.656,76
17009,2012-11-13,IND,,TOR,L 72-74,240,24,75,.320,19,60,.317,5,15,.333,19,25,.760,72
17010,2012-11-13,TOR,@,IND,W 74-72,240,26,72,.361,20,60,.333,6,12,.500,16,19,.842,74
17011,2012-11-13,LAL,,SAS,L 82-84,240,31,74,.419,25,54,.463,6,20,.300,14,22,.636,82
17012,2012-11-13,SAS,@,LAL,W 84-82,240,35,90,.389,28,70,.400,7,20,.350,7,11,.636,84
17013,2012-11-13,NYK,@,ORL,W 99-89,240,41,84,.488,32,60,.533,9,24,.375,8,11,.727,99
17014,2012-11-13,ORL,,NYK,L 89-99,240,37,75,.493,32,61,.525,5,14,.357,10,17,.588,89
17015,2012-11-13,POR,@,SAC,W 103-86,240,35,72,.486,21,45,.467,14,27,.519,19,22,.864,103
17016,2012-11-13,SAC,,POR,L 86-103,240,36,77,.468,35,66,.530,1,11,.091,13,19,.684,86
17017,2012-11-12,BOS,@,CHI,W 101-95,240,41,81,.506,38,65,.585,3,16,.188,16,16,1.000,101
17018,2012-11-12,CHI,,BOS,L 95-101,240,34,74,.459,31,65,.477,3,9,.333,24,31,.774,95
17019,2012-11-12,DAL,,MIN,L 82-90,240,29,80,.363,25,64,.391,4,16,.250,20,25,.800,82
17020,2012-11-12,MIN,@,DAL,W 90-82,240,30,65,.462,26,50,.520,4,15,.267,26,32,.813,90
17021,2012-11-12,DET,,OKC,L 90-92,240,33,83,.398,27,66,.409,6,17,.353,18,27,.667,90
17022,2012-11-12,OKC,@,DET,W 92-90,240,27,73,.370,26,63,.413,1,10,.100,37,42,.881,92
17023,2012-11-12,HOU,,MIA,L 110-113,240,36,80,.450,24,46,.522,12,34,.353,26,33,.788,110
17024,2012-11-12,MIA,@,HOU,W 113-110,240,45,89,.506,35,68,.515,10,21,.476,13,20,.650,113
17025,2012-11-12,MIL,@,PHI,W 105-96,240,41,80,.513,34,60,.567,7,20,.350,16,18,.889,105
17026,2012-11-12,PHI,,MIL,L 96-105,240,37,85,.435,27,61,.443,10,24,.417,12,16,.750,96
17027,2012-11-12,DEN,@,PHO,L 100-110,240,41,76,.539,34,60,.567,7,16,.438,11,18,.611,100
17028,2012-11-12,PHO,,DEN,W 110-100,240,43,94,.457,36,82,.439,7,12,.583,17,21,.810,110
17029,2012-11-12,ATL,@,POR,W 95-87,240,35,79,.443,28,61,.459,7,18,.389,18,22,.818,95
17030,2012-11-12,POR,,ATL,L 87-95,240,30,83,.361,24,60,.400,6,23,.261,21,26,.808,87
17031,2012-11-12,TOR,,UTA,L 133-140 (3OT),315,51,108,.472,43,84,.512,8,24,.333,23,30,.767,133
17032,2012-11-12,UTA,@,TOR,W 140-133 (3OT),315,46,93,.495,32,67,.478,14,26,.538,34,43,.791,140
17033,2012-11-11,BRK,,ORL,W 82-74,240,29,78,.372,22,54,.407,7,24,.292,17,25,.680,82
17034,2012-11-11,ORL,@,BRK,L 74-82,240,30,84,.357,29,71,.408,1,13,.077,13,18,.722,74
17035,2012-11-11,ATL,@,LAC,L 76-89,240,30,72,.417,21,47,.447,9,25,.360,7,16,.438,76
17036,2012-11-11,LAC,,ATL,W 89-76,240,38,82,.463,33,67,.493,5,15,.333,8,8,1.000,89
17037,2012-11-11,LAL,,SAC,W 103-90,240,36,81,.444,28,56,.500,8,25,.320,23,30,.767,103
17038,2012-11-11,SAC,@,LAL,L 90-103,240,36,90,.400,29,67,.433,7,23,.304,11,14,.786,90
17039,2012-11-11,MEM,,MIA,W 104-86,240,38,86,.442,24,62,.387,14,24,.583,14,16,.875,104
17040,2012-11-11,MIA,@,MEM,L 86-104,240,30,79,.380,26,64,.406,4,15,.267,22,36,.611,86
17041,2012-11-11,CLE,@,OKC,L 91-106,240,34,83,.410,27,60,.450,7,23,.304,16,23,.696,91
17042,2012-11-11,OKC,,CLE,W 106-91,240,40,73,.548,33,58,.569,7,15,.467,19,22,.864,106
17043,2012-11-10,CHA,,DAL,W 101-97 (OT),265,40,95,.421,37,75,.493,3,20,.150,18,28,.643,101
17044,2012-11-10,DAL,@,CHA,L 97-101 (OT),265,32,79,.405,23,60,.383,9,19,.474,24,30,.800,97
17045,2012-11-10,CHI,,MIN,W 87-80,240,34,80,.425,28,67,.418,6,13,.462,13,16,.813,87
17046,2012-11-10,MIN,@,CHI,L 80-87,240,33,85,.388,30,72,.417,3,13,.231,11,15,.733,80
17047,2012-11-10,DEN,@,GSW,W 107-101 (2OT),290,43,113,.381,38,89,.427,5,24,.208,16,27,.593,107
17048,2012-11-10,GSW,,DEN,L 101-107 (2OT),290,39,102,.382,30,77,.390,9,25,.360,14,23,.609,101
17049,2012-11-10,DET,@,HOU,L 82-96,240,32,80,.400,25,60,.417,7,20,.350,11,16,.688,82
17050,2012-11-10,HOU,,DET,W 96-82,240,33,82,.402,24,56,.429,9,26,.346,21,26,.808,96
17051,2012-11-10,IND,,WAS,W 89-85,240,34,80,.425,27,64,.422,7,16,.438,14,24,.583,89
17052,2012-11-10,WAS,@,IND,L 85-89,240,35,79,.443,25,55,.455,10,24,.417,5,7,.714,85
17053,2012-11-10,BOS,@,MIL,W 96-92,240,32,72,.444,27,57,.474,5,15,.333,27,34,.794,96
17054,2012-11-10,MIL,,BOS,L 92-96,240,35,88,.398,32,69,.464,3,19,.158,19,26,.731,92
17055,2012-11-10,POR,,SAS,L 109-112,240,42,89,.472,32,67,.478,10,22,.455,15,19,.789,109
17056,2012-11-10,SAS,@,POR,W 112-109,240,40,70,.571,33,52,.635,7,18,.389,25,31,.806,112
17057,2012-11-10,PHI,@,TOR,W 93-83,240,34,73,.466,28,59,.475,6,14,.429,19,25,.760,93
17058,2012-11-10,TOR,,PHI,L 83-93,240,30,79,.380,18,53,.340,12,26,.462,11,16,.688,83
17059,2012-11-10,PHO,@,UTA,L 81-94,240,32,87,.368,28,71,.394,4,16,.250,13,17,.765,81
17060,2012-11-10,UTA,,PHO,W 94-81,240,38,78,.487,36,64,.563,2,14,.143,16,24,.667,94
17061,2012-11-09,ATL,,MIA,L 89-95,240,34,81,.420,25,56,.446,9,25,.360,12,16,.750,89
17062,2012-11-09,MIA,@,ATL,W 95-89,240,37,76,.487,30,54,.556,7,22,.318,14,16,.875,95
17063,2012-11-09,BOS,,PHI,L 100-106,240,37,76,.487,33,66,.500,4,10,.400,22,31,.710,100
17064,2012-11-09,PHI,@,BOS,W 106-100,240,40,82,.488,33,69,.478,7,13,.538,19,23,.826,106
17065,2012-11-09,DEN,,UTA,W 104-84,240,40,92,.435,34,75,.453,6,17,.353,18,25,.720,104
17066,2012-11-09,UTA,@,DEN,L 84-104,240,32,87,.368,28,64,.438,4,23,.174,16,22,.727,84
17067,2012-11-09,GSW,@,LAL,L 77-101,240,29,86,.337,22,61,.361,7,25,.280,12,20,.600,77
17068,2012-11-09,LAL,,GSW,W 101-77,240,36,90,.400,28,62,.452,8,28,.286,21,28,.750,101
17069,2012-11-09,HOU,@,MEM,L 85-93,240,31,76,.408,22,49,.449,9,27,.333,14,15,.933,85
17070,2012-11-09,MEM,,HOU,W 93-85,240,35,94,.372,29,75,.387,6,19,.316,17,23,.739,93
17071,2012-11-09,IND,@,MIN,L 94-96,240,37,84,.440,32,66,.485,5,18,.278,15,17,.882,94
17072,2012-11-09,MIN,,IND,W 96-94,240,35,70,.500,33,61,.541,2,9,.222,24,28,.857,96
17073,2012-11-09,CHA,@,NOH,L 99-107,240,40,83,.482,33,62,.532,7,21,.333,12,18,.667,99
17074,2012-11-09,NOP,,CHA,W 107-99,240,43,83,.518,35,61,.574,8,22,.364,13,21,.619,107
17075,2012-11-09,DAL,@,NYK,L 94-104,240,33,81,.407,25,53,.472,8,28,.286,20,23,.870,94
17076,2012-11-09,NYK,,DAL,W 104-94,240,35,84,.417,27,62,.435,8,22,.364,26,38,.684,104
17077,2012-11-09,DET,@,OKC,L 94-105,240,36,87,.414,30,68,.441,6,19,.316,16,22,.727,94
17078,2012-11-09,OKC,,DET,W 105-94,240,38,71,.535,30,51,.588,8,20,.400,21,26,.808,105
17079,2012-11-09,BRK,@,ORL,W 107-68,240,41,82,.500,32,59,.542,9,23,.391,16,25,.640,107
17080,2012-11-09,ORL,,BRK,L 68-107,240,30,70,.429,26,59,.441,4,11,.364,4,8,.500,68
17081,2012-11-09,CLE,@,PHO,L 105-107,240,37,77,.481,28,56,.500,9,21,.429,22,27,.815,105
17082,2012-11-09,PHO,,CLE,W 107-105,240,38,81,.469,32,64,.500,6,17,.353,25,33,.758,107
17083,2012-11-09,SAC,,SAS,L 86-97,240,32,91,.352,29,75,.387,3,16,.188,19,26,.731,86
17084,2012-11-09,SAS,@,SAC,W 97-86,240,35,72,.486,30,54,.556,5,18,.278,22,26,.846,97
17085,2012-11-09,MIL,@,WAS,W 101-91,240,40,78,.513,34,63,.540,6,15,.400,15,19,.789,101
17086,2012-11-09,WAS,,MIL,L 91-101,240,34,78,.436,30,60,.500,4,18,.222,19,22,.864,91
17087,2012-11-08,CHI,,OKC,L 91-97,240,35,84,.417,30,69,.435,5,15,.333,16,18,.889,91
17088,2012-11-08,OKC,@,CHI,W 97-91,240,36,73,.493,31,60,.517,5,13,.385,20,21,.952,97
17089,2012-11-08,LAC,@,POR,W 103-90,240,41,77,.532,38,64,.594,3,13,.231,18,25,.720,103
17090,2012-11-08,POR,,LAC,L 90-103,240,32,75,.427,25,55,.455,7,20,.350,19,30,.633,90
17091,2012-11-07,ATL,,IND,W 89-86,240,38,87,.437,31,65,.477,7,22,.318,6,12,.500,89
17092,2012-11-07,IND,@,ATL,L 86-89,240,35,85,.412,27,59,.458,8,26,.308,8,9,.889,86
17093,2012-11-07,BOS,,WAS,W 100-94 (OT),265,34,81,.420,30,68,.441,4,13,.308,28,34,.824,100
17094,2012-11-07,WAS,@,BOS,L 94-100 (OT),265,39,95,.411,29,66,.439,10,29,.345,6,7,.857,94
17095,2012-11-07,CHA,,PHO,L 110-117,240,38,87,.437,28,65,.431,10,22,.455,24,27,.889,110
17096,2012-11-07,PHO,@,CHA,W 117-110,240,43,93,.462,31,66,.470,12,27,.444,19,28,.679,117
17097,2012-11-07,DAL,,TOR,W 109-104,240,39,84,.464,31,63,.492,8,21,.381,23,35,.657,109
17098,2012-11-07,TOR,@,DAL,L 104-109,240,36,81,.444,31,59,.525,5,22,.227,27,31,.871,104
17099,2012-11-07,CLE,@,GSW,L 96-106,240,36,86,.419,25,54,.463,11,32,.344,13,21,.619,96
17100,2012-11-07,GSW,,CLE,W 106-96,240,42,78,.538,37,60,.617,5,18,.278,17,23,.739,106
17101,2012-11-07,DEN,@,HOU,W 93-87,240,37,82,.451,30,64,.469,7,18,.389,12,21,.571,93
17102,2012-11-07,HOU,,DEN,L 87-93,240,31,84,.369,23,51,.451,8,33,.242,17,23,.739,87
17103,2012-11-07,LAC,,SAS,W 106-84,240,46,83,.554,40,66,.606,6,17,.353,8,9,.889,106
17104,2012-11-07,SAS,@,LAC,L 84-106,240,30,73,.411,22,50,.440,8,23,.348,16,24,.667,84
17105,2012-11-07,BRK,@,MIA,L 73-103,240,30,80,.375,27,59,.458,3,21,.143,10,17,.588,73
17106,2012-11-07,MIA,,BRK,W 103-73,240,40,77,.519,30,53,.566,10,24,.417,13,16,.813,103
17107,2012-11-07,MEM,@,MIL,W 108-90,240,44,83,.530,38,67,.567,6,16,.375,14,19,.737,108
17108,2012-11-07,MIL,,MEM,L 90-108,240,35,91,.385,29,76,.382,6,15,.400,14,21,.667,90
17109,2012-11-07,MIN,,ORL,W 90-75,240,34,76,.447,27,56,.482,7,20,.350,15,22,.682,90
17110,2012-11-07,ORL,@,MIN,L 75-90,240,28,80,.350,25,68,.368,3,12,.250,16,20,.800,75
17111,2012-11-07,NOP,,PHI,L 62-77,240,23,69,.333,19,50,.380,4,19,.211,12,16,.750,62
17112,2012-11-07,PHI,@,NOH,W 77-62,240,35,84,.417,31,62,.500,4,22,.182,3,5,.600,77
17113,2012-11-07,DET,@,SAC,L 103-105,240,36,73,.493,28,51,.549,8,22,.364,23,31,.742,103
17114,2012-11-07,SAC,,DET,W 105-103,240,40,82,.488,33,66,.500,7,16,.438,18,24,.750,105
17115,2012-11-07,LAL,@,UTA,L 86-95,240,25,74,.338,21,51,.412,4,23,.174,32,46,.696,86
17116,2012-11-07,UTA,,LAL,W 95-86,240,37,83,.446,32,66,.485,5,17,.294,16,18,.889,95
17117,2012-11-06,CHI,,ORL,W 99-93,240,40,84,.476,38,78,.487,2,6,.333,17,24,.708,99
17118,2012-11-06,ORL,@,CHI,L 93-99,240,36,86,.419,28,67,.418,8,19,.421,13,17,.765,93
17119,2012-11-06,DEN,,DET,W 109-97,240,41,92,.446,31,62,.500,10,30,.333,17,22,.773,109
17120,2012-11-06,DET,@,DEN,L 97-109,240,35,78,.449,29,66,.439,6,12,.500,21,25,.840,97
17121,2012-11-06,OKC,,TOR,W 108-88,240,35,74,.473,26,49,.531,9,25,.360,29,34,.853,108
17122,2012-11-06,TOR,@,OKC,L 88-108,240,30,84,.357,23,54,.426,7,30,.233,21,25,.840,88
17123,2012-11-05,BRK,,MIN,L 96-107,240,35,73,.479,22,50,.440,13,23,.565,13,18,.722,96
17124,2012-11-05,MIN,@,BRK,W 107-96,240,44,88,.500,37,68,.544,7,20,.350,12,15,.800,107
17125,2012-11-05,DAL,,POR,W 114-91,240,48,78,.615,38,58,.655,10,20,.500,8,13,.615,114
17126,2012-11-05,POR,@,DAL,L 91-114,240,36,93,.387,31,71,.437,5,22,.227,14,18,.778,91
17127,2012-11-05,CLE,@,LAC,W 108-101,240,40,92,.435,26,63,.413,14,29,.483,14,22,.636,108
17128,2012-11-05,LAC,,CLE,L 101-108,240,39,74,.527,30,49,.612,9,25,.360,14,16,.875,101
17129,2012-11-05,MEM,,UTA,W 103-94,240,38,91,.418,33,77,.429,5,14,.357,22,25,.880,103
17130,2012-11-05,UTA,@,MEM,L 94-103,240,40,90,.444,35,75,.467,5,15,.333,9,13,.692,94
17131,2012-11-05,MIA,,PHO,W 124-99,240,47,86,.547,32,60,.533,15,26,.577,15,19,.789,124
17132,2012-11-05,PHO,@,MIA,L 99-124,240,35,88,.398,28,67,.418,7,21,.333,22,29,.759,99
17133,2012-11-05,NYK,@,PHI,W 110-88,240,39,84,.464,26,52,.500,13,32,.406,19,19,1.000,110
17134,2012-11-05,PHI,,NYK,L 88-110,240,29,86,.337,21,64,.328,8,22,.364,22,26,.846,88
17135,2012-11-05,GSW,@,SAC,L 92-94,240,31,78,.397,25,57,.439,6,21,.286,24,28,.857,92
17136,2012-11-05,SAC,,GSW,W 94-92,240,37,81,.457,33,62,.532,4,19,.211,16,23,.696,94
17137,2012-11-05,IND,@,SAS,L 79-101,240,27,79,.342,21,59,.356,6,20,.300,19,22,.864,79
17138,2012-11-05,SAS,,IND,W 101-79,240,41,87,.471,33,69,.478,8,18,.444,11,13,.846,101
17139,2012-11-04,DET,@,LAL,L 79-108,240,28,79,.354,24,66,.364,4,13,.308,19,23,.826,79
17140,2012-11-04,LAL,,DET,W 108-79,240,40,77,.519,30,55,.545,10,22,.455,18,26,.692,108
17141,2012-11-04,NYK,,PHI,W 100-84,240,39,77,.506,28,50,.560,11,27,.407,11,18,.611,100
17142,2012-11-04,PHI,@,NYK,L 84-100,240,34,79,.430,26,62,.419,8,17,.471,8,10,.800,84
17143,2012-11-04,ATL,@,OKC,W 104-95,240,41,83,.494,33,58,.569,8,25,.320,14,20,.700,104
17144,2012-11-04,OKC,,ATL,L 95-104,240,33,71,.465,24,49,.490,9,22,.409,20,22,.909,95
17145,2012-11-04,ORL,,PHO,W 115-94,240,45,92,.489,36,81,.444,9,11,.818,16,19,.842,115
17146,2012-11-04,PHO,@,ORL,L 94-115,240,39,91,.429,34,72,.472,5,19,.263,11,18,.611,94
17147,2012-11-04,MIN,@,TOR,L 86-105,240,29,64,.453,23,48,.479,6,16,.375,22,31,.710,86
17148,2012-11-04,TOR,,MIN,W 105-86,240,40,90,.444,30,69,.435,10,21,.476,15,17,.882,105
17149,2012-11-03,BRK,,TOR,W 107-100,240,37,81,.457,31,66,.470,6,15,.400,27,37,.730,107
17150,2012-11-03,TOR,@,BRK,L 100-107,240,37,82,.451,30,64,.469,7,18,.389,19,25,.760,100
17151,2012-11-03,CHI,,NOH,L 82-89,240,29,88,.330,26,71,.366,3,17,.176,21,25,.840,82
17152,2012-11-03,NOP,@,CHI,W 89-82,240,32,75,.427,27,57,.474,5,18,.278,20,23,.870,89
17153,2012-11-03,CHA,@,DAL,L 99-126,240,39,91,.429,36,74,.486,3,17,.176,18,24,.750,99
17154,2012-11-03,DAL,,CHA,W 126-99,240,49,80,.613,33,55,.600,16,25,.640,12,15,.800,126
17155,2012-11-03,HOU,,POR,L 85-95 (OT),265,34,96,.354,29,70,.414,5,26,.192,12,18,.667,85
17156,2012-11-03,POR,@,HOU,W 95-85 (OT),265,39,93,.419,29,69,.420,10,24,.417,7,12,.583,95
17157,2012-11-03,IND,,SAC,W 106-98 (2OT),290,39,99,.394,35,77,.455,4,22,.182,24,27,.889,106
17158,2012-11-03,SAC,@,IND,L 98-106 (2OT),290,37,102,.363,29,80,.363,8,22,.364,16,20,.800,98
17159,2012-11-03,GSW,@,LAC,W 114-110,240,41,84,.488,37,68,.544,4,16,.250,28,39,.718,114
17160,2012-11-03,LAC,,GSW,L 110-114,240,30,70,.429,20,49,.408,10,21,.476,40,52,.769,110
17161,2012-11-03,DEN,@,MIA,L 116-119,240,49,95,.516,44,74,.595,5,21,.238,13,20,.650,116
17162,2012-11-03,MIA,,DEN,W 119-116,240,43,83,.518,33,58,.569,10,25,.400,23,27,.852,119
17163,2012-11-03,CLE,@,MIL,L 102-105,240,39,83,.470,33,67,.493,6,16,.375,18,29,.621,102
17164,2012-11-03,MIL,,CLE,W 105-102,240,41,79,.519,32,55,.582,9,24,.375,14,21,.667,105
17165,2012-11-03,SAS,,UTA,W 110-100,240,42,74,.568,35,61,.574,7,13,.538,19,23,.826,110
17166,2012-11-03,UTA,@,SAS,L 100-110,240,38,77,.494,33,64,.516,5,13,.385,19,22,.864,100
17167,2012-11-03,BOS,@,WAS,W 89-86,240,36,84,.429,28,63,.444,8,21,.381,9,13,.692,89
17168,2012-11-03,WAS,,BOS,L 86-89,240,34,78,.436,28,58,.483,6,20,.300,12,17,.706,86
17169,2012-11-02,ATL,,HOU,L 102-109,240,40,85,.471,33,63,.524,7,22,.318,15,17,.882,102
17170,2012-11-02,HOU,@,ATL,W 109-102,240,38,90,.422,30,60,.500,8,30,.267,25,29,.862,109
17171,2012-11-02,BOS,,MIL,L 88-99,240,33,74,.446,28,60,.467,5,14,.357,17,21,.810,88
17172,2012-11-02,MIL,@,BOS,W 99-88,240,40,86,.465,32,68,.471,8,18,.444,11,12,.917,99
17173,2012-11-02,CHA,,IND,W 90-89,240,31,85,.365,24,66,.364,7,19,.368,21,24,.875,90
17174,2012-11-02,IND,@,CHA,L 89-90,240,33,83,.398,26,57,.456,7,26,.269,16,27,.593,89
17175,2012-11-02,CHI,@,CLE,W 115-86,240,44,69,.638,40,59,.678,4,10,.400,23,30,.767,115
17176,2012-11-02,CLE,,CHI,L 86-115,240,32,79,.405,24,59,.407,8,20,.400,14,27,.519,86
17177,2012-11-02,GSW,,MEM,L 94-104,240,36,80,.450,26,60,.433,10,20,.500,12,17,.706,94
17178,2012-11-02,MEM,@,GSW,W 104-94,240,35,77,.455,29,64,.453,6,13,.462,28,34,.824,104
17179,2012-11-02,LAC,@,LAL,W 105-95,240,38,84,.452,30,62,.484,8,22,.364,21,27,.778,105
17180,2012-11-02,LAL,,LAC,L 95-105,240,34,68,.500,27,52,.519,7,16,.438,20,28,.714,95
17181,2012-11-02,MIN,,SAC,W 92-80,240,32,87,.368,30,70,.429,2,17,.118,26,36,.722,92
17182,2012-11-02,SAC,@,MIN,L 80-92,240,32,89,.360,29,73,.397,3,16,.188,13,16,.813,80
17183,2012-11-02,NOP,,UTA,W 88-86,240,37,81,.457,32,67,.478,5,14,.357,9,14,.643,88
17184,2012-11-02,UTA,@,NOH,L 86-88,240,35,85,.412,25,57,.439,10,28,.357,6,12,.500,86
17185,2012-11-02,MIA,@,NYK,L 84-104,240,33,71,.465,26,51,.510,7,20,.350,11,13,.846,84
17186,2012-11-02,NYK,,MIA,W 104-84,240,36,84,.429,17,48,.354,19,36,.528,13,15,.867,104
17187,2012-11-02,OKC,,POR,W 106-92,240,39,76,.513,34,67,.507,5,9,.556,23,32,.719,106
17188,2012-11-02,POR,@,OKC,L 92-106,240,32,89,.360,23,63,.365,9,26,.346,19,24,.792,92
17189,2012-11-02,DEN,@,ORL,L 89-102,240,32,84,.381,25,58,.431,7,26,.269,18,27,.667,89
17190,2012-11-02,ORL,,DEN,W 102-89,240,42,86,.488,37,71,.521,5,15,.333,13,18,.722,102
17191,2012-11-02,DET,@,PHO,L 89-92,240,37,90,.411,33,77,.429,4,13,.308,11,19,.579,89
17192,2012-11-02,PHO,,DET,W 92-89,240,40,92,.435,38,81,.469,2,11,.182,10,14,.714,92
17193,2012-11-01,OKC,@,SAS,L 84-86,240,29,77,.377,22,60,.367,7,17,.412,19,23,.826,84
17194,2012-11-01,SAS,,OKC,W 86-84,240,35,79,.443,30,60,.500,5,19,.263,11,16,.688,86
17195,2012-10-31,CHI,,SAC,W 93-87,240,33,79,.418,31,70,.443,2,9,.222,25,33,.758,93
17196,2012-10-31,SAC,@,CHI,L 87-93,240,34,84,.405,28,67,.418,6,17,.353,13,16,.813,87
17197,2012-10-31,DET,,HOU,L 96-105,240,35,79,.443,29,63,.460,6,16,.375,20,26,.769,96
17198,2012-10-31,HOU,@,DET,W 105-96,240,39,79,.494,29,52,.558,10,27,.370,17,23,.739,105
17199,2012-10-31,LAC,,MEM,W 101-92,240,38,74,.514,33,59,.559,5,15,.333,20,29,.690,101
17200,2012-10-31,MEM,@,LAC,L 92-101,240,33,86,.384,31,72,.431,2,14,.143,24,30,.800,92
17201,2012-10-31,NOP,,SAS,L 95-99,240,35,80,.438,31,63,.492,4,17,.235,21,23,.913,95
17202,2012-10-31,SAS,@,NOH,W 99-95,240,38,80,.475,32,60,.533,6,20,.300,17,26,.654,99
17203,2012-10-31,DEN,@,PHI,L 75-84,240,33,88,.375,29,70,.414,4,18,.222,5,11,.455,75
17204,2012-10-31,PHI,,DEN,W 84-75,240,30,85,.353,23,60,.383,7,25,.280,17,21,.810,84
17205,2012-10-31,GSW,@,PHO,W 87-85,240,33,86,.384,28,69,.406,5,17,.294,16,23,.696,87
17206,2012-10-31,PHO,,GSW,L 85-87,240,32,80,.400,28,59,.475,4,21,.190,17,22,.773,85
17207,2012-10-31,LAL,@,POR,L 106-116,240,36,72,.500,28,54,.519,8,18,.444,26,32,.813,106
17208,2012-10-31,POR,,LAL,W 116-106,240,42,83,.506,33,63,.524,9,20,.450,23,28,.821,116
17209,2012-10-31,IND,@,TOR,W 90-88,240,37,78,.474,32,67,.478,5,11,.455,11,16,.688,90
17210,2012-10-31,TOR,,IND,L 88-90,240,33,91,.363,27,74,.365,6,17,.353,16,19,.842,88
17211,2012-10-31,DAL,@,UTA,L 94-113,240,32,85,.376,21,63,.333,11,22,.500,19,26,.731,94
17212,2012-10-31,UTA,,DAL,W 113-94,240,38,89,.427,32,75,.427,6,14,.429,31,42,.738,113
17213,2012-10-30,CLE,,WAS,W 94-84,240,36,79,.456,29,59,.492,7,20,.350,15,22,.682,94
17214,2012-10-30,WAS,@,CLE,L 84-94,240,32,90,.356,24,58,.414,8,32,.250,12,20,.600,84
17215,2012-10-30,DAL,@,LAL,W 99-91,240,40,85,.471,35,70,.500,5,15,.333,14,18,.778,99
17216,2012-10-30,LAL,,DAL,L 91-99,240,38,77,.494,35,64,.547,3,13,.231,12,31,.387,91
17217,2012-10-30,BOS,@,MIA,L 107-120,240,39,75,.520,33,62,.532,6,13,.462,23,28,.821,107
17218,2012-10-30,MIA,,BOS,W 120-107,240,43,79,.544,35,63,.556,8,16,.500,26,32,.813,120
17219,2012-04-26,ATL,,DAL,W 106-89,240,45,85,.529,36,58,.621,9,27,.333,7,9,.778,106
17220,2012-04-26,DAL,@,ATL,L 89-106,240,33,78,.423,28,63,.444,5,15,.333,18,23,.783,89
17221,2012-04-26,BOS,,MIL,W 87-74,240,35,87,.402,27,63,.429,8,24,.333,9,11,.818,87
17222,2012-04-26,MIL,@,BOS,L 74-87,240,29,78,.372,27,69,.391,2,9,.222,14,23,.609,74
17223,2012-04-26,CHA,,NYK,L 84-104,240,32,74,.432,26,58,.448,6,16,.375,14,26,.538,84
17224,2012-04-26,NYK,@,CHA,W 104-84,240,44,85,.518,36,65,.554,8,20,.400,8,15,.533,104
17225,2012-04-26,CHI,,CLE,W 107-75,240,45,85,.529,40,69,.580,5,16,.313,12,17,.706,107
17226,2012-04-26,CLE,@,CHI,L 75-107,240,28,87,.322,26,74,.351,2,13,.154,17,26,.654,75
17227,2012-04-26,DET,,PHI,W 108-86,240,41,81,.506,27,49,.551,14,32,.438,12,16,.750,108
17228,2012-04-26,PHI,@,DET,L 86-108,240,34,87,.391,29,72,.403,5,15,.333,13,16,.813,86
17229,2012-04-26,GSW,,SAS,L 101-107,240,45,87,.517,43,79,.544,2,8,.250,9,12,.750,101
17230,2012-04-26,SAS,@,GSW,W 107-101,240,42,96,.438,33,65,.508,9,31,.290,14,17,.824,107
17231,2012-04-26,HOU,,NOH,W 84-77,240,32,91,.352,23,63,.365,9,28,.321,11,14,.786,84
17232,2012-04-26,NOP,@,HOU,L 77-84,240,27,68,.397,22,53,.415,5,15,.333,18,30,.600,77
17233,2012-04-26,MEM,,ORL,W 88-76,240,34,72,.472,32,60,.533,2,12,.167,18,22,.818,88
17234,2012-04-26,ORL,@,MEM,L 76-88,240,30,73,.411,23,47,.489,7,26,.269,9,15,.600,76
17235,2012-04-26,DEN,@,MIN,W 131-102,240,56,89,.629,51,79,.646,5,10,.500,14,20,.700,131
17236,2012-04-26,MIN,,DEN,L 102-131,240,40,89,.449,30,62,.484,10,27,.370,12,19,.632,102
17237,2012-04-26,LAL,@,SAC,L 96-113,240,41,91,.451,34,76,.447,7,15,.467,7,9,.778,96
17238,2012-04-26,SAC,,LAL,W 113-96,240,47,92,.511,41,77,.532,6,15,.400,13,18,.722,113
17239,2012-04-26,BRK,@,TOR,L 67-98,240,25,83,.301,19,65,.292,6,18,.333,11,16,.688,67
17240,2012-04-26,TOR,,NJN,W 98-67,240,37,88,.420,27,69,.391,10,19,.526,14,18,.778,98
17241,2012-04-26,POR,@,UTA,L 94-96,240,36,80,.450,30,55,.545,6,25,.240,16,19,.842,94
17242,2012-04-26,UTA,,POR,W 96-94,240,35,83,.422,29,64,.453,6,19,.316,20,27,.741,96
17243,2012-04-26,MIA,@,WAS,L 70-104,240,24,67,.358,20,49,.408,4,18,.222,18,24,.750,70
17244,2012-04-26,WAS,,MIA,W 104-70,240,42,76,.553,37,66,.561,5,10,.500,15,24,.625,104
17245,2012-04-25,CLE,,WAS,L 85-96,240,34,77,.442,30,60,.500,4,17,.235,13,18,.722,85
17246,2012-04-25,WAS,@,CLE,W 96-85,240,40,91,.440,36,75,.480,4,16,.250,12,16,.750,96
17247,2012-04-25,CHI,@,IND,W 92-87,240,38,81,.469,32,64,.500,6,17,.353,10,10,1.000,92
17248,2012-04-25,IND,,CHI,L 87-92,240,35,80,.438,29,66,.439,6,14,.429,11,16,.688,87
17249,2012-04-25,MIL,,PHI,L 85-90,240,36,81,.444,30,65,.462,6,16,.375,7,9,.778,85
17250,2012-04-25,PHI,@,MIL,W 90-85,240,36,101,.356,31,85,.365,5,16,.313,13,18,.722,90
17251,2012-04-25,LAC,@,NYK,L 93-99,240,34,70,.486,23,45,.511,11,25,.440,14,25,.560,93
17252,2012-04-25,NYK,,LAC,W 99-93,240,36,77,.468,27,53,.509,9,24,.375,18,24,.750,99
17253,2012-04-25,DEN,@,OKC,W 106-101,240,40,90,.444,32,67,.478,8,23,.348,18,30,.600,106
17254,2012-04-25,OKC,,DEN,L 101-106,240,39,79,.494,29,55,.527,10,24,.417,13,15,.867,101
17255,2012-04-25,CHA,@,ORL,L 95-102,240,31,70,.443,26,53,.491,5,17,.294,28,32,.875,95
17256,2012-04-25,ORL,,CHA,W 102-95,240,33,82,.402,19,44,.432,14,38,.368,22,28,.786,102
17257,2012-04-25,PHO,,SAS,L 106-110,240,45,94,.479,40,81,.494,5,13,.385,11,13,.846,106
17258,2012-04-25,SAS,@,PHO,W 110-106,240,41,88,.466,33,66,.500,8,22,.364,20,23,.870,110
17259,2012-04-24,ATL,,LAC,W 109-102,240,43,86,.500,32,62,.516,11,24,.458,12,14,.857,109
17260,2012-04-24,LAC,@,ATL,L 102-109,240,40,80,.500,32,61,.525,8,19,.421,14,20,.700,102
17261,2012-04-24,BOS,,MIA,W 78-66,240,32,74,.432,28,62,.452,4,12,.333,10,16,.625,78
17262,2012-04-24,MIA,@,BOS,L 66-78,240,28,73,.384,22,56,.393,6,17,.353,4,7,.571,66
17263,2012-04-24,GSW,,NOH,L 81-83,240,33,79,.418,27,65,.415,6,14,.429,9,13,.692,81
17264,2012-04-24,NOP,@,GSW,W 83-81,240,31,71,.437,29,66,.439,2,5,.400,19,31,.613,83
17265,2012-04-24,OKC,,SAC,W 118-110,240,38,81,.469,29,61,.475,9,20,.450,33,36,.917,118
17266,2012-04-24,SAC,@,OKC,L 110-118,240,43,82,.524,39,66,.591,4,16,.250,20,27,.741,110
17267,2012-04-24,PHO,@,UTA,L 88-100,240,34,84,.405,29,61,.475,5,23,.217,15,23,.652,88
17268,2012-04-24,UTA,,PHO,W 100-88,240,37,87,.425,33,74,.446,4,13,.308,22,29,.759,100
17269,2012-04-23,DET,@,IND,L 97-103,240,38,83,.458,30,67,.448,8,16,.500,13,22,.591,97
17270,2012-04-23,IND,,DET,W 103-97,240,35,92,.380,31,77,.403,4,15,.267,29,38,.763,103
17271,2012-04-23,CLE,@,MEM,L 101-109,240,37,80,.463,26,56,.464,11,24,.458,16,22,.727,101
17272,2012-04-23,MEM,,CLE,W 109-101,240,38,81,.469,33,68,.485,5,13,.385,28,36,.778,109
17273,2012-04-23,MIL,,TOR,W 92-86,240,29,78,.372,23,61,.377,6,17,.353,28,36,.778,92
17274,2012-04-23,TOR,@,MIL,L 86-92,240,34,76,.447,30,62,.484,4,14,.286,14,18,.778,86
17275,2012-04-23,BRK,,PHI,L 87-105,240,31,72,.431,27,58,.466,4,14,.286,21,23,.913,87
17276,2012-04-23,PHI,@,NJN,W 105-87,240,43,80,.538,38,66,.576,5,14,.357,14,17,.824,105
17277,2012-04-23,POR,@,SAS,L 89-124,240,37,96,.385,31,80,.388,6,16,.375,9,11,.818,89
17278,2012-04-23,SAS,,POR,W 124-89,240,48,81,.593,36,59,.610,12,22,.545,16,21,.762,124
17279,2012-04-23,CHA,@,WAS,L 73-101,240,25,73,.342,21,58,.362,4,15,.267,19,23,.826,73
17280,2012-04-23,WAS,,CHA,W 101-73,240,46,83,.554,44,65,.677,2,18,.111,7,12,.583,101
17281,2012-04-22,ATL,,NYK,L 112-113,240,41,76,.539,26,53,.491,15,23,.652,15,23,.652,112
17282,2012-04-22,NYK,@,ATL,W 113-112,240,43,79,.544,31,60,.517,12,19,.632,15,20,.750,113
17283,2012-04-22,CHA,,SAC,L 88-114,240,39,89,.438,37,74,.500,2,15,.133,8,14,.571,88
17284,2012-04-22,SAC,@,CHA,W 114-88,240,48,87,.552,45,78,.577,3,9,.333,15,20,.750,114
17285,2012-04-22,DEN,,ORL,W 101-74,240,44,78,.564,39,63,.619,5,15,.333,8,11,.727,101
17286,2012-04-22,ORL,@,DEN,L 74-101,240,28,75,.373,22,52,.423,6,23,.261,12,17,.706,74
17287,2012-04-22,DET,,TOR,W 76-73,240,26,71,.366,24,56,.429,2,15,.133,22,35,.629,76
17288,2012-04-22,TOR,@,DET,L 73-76,240,29,77,.377,25,64,.391,4,13,.308,11,16,.688,73
17289,2012-04-22,LAC,,NOH,W 107-98,240,33,77,.429,26,49,.531,7,28,.250,34,43,.791,107
17290,2012-04-22,NOP,@,LAC,L 98-107,240,35,71,.493,32,59,.542,3,12,.250,25,34,.735,98
17291,2012-04-22,LAL,,OKC,W 114-106 (2OT),290,41,106,.387,36,90,.400,5,16,.313,27,40,.675,114
17292,2012-04-22,OKC,@,LAL,L 106-114 (2OT),290,37,101,.366,29,77,.377,8,24,.333,24,28,.857,106
17293,2012-04-22,HOU,@,MIA,L 88-97,240,35,76,.461,28,56,.500,7,20,.350,11,13,.846,88
17294,2012-04-22,MIA,,HOU,W 97-88,240,35,85,.412,30,69,.435,5,16,.313,22,24,.917,97
17295,2012-04-22,GSW,@,MIN,W 93-88,240,41,92,.446,36,76,.474,5,16,.313,6,10,.600,93
17296,2012-04-22,MIN,,GSW,L 88-93,240,30,82,.366,23,56,.411,7,26,.269,21,21,1.000,88
17297,2012-04-22,CLE,@,SAS,L 98-114,240,37,88,.420,32,66,.485,5,22,.227,19,28,.679,98
17298,2012-04-22,SAS,,CLE,W 114-98,240,42,77,.545,34,57,.596,8,20,.400,22,29,.759,114
17299,2012-04-21,CHI,,DAL,W 93-83,240,38,84,.452,29,64,.453,9,20,.450,8,12,.667,93
17300,2012-04-21,DAL,@,CHI,L 83-93,240,31,79,.392,27,64,.422,4,15,.267,17,19,.895,83
17301,2012-04-21,GSW,@,HOU,L 96-99,240,36,73,.493,31,57,.544,5,16,.313,19,22,.864,96
17302,2012-04-21,HOU,,GSW,W 99-96,240,40,84,.476,30,58,.517,10,26,.385,9,15,.600,99
17303,2012-04-21,IND,,PHI,L 106-109 (OT),265,42,97,.433,39,85,.459,3,12,.250,19,25,.760,106
17304,2012-04-21,PHI,@,IND,W 109-106 (OT),265,40,89,.449,34,71,.479,6,18,.333,23,33,.697,109
17305,2012-04-21,MEM,,POR,W 93-89,240,40,90,.444,36,73,.493,4,17,.235,9,10,.900,93
17306,2012-04-21,POR,@,MEM,L 89-93,240,29,78,.372,23,54,.426,6,24,.250,25,31,.806,89
17307,2012-04-21,MIA,,WAS,L 84-86,240,31,77,.403,22,52,.423,9,25,.360,13,16,.813,84
17308,2012-04-21,WAS,@,MIA,W 86-84,240,36,87,.414,29,69,.420,7,18,.389,7,9,.778,86
17309,2012-04-21,MIL,,NJN,W 106-95,240,38,84,.452,34,71,.479,4,13,.308,26,37,.703,106
17310,2012-04-21,BRK,@,MIL,L 95-106,240,40,86,.465,36,74,.486,4,12,.333,11,15,.733,95
17311,2012-04-21,DEN,@,PHO,W 118-107,240,48,87,.552,42,74,.568,6,13,.462,16,17,.941,118
17312,2012-04-21,PHO,,DEN,L 107-118,240,44,95,.463,33,69,.478,11,26,.423,8,11,.727,107
17313,2012-04-21,ORL,@,UTA,L 107-117 (OT),265,42,96,.438,27,58,.466,15,38,.395,8,13,.615,107
17314,2012-04-21,UTA,,ORL,W 117-107 (OT),265,47,88,.534,43,80,.538,4,8,.500,19,23,.826,117
17315,2012-04-20,ATL,,BOS,W 97-92,240,37,72,.514,28,55,.509,9,17,.529,14,17,.824,97
17316,2012-04-20,BOS,@,ATL,L 92-97,240,39,81,.481,34,69,.493,5,12,.417,9,14,.643,92
17317,2012-04-20,CHA,,MEM,L 80-85,240,32,79,.405,29,70,.414,3,9,.333,13,18,.722,80
17318,2012-04-20,MEM,@,CHA,W 85-80,240,34,75,.453,32,67,.478,2,8,.250,15,21,.714,85
17319,2012-04-20,CLE,,NYK,W 98-90,240,36,79,.456,30,60,.500,6,19,.316,20,27,.741,98
17320,2012-04-20,NYK,@,CLE,L 90-98,240,35,83,.422,23,50,.460,12,33,.364,8,15,.533,90
17321,2012-04-20,DAL,,GSW,W 104-94,240,38,81,.469,35,62,.565,3,19,.158,25,26,.962,104
17322,2012-04-20,GSW,@,DAL,L 94-104,240,37,83,.446,28,64,.438,9,19,.474,11,21,.524,94
17323,2012-04-20,OKC,@,SAC,W 103-92,240,40,75,.533,36,63,.571,4,12,.333,19,22,.864,103
17324,2012-04-20,SAC,,OKC,L 92-103,240,38,93,.409,33,77,.429,5,16,.313,11,18,.611,92
17325,2012-04-20,LAL,@,SAS,L 97-121,240,33,76,.434,27,62,.435,6,14,.429,25,30,.833,97
17326,2012-04-20,SAS,,LAL,W 121-97,240,47,77,.610,37,62,.597,10,15,.667,17,18,.944,121
17327,2012-04-19,DET,,MIN,L 80-91,240,33,91,.363,26,72,.361,7,19,.368,7,9,.778,80
17328,2012-04-19,MIN,@,DET,W 91-80,240,34,73,.466,31,58,.534,3,15,.200,20,28,.714,91
17329,2012-04-19,IND,,MIL,W 118-109,240,43,91,.473,36,74,.486,7,17,.412,25,32,.781,118
17330,2012-04-19,MIL,@,IND,L 109-118,240,37,88,.420,31,68,.456,6,20,.300,29,33,.879,109
17331,2012-04-19,CHI,@,MIA,L 72-83,240,25,70,.357,23,54,.426,2,16,.125,20,28,.714,72
17332,2012-04-19,MIA,,CHI,W 83-72,240,32,76,.421,28,63,.444,4,13,.308,15,21,.714,83
17333,2012-04-19,HOU,@,NOH,L 99-105 (OT),265,37,89,.416,26,58,.448,11,31,.355,14,25,.560,99
17334,2012-04-19,NOP,,HOU,W 105-99 (OT),265,41,87,.471,37,67,.552,4,20,.200,19,24,.792,105
17335,2012-04-19,LAC,@,PHO,L 90-93,240,37,83,.446,32,67,.478,5,16,.313,11,17,.647,90
17336,2012-04-19,PHO,,LAC,W 93-90,240,33,74,.446,24,50,.480,9,24,.375,18,24,.750,93
17337,2012-04-18,ATL,,DET,W 116-84,240,42,85,.494,34,57,.596,8,28,.286,24,29,.828,116
17338,2012-04-18,DET,@,ATL,L 84-116,240,32,92,.348,25,67,.373,7,25,.280,13,19,.684,84
17339,2012-04-18,BOS,,ORL,W 102-98,240,38,70,.543,35,63,.556,3,7,.429,23,27,.852,102
17340,2012-04-18,ORL,@,BOS,L 98-102,240,36,78,.462,30,54,.556,6,24,.250,20,30,.667,98
17341,2012-04-18,CHA,,CHI,L 68-100,240,25,84,.298,24,76,.316,1,8,.125,17,23,.739,68
17342,2012-04-18,CHI,@,CHA,W 100-68,240,40,83,.482,31,64,.484,9,19,.474,11,19,.579,100
17343,2012-04-18,CLE,,PHI,L 87-103,240,36,79,.456,31,65,.477,5,14,.357,10,16,.625,87
17344,2012-04-18,PHI,@,CLE,W 103-87,240,43,82,.524,34,67,.507,9,15,.600,8,10,.800,103
17345,2012-04-18,DAL,,HOU,W 117-110,240,41,79,.519,30,53,.566,11,26,.423,24,26,.923,117
17346,2012-04-18,HOU,@,DAL,L 110-117,240,43,86,.500,31,58,.534,12,28,.429,12,15,.800,110
17347,2012-04-18,DEN,,LAC,L 98-104,240,36,73,.493,31,55,.564,5,18,.278,21,26,.808,98
17348,2012-04-18,LAC,@,DEN,W 104-98,240,38,78,.487,24,54,.444,14,24,.583,14,20,.700,104
17349,2012-04-18,GSW,,LAL,L 87-99,240,38,90,.422,34,71,.479,4,19,.211,7,10,.700,87
17350,2012-04-18,LAL,@,GSW,W 99-87,240,37,79,.468,33,63,.524,4,16,.250,21,28,.750,99
17351,2012-04-18,MEM,,NOH,W 103-91,240,42,83,.506,34,61,.557,8,22,.364,11,13,.846,103
17352,2012-04-18,NOP,@,MEM,L 91-103,240,29,60,.483,27,53,.509,2,7,.286,31,38,.816,91
17353,2012-04-18,MIA,,TOR,W 96-72,240,40,76,.526,33,59,.559,7,17,.412,9,15,.600,96
17354,2012-04-18,TOR,@,MIA,L 72-96,240,30,72,.417,29,56,.518,1,16,.063,11,15,.733,72
17355,2012-04-18,BRK,,NYK,L 95-104,240,35,78,.449,25,53,.472,10,25,.400,15,17,.882,95
17356,2012-04-18,NYK,@,NJN,W 104-95,240,36,83,.434,23,48,.479,13,35,.371,19,24,.792,104
17357,2012-04-18,OKC,@,PHO,W 109-97,240,36,80,.450,30,64,.469,6,16,.375,31,34,.912,109
17358,2012-04-18,PHO,,OKC,L 97-109,240,34,83,.410,28,63,.444,6,20,.300,23,32,.719,97
17359,2012-04-18,POR,,UTA,L 91-112,240,31,79,.392,25,59,.424,6,20,.300,23,29,.793,91
17360,2012-04-18,UTA,@,POR,W 112-91,240,38,80,.475,28,63,.444,10,17,.588,26,32,.813,112
17361,2012-04-18,SAC,,SAS,L 102-127,240,41,92,.446,35,71,.493,6,21,.286,14,20,.700,102
17362,2012-04-18,SAS,@,SAC,W 127-102,240,47,80,.588,39,59,.661,8,21,.381,25,31,.806,127
17363,2012-04-18,MIL,@,WAS,L 112-121,240,42,93,.452,37,74,.500,5,19,.263,23,27,.852,112
17364,2012-04-18,WAS,,MIL,W 121-112,240,49,88,.557,42,75,.560,7,13,.538,16,25,.640,121
17365,2012-04-17,CLE,@,DET,L 77-116,240,27,78,.346,20,57,.351,7,21,.333,16,21,.762,77
17366,2012-04-17,DET,,CLE,W 116-77,240,45,75,.600,37,57,.649,8,18,.444,18,20,.900,116
17367,2012-04-17,LAL,,SAS,L 91-112,240,39,80,.488,37,70,.529,2,10,.200,11,11,1.000,91
17368,2012-04-17,SAS,@,LAL,W 112-91,240,50,84,.595,43,66,.652,7,18,.389,5,11,.455,112
17369,2012-04-17,MEM,@,MIN,W 91-84,240,40,91,.440,35,78,.449,5,13,.385,6,11,.545,91
17370,2012-04-17,MIN,,MEM,L 84-91,240,26,73,.356,19,51,.373,7,22,.318,25,30,.833,84
17371,2012-04-17,BOS,@,NYK,L 110-118,240,36,66,.545,25,45,.556,11,21,.524,27,34,.794,110
17372,2012-04-17,NYK,,BOS,W 118-110,240,42,74,.568,23,42,.548,19,32,.594,15,17,.882,118
17373,2012-04-17,IND,@,PHI,W 102-97,240,37,89,.416,24,65,.369,13,24,.542,15,18,.833,102
17374,2012-04-17,PHI,,IND,L 97-102,240,34,76,.447,29,62,.468,5,14,.357,24,32,.750,97
17375,2012-04-16,CHA,,NOH,L 67-75,240,23,76,.303,22,60,.367,1,16,.063,20,30,.667,67
17376,2012-04-16,NOP,@,CHA,W 75-67,240,26,77,.338,25,66,.379,1,11,.091,22,25,.880,75
17377,2012-04-16,CHI,,WAS,L 84-87,240,32,84,.381,28,70,.400,4,14,.286,16,22,.727,84
17378,2012-04-16,WAS,@,CHI,W 87-84,240,34,89,.382,30,71,.423,4,18,.222,15,19,.789,87
17379,2012-04-16,GSW,,SAS,L 99-120,240,38,93,.409,30,73,.411,8,20,.400,15,17,.882,99
17380,2012-04-16,SAS,@,GSW,W 120-99,240,36,92,.391,24,65,.369,12,27,.444,36,43,.837,120
17381,2012-04-16,DEN,@,HOU,W 105-102,240,38,80,.475,29,62,.468,9,18,.500,20,29,.690,105
17382,2012-04-16,HOU,,DEN,L 102-105,240,40,94,.426,32,65,.492,8,29,.276,14,17,.824,102
17383,2012-04-16,IND,,MIN,W 111-88,240,39,88,.443,28,64,.438,11,24,.458,22,25,.880,111
17384,2012-04-16,MIN,@,IND,L 88-111,240,32,87,.368,25,62,.403,7,25,.280,17,25,.680,88
17385,2012-04-16,LAC,,OKC,W 92-77,240,36,81,.444,27,61,.443,9,20,.450,11,16,.688,92
17386,2012-04-16,OKC,@,LAC,L 77-92,240,27,72,.375,22,50,.440,5,22,.227,18,29,.621,77
17387,2012-04-16,MIA,@,NJN,W 101-98,240,36,71,.507,30,53,.566,6,18,.333,23,27,.852,101
17388,2012-04-16,BRK,,MIA,L 98-101,240,41,82,.500,36,66,.545,5,16,.313,11,16,.688,98
17389,2012-04-16,ORL,,PHI,W 113-100,240,48,90,.533,37,72,.514,11,18,.611,6,6,1.000,113
17390,2012-04-16,PHI,@,ORL,L 100-113,240,40,80,.500,31,62,.500,9,18,.500,11,15,.733,100
17391,2012-04-16,PHO,,POR,W 125-107,240,51,85,.600,44,70,.629,7,15,.467,16,19,.842,125
17392,2012-04-16,POR,@,PHO,L 107-125,240,41,89,.461,33,68,.485,8,21,.381,17,23,.739,107
17393,2012-04-16,ATL,@,TOR,W 109-87,240,39,80,.488,33,59,.559,6,21,.286,25,36,.694,109
17394,2012-04-16,TOR,,ATL,L 87-109,240,35,79,.443,31,70,.443,4,9,.444,13,16,.813,87
17395,2012-04-16,DAL,@,UTA,L 121-123 (3OT),315,42,98,.429,28,64,.438,14,34,.412,23,25,.920,121
17396,2012-04-16,UTA,,DAL,W 123-121 (3OT),315,41,95,.432,29,67,.433,12,28,.429,29,37,.784,123
17397,2012-04-15,ATL,,TOR,L 86-102,240,29,72,.403,24,50,.480,5,22,.227,23,31,.742,86
17398,2012-04-15,TOR,@,ATL,W 102-86,240,41,74,.554,37,62,.597,4,12,.333,16,23,.696,102
17399,2012-04-15,BOS,@,CHA,W 94-82,240,39,80,.488,34,65,.523,5,15,.333,11,17,.647,94
17400,2012-04-15,CHA,,BOS,L 82-94,240,32,79,.405,29,66,.439,3,13,.231,15,20,.750,82
17401,2012-04-15,CLE,,ORL,L 84-100,240,28,75,.373,22,56,.393,6,19,.316,22,29,.759,84
17402,2012-04-15,ORL,@,CLE,W 100-84,240,36,79,.456,25,50,.500,11,29,.379,17,21,.810,100
17403,2012-04-15,DEN,,HOU,W 101-86,240,41,83,.494,37,67,.552,4,16,.250,15,21,.714,101
17404,2012-04-15,HOU,@,DEN,L 86-101,240,32,87,.368,22,61,.361,10,26,.385,12,20,.600,86
17405,2012-04-15,CHI,@,DET,W 100-94 (OT),265,39,91,.429,34,74,.459,5,17,.294,17,23,.739,100
17406,2012-04-15,DET,,CHI,L 94-100 (OT),265,33,84,.393,27,69,.391,6,15,.400,22,28,.786,94
17407,2012-04-15,DAL,@,LAL,L 108-112 (OT),265,41,88,.466,29,67,.433,12,21,.571,14,15,.933,108
17408,2012-04-15,LAL,,DAL,W 112-108 (OT),265,42,93,.452,35,75,.467,7,18,.389,21,27,.778,112
17409,2012-04-15,MEM,@,NOH,L 75-88,240,25,70,.357,20,52,.385,5,18,.278,20,25,.800,75
17410,2012-04-15,NOP,,MEM,W 88-75,240,32,73,.438,29,60,.483,3,13,.231,21,21,1.000,88
17411,2012-04-15,MIA,@,NYK,W 93-85,240,36,78,.462,32,61,.525,4,17,.235,17,21,.810,93
17412,2012-04-15,NYK,,MIA,L 85-93,240,31,73,.425,22,43,.512,9,30,.300,14,23,.609,85
17413,2012-04-15,POR,@,SAC,L 103-104,240,40,76,.526,24,44,.545,16,32,.500,7,10,.700,103
17414,2012-04-15,SAC,,POR,W 104-103,240,45,95,.474,37,76,.487,8,19,.421,6,9,.667,104
17415,2012-04-14,GSW,@,LAC,L 104-112,240,37,80,.463,22,49,.449,15,31,.484,15,21,.714,104
17416,2012-04-14,LAC,,GSW,W 112-104,240,44,81,.543,34,59,.576,10,22,.455,14,30,.467,112
17417,2012-04-14,MEM,,UTA,W 103-98,240,34,70,.486,27,57,.474,7,13,.538,28,34,.824,103
17418,2012-04-14,UTA,@,MEM,L 98-103,240,40,83,.482,35,72,.486,5,11,.455,13,17,.765,98
17419,2012-04-14,IND,@,MIL,W 105-99,240,37,92,.402,30,73,.411,7,19,.368,24,26,.923,105
17420,2012-04-14,MIL,,IND,L 99-105,240,37,84,.440,28,61,.459,9,23,.391,16,26,.615,99
17421,2012-04-14,MIN,,OKC,L 110-115,240,42,84,.500,38,73,.521,4,11,.364,22,34,.647,110
17422,2012-04-14,OKC,@,MIN,W 115-110,240,40,91,.440,33,66,.500,7,25,.280,28,32,.875,115
17423,2012-04-14,BOS,@,NJN,W 94-82,240,37,81,.457,32,67,.478,5,14,.357,15,22,.682,94
17424,2012-04-14,BRK,,BOS,L 82-94,240,32,87,.368,26,65,.400,6,22,.273,12,14,.857,82
17425,2012-04-14,PHO,@,SAS,L 91-105,240,38,96,.396,36,80,.450,2,16,.125,13,18,.722,91
17426,2012-04-14,SAS,,PHO,W 105-91,240,40,76,.526,31,58,.534,9,18,.500,16,19,.842,105
17427,2012-04-14,CLE,@,WAS,W 98-89,240,34,66,.515,31,58,.534,3,8,.375,27,33,.818,98
17428,2012-04-14,WAS,,CLE,L 89-98,240,38,87,.437,34,73,.466,4,14,.286,9,12,.750,89
17429,2012-04-13,DET,,MIL,L 97-113,240,37,78,.474,34,68,.500,3,10,.300,20,24,.833,97
17430,2012-04-13,MIL,@,DET,W 113-97,240,45,87,.517,40,72,.556,5,15,.333,18,22,.818,113
17431,2012-04-13,HOU,,PHO,L 105-112,240,36,84,.429,32,65,.492,4,19,.211,29,33,.879,105
17432,2012-04-13,PHO,@,HOU,W 112-105,240,38,77,.494,30,59,.508,8,18,.444,28,33,.848,112
17433,2012-04-13,CLE,@,IND,L 83-102,240,28,79,.354,21,58,.362,7,21,.333,20,22,.909,83
17434,2012-04-13,IND,,CLE,W 102-83,240,37,90,.411,31,70,.443,6,20,.300,22,26,.846,102
17435,2012-04-13,DEN,@,LAL,L 97-103,240,41,92,.446,36,75,.480,5,17,.294,10,15,.667,97
17436,2012-04-13,LAL,,DEN,W 103-97,240,38,75,.507,31,60,.517,7,15,.467,20,29,.690,103
17437,2012-04-13,CHA,@,MIA,L 82-105,240,33,74,.446,28,57,.491,5,17,.294,11,19,.579,82
17438,2012-04-13,MIA,,CHA,W 105-82,240,44,85,.518,42,71,.592,2,14,.143,15,17,.882,105
17439,2012-04-13,NOP,,UTA,W 96-85,240,38,69,.551,32,56,.571,6,13,.462,14,21,.667,96
17440,2012-04-13,UTA,@,NOH,L 85-96,240,33,73,.452,31,62,.500,2,11,.182,17,21,.810,85
17441,2012-04-13,NYK,,WAS,W 103-65,240,39,84,.464,25,55,.455,14,29,.483,11,13,.846,103
17442,2012-04-13,WAS,@,NYK,L 65-103,240,22,79,.278,18,59,.305,4,20,.200,17,21,.810,65
17443,2012-04-13,OKC,,SAC,W 115-89,240,43,90,.478,38,78,.487,5,12,.417,24,32,.750,115
17444,2012-04-13,SAC,@,OKC,L 89-115,240,35,90,.389,26,65,.400,9,25,.360,10,14,.714,89
17445,2012-04-13,ATL,@,ORL,W 109-81,240,40,79,.506,26,44,.591,14,35,.400,15,16,.938,109
17446,2012-04-13,ORL,,ATL,L 81-109,240,33,85,.388,27,57,.474,6,28,.214,9,14,.643,81
17447,2012-04-13,BRK,@,PHI,W 95-89,240,34,81,.420,28,65,.431,6,16,.375,21,27,.778,95
17448,2012-04-13,PHI,,NJN,L 89-95,240,34,81,.420,33,71,.465,1,10,.100,20,27,.741,89
17449,2012-04-13,DAL,@,POR,W 97-94,240,40,83,.482,31,63,.492,9,20,.450,8,10,.800,97
17450,2012-04-13,POR,,DAL,L 94-97,240,35,83,.422,29,58,.500,6,25,.240,18,23,.783,94
17451,2012-04-13,BOS,@,TOR,L 79-84,240,30,80,.375,26,61,.426,4,19,.211,15,19,.789,79
17452,2012-04-13,TOR,,BOS,W 84-79,240,25,72,.347,18,54,.333,7,18,.389,27,31,.871,84
17453,2012-04-12,CHA,,DET,L 85-109,240,31,70,.443,25,59,.424,6,11,.545,17,23,.739,85
17454,2012-04-12,DET,@,CHA,W 109-85,240,43,82,.524,38,69,.551,5,13,.385,18,21,.857,109
17455,2012-04-12,CHI,,MIA,W 96-86 (OT),265,37,86,.430,26,64,.406,11,22,.500,11,19,.579,96
17456,2012-04-12,MIA,@,CHI,L 86-96 (OT),265,36,82,.439,32,71,.451,4,11,.364,10,16,.625,86
17457,2012-04-12,DAL,@,GSW,W 112-103,240,44,88,.500,35,64,.547,9,24,.375,15,20,.750,112
17458,2012-04-12,GSW,,DAL,L 103-112,240,38,81,.469,31,63,.492,7,18,.389,20,23,.870,103
17459,2012-04-12,LAC,@,MIN,W 95-82,240,39,91,.429,27,60,.450,12,31,.387,5,10,.500,95
17460,2012-04-12,MIN,,LAC,L 82-95,240,31,77,.403,26,56,.464,5,21,.238,15,22,.682,82
17461,2012-04-12,MEM,@,SAS,L 97-107,240,36,85,.424,32,66,.485,4,19,.211,21,27,.778,97
17462,2012-04-12,SAS,,MEM,W 107-97,240,37,76,.487,30,56,.536,7,20,.350,26,31,.839,107
17463,2012-04-11,ATL,@,BOS,L 86-88 (OT),265,34,83,.410,32,63,.508,2,20,.100,16,23,.696,86
17464,2012-04-11,BOS,,ATL,W 88-86 (OT),265,37,89,.416,34,76,.447,3,13,.231,11,13,.846,88
17465,2012-04-11,CLE,,IND,L 98-104 (OT),265,40,88,.455,37,67,.552,3,21,.143,15,19,.789,98
17466,2012-04-11,IND,@,CLE,W 104-98 (OT),265,36,77,.468,28,57,.491,8,20,.400,24,32,.750,104
17467,2012-04-11,DEN,,MIN,W 113-107,240,41,82,.500,32,60,.533,9,22,.409,22,31,.710,113
17468,2012-04-11,MIN,@,DEN,L 107-113,240,42,84,.500,34,60,.567,8,24,.333,15,18,.833,107
17469,2012-04-11,HOU,,UTA,L 91-103,240,31,87,.356,27,67,.403,4,20,.200,25,29,.862,91
17470,2012-04-11,UTA,@,HOU,W 103-91,240,40,78,.513,34,64,.531,6,14,.429,17,22,.773,103
17471,2012-04-11,MEM,,PHO,W 104-93,240,42,84,.500,38,70,.543,4,14,.286,16,19,.842,104
17472,2012-04-11,PHO,@,MEM,L 93-104,240,38,79,.481,31,55,.564,7,24,.292,10,14,.714,93
17473,2012-04-11,MIL,,NYK,L 107-111,240,42,85,.494,34,60,.567,8,25,.320,15,24,.625,107
17474,2012-04-11,NYK,@,MIL,W 111-107,240,41,80,.513,35,64,.547,6,16,.375,23,27,.852,111
17475,2012-04-11,NOP,,SAC,W 105-96,240,38,68,.559,34,59,.576,4,9,.444,25,36,.694,105
17476,2012-04-11,SAC,@,NOH,L 96-105,240,36,83,.434,29,61,.475,7,22,.318,17,23,.739,96
17477,2012-04-11,LAC,@,OKC,W 100-98,240,38,81,.469,33,65,.508,5,16,.313,19,21,.905,100
17478,2012-04-11,OKC,,LAC,L 98-100,240,31,76,.408,19,50,.380,12,26,.462,24,27,.889,98
17479,2012-04-11,GSW,@,POR,L 110-118,240,47,90,.522,39,74,.527,8,16,.500,8,11,.727,110
17480,2012-04-11,POR,,GSW,W 118-110,240,42,88,.477,32,65,.492,10,23,.435,24,28,.857,118
17481,2012-04-11,LAL,@,SAS,W 98-84,240,40,89,.449,29,66,.439,11,23,.478,7,12,.583,98
17482,2012-04-11,SAS,,LAL,L 84-98,240,33,81,.407,20,57,.351,13,24,.542,5,9,.556,84
17483,2012-04-11,PHI,@,TOR,W 93-75,240,41,77,.532,40,67,.597,1,10,.100,10,16,.625,93
17484,2012-04-11,TOR,,PHI,L 75-93,240,29,80,.363,22,62,.355,7,18,.389,10,12,.833,75
17485,2012-04-10,CHI,,NYK,W 98-86,240,39,90,.433,30,70,.429,9,20,.450,11,16,.688,98
17486,2012-04-10,NYK,@,CHI,L 86-98,240,31,73,.425,24,52,.462,7,21,.333,17,21,.810,86
17487,2012-04-10,CHA,@,CLE,L 90-103,240,37,79,.468,34,68,.500,3,11,.273,13,16,.813,90
17488,2012-04-10,CLE,,CHA,W 103-90,240,40,83,.482,29,64,.453,11,19,.579,12,14,.857,103
17489,2012-04-10,DAL,,SAC,W 110-100,240,41,92,.446,34,78,.436,7,14,.500,21,28,.750,110
17490,2012-04-10,SAC,@,DAL,L 100-110,240,41,92,.446,32,67,.478,9,25,.360,9,17,.529,100
17491,2012-04-10,BOS,@,MIA,W 115-107,240,43,71,.606,34,57,.596,9,14,.643,20,25,.800,115
17492,2012-04-10,MIA,,BOS,L 107-115,240,39,87,.448,31,69,.449,8,18,.444,21,27,.778,107
17493,2012-04-10,BRK,,PHI,L 88-107,240,34,88,.386,32,77,.416,2,11,.182,18,21,.857,88
17494,2012-04-10,PHI,@,NJN,W 107-88,240,39,85,.459,33,68,.485,6,17,.353,23,26,.885,107
17495,2012-04-10,ORL,@,WAS,L 85-93,240,34,93,.366,23,58,.397,11,35,.314,6,10,.600,85
17496,2012-04-10,WAS,,ORL,W 93-85,240,39,78,.500,36,63,.571,3,15,.200,12,15,.800,93
17497,2012-04-09,CHA,,WAS,L 85-113,240,32,82,.390,29,73,.397,3,9,.333,18,22,.818,85
17498,2012-04-09,WAS,@,CHA,W 113-85,240,40,83,.482,29,58,.500,11,25,.440,22,26,.846,113
17499,2012-04-09,DEN,,GSW,W 123-84,240,48,88,.545,39,70,.557,9,18,.500,18,24,.750,123
17500,2012-04-09,GSW,@,DEN,L 84-123,240,31,84,.369,19,59,.322,12,25,.480,10,14,.714,84
17501,2012-04-09,IND,,TOR,W 103-98,240,36,71,.507,29,55,.527,7,16,.438,24,31,.774,103
17502,2012-04-09,TOR,@,IND,L 98-103,240,36,75,.480,26,55,.473,10,20,.500,16,24,.667,98
17503,2012-04-09,LAC,@,MEM,L 85-94,240,34,84,.405,30,66,.455,4,18,.222,13,18,.722,85
17504,2012-04-09,MEM,,LAC,W 94-85,240,37,74,.500,33,61,.541,4,13,.308,16,20,.800,94
17505,2012-04-09,MIL,,OKC,L 89-109,240,37,87,.425,31,68,.456,6,19,.316,9,13,.692,89
17506,2012-04-09,OKC,@,MIL,W 109-89,240,39,81,.481,31,61,.508,8,20,.400,23,25,.920,109
17507,2012-04-09,MIN,,PHO,L 90-114,240,32,83,.386,26,61,.426,6,22,.273,20,23,.870,90
17508,2012-04-09,PHO,@,MIN,W 114-90,240,47,82,.573,40,62,.645,7,20,.350,13,16,.813,114
17509,2012-04-09,LAL,@,NOH,W 93-91,240,34,73,.466,29,63,.460,5,10,.500,20,26,.769,93
17510,2012-04-09,NOP,,LAL,L 91-93,240,36,80,.450,27,65,.415,9,15,.600,10,10,1.000,91
17511,2012-04-09,DET,@,ORL,L 89-119,240,30,74,.405,23,54,.426,7,20,.350,22,26,.846,89
17512,2012-04-09,ORL,,DET,W 119-89,240,42,80,.525,27,52,.519,15,28,.536,20,24,.833,119
17513,2012-04-09,HOU,@,POR,W 94-89,240,37,80,.463,27,61,.443,10,19,.526,10,13,.769,94
17514,2012-04-09,POR,,HOU,L 89-94,240,33,83,.398,27,62,.435,6,21,.286,17,19,.895,89
17515,2012-04-09,SAS,@,UTA,L 84-91,240,35,87,.402,28,63,.444,7,24,.292,7,10,.700,84
17516,2012-04-09,UTA,,SAS,W 91-84,240,31,73,.425,27,59,.458,4,14,.286,25,33,.758,91
17517,2012-04-08,BOS,,PHI,W 103-79,240,40,68,.588,33,53,.623,7,15,.467,16,19,.842,103
17518,2012-04-08,PHI,@,BOS,L 79-103,240,29,76,.382,27,65,.415,2,11,.182,19,24,.792,79
17519,2012-04-08,DET,@,MIA,L 75-98,240,28,75,.373,25,56,.446,3,19,.158,16,23,.696,75
17520,2012-04-08,MIA,,DET,W 98-75,240,36,83,.434,29,60,.483,7,23,.304,19,29,.655,98
17521,2012-04-08,CLE,@,NJN,L 117-122 (OT),265,43,96,.448,31,72,.431,12,24,.500,19,25,.760,117
17522,2012-04-08,BRK,,CLE,W 122-117 (OT),265,44,98,.449,36,72,.500,8,26,.308,26,32,.813,122
17523,2012-04-08,CHI,@,NYK,L 99-100 (OT),265,35,89,.393,28,67,.418,7,22,.318,22,31,.710,99
17524,2012-04-08,NYK,,CHI,W 100-99 (OT),265,39,102,.382,31,68,.456,8,34,.235,14,20,.700,100
17525,2012-04-08,OKC,,TOR,W 91-75,240,30,72,.417,20,49,.408,10,23,.435,21,26,.808,91
17526,2012-04-08,TOR,@,OKC,L 75-91,240,29,78,.372,23,62,.371,6,16,.375,11,16,.688,75
17527,2012-04-08,HOU,@,SAC,W 104-87,240,42,93,.452,33,71,.465,9,22,.409,11,13,.846,104
17528,2012-04-08,SAC,,HOU,L 87-104,240,30,70,.429,23,56,.411,7,14,.500,20,37,.541,87
17529,2012-04-08,SAS,,UTA,W 114-104,240,35,69,.507,29,47,.617,6,22,.273,38,43,.884,114
17530,2012-04-08,UTA,@,SAS,L 104-114,240,41,93,.441,35,77,.455,6,16,.375,16,26,.615,104
17531,2012-04-07,ATL,@,CHA,W 116-96,240,43,82,.524,34,62,.548,9,20,.450,21,23,.913,116
17532,2012-04-07,CHA,,ATL,L 96-116,240,38,81,.469,35,74,.473,3,7,.429,17,24,.708,96
17533,2012-04-07,DEN,@,GSW,L 97-112,240,37,80,.463,29,55,.527,8,25,.320,15,20,.750,97
17534,2012-04-07,GSW,,DEN,W 112-97,240,46,88,.523,38,67,.567,8,21,.381,12,16,.750,112
17535,2012-04-07,BOS,@,IND,W 86-72,240,32,76,.421,23,58,.397,9,18,.500,13,14,.929,86
17536,2012-04-07,IND,,BOS,L 72-86,240,26,74,.351,21,52,.404,5,22,.227,15,19,.789,72
17537,2012-04-07,LAC,,SAC,W 109-94,240,44,89,.494,33,62,.532,11,27,.407,10,19,.526,109
17538,2012-04-07,SAC,@,LAC,L 94-109,240,34,82,.415,27,60,.450,7,22,.318,19,28,.679,94
17539,2012-04-07,DAL,@,MEM,L 89-94,240,34,73,.466,25,52,.481,9,21,.429,12,17,.706,89
17540,2012-04-07,MEM,,DAL,W 94-89,240,31,80,.388,22,60,.367,9,20,.450,23,27,.852,94
17541,2012-04-07,MIL,,POR,W 116-94,240,47,94,.500,35,69,.507,12,25,.480,10,11,.909,116
17542,2012-04-07,POR,@,MIL,L 94-116,240,34,78,.436,28,56,.500,6,22,.273,20,23,.870,94
17543,2012-04-07,MIN,@,NOH,L 90-99,240,33,81,.407,23,56,.411,10,25,.400,14,18,.778,90
17544,2012-04-07,NOP,,MIN,W 99-90,240,40,82,.488,36,69,.522,4,13,.308,15,19,.789,99
17545,2012-04-07,ORL,@,PHI,W 88-82,240,29,80,.363,23,60,.383,6,20,.300,24,31,.774,88
17546,2012-04-07,PHI,,ORL,L 82-88,240,31,78,.397,26,65,.400,5,13,.385,15,20,.750,82
17547,2012-04-07,LAL,@,PHO,L 105-125,240,47,97,.485,46,88,.523,1,9,.111,10,18,.556,105
17548,2012-04-07,PHO,,LAL,W 125-105,240,47,94,.500,33,65,.508,14,29,.483,17,21,.810,125
17549,2012-04-06,ATL,,DET,W 101-96,240,39,81,.481,35,66,.530,4,15,.267,19,27,.704,101
17550,2012-04-06,DET,@,ATL,L 96-101,240,37,78,.474,30,63,.476,7,15,.467,15,22,.682,96
17551,2012-04-06,DAL,,POR,L 97-99 (OT),265,42,93,.452,35,69,.507,7,24,.292,6,8,.750,97
17552,2012-04-06,POR,@,DAL,W 99-97 (OT),265,41,94,.436,33,73,.452,8,21,.381,9,11,.818,99
17553,2012-04-06,DEN,,PHO,W 105-99,240,37,92,.402,26,65,.400,11,27,.407,20,31,.645,105
17554,2012-04-06,PHO,@,DEN,L 99-105,240,34,82,.415,26,60,.433,8,22,.364,23,29,.793,99
17555,2012-04-06,IND,,OKC,W 103-98,240,35,85,.412,29,66,.439,6,19,.316,27,34,.794,103
17556,2012-04-06,OKC,@,IND,L 98-103,240,34,77,.442,28,58,.483,6,19,.316,24,31,.774,98
17557,2012-04-06,HOU,@,LAL,W 112-107,240,42,88,.477,32,71,.451,10,17,.588,18,22,.818,112
17558,2012-04-06,LAL,,HOU,L 107-112,240,36,84,.429,33,73,.452,3,11,.273,32,36,.889,107
17559,2012-04-06,MEM,@,MIA,W 97-82,240,38,82,.463,30,65,.462,8,17,.471,13,17,.765,97
17560,2012-04-06,MIA,,MEM,L 82-97,240,33,82,.402,29,64,.453,4,18,.222,12,16,.750,82
17561,2012-04-06,CHA,@,MIL,L 90-95,240,36,85,.424,34,73,.466,2,12,.167,16,24,.667,90
17562,2012-04-06,MIL,,CHA,W 95-90,240,37,91,.407,32,76,.421,5,15,.333,16,24,.667,95
17563,2012-04-06,BRK,,WAS,W 110-98,240,45,80,.563,38,62,.613,7,18,.389,13,19,.684,110
17564,2012-04-06,WAS,@,NJN,L 98-110,240,38,84,.452,33,72,.458,5,12,.417,17,22,.773,98
17565,2012-04-06,NOP,@,SAS,L 103-128,240,36,77,.468,31,65,.477,5,12,.417,26,35,.743,103
17566,2012-04-06,SAS,,NOH,W 128-103,240,51,84,.607,42,66,.636,9,18,.500,17,21,.810,128
17567,2012-04-06,CLE,@,TOR,W 84-80,240,25,73,.342,20,56,.357,5,17,.294,29,40,.725,84
17568,2012-04-06,TOR,,CLE,L 80-84,240,31,73,.425,28,58,.483,3,15,.200,15,24,.625,80
17569,2012-04-06,GSW,@,UTA,L 98-104,240,39,86,.453,30,64,.469,9,22,.409,11,12,.917,98
17570,2012-04-06,UTA,,GSW,W 104-98,240,38,79,.481,32,63,.508,6,16,.375,22,25,.880,104
17571,2012-04-05,BOS,@,CHI,L 86-93,240,33,77,.429,28,64,.438,5,13,.385,15,18,.833,86
17572,2012-04-05,CHI,,BOS,W 93-86,240,33,80,.413,28,64,.438,5,16,.313,22,26,.846,93
17573,2012-04-05,DET,,WAS,W 99-94,240,36,68,.529,32,58,.552,4,10,.400,23,39,.590,99
17574,2012-04-05,WAS,@,DET,L 94-99,240,33,78,.423,26,57,.456,7,21,.333,21,29,.724,94
17575,2012-04-05,NYK,@,ORL,W 96-80,240,38,78,.487,25,53,.472,13,25,.520,7,15,.467,96
17576,2012-04-05,ORL,,NYK,L 80-96,240,30,72,.417,21,48,.438,9,24,.375,11,16,.688,80
17577,2012-04-05,LAC,@,SAC,W 93-85,240,36,80,.450,31,61,.508,5,19,.263,16,24,.667,93
17578,2012-04-05,SAC,,LAC,L 85-93,240,35,84,.417,31,67,.463,4,17,.235,11,15,.733,85
17579,2012-04-04,ATL,,CHA,W 120-93,240,47,83,.566,38,64,.594,9,19,.474,17,19,.895,120
17580,2012-04-04,CHA,@,ATL,L 93-120,240,36,79,.456,31,65,.477,5,14,.357,16,20,.800,93
17581,2012-04-04,BOS,,SAS,L 86-87,240,38,83,.458,34,73,.466,4,10,.400,6,13,.462,86
17582,2012-04-04,SAS,@,BOS,W 87-86,240,36,86,.419,29,58,.500,7,28,.250,8,11,.727,87
17583,2012-04-04,DAL,,MEM,W 95-85,240,40,80,.500,36,65,.554,4,15,.267,11,16,.688,95
17584,2012-04-04,MEM,@,DAL,L 85-95,240,35,83,.422,28,67,.418,7,16,.438,8,14,.571,85
17585,2012-04-04,LAC,,LAL,L 108-113,240,43,95,.453,34,70,.486,9,25,.360,13,20,.650,108
17586,2012-04-04,LAL,@,LAC,W 113-108,240,43,83,.518,37,67,.552,6,16,.375,21,30,.700,113
17587,2012-04-04,MIA,,OKC,W 98-93,240,31,83,.373,21,59,.356,10,24,.417,26,29,.897,98
17588,2012-04-04,OKC,@,MIA,L 93-98,240,35,81,.432,30,64,.469,5,17,.294,18,20,.900,93
17589,2012-04-04,CLE,@,MIL,L 98-107,240,39,95,.411,31,69,.449,8,26,.308,12,13,.923,98
17590,2012-04-04,MIL,,CLE,W 107-98,240,48,84,.571,46,73,.630,2,11,.182,9,17,.529,107
17591,2012-04-04,GSW,@,MIN,W 97-94,240,41,86,.477,37,70,.529,4,16,.250,11,16,.688,97
17592,2012-04-04,MIN,,GSW,L 94-97,240,37,87,.425,28,56,.500,9,31,.290,11,16,.688,94
17593,2012-04-04,DEN,@,NOH,L 92-94,240,35,83,.422,29,63,.460,6,20,.300,16,22,.727,92
17594,2012-04-04,NOP,,DEN,W 94-92,240,35,67,.522,30,57,.526,5,10,.500,19,27,.704,94
17595,2012-04-04,PHI,,TOR,L 78-99,240,34,79,.430,31,67,.463,3,12,.250,7,8,.875,78
17596,2012-04-04,TOR,@,PHI,W 99-78,240,39,77,.506,30,56,.536,9,21,.429,12,12,1.000,99
17597,2012-04-04,BRK,@,POR,L 88-101,240,32,86,.372,26,67,.388,6,19,.316,18,19,.947,88
17598,2012-04-04,POR,,NJN,W 101-88,240,37,81,.457,25,57,.439,12,24,.500,15,19,.789,101
17599,2012-04-04,PHO,@,UTA,W 107-105,240,41,91,.451,28,60,.467,13,31,.419,12,22,.545,107
17600,2012-04-04,UTA,,PHO,L 105-107,240,40,79,.506,37,70,.529,3,9,.333,22,28,.786,105
17601,2012-04-04,IND,@,WAS,W 109-96,240,44,76,.579,40,65,.615,4,11,.364,17,19,.895,109
17602,2012-04-04,WAS,,IND,L 96-109,240,39,84,.464,33,66,.500,6,18,.333,12,19,.632,96
17603,2012-04-03,CLE,,SAS,L 90-125,240,34,82,.415,25,58,.431,9,24,.375,13,15,.867,90
17604,2012-04-03,SAS,@,CLE,W 125-90,240,48,81,.593,37,58,.638,11,23,.478,18,21,.857,125
17605,2012-04-03,DET,,ORL,W 102-95,240,43,76,.566,40,65,.615,3,11,.273,13,19,.684,102
17606,2012-04-03,ORL,@,DET,L 95-102,240,33,72,.458,23,48,.479,10,24,.417,19,24,.792,95
17607,2012-04-03,IND,,NYK,W 112-104,240,41,86,.477,35,63,.556,6,23,.261,24,31,.774,112
17608,2012-04-03,NYK,@,IND,L 104-112,240,38,83,.458,28,60,.467,10,23,.435,18,25,.720,104
17609,2012-04-03,LAL,,NJN,W 91-87,240,39,81,.481,32,59,.542,7,22,.318,6,6,1.000,91
17610,2012-04-03,BRK,@,LAL,L 87-91,240,34,85,.400,28,67,.418,6,18,.333,13,15,.867,87
17611,2012-04-03,GSW,@,MEM,L 94-98,240,38,82,.463,31,64,.484,7,18,.389,11,16,.688,94
17612,2012-04-03,MEM,,GSW,W 98-94,240,37,80,.463,28,63,.444,9,17,.529,15,24,.625,98
17613,2012-04-03,MIA,,PHI,W 99-93,240,35,75,.467,32,62,.516,3,13,.231,26,32,.813,99
17614,2012-04-03,PHI,@,MIA,L 93-99,240,38,83,.458,35,73,.479,3,10,.300,14,17,.824,93
17615,2012-04-03,PHO,@,SAC,W 109-100,240,40,90,.444,35,68,.515,5,22,.227,24,28,.857,109
17616,2012-04-03,SAC,,PHO,L 100-109,240,39,85,.459,38,75,.507,1,10,.100,21,32,.656,100
17617,2012-04-03,CHA,@,TOR,L 87-92,240,31,77,.403,27,65,.415,4,12,.333,21,30,.700,87
17618,2012-04-03,TOR,,CHA,W 92-87,240,35,76,.461,28,58,.483,7,18,.389,15,22,.682,92
17619,2012-04-02,CHI,,HOU,L 93-99,240,40,83,.482,35,66,.530,5,17,.294,8,17,.471,93
17620,2012-04-02,HOU,@,CHI,W 99-93,240,42,89,.472,38,76,.500,4,13,.308,11,14,.786,99
17621,2012-04-02,DAL,,LAC,L 75-94,240,30,77,.390,25,54,.463,5,23,.217,10,17,.588,75
17622,2012-04-02,LAC,@,DAL,W 94-75,240,39,83,.470,28,51,.549,11,32,.344,5,12,.417,94
17623,2012-04-02,MEM,@,OKC,W 94-88,240,34,87,.391,30,71,.423,4,16,.250,22,24,.917,94
17624,2012-04-02,OKC,,MEM,L 88-94,240,33,73,.452,28,52,.538,5,21,.238,17,24,.708,88
17625,2012-04-02,POR,,UTA,L 97-102,240,35,81,.432,23,59,.390,12,22,.545,15,18,.833,97
17626,2012-04-02,UTA,@,POR,W 102-97,240,41,84,.488,37,69,.536,4,15,.267,16,21,.762,102
17627,2012-04-02,MIN,@,SAC,L 108-116,240,39,81,.481,28,60,.467,11,21,.524,19,26,.731,108
17628,2012-04-02,SAC,,MIN,W 116-108,240,43,85,.506,36,62,.581,7,23,.304,23,28,.821,116
17629,2012-04-02,MIL,@,WAS,W 112-98,240,43,83,.518,39,73,.534,4,10,.400,22,29,.759,112
17630,2012-04-02,WAS,,MIL,L 98-112,240,36,81,.444,29,63,.460,7,18,.389,19,20,.950,98
17631,2012-04-01,BOS,,MIA,W 91-72,240,33,70,.471,28,57,.491,5,13,.385,20,22,.909,91
17632,2012-04-01,MIA,@,BOS,L 72-91,240,31,89,.348,28,73,.384,3,16,.188,7,17,.412,72
17633,2012-04-01,HOU,,IND,L 102-104 (OT),265,44,101,.436,35,80,.438,9,21,.429,5,10,.500,102
17634,2012-04-01,IND,@,HOU,W 104-102 (OT),265,37,83,.446,31,68,.456,6,15,.400,24,28,.857,104
17635,2012-04-01,GSW,@,LAL,L 112-120,240,44,90,.489,33,69,.478,11,21,.524,13,15,.867,112
17636,2012-04-01,LAL,,GSW,W 120-112,240,44,82,.537,34,63,.540,10,19,.526,22,31,.710,120
17637,2012-04-01,CHI,@,OKC,L 78-92,240,30,91,.330,22,67,.328,8,24,.333,10,15,.667,78
17638,2012-04-01,OKC,,CHI,W 92-78,240,36,74,.486,32,65,.492,4,9,.444,16,17,.941,92
17639,2012-04-01,DEN,@,ORL,W 104-101,240,40,72,.556,32,53,.604,8,19,.421,16,21,.762,104
17640,2012-04-01,ORL,,DEN,L 101-104,240,37,88,.420,29,56,.518,8,32,.250,19,25,.760,101
17641,2012-04-01,NOP,@,PHO,L 75-92,240,32,77,.416,28,68,.412,4,9,.444,7,9,.778,75
17642,2012-04-01,PHO,,NOH,W 92-75,240,35,71,.493,32,56,.571,3,15,.200,19,21,.905,92
17643,2012-04-01,MIN,@,POR,L 106-119,240,36,78,.462,31,57,.544,5,21,.238,29,35,.829,106
17644,2012-04-01,POR,,MIN,W 119-106,240,46,88,.523,37,60,.617,9,28,.321,18,20,.900,119
17645,2012-04-01,TOR,,WAS,W 99-92,240,37,77,.481,33,60,.550,4,17,.235,21,23,.913,99
17646,2012-04-01,WAS,@,TOR,L 92-99,240,34,71,.479,26,51,.510,8,20,.400,16,20,.800,92
17647,2012-03-31,CHA,@,DET,L 107-110 (OT),265,40,86,.465,32,64,.500,8,22,.364,19,22,.864,107
17648,2012-03-31,DET,,CHA,W 110-107 (OT),265,45,87,.517,41,77,.532,4,10,.400,16,22,.727,110
17649,2012-03-31,LAC,,UTA,W 105-96,240,39,72,.542,29,51,.569,10,21,.476,17,24,.708,105
17650,2012-03-31,UTA,@,LAC,L 96-105,240,35,77,.455,31,65,.477,4,12,.333,22,31,.710,96
17651,2012-03-31,LAL,,NOH,W 88-85,240,32,77,.416,25,55,.455,7,22,.318,17,22,.773,88
17652,2012-03-31,NOP,@,LAL,L 85-88,240,39,92,.424,37,82,.451,2,10,.200,5,10,.500,85
17653,2012-03-31,MEM,@,MIL,W 99-95,240,37,88,.420,33,73,.452,4,15,.267,21,28,.750,99
17654,2012-03-31,MIL,,MEM,L 95-99,240,34,82,.415,29,65,.446,5,17,.294,22,28,.786,95
17655,2012-03-31,CLE,@,NYK,L 75-91,240,28,72,.389,26,59,.441,2,13,.154,17,27,.630,75
17656,2012-03-31,NYK,,CLE,W 91-75,240,30,76,.395,21,48,.438,9,28,.321,22,32,.688,91
17657,2012-03-31,ATL,@,PHI,L 90-95,240,35,74,.473,31,60,.517,4,14,.286,16,22,.727,90
17658,2012-03-31,PHI,,ATL,W 95-90,240,37,77,.481,31,65,.477,6,12,.500,15,19,.789,95
17659,2012-03-31,BRK,@,SAC,W 111-99,240,43,92,.467,33,64,.516,10,28,.357,15,20,.750,111
17660,2012-03-31,SAC,,NJN,L 99-111,240,39,90,.433,36,73,.493,3,17,.176,18,23,.783,99
17661,2012-03-31,IND,@,SAS,L 103-112,240,42,79,.532,37,65,.569,5,14,.357,14,18,.778,103
17662,2012-03-31,SAS,,IND,W 112-103,240,38,76,.500,29,57,.509,9,19,.474,27,33,.818,112
17663,2012-03-30,ATL,,NYK,W 100-90,240,37,73,.507,33,54,.611,4,19,.211,22,26,.846,100
17664,2012-03-30,NYK,@,ATL,L 90-100,240,31,70,.443,25,53,.472,6,17,.353,22,33,.667,90
17665,2012-03-30,CHA,,DEN,L 88-99,240,36,98,.367,30,76,.395,6,22,.273,10,11,.909,88
17666,2012-03-30,DEN,@,CHA,W 99-88,240,38,73,.521,36,56,.643,2,17,.118,21,29,.724,99
17667,2012-03-30,CHI,,DET,W 83-71,240,32,75,.427,30,63,.476,2,12,.167,17,21,.810,83
17668,2012-03-30,DET,@,CHI,L 71-83,240,31,84,.369,28,73,.384,3,11,.273,6,7,.857,71
17669,2012-03-30,CLE,,MIL,L 84-121,240,34,85,.400,28,63,.444,6,22,.273,10,19,.526,84
17670,2012-03-30,MIL,@,CLE,W 121-84,240,50,88,.568,40,72,.556,10,16,.625,11,18,.611,121
17671,2012-03-30,GSW,,NJN,L 100-102,240,40,76,.526,33,61,.541,7,15,.467,13,16,.813,100
17672,2012-03-30,BRK,@,GSW,W 102-100,240,35,81,.432,27,61,.443,8,20,.400,24,30,.800,102
17673,2012-03-30,HOU,,MEM,W 98-89,240,38,73,.521,31,59,.525,7,14,.500,15,20,.750,98
17674,2012-03-30,MEM,@,HOU,L 89-98,240,35,94,.372,34,79,.430,1,15,.067,18,26,.692,89
17675,2012-03-30,LAC,,POR,W 98-97,240,39,75,.520,31,54,.574,8,21,.381,12,19,.632,98
17676,2012-03-30,POR,@,LAC,L 97-98,240,39,78,.500,31,59,.525,8,19,.421,11,15,.733,97
17677,2012-03-30,BOS,@,MIN,W 100-79,240,44,90,.489,40,78,.513,4,12,.333,8,11,.727,100
17678,2012-03-30,MIN,,BOS,L 79-100,240,26,75,.347,20,51,.392,6,24,.250,21,25,.840,79
17679,2012-03-30,DAL,@,ORL,W 100-98,240,38,80,.475,31,58,.534,7,22,.318,17,21,.810,100
17680,2012-03-30,ORL,,DAL,L 98-100,240,35,78,.449,24,46,.522,11,32,.344,17,28,.607,98
17681,2012-03-30,MIA,@,TOR,W 113-101,240,44,77,.571,39,63,.619,5,14,.357,20,24,.833,113
17682,2012-03-30,TOR,,MIA,L 101-113,240,39,72,.542,34,58,.586,5,14,.357,18,19,.947,101
17683,2012-03-30,SAC,@,UTA,W 104-103,240,39,90,.433,35,74,.473,4,16,.250,22,32,.688,104
17684,2012-03-30,UTA,,SAC,L 103-104,240,31,88,.352,28,75,.373,3,13,.231,38,52,.731,103
17685,2012-03-30,PHI,@,WAS,L 76-97,240,30,82,.366,27,68,.397,3,14,.214,13,17,.765,76
17686,2012-03-30,WAS,,PHI,W 97-76,240,42,87,.483,35,70,.500,7,17,.412,6,6,1.000,97
17687,2012-03-29,IND,,WAS,W 93-89,240,31,79,.392,25,63,.397,6,16,.375,25,32,.781,93
17688,2012-03-29,WAS,@,IND,L 89-93,240,33,78,.423,26,56,.464,7,22,.318,16,25,.640,89
17689,2012-03-29,LAL,,OKC,L 93-102,240,35,84,.417,31,73,.425,4,11,.364,19,23,.826,93
17690,2012-03-29,OKC,@,LAL,W 102-93,240,42,91,.462,37,79,.468,5,12,.417,13,17,.765,102
17691,2012-03-29,DAL,@,MIA,L 85-106,240,33,78,.423,24,54,.444,9,24,.375,10,13,.769,85
17692,2012-03-29,MIA,,DAL,W 106-85,240,39,80,.488,34,63,.540,5,17,.294,23,27,.852,106
17693,2012-03-29,NOP,@,POR,L 93-99,240,33,71,.465,26,58,.448,7,13,.538,20,21,.952,93
17694,2012-03-29,POR,,NOH,W 99-93,240,39,80,.488,27,52,.519,12,28,.429,9,13,.692,99
17695,2012-03-28,ATL,,CHI,L 77-98,240,32,80,.400,27,63,.429,5,17,.294,8,9,.889,77
17696,2012-03-28,CHI,@,ATL,W 98-77,240,38,81,.469,29,65,.446,9,16,.563,13,20,.650,98
17697,2012-03-28,BOS,,UTA,W 94-82,240,36,77,.468,32,62,.516,4,15,.267,18,21,.857,94
17698,2012-03-28,UTA,@,BOS,L 82-94,240,32,82,.390,29,72,.403,3,10,.300,15,24,.625,82
17699,2012-03-28,CHA,,MIN,L 83-88,240,31,78,.397,28,65,.431,3,13,.231,18,22,.818,83
17700,2012-03-28,MIN,@,CHA,W 88-83,240,33,81,.407,25,60,.417,8,21,.381,14,20,.700,88
17701,2012-03-28,CLE,,DET,L 75-87,240,30,87,.345,25,70,.357,5,17,.294,10,12,.833,75
17702,2012-03-28,DET,@,CLE,W 87-75,240,35,83,.422,28,68,.412,7,15,.467,10,16,.625,87
17703,2012-03-28,GSW,,NOH,L 87-102,240,33,74,.446,23,46,.500,10,28,.357,11,15,.733,87
17704,2012-03-28,NOP,@,GSW,W 102-87,240,43,79,.544,36,68,.529,7,11,.636,9,14,.643,102
17705,2012-03-28,LAC,,PHO,W 103-86,240,41,82,.500,34,63,.540,7,19,.368,14,23,.609,103
17706,2012-03-28,PHO,@,LAC,L 86-103,240,30,80,.375,25,54,.463,5,26,.192,21,32,.656,86
17707,2012-03-28,IND,@,NJN,L 84-100,240,35,77,.455,29,57,.509,6,20,.300,8,13,.615,84
17708,2012-03-28,BRK,,IND,W 100-84,240,40,82,.488,33,66,.500,7,16,.438,13,15,.867,100
17709,2012-03-28,NYK,,ORL,W 108-86,240,43,85,.506,31,51,.608,12,34,.353,10,12,.833,108
17710,2012-03-28,ORL,@,NYK,L 86-108,240,31,69,.449,22,43,.512,9,26,.346,15,26,.577,86
17711,2012-03-28,SAC,,SAS,L 112-117,240,47,86,.547,39,65,.600,8,21,.381,10,13,.769,112
17712,2012-03-28,SAS,@,SAC,W 117-112,240,49,91,.538,39,71,.549,10,20,.500,9,12,.750,117
17713,2012-03-28,DEN,@,TOR,L 96-105,240,33,80,.413,28,60,.467,5,20,.250,25,30,.833,96
17714,2012-03-28,TOR,,DEN,W 105-96,240,35,86,.407,23,64,.359,12,22,.545,23,33,.697,105
17715,2012-03-27,DAL,,HOU,W 90-81,240,34,73,.466,28,54,.519,6,19,.316,16,20,.800,90
17716,2012-03-27,HOU,@,DAL,L 81-90,240,33,79,.418,27,58,.466,6,21,.286,9,12,.750,81
17717,2012-03-27,GSW,,LAL,L 101-104,240,39,91,.429,33,72,.458,6,19,.316,17,18,.944,101
17718,2012-03-27,LAL,@,GSW,W 104-101,240,36,86,.419,31,66,.470,5,20,.250,27,34,.794,104
17719,2012-03-27,MEM,,MIN,W 93-86,240,34,80,.425,34,69,.493,0,11,.000,25,28,.893,93
17720,2012-03-27,MIN,@,MEM,L 86-93,240,33,85,.388,24,56,.429,9,29,.310,11,13,.846,86
17721,2012-03-27,ATL,@,MIL,L 101-108,240,42,84,.500,35,61,.574,7,23,.304,10,17,.588,101
17722,2012-03-27,MIL,,ATL,W 108-101,240,44,88,.500,39,77,.506,5,11,.455,15,16,.938,108
17723,2012-03-27,CLE,@,PHI,L 85-103,240,28,70,.400,19,47,.404,9,23,.391,20,28,.714,85
17724,2012-03-27,PHI,,CLE,W 103-85,240,45,92,.489,35,73,.479,10,19,.526,3,5,.600,103
17725,2012-03-27,PHO,,SAS,L 100-107,240,41,87,.471,34,68,.500,7,19,.368,11,12,.917,100
17726,2012-03-27,SAS,@,PHO,W 107-100,240,45,92,.489,39,65,.600,6,27,.222,11,13,.846,107
17727,2012-03-27,OKC,@,POR,W 109-95,240,45,79,.570,39,62,.629,6,17,.353,13,16,.813,109
17728,2012-03-27,POR,,OKC,L 95-109,240,34,79,.430,27,63,.429,7,16,.438,20,25,.800,95
17729,2012-03-26,BOS,@,CHA,W 102-95,240,33,73,.452,31,61,.508,2,12,.167,34,45,.756,102
17730,2012-03-26,CHA,,BOS,L 95-102,240,33,79,.418,29,67,.433,4,12,.333,25,35,.714,95
17731,2012-03-26,CHI,,DEN,L 91-108,240,35,74,.473,22,54,.407,13,20,.650,8,11,.727,91
17732,2012-03-26,DEN,@,CHI,W 108-91,240,44,88,.500,36,72,.500,8,16,.500,12,16,.750,108
17733,2012-03-26,HOU,,SAC,W 113-106 (OT),265,43,89,.483,39,69,.565,4,20,.200,23,27,.852,113
17734,2012-03-26,SAC,@,HOU,L 106-113 (OT),265,41,96,.427,36,78,.462,5,18,.278,19,26,.731,106
17735,2012-03-26,IND,,MIA,W 105-90,240,37,81,.457,27,63,.429,10,18,.556,21,28,.750,105
17736,2012-03-26,MIA,@,IND,L 90-105,240,29,69,.420,21,49,.429,8,20,.400,24,37,.649,90
17737,2012-03-26,LAC,,NOH,W 97-85,240,37,74,.500,29,48,.604,8,26,.308,15,21,.714,97
17738,2012-03-26,NOP,@,LAC,L 85-97,240,31,62,.500,29,51,.569,2,11,.182,21,31,.677,85
17739,2012-03-26,BRK,,UTA,L 84-105,240,29,81,.358,24,60,.400,5,21,.238,21,35,.600,84
17740,2012-03-26,UTA,@,NJN,W 105-84,240,42,81,.519,37,67,.552,5,14,.357,16,18,.889,105
17741,2012-03-26,MIL,@,NYK,L 80-89,240,31,85,.365,25,61,.410,6,24,.250,12,18,.667,80
17742,2012-03-26,NYK,,MIL,W 89-80,240,26,74,.351,19,43,.442,7,31,.226,30,35,.857,89
17743,2012-03-26,ORL,@,TOR,W 117-101,240,44,81,.543,29,47,.617,15,34,.441,14,19,.737,117
17744,2012-03-26,TOR,,ORL,L 101-117,240,35,74,.473,24,52,.462,11,22,.500,20,24,.833,101
17745,2012-03-26,DET,@,WAS,W 79-77,240,28,76,.368,25,63,.397,3,13,.231,20,27,.741,79
17746,2012-03-26,WAS,,DET,L 77-79,240,32,78,.410,28,61,.459,4,17,.235,9,14,.643,77
17747,2012-03-25,ATL,,UTA,W 139-133 (4OT),340,48,107,.449,42,88,.477,6,19,.316,37,47,.787,139
17748,2012-03-25,UTA,@,ATL,L 133-139 (4OT),340,49,126,.389,43,105,.410,6,21,.286,29,35,.829,133
17749,2012-03-25,BOS,,WAS,W 88-76,240,34,70,.486,31,60,.517,3,10,.300,17,18,.944,88
17750,2012-03-25,WAS,@,BOS,L 76-88,240,30,87,.345,27,73,.370,3,14,.214,13,19,.684,76
17751,2012-03-25,CLE,,PHO,L 83-108,240,27,70,.386,23,54,.426,4,16,.250,25,30,.833,83
17752,2012-03-25,PHO,@,CLE,W 108-83,240,42,82,.512,36,65,.554,6,17,.353,18,26,.692,108
17753,2012-03-25,LAL,,MEM,L 96-102,240,31,73,.425,24,55,.436,7,18,.389,27,30,.900,96
17754,2012-03-25,MEM,@,LAL,W 102-96,240,44,86,.512,38,73,.521,6,13,.462,8,10,.800,102
17755,2012-03-25,DEN,@,MIN,L 100-117,240,41,81,.506,38,66,.576,3,15,.200,15,22,.682,100
17756,2012-03-25,MIN,,DEN,W 117-100,240,45,99,.455,33,64,.516,12,35,.343,15,15,1.000,117
17757,2012-03-25,MIA,@,OKC,L 87-103,240,33,71,.465,26,49,.531,7,22,.318,14,14,1.000,87
17758,2012-03-25,OKC,,MIA,W 103-87,240,39,74,.527,33,63,.524,6,11,.545,19,23,.826,103
17759,2012-03-25,GSW,@,POR,L 87-90,240,32,74,.432,25,52,.481,7,22,.318,16,17,.941,87
17760,2012-03-25,POR,,GSW,W 90-87,240,31,85,.365,21,55,.382,10,30,.333,18,27,.667,90
17761,2012-03-25,PHI,@,SAS,L 76-93,240,35,85,.412,34,76,.447,1,9,.111,5,11,.455,76
17762,2012-03-25,SAS,,PHI,W 93-76,240,37,81,.457,30,53,.566,7,28,.250,12,18,.667,93
17763,2012-03-24,CHI,,TOR,W 102-101 (OT),265,41,103,.398,38,80,.475,3,23,.130,17,26,.654,102
17764,2012-03-24,TOR,@,CHI,L 101-102 (OT),265,39,87,.448,36,73,.493,3,14,.214,20,25,.800,101
17765,2012-03-24,GSW,,SAC,W 111-108,240,43,88,.489,36,67,.537,7,21,.333,18,21,.857,111
17766,2012-03-24,SAC,@,GSW,L 108-111,240,43,91,.473,42,76,.553,1,15,.067,21,27,.778,108
17767,2012-03-24,DAL,@,HOU,W 101-99 (OT),265,37,80,.463,31,58,.534,6,22,.273,21,24,.875,101
17768,2012-03-24,HOU,,DAL,L 99-101 (OT),265,37,96,.385,28,71,.394,9,25,.360,16,18,.889,99
17769,2012-03-24,LAC,,MEM,W 101-85,240,36,72,.500,31,56,.554,5,16,.313,24,33,.727,101
17770,2012-03-24,MEM,@,LAC,L 85-101,240,33,78,.423,24,63,.381,9,15,.600,10,14,.714,85
17771,2012-03-24,IND,@,MIL,W 125-104,240,43,84,.512,36,72,.500,7,12,.583,32,39,.821,125
17772,2012-03-24,MIL,,IND,L 104-125,240,40,91,.440,30,70,.429,10,21,.476,14,18,.778,104
17773,2012-03-24,CHA,@,NJN,L 89-102,240,35,79,.443,32,65,.492,3,14,.214,16,22,.727,89
17774,2012-03-24,BRK,,CHA,W 102-89,240,39,88,.443,34,72,.472,5,16,.313,19,22,.864,102
17775,2012-03-24,NOP,,SAS,L 86-89,240,37,81,.457,36,76,.474,1,5,.200,11,12,.917,86
17776,2012-03-24,SAS,@,NOH,W 89-86,240,36,90,.400,34,71,.479,2,19,.105,15,17,.882,89
17777,2012-03-24,DET,@,NYK,L 79-101,240,28,76,.368,22,57,.386,6,19,.316,17,22,.773,79
17778,2012-03-24,NYK,,DET,W 101-79,240,38,78,.487,32,58,.552,6,20,.300,19,30,.633,101
17779,2012-03-24,ATL,@,WAS,W 95-92,240,37,76,.487,30,53,.566,7,23,.304,14,21,.667,95
17780,2012-03-24,WAS,,ATL,L 92-95,240,38,85,.447,34,67,.507,4,18,.222,12,14,.857,92
17781,2012-03-23,ATL,,NJN,W 93-84,240,36,77,.468,29,56,.518,7,21,.333,14,20,.700,93
17782,2012-03-23,BRK,@,ATL,L 84-93,240,32,80,.400,26,55,.473,6,25,.240,14,21,.667,84
17783,2012-03-23,CHA,,MIL,L 92-112,240,34,84,.405,33,76,.434,1,8,.125,23,26,.885,92
17784,2012-03-23,MIL,@,CHA,W 112-92,240,48,90,.533,44,77,.571,4,13,.308,12,21,.571,112
17785,2012-03-23,DET,,MIA,L 73-88,240,29,75,.387,23,60,.383,6,15,.400,9,17,.529,73
17786,2012-03-23,MIA,@,DET,W 88-73,240,34,77,.442,32,61,.525,2,16,.125,18,20,.900,88
17787,2012-03-23,IND,,PHO,L 111-113,240,42,81,.519,35,70,.500,7,11,.636,20,22,.909,111
17788,2012-03-23,PHO,@,IND,W 113-111,240,41,84,.488,36,67,.537,5,17,.294,26,37,.703,113
17789,2012-03-23,LAL,,POR,W 103-96,240,40,85,.471,34,66,.515,6,19,.316,17,26,.654,103
17790,2012-03-23,POR,@,LAL,L 96-103,240,36,82,.439,28,62,.452,8,20,.400,16,19,.842,96
17791,2012-03-23,MIN,@,OKC,L 140-149 (2OT),290,49,100,.490,35,64,.547,14,36,.389,28,36,.778,140
17792,2012-03-23,OKC,,MIN,W 149-140 (2OT),290,60,113,.531,50,86,.581,10,27,.370,19,20,.950,149
17793,2012-03-23,CLE,@,ORL,L 80-93,240,31,82,.378,27,64,.422,4,18,.222,14,21,.667,80
17794,2012-03-23,ORL,,CLE,W 93-80,240,37,79,.468,25,44,.568,12,35,.343,7,12,.583,93
17795,2012-03-23,BOS,@,PHI,L 86-99,240,36,74,.486,32,64,.500,4,10,.400,10,13,.769,86
17796,2012-03-23,PHI,,BOS,W 99-86,240,41,92,.446,38,82,.463,3,10,.300,14,18,.778,99
17797,2012-03-23,DAL,@,SAS,L 87-104,240,31,81,.383,20,55,.364,11,26,.423,14,17,.824,87
17798,2012-03-23,SAS,,DAL,W 104-87,240,43,88,.489,34,63,.540,9,25,.360,9,11,.818,104
17799,2012-03-23,NYK,@,TOR,L 79-96,240,32,85,.376,27,57,.474,5,28,.179,10,18,.556,79
17800,2012-03-23,TOR,,NYK,W 96-79,240,38,83,.458,37,70,.529,1,13,.077,19,26,.731,96
17801,2012-03-23,DEN,@,UTA,L 102-121,240,36,78,.462,30,60,.500,6,18,.333,24,32,.750,102
17802,2012-03-23,UTA,,DEN,W 121-102,240,48,81,.593,41,66,.621,7,15,.467,18,29,.621,121
17803,2012-03-22,GSW,@,HOU,L 83-109,240,34,82,.415,28,66,.424,6,16,.375,9,10,.900,83
17804,2012-03-22,HOU,,GSW,W 109-83,240,40,85,.471,34,68,.500,6,17,.353,23,27,.852,109
17805,2012-03-22,BOS,@,MIL,W 100-91,240,43,89,.483,36,72,.500,7,17,.412,7,10,.700,100
17806,2012-03-22,MIL,,BOS,L 91-100,240,36,90,.400,33,75,.440,3,15,.200,16,20,.800,91
17807,2012-03-22,LAC,@,NOH,L 90-97,240,35,90,.389,30,63,.476,5,27,.185,15,24,.625,90
17808,2012-03-22,NOP,,LAC,W 97-90,240,34,59,.576,32,54,.593,2,5,.400,27,34,.794,97
17809,2012-03-22,MEM,@,POR,L 93-97,240,37,81,.457,34,73,.466,3,8,.375,16,23,.696,93
17810,2012-03-22,POR,,MEM,W 97-93,240,31,73,.425,21,48,.438,10,25,.400,25,25,1.000,97
17811,2012-03-22,SAC,,UTA,L 102-103,240,43,106,.406,39,91,.429,4,15,.267,12,21,.571,102
17812,2012-03-22,UTA,@,SAC,W 103-102,240,43,91,.473,40,74,.541,3,17,.176,14,17,.824,103
17813,2012-03-22,IND,@,WAS,W 85-83,240,31,74,.419,27,56,.482,4,18,.222,19,28,.679,85
17814,2012-03-22,WAS,,IND,L 83-85,240,30,71,.423,25,53,.472,5,18,.278,18,23,.783,83
17815,2012-03-21,ATL,,CLE,W 103-102 (OT),265,37,93,.398,29,73,.397,8,20,.400,21,24,.875,103
17816,2012-03-21,CLE,@,ATL,L 102-103 (OT),265,36,78,.462,30,59,.508,6,19,.316,24,33,.727,102
17817,2012-03-21,DAL,,LAL,L 93-109,240,35,82,.427,27,56,.482,8,26,.308,15,22,.682,93
17818,2012-03-21,LAL,@,DAL,W 109-93,240,45,77,.584,36,59,.610,9,18,.500,10,13,.769,109
17819,2012-03-21,DEN,,DET,W 116-115,240,46,79,.582,37,62,.597,9,17,.529,15,22,.682,116
17820,2012-03-21,DET,@,DEN,L 115-116,240,40,79,.506,26,61,.426,14,18,.778,21,30,.700,115
17821,2012-03-21,BRK,,WAS,L 89-108,240,31,84,.369,25,64,.391,6,20,.300,21,27,.778,89
17822,2012-03-21,WAS,@,NJN,W 108-89,240,40,83,.482,34,66,.515,6,17,.353,22,29,.759,108
17823,2012-03-21,GSW,@,NOH,W 101-92,240,39,89,.438,25,60,.417,14,29,.483,9,10,.900,101
17824,2012-03-21,NOP,,GSW,L 92-101,240,39,79,.494,36,70,.514,3,9,.333,11,14,.786,92
17825,2012-03-21,LAC,@,OKC,L 91-114,240,29,79,.367,17,53,.321,12,26,.462,21,27,.778,91
17826,2012-03-21,OKC,,LAC,W 114-91,240,42,78,.538,33,56,.589,9,22,.409,21,22,.955,114
17827,2012-03-21,ORL,,PHO,W 103-93,240,39,83,.470,28,60,.467,11,23,.478,14,21,.667,103
17828,2012-03-21,PHO,@,ORL,L 93-103,240,38,79,.481,34,67,.507,4,12,.333,13,19,.684,93
17829,2012-03-21,NYK,@,PHI,W 82-79,240,29,79,.367,27,66,.409,2,13,.154,22,28,.786,82
17830,2012-03-21,PHI,,NYK,L 79-82,240,29,75,.387,21,58,.362,8,17,.471,13,18,.722,79
17831,2012-03-21,MIN,@,SAS,L 100-116,240,39,88,.443,32,66,.485,7,22,.318,15,20,.750,100
17832,2012-03-21,SAS,,MIN,W 116-100,240,45,95,.474,38,76,.500,7,19,.368,19,25,.760,116
17833,2012-03-21,CHI,@,TOR,W 94-82,240,36,82,.439,29,66,.439,7,16,.438,15,23,.652,94
17834,2012-03-21,TOR,,CHI,L 82-94,240,35,85,.412,34,77,.442,1,8,.125,11,11,1.000,82
17835,2012-03-20,HOU,,LAL,W 107-104,240,39,80,.488,30,60,.500,9,20,.450,20,27,.741,107
17836,2012-03-20,LAL,@,HOU,L 104-107,240,42,83,.506,36,67,.537,6,16,.375,14,16,.875,104
17837,2012-03-20,IND,,LAC,W 102-89,240,35,72,.486,27,58,.466,8,14,.571,24,26,.923,102
17838,2012-03-20,LAC,@,IND,L 89-102,240,37,85,.435,31,63,.492,6,22,.273,9,20,.450,89
17839,2012-03-20,MIA,,PHO,W 99-95,240,36,76,.474,35,67,.522,1,9,.111,26,35,.743,99
17840,2012-03-20,PHO,@,MIA,L 95-99,240,36,80,.450,30,65,.462,6,15,.400,17,24,.708,95
17841,2012-03-20,NYK,,TOR,W 106-87,240,39,81,.481,34,65,.523,5,16,.313,23,33,.697,106
17842,2012-03-20,TOR,@,NYK,L 87-106,240,33,69,.478,31,56,.554,2,13,.154,19,22,.864,87
17843,2012-03-20,MIL,@,POR,W 116-87,240,48,83,.578,37,62,.597,11,21,.524,9,13,.692,116
17844,2012-03-20,POR,,MIL,L 87-116,240,29,82,.354,22,58,.379,7,24,.292,22,26,.846,87
17845,2012-03-20,MEM,@,SAC,L 110-119,240,43,90,.478,39,74,.527,4,16,.250,20,25,.800,110
17846,2012-03-20,SAC,,MEM,W 119-110,240,47,88,.534,43,71,.606,4,17,.235,21,32,.656,119
17847,2012-03-20,OKC,@,UTA,L 90-97,240,30,71,.423,22,52,.423,8,19,.421,22,30,.733,90
17848,2012-03-20,UTA,,OKC,W 97-90,240,38,80,.475,33,70,.471,5,10,.500,16,22,.727,97
17849,2012-03-19,ATL,,BOS,L 76-79,240,29,75,.387,24,60,.400,5,15,.333,13,19,.684,76
17850,2012-03-19,BOS,@,ATL,W 79-76,240,29,74,.392,23,58,.397,6,16,.375,15,17,.882,79
17851,2012-03-19,CHA,,PHI,L 80-105,240,29,75,.387,27,67,.403,2,8,.250,20,28,.714,80
17852,2012-03-19,PHI,@,CHA,W 105-80,240,46,86,.535,41,75,.547,5,11,.455,8,9,.889,105
17853,2012-03-19,DAL,@,DEN,W 112-95,240,45,84,.536,35,59,.593,10,25,.400,12,15,.800,112
17854,2012-03-19,DEN,,DAL,L 95-112,240,36,83,.434,30,62,.484,6,21,.286,17,20,.850,95
17855,2012-03-19,GSW,,MIN,L 93-97,240,34,80,.425,24,54,.444,10,26,.385,15,20,.750,93
17856,2012-03-19,MIN,@,GSW,W 97-93,240,35,74,.473,26,53,.491,9,21,.429,18,23,.783,97
17857,2012-03-19,CLE,@,NJN,W 105-100,240,41,89,.461,36,74,.486,5,15,.333,18,27,.667,105
17858,2012-03-19,BRK,,CLE,L 100-105,240,34,81,.420,28,58,.483,6,23,.261,26,31,.839,100
17859,2012-03-19,CHI,@,ORL,W 85-59,240,35,79,.443,28,61,.459,7,18,.389,8,11,.727,85
17860,2012-03-19,ORL,,CHI,L 59-85,240,24,68,.353,20,48,.417,4,20,.200,7,18,.389,59
17861,2012-03-18,ATL,@,CLE,W 103-87,240,43,85,.506,35,67,.522,8,18,.444,9,12,.750,103
17862,2012-03-18,CLE,,ATL,L 87-103,240,33,84,.393,28,64,.438,5,20,.250,16,20,.800,87
17863,2012-03-18,DET,@,LAC,L 83-87 (OT),265,31,81,.383,29,65,.446,2,16,.125,19,23,.826,83
17864,2012-03-18,LAC,,DET,W 87-83 (OT),265,35,87,.402,31,67,.463,4,20,.200,13,19,.684,87
17865,2012-03-18,LAL,,UTA,L 99-103,240,33,73,.452,31,60,.517,2,13,.154,31,40,.775,99
17866,2012-03-18,UTA,@,LAL,W 103-99,240,43,91,.473,41,81,.506,2,10,.200,15,22,.682,103
17867,2012-03-18,MEM,,WAS,W 97-92,240,34,85,.400,32,78,.410,2,7,.286,27,37,.730,97
17868,2012-03-18,WAS,@,MEM,L 92-97,240,37,78,.474,31,60,.517,6,18,.333,12,19,.632,92
17869,2012-03-18,MIA,,ORL,W 91-81,240,34,74,.459,32,66,.485,2,8,.250,21,27,.778,91
17870,2012-03-18,ORL,@,MIA,L 81-91,240,30,76,.395,21,51,.412,9,25,.360,12,21,.571,81
17871,2012-03-18,OKC,,POR,W 111-95,240,41,74,.554,30,56,.536,11,18,.611,18,28,.643,111
17872,2012-03-18,POR,@,OKC,L 95-111,240,39,84,.464,31,63,.492,8,21,.381,9,14,.643,95
17873,2012-03-18,HOU,@,PHO,L 86-99,240,35,82,.427,34,71,.479,1,11,.091,15,22,.682,86
17874,2012-03-18,PHO,,HOU,W 99-86,240,40,85,.471,33,65,.508,7,20,.350,12,19,.632,99
17875,2012-03-18,MIN,@,SAC,L 99-115,240,38,92,.413,32,67,.478,6,25,.240,17,17,1.000,99
17876,2012-03-18,SAC,,MIN,W 115-99,240,44,96,.458,36,68,.529,8,28,.286,19,21,.905,115
17877,2012-03-17,CHA,,TOR,W 107-103,240,36,71,.507,32,62,.516,4,9,.444,31,34,.912,107
17878,2012-03-17,TOR,@,CHA,L 103-107,240,38,73,.521,30,55,.545,8,18,.444,19,24,.792,103
17879,2012-03-17,CHI,,PHI,W 89-80,240,31,77,.403,25,56,.446,6,21,.286,21,31,.677,89
17880,2012-03-17,PHI,@,CHI,L 80-89,240,33,79,.418,30,66,.455,3,13,.231,11,15,.733,80
17881,2012-03-17,DAL,,SAS,W 106-99,240,37,79,.468,26,55,.473,11,24,.458,21,25,.840,106
17882,2012-03-17,SAS,@,DAL,L 99-106,240,39,79,.494,28,55,.509,11,24,.458,10,18,.556,99
17883,2012-03-17,BOS,@,DEN,L 91-98,240,36,76,.474,33,61,.541,3,15,.200,16,17,.941,91
17884,2012-03-17,DEN,,BOS,W 98-91,240,34,74,.459,27,54,.500,7,20,.350,23,31,.742,98
17885,2012-03-17,IND,,NYK,L 88-102,240,32,79,.405,28,60,.467,4,19,.211,20,27,.741,88
17886,2012-03-17,NYK,@,IND,W 102-88,240,32,77,.416,25,53,.472,7,24,.292,31,40,.775,102
17887,2012-03-17,HOU,@,LAC,L 91-95,240,35,72,.486,29,52,.558,6,20,.300,15,18,.833,91
17888,2012-03-17,LAC,,HOU,W 95-91,240,35,86,.407,29,63,.460,6,23,.261,19,27,.704,95
17889,2012-03-17,BRK,,NOH,L 94-102,240,36,86,.419,26,63,.413,10,23,.435,12,14,.857,94
17890,2012-03-17,NOP,@,NJN,W 102-94,240,41,81,.506,33,65,.508,8,16,.500,12,13,.923,102
17891,2012-03-17,GSW,@,UTA,L 92-99 (OT),265,33,80,.413,27,55,.491,6,25,.240,20,25,.800,92
17892,2012-03-17,UTA,,GSW,W 99-92 (OT),265,42,101,.416,40,88,.455,2,13,.154,13,16,.813,99
17893,2012-03-16,ATL,,WAS,W 102-88,240,40,83,.482,28,56,.500,12,27,.444,10,13,.769,102
17894,2012-03-16,WAS,@,ATL,L 88-102,240,38,78,.487,33,67,.493,5,11,.455,7,9,.778,88
17895,2012-03-16,CHI,,POR,L 89-100,240,36,85,.424,28,58,.483,8,27,.296,9,11,.818,89
17896,2012-03-16,POR,@,CHI,W 100-89,240,39,79,.494,28,58,.483,11,21,.524,11,12,.917,100
17897,2012-03-16,GSW,,MIL,L 98-120,240,35,79,.443,25,57,.439,10,22,.455,18,20,.900,98
17898,2012-03-16,MIL,@,GSW,W 120-98,240,45,93,.484,35,71,.493,10,22,.455,20,22,.909,120
17899,2012-03-16,LAL,,MIN,W 97-92,240,33,80,.413,23,58,.397,10,22,.455,21,27,.778,97
17900,2012-03-16,MIN,@,LAL,L 92-97,240,37,92,.402,33,70,.471,4,22,.182,14,20,.700,92
17901,2012-03-16,MEM,,TOR,L 110-114 (OT),265,37,82,.451,32,66,.485,5,16,.313,31,51,.608,110
17902,2012-03-16,TOR,@,MEM,W 114-110 (OT),265,39,81,.481,32,66,.485,7,15,.467,29,38,.763,114
17903,2012-03-16,IND,@,NYK,L 100-115,240,32,81,.395,24,62,.387,8,19,.421,28,34,.824,100
17904,2012-03-16,NYK,,IND,W 115-100,240,41,81,.506,30,56,.536,11,25,.440,22,28,.786,115
17905,2012-03-16,OKC,,SAS,L 105-114,240,39,88,.443,30,63,.476,9,25,.360,18,20,.900,105
17906,2012-03-16,SAS,@,OKC,W 114-105,240,45,87,.517,36,68,.529,9,19,.474,15,25,.600,114
17907,2012-03-16,BRK,@,ORL,L 70-86,240,28,83,.337,22,63,.349,6,20,.300,8,10,.800,70
17908,2012-03-16,ORL,,NJN,W 86-70,240,34,67,.507,26,38,.684,8,29,.276,10,14,.714,86
17909,2012-03-16,MIA,@,PHI,W 84-78,240,35,74,.473,31,62,.500,4,12,.333,10,19,.526,84
17910,2012-03-16,PHI,,MIA,L 78-84,240,33,93,.355,28,75,.373,5,18,.278,7,14,.500,78
17911,2012-03-16,DET,@,PHO,L 101-109,240,40,78,.513,32,63,.508,8,15,.533,13,18,.722,101
17912,2012-03-16,PHO,,DET,W 109-101,240,41,83,.494,31,63,.492,10,20,.500,17,22,.773,109
17913,2012-03-16,BOS,@,SAC,L 95-120,240,36,80,.450,30,61,.492,6,19,.316,17,21,.810,95
17914,2012-03-16,SAC,,BOS,W 120-95,240,46,86,.535,37,65,.569,9,21,.429,19,21,.905,120
17915,2012-03-15,CHA,@,DAL,L 96-101,240,35,84,.417,27,63,.429,8,21,.381,18,20,.900,96
17916,2012-03-15,DAL,,CHA,W 101-96,240,38,84,.452,29,59,.492,9,25,.360,16,21,.762,101
17917,2012-03-15,DEN,,OKC,L 90-103,240,34,78,.436,29,56,.518,5,22,.227,17,25,.680,90
17918,2012-03-15,OKC,@,DEN,W 103-90,240,36,79,.456,24,54,.444,12,25,.480,19,24,.792,103
17919,2012-03-15,LAC,,PHO,L 87-91,240,39,85,.459,35,69,.507,4,16,.250,5,12,.417,87
17920,2012-03-15,PHO,@,LAC,W 91-87,240,32,78,.410,23,54,.426,9,24,.375,18,23,.783,91
17921,2012-03-15,NOP,,WAS,L 89-99,240,34,75,.453,30,61,.492,4,14,.286,17,19,.895,89
17922,2012-03-15,WAS,@,NOH,W 99-89,240,39,75,.520,33,57,.579,6,18,.333,15,17,.882,99
17923,2012-03-15,MIN,@,UTA,L 105-111 (OT),265,36,83,.434,27,56,.482,9,27,.333,24,33,.727,105
17924,2012-03-15,UTA,,MIN,W 111-105 (OT),265,43,103,.417,38,90,.422,5,13,.385,20,27,.741,111
17925,2012-03-14,CHI,,MIA,W 106-102,240,36,77,.468,26,58,.448,10,19,.526,24,26,.923,106
17926,2012-03-14,MIA,@,CHI,L 102-106,240,38,85,.447,32,73,.438,6,12,.500,20,23,.870,102
17927,2012-03-14,BOS,@,GSW,W 105-103,240,40,78,.513,34,65,.523,6,13,.462,19,21,.905,105
17928,2012-03-14,GSW,,BOS,L 103-105,240,41,78,.526,36,57,.632,5,21,.238,16,19,.842,103
17929,2012-03-14,CHA,@,HOU,L 87-107,240,33,81,.407,29,69,.420,4,12,.333,17,19,.895,87
17930,2012-03-14,HOU,,CHA,W 107-87,240,45,84,.536,39,75,.520,6,9,.667,11,17,.647,107
17931,2012-03-14,IND,,PHI,W 111-94,240,43,76,.566,36,59,.610,7,17,.412,18,22,.818,111
17932,2012-03-14,PHI,@,IND,L 94-111,240,40,76,.526,34,63,.540,6,13,.462,8,10,.800,94
17933,2012-03-14,ATL,@,LAC,L 82-96,240,29,68,.426,21,43,.488,8,25,.320,16,20,.800,82
17934,2012-03-14,LAC,,ATL,W 96-82,240,38,70,.543,28,50,.560,10,20,.500,10,17,.588,96
17935,2012-03-14,CLE,@,MIL,L 105-115,240,38,85,.447,27,61,.443,11,24,.458,18,25,.720,105
17936,2012-03-14,MIL,,CLE,W 115-105,240,46,86,.535,39,63,.619,7,23,.304,16,21,.762,115
17937,2012-03-14,BRK,,TOR,W 98-84,240,38,79,.481,31,62,.500,7,17,.412,15,17,.882,98
17938,2012-03-14,TOR,@,NJN,L 84-98,240,31,81,.383,30,71,.423,1,10,.100,21,25,.840,84
17939,2012-03-14,LAL,@,NOH,W 107-101 (OT),265,37,82,.451,32,63,.508,5,19,.263,28,35,.800,107
17940,2012-03-14,NOP,,LAL,L 101-107 (OT),265,44,85,.518,41,75,.547,3,10,.300,10,13,.769,101
17941,2012-03-14,NYK,,POR,W 121-79,240,43,80,.538,24,42,.571,19,38,.500,16,26,.615,121
17942,2012-03-14,POR,@,NYK,L 79-121,240,28,75,.373,23,58,.397,5,17,.294,18,23,.783,79
17943,2012-03-14,PHO,,UTA,W 120-111,240,44,78,.564,35,59,.593,9,19,.474,23,32,.719,120
17944,2012-03-14,UTA,@,PHO,L 111-120,240,47,90,.522,42,77,.545,5,13,.385,12,17,.706,111
17945,2012-03-14,DET,@,SAC,W 124-112,240,50,86,.581,42,73,.575,8,13,.615,16,20,.800,124
17946,2012-03-14,SAC,,DET,L 112-124,240,45,87,.517,40,68,.588,5,19,.263,17,24,.708,112
17947,2012-03-14,ORL,@,SAS,L 111-122,240,45,86,.523,34,59,.576,11,27,.407,10,16,.625,111
17948,2012-03-14,SAS,,ORL,W 122-111,240,43,83,.518,30,57,.526,13,26,.500,23,27,.852,122
17949,2012-03-13,CLE,,TOR,L 88-96,240,29,76,.382,26,61,.426,3,15,.200,27,33,.818,88
17950,2012-03-13,TOR,@,CLE,W 96-88,240,37,74,.500,29,55,.527,8,19,.421,14,21,.667,96
17951,2012-03-13,DAL,,WAS,W 107-98,240,44,87,.506,38,65,.585,6,22,.273,13,15,.867,107
17952,2012-03-13,WAS,@,DAL,L 98-107,240,35,80,.438,33,68,.485,2,12,.167,26,38,.684,98
17953,2012-03-13,ATL,@,DEN,L 117-118 (OT),265,43,92,.467,29,63,.460,14,29,.483,17,19,.895,117
17954,2012-03-13,DEN,,ATL,W 118-117 (OT),265,45,87,.517,38,67,.567,7,20,.350,21,26,.808,118
17955,2012-03-13,IND,,POR,W 92-75,240,40,82,.488,36,71,.507,4,11,.364,8,15,.533,92
17956,2012-03-13,POR,@,IND,L 75-92,240,20,64,.313,15,42,.357,5,22,.227,30,38,.789,75
17957,2012-03-13,LAL,@,MEM,W 116-111 (2OT),290,41,83,.494,35,63,.556,6,20,.300,28,34,.824,116
17958,2012-03-13,MEM,,LAL,L 111-116 (2OT),290,52,116,.448,50,97,.515,2,19,.105,5,5,1.000,111
17959,2012-03-13,HOU,@,OKC,W 104-103,240,41,89,.461,31,65,.477,10,24,.417,12,14,.857,104
17960,2012-03-13,OKC,,HOU,L 103-104,240,39,84,.464,31,61,.508,8,23,.348,17,22,.773,103
17961,2012-03-13,MIA,@,ORL,L 98-104 (OT),265,40,91,.440,32,68,.471,8,23,.348,10,11,.909,98
17962,2012-03-13,ORL,,MIA,W 104-98 (OT),265,36,73,.493,25,45,.556,11,28,.393,21,37,.568,104
17963,2012-03-13,GSW,@,SAC,W 115-89,240,46,91,.505,34,67,.507,12,24,.500,11,15,.733,115
17964,2012-03-13,SAC,,GSW,L 89-115,240,33,82,.402,26,63,.413,7,19,.368,16,21,.762,89
17965,2012-03-12,CHI,,NYK,W 104-99,240,40,93,.430,35,79,.443,5,14,.357,19,28,.679,104
17966,2012-03-12,NYK,@,CHI,L 99-104,240,37,80,.463,34,69,.493,3,11,.273,22,31,.710,99
17967,2012-03-12,BOS,@,LAC,W 94-85,240,33,67,.493,28,54,.519,5,13,.385,23,27,.852,94
17968,2012-03-12,LAC,,BOS,L 85-94,240,31,83,.373,26,60,.433,5,23,.217,18,21,.857,85
17969,2012-03-12,MIL,@,NJN,W 105-99,240,43,92,.467,33,67,.493,10,25,.400,9,11,.818,105
17970,2012-03-12,BRK,,MIL,L 99-105,240,37,76,.487,33,59,.559,4,17,.235,21,29,.724,99
17971,2012-03-12,CHA,@,NOH,W 73-71,240,34,79,.430,34,67,.507,0,12,.000,5,7,.714,73
17972,2012-03-12,NOP,,CHA,L 71-73,240,30,78,.385,25,66,.379,5,12,.417,6,7,.857,71
17973,2012-03-12,MIN,@,PHO,W 127-124,240,50,89,.562,36,67,.537,14,22,.636,13,21,.619,127
17974,2012-03-12,PHO,,MIN,L 124-127,240,46,89,.517,37,68,.544,9,21,.429,23,29,.793,124
17975,2012-03-12,SAS,,WAS,W 112-97,240,47,87,.540,39,65,.600,8,22,.364,10,19,.526,112
17976,2012-03-12,WAS,@,SAS,L 97-112,240,39,87,.448,31,70,.443,8,17,.471,11,14,.786,97
17977,2012-03-12,DET,@,UTA,L 90-105,240,34,71,.479,31,59,.525,3,12,.250,19,28,.679,90
17978,2012-03-12,UTA,,DET,W 105-90,240,39,72,.542,32,61,.525,7,11,.636,20,26,.769,105
17979,2012-03-11,CLE,,HOU,W 118-107,240,39,82,.476,28,62,.452,11,20,.550,29,36,.806,118
17980,2012-03-11,HOU,@,CLE,L 107-118,240,44,86,.512,36,69,.522,8,17,.471,11,17,.647,107
17981,2012-03-11,DEN,,MEM,L 91-94,240,32,79,.405,28,70,.400,4,9,.444,23,30,.767,91
17982,2012-03-11,MEM,@,DEN,W 94-91,240,37,73,.507,32,58,.552,5,15,.333,15,23,.652,94
17983,2012-03-11,GSW,@,LAC,W 97-93,240,36,70,.514,28,55,.509,8,15,.533,17,21,.810,97
17984,2012-03-11,LAC,,GSW,L 93-97,240,34,79,.430,28,60,.467,6,19,.316,19,35,.543,93
17985,2012-03-11,BOS,@,LAL,L 94-97,240,39,83,.470,33,66,.500,6,17,.353,10,12,.833,94
17986,2012-03-11,LAL,,BOS,W 97-94,240,36,71,.507,28,55,.509,8,16,.500,17,26,.654,97
17987,2012-03-11,NYK,,PHI,L 94-106,240,33,80,.413,26,63,.413,7,17,.412,21,26,.808,94
17988,2012-03-11,PHI,@,NYK,W 106-94,240,40,79,.506,35,70,.500,5,9,.556,21,26,.808,106
17989,2012-03-11,IND,@,ORL,L 94-107,240,39,82,.476,38,70,.543,1,12,.083,15,18,.833,94
17990,2012-03-11,ORL,,IND,W 107-94,240,37,79,.468,27,52,.519,10,27,.370,23,30,.767,107
17991,2012-03-11,ATL,@,SAC,W 106-99,240,42,82,.512,35,61,.574,7,21,.333,15,23,.652,106
17992,2012-03-11,SAC,,ATL,L 99-106,240,38,82,.463,28,53,.528,10,29,.345,13,17,.765,99
17993,2012-03-11,MIL,@,TOR,W 105-99,240,35,73,.479,29,55,.527,6,18,.333,29,35,.829,105
17994,2012-03-11,TOR,,MIL,L 99-105,240,40,86,.465,36,73,.493,4,13,.308,15,19,.789,99
17995,2012-03-10,CHI,,UTA,W 111-97,240,43,77,.558,36,59,.610,7,18,.389,18,24,.750,111
17996,2012-03-10,UTA,@,CHI,L 97-111,240,40,85,.471,40,82,.488,0,3,.000,17,22,.773,97
17997,2012-03-10,DET,,TOR,W 105-86,240,39,74,.527,32,53,.604,7,21,.333,20,25,.800,105
17998,2012-03-10,TOR,@,DET,L 86-105,240,29,73,.397,24,52,.462,5,21,.238,23,25,.920,86
17999,2012-03-10,DAL,@,GSW,L 87-111,240,28,75,.373,18,52,.346,10,23,.435,21,26,.808,87
18000,2012-03-10,GSW,,DAL,W 111-87,240,40,74,.541,30,49,.612,10,25,.400,21,25,.840,111
18001,2012-03-10,IND,@,MIA,L 91-93 (OT),265,33,88,.375,26,71,.366,7,17,.412,18,25,.720,91
18002,2012-03-10,MIA,,IND,W 93-91 (OT),265,35,75,.467,32,62,.516,3,13,.231,20,31,.645,93
18003,2012-03-10,MIN,,NOH,L 89-95,240,33,80,.413,28,57,.491,5,23,.217,18,25,.720,89
18004,2012-03-10,NOP,@,MIN,W 95-89,240,39,85,.459,36,78,.462,3,7,.429,14,16,.875,95
18005,2012-03-10,HOU,@,NJN,W 112-106,240,46,82,.561,37,66,.561,9,16,.563,11,14,.786,112
18006,2012-03-10,BRK,,HOU,L 106-112,240,43,81,.531,34,57,.596,9,24,.375,11,14,.786,106
18007,2012-03-10,CHA,@,OKC,L 95-122,240,36,88,.409,29,74,.392,7,14,.500,16,19,.842,95
18008,2012-03-10,OKC,,CHA,W 122-95,240,46,73,.630,36,50,.720,10,23,.435,20,26,.769,122
18009,2012-03-10,MEM,@,PHO,L 91-98,240,36,86,.419,31,72,.431,5,14,.357,14,19,.737,91
18010,2012-03-10,PHO,,MEM,W 98-91,240,41,86,.477,37,75,.493,4,11,.364,12,15,.800,98
18011,2012-03-10,POR,@,WAS,W 110-99,240,40,78,.513,36,61,.590,4,17,.235,26,27,.963,110
18012,2012-03-10,WAS,,POR,L 99-110,240,39,82,.476,34,66,.515,5,16,.313,16,25,.640,99
18013,2012-03-09,BOS,,POR,W 104-86,240,42,88,.477,34,70,.486,8,18,.444,12,17,.706,104
18014,2012-03-09,POR,@,BOS,L 86-104,240,31,72,.431,25,57,.439,6,15,.400,18,23,.783,86
18015,2012-03-09,CHA,,NJN,L 74-83,240,30,86,.349,28,75,.373,2,11,.182,12,21,.571,74
18016,2012-03-09,BRK,@,CHA,W 83-74,240,30,83,.361,26,61,.426,4,22,.182,19,26,.731,83
18017,2012-03-09,DEN,,NOH,W 110-97,240,41,73,.562,35,50,.700,6,23,.261,22,32,.688,110
18018,2012-03-09,NOP,@,DEN,L 97-110,240,33,72,.458,29,61,.475,4,11,.364,27,32,.844,97
18019,2012-03-09,ATL,@,DET,L 85-86,240,31,73,.425,23,54,.426,8,19,.421,15,22,.682,85
18020,2012-03-09,DET,,ATL,W 86-85,240,38,68,.559,37,60,.617,1,8,.125,9,15,.600,86
18021,2012-03-09,MIL,,NYK,W 119-114,240,45,93,.484,32,67,.478,13,26,.500,16,21,.762,119
18022,2012-03-09,NYK,@,MIL,L 114-119,240,46,83,.554,39,66,.591,7,17,.412,15,21,.714,114
18023,2012-03-09,LAL,@,MIN,W 105-102,240,39,82,.476,33,64,.516,6,18,.333,21,27,.778,105
18024,2012-03-09,MIN,,LAL,L 102-105,240,37,81,.457,29,61,.475,8,20,.400,20,26,.769,102
18025,2012-03-09,CLE,@,OKC,W 96-90,240,38,91,.418,33,74,.446,5,17,.294,15,24,.625,96
18026,2012-03-09,OKC,,CLE,L 90-96,240,37,76,.487,31,52,.596,6,24,.250,10,17,.588,90
18027,2012-03-09,PHI,,UTA,W 104-91,240,41,78,.526,38,71,.535,3,7,.429,19,27,.704,104
18028,2012-03-09,UTA,@,PHI,L 91-104,240,34,84,.405,31,73,.425,3,11,.273,20,24,.833,91
18029,2012-03-09,DAL,@,SAC,L 97-110,240,39,86,.453,33,64,.516,6,22,.273,13,18,.722,97
18030,2012-03-09,SAC,,DAL,W 110-97,240,43,85,.506,32,58,.552,11,27,.407,13,13,1.000,110
18031,2012-03-09,LAC,@,SAS,W 120-108,240,43,84,.512,29,57,.509,14,27,.519,20,24,.833,120
18032,2012-03-09,SAS,,LAC,L 108-120,240,38,78,.487,26,48,.542,12,30,.400,20,32,.625,108
18033,2012-03-08,CHI,,ORL,L 94-99,240,35,86,.407,30,64,.469,5,22,.227,19,26,.731,94
18034,2012-03-08,ORL,@,CHI,W 99-94,240,32,76,.421,21,50,.420,11,26,.423,24,31,.774,99
18035,2012-03-08,DAL,@,PHO,L 94-96,240,38,87,.437,30,65,.462,8,22,.364,10,13,.769,94
18036,2012-03-08,PHO,,DAL,W 96-94,240,37,76,.487,34,62,.548,3,14,.214,19,27,.704,96
18037,2012-03-07,CHA,,UTA,L 93-99,240,32,68,.471,29,61,.475,3,7,.429,26,37,.703,93
18038,2012-03-07,UTA,@,CHA,W 99-93,240,39,87,.448,38,80,.475,1,7,.143,20,24,.833,99
18039,2012-03-07,CLE,@,DEN,W 100-99,240,37,82,.451,30,59,.508,7,23,.304,19,23,.826,100
18040,2012-03-07,DEN,,CLE,L 99-100,240,35,81,.432,31,61,.508,4,20,.200,25,32,.781,99
18041,2012-03-07,GSW,,MEM,L 92-110,240,35,79,.443,27,61,.443,8,18,.444,14,23,.609,92
18042,2012-03-07,MEM,@,GSW,W 110-92,240,42,80,.525,35,61,.574,7,19,.368,19,21,.905,110
18043,2012-03-07,ATL,@,MIA,L 86-89,240,35,76,.461,27,53,.509,8,23,.348,8,9,.889,86
18044,2012-03-07,MIA,,ATL,W 89-86,240,35,80,.438,35,70,.500,0,10,.000,19,25,.760,89
18045,2012-03-07,CHI,@,MIL,W 106-104,240,43,83,.518,38,67,.567,5,16,.313,15,17,.882,106
18046,2012-03-07,MIL,,CHI,L 104-106,240,42,88,.477,37,73,.507,5,15,.333,15,19,.789,104
18047,2012-03-07,MIN,,POR,W 106-94,240,37,78,.474,24,55,.436,13,23,.565,19,26,.731,106
18048,2012-03-07,POR,@,MIN,L 94-106,240,44,93,.473,41,70,.586,3,23,.130,3,4,.750,94
18049,2012-03-07,LAC,@,NJN,L 100-101,240,35,76,.461,24,54,.444,11,22,.500,19,27,.704,100
18050,2012-03-07,BRK,,LAC,W 101-100,240,33,72,.458,23,47,.489,10,25,.400,25,31,.806,101
18051,2012-03-07,OKC,,PHO,W 115-104,240,40,91,.440,32,65,.492,8,26,.308,27,32,.844,115
18052,2012-03-07,PHO,@,OKC,L 104-115,240,38,84,.452,35,65,.538,3,19,.158,25,34,.735,104
18053,2012-03-07,BOS,@,PHI,L 71-103,240,28,80,.350,28,72,.389,0,8,.000,15,18,.833,71
18054,2012-03-07,PHI,,BOS,W 103-71,240,43,89,.483,37,72,.514,6,17,.353,11,15,.733,103
18055,2012-03-07,NOP,@,SAC,L 98-99,240,42,77,.545,39,68,.574,3,9,.333,11,12,.917,98
18056,2012-03-07,SAC,,NOH,W 99-98,240,38,76,.500,30,53,.566,8,23,.348,15,23,.652,99
18057,2012-03-07,NYK,@,SAS,L 105-118,240,41,96,.427,31,68,.456,10,28,.357,13,17,.765,105
18058,2012-03-07,SAS,,NYK,W 118-105,240,46,85,.541,39,66,.591,7,19,.368,19,25,.760,118
18059,2012-03-07,HOU,@,TOR,L 98-116,240,29,70,.414,26,59,.441,3,11,.273,37,44,.841,98
18060,2012-03-07,TOR,,HOU,W 116-98,240,45,76,.592,39,64,.609,6,12,.500,20,24,.833,116
18061,2012-03-07,LAL,@,WAS,L 101-106,240,32,81,.395,24,60,.400,8,21,.381,29,37,.784,101
18062,2012-03-07,WAS,,LAL,W 106-101,240,43,92,.467,36,66,.545,7,26,.269,13,19,.684,106
18063,2012-03-06,BOS,,HOU,W 97-92 (OT),265,35,81,.432,31,67,.463,4,14,.286,23,31,.742,97
18064,2012-03-06,HOU,@,BOS,L 92-97 (OT),265,32,83,.386,27,64,.422,5,19,.263,23,29,.793,92
18065,2012-03-06,CHA,,ORL,W 100-84,240,38,80,.475,34,70,.486,4,10,.400,20,27,.741,100
18066,2012-03-06,ORL,@,CHA,L 84-100,240,31,80,.388,18,45,.400,13,35,.371,9,17,.529,84
18067,2012-03-06,DAL,,NYK,W 95-85,240,31,80,.388,24,54,.444,7,26,.269,26,30,.867,95
18068,2012-03-06,NYK,@,DAL,L 85-95,240,32,84,.381,26,61,.426,6,23,.261,15,23,.652,85
18069,2012-03-06,DET,,LAL,W 88-85 (OT),265,37,93,.398,34,83,.410,3,10,.300,11,12,.917,88
18070,2012-03-06,LAL,@,DET,L 85-88 (OT),265,34,81,.420,31,59,.525,3,22,.136,14,17,.824,85
18071,2012-03-06,ATL,@,IND,W 101-96,240,38,83,.458,30,64,.469,8,19,.421,17,22,.773,101
18072,2012-03-06,IND,,ATL,L 96-101,240,31,70,.443,26,55,.473,5,15,.333,29,40,.725,96
18073,2012-03-06,MIA,,NJN,W 108-78,240,45,77,.584,35,60,.583,10,17,.588,8,9,.889,108
18074,2012-03-06,BRK,@,MIA,L 78-108,240,31,83,.373,23,61,.377,8,22,.364,8,12,.667,78
18075,2012-03-05,CHI,,IND,W 92-72,240,33,78,.423,24,63,.381,9,15,.600,17,27,.630,92
18076,2012-03-05,IND,@,CHI,L 72-92,240,27,79,.342,24,63,.381,3,16,.188,15,22,.682,72
18077,2012-03-05,CLE,,UTA,L 100-109,240,37,81,.457,28,58,.483,9,23,.391,17,27,.630,100
18078,2012-03-05,UTA,@,CLE,W 109-100,240,40,80,.500,35,71,.493,5,9,.556,24,29,.828,109
18079,2012-03-05,DEN,,SAC,W 119-116 (OT),265,40,88,.455,29,61,.475,11,27,.407,28,35,.800,119
18080,2012-03-05,SAC,@,DEN,L 116-119 (OT),265,45,98,.459,33,71,.465,12,27,.444,14,21,.667,116
18081,2012-03-05,MIL,,PHI,W 97-93,240,35,88,.398,28,68,.412,7,20,.350,20,23,.870,97
18082,2012-03-05,PHI,@,MIL,L 93-97,240,35,94,.372,28,75,.373,7,19,.368,16,23,.696,93
18083,2012-03-05,LAC,@,MIN,L 94-95,240,34,84,.405,29,61,.475,5,23,.217,21,32,.656,94
18084,2012-03-05,MIN,,LAC,W 95-94,240,32,80,.400,21,52,.404,11,28,.393,20,27,.741,95
18085,2012-03-05,DAL,@,OKC,L 91-95,240,36,84,.429,27,63,.429,9,21,.429,10,10,1.000,91
18086,2012-03-05,OKC,,DAL,W 95-91,240,29,76,.382,21,49,.429,8,27,.296,29,33,.879,95
18087,2012-03-05,NOP,@,POR,L 74-86,240,29,70,.414,26,61,.426,3,9,.333,13,22,.591,74
18088,2012-03-05,POR,,NOH,W 86-74,240,31,72,.431,25,50,.500,6,22,.273,18,24,.750,86
18089,2012-03-05,ORL,@,TOR,W 92-88,240,35,79,.443,26,51,.510,9,28,.321,13,28,.464,92
18090,2012-03-05,TOR,,ORL,L 88-92,240,32,79,.405,24,59,.407,8,20,.400,16,20,.800,88
18091,2012-03-05,GSW,@,WAS,W 120-100,240,45,83,.542,30,60,.500,15,23,.652,15,16,.938,120
18092,2012-03-05,WAS,,GSW,L 100-120,240,36,85,.424,28,63,.444,8,22,.364,20,36,.556,100
18093,2012-03-04,BOS,,NYK,W 115-111 (OT),265,45,103,.437,38,85,.447,7,18,.389,18,22,.818,115
18094,2012-03-04,NYK,@,BOS,L 111-115 (OT),265,41,94,.436,33,76,.434,8,18,.444,21,26,.808,111
18095,2012-03-04,CHA,,NJN,L 101-104,240,31,80,.388,29,66,.439,2,14,.143,37,39,.949,101
18096,2012-03-04,BRK,@,CHA,W 104-101,240,33,68,.485,28,51,.549,5,17,.294,33,44,.750,104
18097,2012-03-04,HOU,,LAC,L 103-105 (OT),265,37,86,.430,27,66,.409,10,20,.500,19,24,.792,103
18098,2012-03-04,LAC,@,HOU,W 105-103 (OT),265,40,86,.465,34,72,.472,6,14,.429,19,25,.760,105
18099,2012-03-04,LAL,,MIA,W 93-83,240,35,71,.493,30,54,.556,5,17,.294,18,25,.720,93
18100,2012-03-04,MIA,@,LAL,L 83-93,240,33,88,.375,26,64,.406,7,24,.292,10,15,.667,83
18101,2012-03-04,CHI,@,PHI,W 96-91,240,39,82,.476,32,66,.485,7,16,.438,11,16,.688,96
18102,2012-03-04,PHI,,CHI,L 91-96,240,38,97,.392,37,86,.430,1,11,.091,14,17,.824,91
18103,2012-03-04,PHO,,SAC,W 96-88,240,40,88,.455,35,76,.461,5,12,.417,11,16,.688,96
18104,2012-03-04,SAC,@,PHO,L 88-96,240,38,99,.384,36,86,.419,2,13,.154,10,14,.714,88
18105,2012-03-04,DEN,@,SAS,W 99-94,240,36,86,.419,30,69,.435,6,17,.353,21,28,.750,99
18106,2012-03-04,SAS,,DEN,L 94-99,240,32,72,.444,22,45,.489,10,27,.370,20,27,.741,94
18107,2012-03-04,GSW,@,TOR,L 75-83,240,29,80,.363,25,61,.410,4,19,.211,13,19,.684,75
18108,2012-03-04,TOR,,GSW,W 83-75,240,29,78,.372,25,68,.368,4,10,.400,21,24,.875,83
18109,2012-03-03,ATL,,OKC,W 97-90,240,37,85,.435,29,68,.426,8,17,.471,15,22,.682,97
18110,2012-03-03,OKC,@,ATL,L 90-97,240,30,73,.411,24,50,.480,6,23,.261,24,29,.828,90
18111,2012-03-03,DAL,,UTA,W 102-96,240,36,75,.480,26,52,.500,10,23,.435,20,24,.833,102
18112,2012-03-03,UTA,@,DAL,L 96-102,240,38,85,.447,34,69,.493,4,16,.250,16,21,.762,96
18113,2012-03-03,DET,@,MEM,L 83-100,240,29,76,.382,27,67,.403,2,9,.222,23,29,.793,83
18114,2012-03-03,MEM,,DET,W 100-83,240,37,75,.493,31,64,.484,6,11,.545,20,22,.909,100
18115,2012-03-03,IND,@,NOH,W 102-84,240,35,80,.438,26,61,.426,9,19,.474,23,32,.719,102
18116,2012-03-03,NOP,,IND,L 84-102,240,33,81,.407,29,69,.420,4,12,.333,14,21,.667,84
18117,2012-03-03,MIL,@,ORL,L 98-114,240,37,79,.468,31,63,.492,6,16,.375,18,27,.667,98
18118,2012-03-03,ORL,,MIL,W 114-98,240,42,81,.519,28,54,.519,14,27,.519,16,27,.593,114
18119,2012-03-03,MIN,@,POR,W 122-110,240,43,80,.538,31,57,.544,12,23,.522,24,28,.857,122
18120,2012-03-03,POR,,MIN,L 110-122,240,40,83,.482,30,57,.526,10,26,.385,20,28,.714,110
18121,2012-03-03,CLE,@,WAS,L 98-101,240,37,83,.446,29,62,.468,8,21,.381,16,26,.615,98
18122,2012-03-03,WAS,,CLE,W 101-98,240,40,87,.460,32,66,.485,8,21,.381,13,21,.619,101
18123,2012-03-02,ATL,,MIL,W 99-94,240,39,86,.453,31,63,.492,8,23,.348,13,15,.867,99
18124,2012-03-02,MIL,@,ATL,L 94-99,240,32,85,.376,26,67,.388,6,18,.333,24,28,.857,94
18125,2012-03-02,BOS,,NJN,W 107-94,240,45,87,.517,41,71,.577,4,16,.250,13,17,.765,107
18126,2012-03-02,BRK,@,BOS,L 94-107,240,34,76,.447,29,57,.509,5,19,.263,21,28,.750,94
18127,2012-03-02,CHI,@,CLE,W 112-91,240,47,89,.528,37,69,.536,10,20,.500,8,12,.667,112
18128,2012-03-02,CLE,,CHI,L 91-112,240,35,80,.438,26,58,.448,9,22,.409,12,16,.750,91
18129,2012-03-02,DEN,@,HOU,W 117-105,240,43,97,.443,35,75,.467,8,22,.364,23,35,.657,117
18130,2012-03-02,HOU,,DEN,L 105-117,240,36,76,.474,26,47,.553,10,29,.345,23,29,.793,105
18131,2012-03-02,LAL,,SAC,W 115-107,240,44,82,.537,38,65,.585,6,17,.353,21,26,.808,115
18132,2012-03-02,SAC,@,LAL,L 107-115,240,45,103,.437,36,78,.462,9,25,.360,8,9,.889,107
18133,2012-03-02,DAL,@,NOH,L 92-97,240,37,83,.446,26,54,.481,11,29,.379,7,10,.700,92
18134,2012-03-02,NOP,,DAL,W 97-92,240,40,88,.455,37,75,.493,3,13,.231,14,17,.824,97
18135,2012-03-02,GSW,@,PHI,L 83-105,240,33,82,.402,28,64,.438,5,18,.278,12,14,.857,83
18136,2012-03-02,PHI,,GSW,W 105-83,240,42,89,.472,34,72,.472,8,17,.471,13,16,.813,105
18137,2012-03-02,LAC,@,PHO,L 78-81,240,32,87,.368,26,71,.366,6,16,.375,8,9,.889,78
18138,2012-03-02,PHO,,LAC,W 81-78,240,28,80,.350,21,59,.356,7,21,.333,18,29,.621,81
18139,2012-03-02,CHA,@,SAS,L 72-102,240,31,83,.373,28,67,.418,3,16,.188,7,10,.700,72
18140,2012-03-02,SAS,,CHA,W 102-72,240,39,82,.476,29,62,.468,10,20,.500,14,21,.667,102
18141,2012-03-02,MEM,@,TOR,W 102-99,240,38,81,.469,34,70,.486,4,11,.364,22,32,.688,102
18142,2012-03-02,TOR,,MEM,L 99-102,240,38,72,.528,32,56,.571,6,16,.375,17,20,.850,99
18143,2012-03-02,MIA,@,UTA,L 98-99,240,37,75,.493,29,58,.500,8,17,.471,16,22,.727,98
18144,2012-03-02,UTA,,MIA,W 99-98,240,38,90,.422,35,80,.438,3,10,.300,20,27,.741,99
18145,2012-03-01,OKC,@,ORL,W 105-102,240,38,74,.514,30,56,.536,8,18,.444,21,27,.778,105
18146,2012-03-01,ORL,,OKC,L 102-105,240,40,84,.476,31,59,.525,9,25,.360,13,19,.684,102
18147,2012-03-01,MIN,@,PHO,L 95-104,240,34,86,.395,33,73,.452,1,13,.077,26,32,.813,95
18148,2012-03-01,PHO,,MIN,W 104-95,240,42,79,.532,39,71,.549,3,8,.375,17,21,.810,104
18149,2012-03-01,MIA,@,POR,W 107-93,240,39,82,.476,33,71,.465,6,11,.545,23,29,.793,107
18150,2012-03-01,POR,,MIA,L 93-107,240,36,76,.474,31,60,.517,5,16,.313,16,19,.842,93
18151,2012-03-01,LAC,@,SAC,W 108-100,240,44,92,.478,32,69,.464,12,23,.522,8,8,1.000,108
18152,2012-03-01,SAC,,LAC,L 100-108,240,37,79,.468,28,59,.475,9,20,.450,17,23,.739,100
18153,2012-02-29,ATL,,GSW,L 82-85,240,31,92,.337,27,74,.365,4,18,.222,16,26,.615,82
18154,2012-02-29,GSW,@,ATL,W 85-82,240,34,83,.410,33,71,.465,1,12,.083,16,17,.941,85
18155,2012-02-29,BOS,,MIL,W 102-96,240,40,87,.460,37,71,.521,3,16,.188,19,28,.679,102
18156,2012-02-29,MIL,@,BOS,L 96-102,240,39,96,.406,35,81,.432,4,15,.267,14,16,.875,96
18157,2012-02-29,DEN,,POR,W 104-95,240,44,91,.484,38,70,.543,6,21,.286,10,16,.625,104
18158,2012-02-29,POR,@,DEN,L 95-104,240,38,87,.437,29,63,.460,9,24,.375,10,11,.909,95
18159,2012-02-29,CHA,@,DET,L 94-109,240,36,82,.439,33,73,.452,3,9,.333,19,29,.655,94
18160,2012-02-29,DET,,CHA,W 109-94,240,42,84,.500,41,74,.554,1,10,.100,24,32,.750,109
18161,2012-02-29,LAL,,MIN,W 104-85,240,41,84,.488,36,63,.571,5,21,.238,17,22,.773,104
18162,2012-02-29,MIN,@,LAL,L 85-104,240,35,89,.393,30,70,.429,5,19,.263,10,18,.556,85
18163,2012-02-29,DAL,@,MEM,L 85-96,240,35,79,.443,31,56,.554,4,23,.174,11,14,.786,85
18164,2012-02-29,MEM,,DAL,W 96-85,240,39,80,.488,37,68,.544,2,12,.167,16,19,.842,96
18165,2012-02-29,NOP,,TOR,L 84-95,240,30,80,.375,27,64,.422,3,16,.188,21,27,.778,84
18166,2012-02-29,TOR,@,NOH,W 95-84,240,34,77,.442,25,62,.403,9,15,.600,18,23,.783,95
18167,2012-02-29,CLE,@,NYK,L 103-120,240,38,82,.463,29,62,.468,9,20,.450,18,27,.667,103
18168,2012-02-29,NYK,,CLE,W 120-103,240,43,85,.506,37,65,.569,6,20,.300,28,42,.667,120
18169,2012-02-29,OKC,@,PHI,W 92-88,240,30,78,.385,24,59,.407,6,19,.316,26,34,.765,92
18170,2012-02-29,PHI,,OKC,L 88-92,240,37,90,.411,33,73,.452,4,17,.235,10,12,.833,88
18171,2012-02-29,CHI,@,SAS,W 96-89,240,37,88,.420,30,73,.411,7,15,.467,15,21,.714,96
18172,2012-02-29,SAS,,CHI,L 89-96,240,37,86,.430,29,66,.439,8,20,.400,7,12,.583,89
18173,2012-02-29,HOU,@,UTA,L 83-104,240,32,82,.390,26,59,.441,6,23,.261,13,16,.813,83
18174,2012-02-29,UTA,,HOU,W 104-83,240,42,87,.483,38,75,.507,4,12,.333,16,16,1.000,104
18175,2012-02-29,ORL,@,WAS,W 102-95,240,34,75,.453,19,39,.487,15,36,.417,19,27,.704,102
18176,2012-02-29,WAS,,ORL,L 95-102,240,37,90,.411,31,74,.419,6,16,.375,15,19,.789,95
18177,2012-02-28,CHI,,NOH,W 99-95,240,41,90,.456,38,72,.528,3,18,.167,14,20,.700,99
18178,2012-02-28,NOP,@,CHI,L 95-99,240,36,89,.404,32,80,.400,4,9,.444,19,22,.864,95
18179,2012-02-28,BOS,@,CLE,W 86-83,240,33,74,.446,26,57,.456,7,17,.412,13,14,.929,86
18180,2012-02-28,CLE,,BOS,L 83-86,240,31,78,.397,27,61,.443,4,17,.235,17,25,.680,83
18181,2012-02-28,DAL,,NJN,L 92-93,240,32,89,.360,24,64,.375,8,25,.320,20,28,.714,92
18182,2012-02-28,BRK,@,DAL,W 93-92,240,37,84,.440,30,59,.508,7,25,.280,12,14,.857,93
18183,2012-02-28,DET,,PHI,L 68-97,240,25,79,.316,23,69,.333,2,10,.200,16,20,.800,68
18184,2012-02-28,PHI,@,DET,W 97-68,240,42,84,.500,37,71,.521,5,13,.385,8,9,.889,97
18185,2012-02-28,HOU,,TOR,W 88-85,240,29,75,.387,22,55,.400,7,20,.350,23,28,.821,88
18186,2012-02-28,TOR,@,HOU,L 85-88,240,35,75,.467,33,58,.569,2,17,.118,13,18,.722,85
18187,2012-02-28,GSW,@,IND,L 78-102,240,29,85,.341,26,63,.413,3,22,.136,17,24,.708,78
18188,2012-02-28,IND,,GSW,W 102-78,240,37,84,.440,32,73,.438,5,11,.455,23,32,.719,102
18189,2012-02-28,LAC,,MIN,L 97-109,240,40,85,.471,38,74,.514,2,11,.182,15,22,.682,97
18190,2012-02-28,MIN,@,LAC,W 109-97,240,40,78,.513,30,56,.536,10,22,.455,19,27,.704,109
18191,2012-02-28,MIL,,WAS,W 119-118,240,41,91,.451,33,66,.500,8,25,.320,29,37,.784,119
18192,2012-02-28,WAS,@,MIL,L 118-119,240,42,87,.483,29,63,.460,13,24,.542,21,21,1.000,118
18193,2012-02-28,SAC,,UTA,W 103-96,240,37,84,.440,32,64,.500,5,20,.250,24,29,.828,103
18194,2012-02-28,UTA,@,SAC,L 96-103,240,40,85,.471,35,72,.486,5,13,.385,11,22,.500,96
18195,2012-02-23,ATL,,ORL,W 83-78,240,31,78,.397,24,61,.393,7,17,.412,14,20,.700,83
18196,2012-02-23,ORL,@,ATL,L 78-83,240,31,82,.378,24,50,.480,7,32,.219,9,13,.692,78
18197,2012-02-23,DEN,,SAS,L 99-114,240,37,83,.446,30,64,.469,7,19,.368,18,21,.857,99
18198,2012-02-23,SAS,@,DEN,W 114-99,240,41,86,.477,28,59,.475,13,27,.481,19,23,.826,114
18199,2012-02-23,MIA,,NYK,W 102-88,240,42,85,.494,38,71,.535,4,14,.286,14,19,.737,102
18200,2012-02-23,NYK,@,MIA,L 88-102,240,31,79,.392,24,62,.387,7,17,.412,19,22,.864,88
18201,2012-02-23,LAL,@,OKC,L 85-100,240,30,78,.385,26,65,.400,4,13,.308,21,23,.913,85
18202,2012-02-23,OKC,,LAL,W 100-85,240,36,77,.468,29,52,.558,7,25,.280,21,25,.840,100
18203,2012-02-22,CHA,,IND,L 88-102,240,31,88,.352,23,69,.333,8,19,.421,18,23,.783,88
18204,2012-02-22,IND,@,CHA,W 102-88,240,34,85,.400,27,69,.391,7,16,.438,27,32,.844,102
18205,2012-02-22,CHI,,MIL,W 110-91,240,43,79,.544,37,66,.561,6,13,.462,18,24,.750,110
18206,2012-02-22,MIL,@,CHI,L 91-110,240,37,88,.420,35,75,.467,2,13,.154,15,19,.789,91
18207,2012-02-22,CLE,,NOH,L 84-89,240,27,85,.318,21,58,.362,6,27,.222,24,37,.649,84
18208,2012-02-22,NOP,@,CLE,W 89-84,240,36,89,.404,34,79,.430,2,10,.200,15,20,.750,89
18209,2012-02-22,DAL,,LAL,L 91-96,240,36,90,.400,28,58,.483,8,32,.250,11,16,.688,91
18210,2012-02-22,LAL,@,DAL,W 96-91,240,35,76,.461,27,56,.482,8,20,.400,18,31,.581,96
18211,2012-02-22,HOU,,PHI,W 93-87,240,36,78,.462,31,60,.517,5,18,.278,16,20,.800,93
18212,2012-02-22,PHI,@,HOU,L 87-93,240,33,82,.402,33,73,.452,0,9,.000,21,27,.778,87
18213,2012-02-22,DEN,@,LAC,L 95-103,240,33,82,.402,27,59,.458,6,23,.261,23,31,.742,95
18214,2012-02-22,LAC,,DEN,W 103-95,240,38,86,.442,31,59,.525,7,27,.259,20,28,.714,103
18215,2012-02-22,MIN,,UTA,W 100-98,240,31,77,.403,20,55,.364,11,22,.500,27,38,.711,100
18216,2012-02-22,UTA,@,MIN,L 98-100,240,39,85,.459,38,78,.487,1,7,.143,19,24,.792,98
18217,2012-02-22,BRK,,ORL,L 91-108,240,38,81,.469,29,57,.509,9,24,.375,6,9,.667,91
18218,2012-02-22,ORL,@,NJN,W 108-91,240,45,84,.536,32,55,.582,13,29,.448,5,15,.333,108
18219,2012-02-22,ATL,@,NYK,L 82-99,240,32,81,.395,24,52,.462,8,29,.276,10,18,.556,82
18220,2012-02-22,NYK,,ATL,W 99-82,240,38,80,.475,30,58,.517,8,22,.364,15,24,.625,99
18221,2012-02-22,BOS,@,OKC,L 104-119,240,34,70,.486,27,52,.519,7,18,.389,29,34,.853,104
18222,2012-02-22,OKC,,BOS,W 119-104,240,42,84,.500,33,65,.508,9,19,.474,26,35,.743,119
18223,2012-02-22,GSW,@,PHO,W 106-104,240,39,84,.464,30,64,.469,9,20,.450,19,22,.864,106
18224,2012-02-22,PHO,,GSW,L 104-106,240,43,90,.478,39,71,.549,4,19,.211,14,20,.700,104
18225,2012-02-22,DET,@,TOR,L 93-103,240,35,84,.417,33,72,.458,2,12,.167,21,27,.778,93
18226,2012-02-22,TOR,,DET,W 103-93,240,40,76,.526,37,69,.536,3,7,.429,20,28,.714,103
18227,2012-02-22,SAC,@,WAS,W 115-107,240,43,96,.448,39,79,.494,4,17,.235,25,27,.926,115
18228,2012-02-22,WAS,,SAC,L 107-115,240,41,84,.488,32,61,.525,9,23,.391,16,27,.593,107
18229,2012-02-21,CLE,,DET,W 101-100,240,34,78,.436,25,60,.417,9,18,.500,24,32,.750,101
18230,2012-02-21,DET,@,CLE,L 100-101,240,37,95,.389,30,78,.385,7,17,.412,19,24,.792,100
18231,2012-02-21,IND,,NOH,W 117-108 (OT),265,44,88,.500,37,69,.536,7,19,.368,22,31,.710,117
18232,2012-02-21,NOP,@,IND,L 108-117 (OT),265,42,79,.532,33,58,.569,9,21,.429,15,23,.652,108
18233,2012-02-21,MEM,,PHI,W 89-76,240,31,78,.397,25,66,.379,6,12,.500,21,29,.724,89
18234,2012-02-21,PHI,@,MEM,L 76-89,240,31,85,.365,23,70,.329,8,15,.533,6,8,.750,76
18235,2012-02-21,MIA,,SAC,W 120-108,240,45,81,.556,35,58,.603,10,23,.435,20,23,.870,120
18236,2012-02-21,SAC,@,MIA,L 108-120,240,40,89,.449,27,62,.435,13,27,.481,15,19,.789,108
18237,2012-02-21,POR,,SAS,W 137-97,240,51,86,.593,36,58,.621,15,28,.536,20,24,.833,137
18238,2012-02-21,SAS,@,POR,L 97-137,240,32,84,.381,24,64,.375,8,20,.400,25,32,.781,97
18239,2012-02-20,ATL,@,CHI,L 79-90,240,30,74,.405,21,49,.429,9,25,.360,10,21,.476,79
18240,2012-02-20,CHI,,ATL,W 90-79,240,34,88,.386,26,68,.382,8,20,.400,14,19,.737,90
18241,2012-02-20,BOS,@,DAL,L 73-89,240,29,74,.392,22,50,.440,7,24,.292,8,11,.727,73
18242,2012-02-20,DAL,,BOS,W 89-73,240,36,89,.404,29,64,.453,7,25,.280,10,14,.714,89
18243,2012-02-20,DEN,,MIN,W 103-101 (OT),265,37,92,.402,32,70,.457,5,22,.227,24,35,.686,103
18244,2012-02-20,MIN,@,DEN,L 101-103 (OT),265,36,99,.364,30,72,.417,6,27,.222,23,24,.958,101
18245,2012-02-20,GSW,,LAC,W 104-97,240,38,83,.458,29,60,.483,9,23,.391,19,24,.792,104
18246,2012-02-20,LAC,@,GSW,L 97-104,240,33,77,.429,22,51,.431,11,26,.423,20,27,.741,97
18247,2012-02-20,HOU,,MEM,W 97-93,240,35,74,.473,28,52,.538,7,22,.318,20,25,.800,97
18248,2012-02-20,MEM,@,HOU,L 93-97,240,38,79,.481,35,66,.530,3,13,.231,14,18,.778,93
18249,2012-02-20,LAL,,POR,W 103-92,240,38,83,.458,30,64,.469,8,19,.421,19,22,.864,103
18250,2012-02-20,POR,@,LAL,L 92-103,240,32,78,.410,20,55,.364,12,23,.522,16,22,.727,92
18251,2012-02-20,MIL,,ORL,L 90-93,240,37,91,.407,32,69,.464,5,22,.227,11,13,.846,90
18252,2012-02-20,ORL,@,MIL,W 93-90,240,33,76,.434,25,54,.463,8,22,.364,19,25,.760,93
18253,2012-02-20,BRK,@,NYK,W 100-92,240,32,82,.390,17,51,.333,15,31,.484,21,29,.724,100
18254,2012-02-20,NYK,,NJN,L 92-100,240,34,85,.400,29,64,.453,5,21,.238,19,26,.731,92
18255,2012-02-20,NOP,@,OKC,L 93-101,240,33,91,.363,26,77,.338,7,14,.500,20,23,.870,93
18256,2012-02-20,OKC,,NOH,W 101-93,240,36,80,.450,28,54,.519,8,26,.308,21,24,.875,101
18257,2012-02-20,PHO,,WAS,W 104-88,240,37,79,.468,30,58,.517,7,21,.333,23,29,.793,104
18258,2012-02-20,WAS,@,PHO,L 88-104,240,36,84,.429,31,64,.484,5,20,.250,11,19,.579,88
18259,2012-02-20,SAS,@,UTA,W 106-102,240,36,78,.462,26,57,.456,10,21,.476,24,30,.800,106
18260,2012-02-20,UTA,,SAS,L 102-106,240,40,84,.476,37,76,.487,3,8,.375,19,23,.826,102
18261,2012-02-19,CLE,,SAC,W 93-92,240,32,89,.360,25,67,.373,7,22,.318,22,30,.733,93
18262,2012-02-19,SAC,@,CLE,L 92-93,240,35,93,.376,31,74,.419,4,19,.211,18,25,.720,92
18263,2012-02-19,BOS,@,DET,L 81-96,240,32,72,.444,26,56,.464,6,16,.375,11,15,.733,81
18264,2012-02-19,DET,,BOS,W 96-81,240,31,82,.378,26,73,.356,5,9,.556,29,46,.630,96
18265,2012-02-19,HOU,,UTA,W 101-85,240,37,72,.514,27,53,.509,10,19,.526,17,24,.708,101
18266,2012-02-19,UTA,@,HOU,L 85-101,240,32,81,.395,27,67,.403,5,14,.357,16,20,.800,85
18267,2012-02-19,CHA,@,IND,L 73-108,240,28,75,.373,24,58,.414,4,17,.235,13,22,.591,73
18268,2012-02-19,IND,,CHA,W 108-73,240,39,78,.500,33,62,.532,6,16,.375,24,32,.750,108
18269,2012-02-19,MIA,,ORL,W 90-78,240,38,80,.475,35,68,.515,3,12,.250,11,14,.786,90
18270,2012-02-19,ORL,@,MIA,L 78-90,240,27,74,.365,16,45,.356,11,29,.379,13,25,.520,78
18271,2012-02-19,MIN,,PHI,W 92-91,240,33,85,.388,30,69,.435,3,16,.188,23,26,.885,92
18272,2012-02-19,PHI,@,MIN,L 91-92,240,40,90,.444,37,79,.468,3,11,.273,8,10,.800,91
18273,2012-02-19,MIL,@,NJN,W 92-85,240,33,86,.384,26,67,.388,7,19,.368,19,24,.792,92
18274,2012-02-19,BRK,,MIL,L 85-92,240,29,85,.341,24,62,.387,5,23,.217,22,33,.667,85
18275,2012-02-19,DAL,@,NYK,L 97-104,240,36,81,.444,24,48,.500,12,33,.364,13,17,.765,97
18276,2012-02-19,NYK,,DAL,W 104-97,240,40,86,.465,28,57,.491,12,29,.414,12,18,.667,104
18277,2012-02-19,DEN,@,OKC,L 118-124 (OT),265,49,101,.485,43,79,.544,6,22,.273,14,18,.778,118
18278,2012-02-19,OKC,,DEN,W 124-118 (OT),265,46,94,.489,37,66,.561,9,28,.321,23,28,.821,124
18279,2012-02-19,LAL,@,PHO,L 90-102,240,35,78,.449,32,60,.533,3,18,.167,17,25,.680,90
18280,2012-02-19,PHO,,LAL,W 102-90,240,34,80,.425,27,60,.450,7,20,.350,27,32,.844,102
18281,2012-02-18,CHI,,NJN,L 85-97,240,33,84,.393,30,71,.423,3,13,.231,16,27,.593,85
18282,2012-02-18,BRK,@,CHI,W 97-85,240,34,85,.400,24,63,.381,10,22,.455,19,25,.760,97
18283,2012-02-18,LAC,,SAS,L 100-103 (OT),265,36,89,.404,28,63,.444,8,26,.308,20,23,.870,100
18284,2012-02-18,SAS,@,LAC,W 103-100 (OT),265,40,92,.435,28,64,.438,12,28,.429,11,21,.524,103
18285,2012-02-18,GSW,@,MEM,L 103-104,240,35,82,.427,23,56,.411,12,26,.462,21,27,.778,103
18286,2012-02-18,MEM,,GSW,W 104-103,240,37,73,.507,33,63,.524,4,10,.400,26,38,.684,104
18287,2012-02-18,ATL,@,POR,L 77-97,240,30,73,.411,23,46,.500,7,27,.259,10,13,.769,77
18288,2012-02-18,POR,,ATL,W 97-77,240,38,81,.469,29,59,.492,9,22,.409,12,16,.750,97
18289,2012-02-17,CLE,,MIA,L 87-111,240,30,76,.395,24,60,.400,6,16,.375,21,31,.677,87
18290,2012-02-17,MIA,@,CLE,W 111-87,240,40,79,.506,26,58,.448,14,21,.667,17,20,.850,111
18291,2012-02-17,DET,,SAC,W 114-108,240,43,93,.462,37,81,.457,6,12,.500,22,25,.880,114
18292,2012-02-17,SAC,@,DET,L 108-114,240,43,86,.500,39,75,.520,4,11,.364,18,22,.818,108
18293,2012-02-17,HOU,,MIN,L 98-111,240,40,85,.471,30,65,.462,10,20,.500,8,10,.800,98
18294,2012-02-17,MIN,@,HOU,W 111-98,240,43,77,.558,38,62,.613,5,15,.333,20,23,.870,111
18295,2012-02-17,LAL,,PHO,W 111-99,240,44,83,.530,39,72,.542,5,11,.455,18,24,.750,111
18296,2012-02-17,PHO,@,LAL,L 99-111,240,41,90,.456,33,64,.516,8,26,.308,9,13,.692,99
18297,2012-02-17,DEN,@,MEM,L 102-103,240,41,83,.494,33,66,.500,8,17,.471,12,18,.667,102
18298,2012-02-17,MEM,,DEN,W 103-102,240,41,82,.500,35,66,.530,6,16,.375,15,19,.789,103
18299,2012-02-17,NOP,@,NYK,W 89-85,240,32,75,.427,25,63,.397,7,12,.583,18,23,.783,89
18300,2012-02-17,NYK,,NOH,L 85-89,240,31,75,.413,27,51,.529,4,24,.167,19,29,.655,85
18301,2012-02-17,GSW,@,OKC,L 87-110,240,31,89,.348,24,66,.364,7,23,.304,18,21,.857,87
18302,2012-02-17,OKC,,GSW,W 110-87,240,39,74,.527,29,50,.580,10,24,.417,22,27,.815,110
18303,2012-02-17,MIL,@,ORL,L 85-94,240,33,90,.367,27,69,.391,6,21,.286,13,17,.765,85
18304,2012-02-17,ORL,,MIL,W 94-85,240,33,76,.434,24,47,.511,9,29,.310,19,26,.731,94
18305,2012-02-17,DAL,@,PHI,W 82-75,240,31,81,.383,26,67,.388,5,14,.357,15,18,.833,82
18306,2012-02-17,PHI,,DAL,L 75-82,240,29,86,.337,28,72,.389,1,14,.071,16,19,.842,75
18307,2012-02-17,CHA,@,TOR,W 98-91,240,37,74,.500,31,59,.525,6,15,.400,18,23,.783,98
18308,2012-02-17,TOR,,CHA,L 91-98,240,35,84,.417,33,68,.485,2,16,.125,19,28,.679,91
18309,2012-02-17,UTA,,WAS,W 114-100,240,47,89,.528,42,74,.568,5,15,.333,15,19,.789,114
18310,2012-02-17,WAS,@,UTA,L 100-114,240,38,84,.452,36,73,.493,2,11,.182,22,26,.846,100
18311,2012-02-16,BOS,@,CHI,L 80-89,240,31,78,.397,28,63,.444,3,15,.200,15,18,.833,80
18312,2012-02-16,CHI,,BOS,W 89-80,240,30,76,.395,20,55,.364,10,21,.476,19,28,.679,89
18313,2012-02-16,IND,,NJN,W 93-88,240,32,81,.395,25,62,.403,7,19,.368,22,26,.846,93
18314,2012-02-16,BRK,@,IND,L 88-93,240,35,75,.467,31,58,.534,4,17,.235,14,16,.875,88
18315,2012-02-16,LAC,@,POR,W 74-71,240,30,78,.385,28,61,.459,2,17,.118,12,19,.632,74
18316,2012-02-16,POR,,LAC,L 71-74,240,27,71,.380,21,57,.368,6,14,.429,11,18,.611,71
18317,2012-02-15,BOS,,DET,L 88-98,240,34,77,.442,33,71,.465,1,6,.167,19,32,.594,88
18318,2012-02-15,DET,@,BOS,W 98-88,240,35,74,.473,31,62,.500,4,12,.333,24,29,.828,98
18319,2012-02-15,CLE,,IND,W 98-87,240,36,77,.468,26,50,.520,10,27,.370,16,23,.696,98
18320,2012-02-15,IND,@,CLE,L 87-98,240,32,87,.368,27,71,.380,5,16,.313,18,27,.667,87
18321,2012-02-15,DAL,,DEN,W 102-84,240,37,80,.463,27,54,.500,10,26,.385,18,22,.818,102
18322,2012-02-15,DEN,@,DAL,L 84-102,240,30,84,.357,24,57,.421,6,27,.222,18,31,.581,84
18323,2012-02-15,GSW,,POR,L 91-93,240,36,76,.474,29,57,.509,7,19,.368,12,16,.750,91
18324,2012-02-15,POR,@,GSW,W 93-91,240,34,84,.405,24,62,.387,10,22,.455,15,17,.882,93
18325,2012-02-15,HOU,,OKC,W 96-95,240,37,87,.425,29,69,.420,8,18,.444,14,18,.778,96
18326,2012-02-15,OKC,@,HOU,L 95-96,240,36,83,.434,29,60,.483,7,23,.304,16,18,.889,95
18327,2012-02-15,LAC,,WAS,W 102-84,240,35,83,.422,24,62,.387,11,21,.524,21,28,.750,102
18328,2012-02-15,WAS,@,LAC,L 84-102,240,30,76,.395,25,54,.463,5,22,.227,19,28,.679,84
18329,2012-02-15,MIL,,NOH,L 89-92,240,33,86,.384,26,68,.382,7,18,.389,16,18,.889,89
18330,2012-02-15,NOP,@,MIL,W 92-89,240,36,80,.450,29,65,.446,7,15,.467,13,17,.765,92
18331,2012-02-15,CHA,@,MIN,L 90-102,240,38,85,.447,31,67,.463,7,18,.389,7,15,.467,90
18332,2012-02-15,MIN,,CHA,W 102-90,240,43,85,.506,39,69,.565,4,16,.250,12,16,.750,102
18333,2012-02-15,MEM,@,NJN,W 105-100,240,41,88,.466,35,73,.479,6,15,.400,17,20,.850,105
18334,2012-02-15,BRK,,MEM,L 100-105,240,37,72,.514,26,45,.578,11,27,.407,15,15,1.000,100
18335,2012-02-15,NYK,,SAC,W 100-85,240,39,77,.506,32,53,.604,7,24,.292,15,17,.882,100
18336,2012-02-15,SAC,@,NYK,L 85-100,240,33,87,.379,29,69,.420,4,18,.222,15,20,.750,85
18337,2012-02-15,ORL,,PHI,W 103-87,240,40,75,.533,25,50,.500,15,25,.600,8,13,.615,103
18338,2012-02-15,PHI,@,ORL,L 87-103,240,36,85,.424,30,67,.448,6,18,.333,9,12,.750,87
18339,2012-02-15,ATL,@,PHO,W 101-99,240,38,80,.475,28,59,.475,10,21,.476,15,18,.833,101
18340,2012-02-15,PHO,,ATL,L 99-101,240,37,69,.536,31,52,.596,6,17,.353,19,27,.704,99
18341,2012-02-15,SAS,@,TOR,W 113-106,240,41,76,.539,33,57,.579,8,19,.421,23,25,.920,113
18342,2012-02-15,TOR,,SAS,L 106-113,240,47,86,.547,44,75,.587,3,11,.273,9,14,.643,106
18343,2012-02-14,CHI,,SAC,W 121-115,240,44,84,.524,35,65,.538,9,19,.474,24,26,.923,121
18344,2012-02-14,SAC,@,CHI,L 115-121,240,42,89,.472,33,72,.458,9,17,.529,22,28,.786,115
18345,2012-02-14,DEN,,PHO,W 109-92,240,40,78,.513,36,64,.563,4,14,.286,25,34,.735,109
18346,2012-02-14,PHO,@,DEN,L 92-109,240,33,99,.333,24,75,.320,9,24,.375,17,19,.895,92
18347,2012-02-14,DET,,SAS,L 95-99,240,39,84,.464,36,71,.507,3,13,.231,14,25,.560,95
18348,2012-02-14,SAS,@,DET,W 99-95,240,36,83,.434,30,69,.435,6,14,.429,21,32,.656,99
18349,2012-02-14,IND,,MIA,L 90-105,240,33,76,.434,31,61,.508,2,15,.133,22,29,.759,90
18350,2012-02-14,MIA,@,IND,W 105-90,240,35,70,.500,30,57,.526,5,13,.385,30,35,.857,105
18351,2012-02-14,ATL,@,LAL,L 78-86,240,31,90,.344,24,63,.381,7,27,.259,9,14,.643,78
18352,2012-02-14,LAL,,ATL,W 86-78,240,37,84,.440,29,67,.433,8,17,.471,4,9,.444,86
18353,2012-02-14,HOU,@,MEM,L 83-93,240,30,78,.385,27,68,.397,3,10,.300,20,24,.833,83
18354,2012-02-14,MEM,,HOU,W 93-83,240,35,73,.479,30,64,.469,5,9,.556,18,21,.857,93
18355,2012-02-14,OKC,,UTA,W 111-85,240,42,77,.545,37,63,.587,5,14,.357,22,34,.647,111
18356,2012-02-14,UTA,@,OKC,L 85-111,240,32,90,.356,29,77,.377,3,13,.231,18,24,.750,85
18357,2012-02-14,POR,,WAS,L 109-124,240,40,85,.471,33,62,.532,7,23,.304,22,27,.815,109
18358,2012-02-14,WAS,@,POR,W 124-109,240,48,80,.600,39,63,.619,9,17,.529,19,23,.826,124
18359,2012-02-14,NYK,@,TOR,W 90-87,240,33,80,.413,27,63,.429,6,17,.353,18,27,.667,90
18360,2012-02-14,TOR,,NYK,L 87-90,240,37,73,.507,33,58,.569,4,15,.267,9,15,.600,87
18361,2012-02-13,CHA,,PHI,L 89-98,240,30,73,.411,23,56,.411,7,17,.412,22,30,.733,89
18362,2012-02-13,PHI,@,CHA,W 98-89,240,36,83,.434,30,65,.462,6,18,.333,20,24,.833,98
18363,2012-02-13,DAL,,LAC,W 96-92,240,35,79,.443,29,61,.475,6,18,.333,20,28,.714,96
18364,2012-02-13,LAC,@,DAL,L 92-96,240,33,74,.446,23,47,.489,10,27,.370,16,25,.640,92
18365,2012-02-13,GSW,,PHO,W 102-96,240,39,86,.453,32,68,.471,7,18,.389,17,21,.810,102
18366,2012-02-13,PHO,@,GSW,L 96-102,240,38,82,.463,33,57,.579,5,25,.200,15,19,.789,96
18367,2012-02-13,MIA,@,MIL,W 114-96,240,43,83,.518,36,69,.522,7,14,.500,21,25,.840,114
18368,2012-02-13,MIL,,MIA,L 96-114,240,33,84,.393,24,61,.393,9,23,.391,21,25,.840,96
18369,2012-02-13,NOP,,UTA,W 86-80,240,32,75,.427,29,64,.453,3,11,.273,19,28,.679,86
18370,2012-02-13,UTA,@,NOH,L 80-86,240,30,73,.411,26,59,.441,4,14,.286,16,23,.696,80
18371,2012-02-13,MIN,@,ORL,L 89-102,240,33,80,.413,27,59,.458,6,21,.286,17,25,.680,89
18372,2012-02-13,ORL,,MIN,W 102-89,240,36,85,.424,24,55,.436,12,30,.400,18,22,.818,102
18373,2012-02-12,ATL,,MIA,L 87-107,240,35,90,.389,24,63,.381,11,27,.407,6,7,.857,87
18374,2012-02-12,MIA,@,ATL,W 107-87,240,38,83,.458,33,71,.465,5,12,.417,26,31,.839,107
18375,2012-02-12,BOS,,CHI,W 95-91,240,37,75,.493,34,62,.548,3,13,.231,18,26,.692,95
18376,2012-02-12,CHI,@,BOS,L 91-95,240,34,88,.386,28,68,.412,6,20,.300,17,24,.708,91
18377,2012-02-12,DET,,WAS,L 77-98,240,29,89,.326,28,78,.359,1,11,.091,18,19,.947,77
18378,2012-02-12,WAS,@,DET,W 98-77,240,37,79,.468,31,64,.484,6,15,.400,18,21,.857,98
18379,2012-02-12,GSW,,HOU,W 106-97,240,40,79,.506,27,55,.491,13,24,.542,13,18,.722,106
18380,2012-02-12,HOU,@,GSW,L 97-106,240,31,75,.413,20,46,.435,11,29,.379,24,33,.727,97
18381,2012-02-12,MEM,,UTA,L 88-98,240,34,78,.436,32,68,.471,2,10,.200,18,23,.783,88
18382,2012-02-12,UTA,@,MEM,W 98-88,240,42,83,.506,37,70,.529,5,13,.385,9,13,.692,98
18383,2012-02-12,LAL,@,TOR,W 94-92,240,35,81,.432,25,58,.431,10,23,.435,14,20,.700,94
18384,2012-02-12,TOR,,LAL,L 92-94,240,37,78,.474,31,67,.463,6,11,.545,12,17,.706,92
18385,2012-02-11,CHA,,LAC,L 86-111,240,26,74,.351,25,60,.417,1,14,.071,33,43,.767,86
18386,2012-02-11,LAC,@,CHA,W 111-86,240,41,78,.526,33,58,.569,8,20,.400,21,24,.875,111
18387,2012-02-11,CLE,,PHI,L 84-99,240,31,84,.369,28,70,.400,3,14,.214,19,25,.760,84
18388,2012-02-11,PHI,@,CLE,W 99-84,240,35,79,.443,29,65,.446,6,14,.429,23,30,.767,99
18389,2012-02-11,DAL,,POR,W 97-94 (2OT),290,39,84,.464,33,65,.508,6,19,.316,13,19,.684,97
18390,2012-02-11,POR,@,DAL,L 94-97 (2OT),290,36,97,.371,33,77,.429,3,20,.150,19,21,.905,94
18391,2012-02-11,DEN,@,IND,W 113-109,240,43,87,.494,38,70,.543,5,17,.294,22,33,.667,113
18392,2012-02-11,IND,,DEN,L 109-113,240,42,79,.532,34,57,.596,8,22,.364,17,22,.773,109
18393,2012-02-11,MIL,,ORL,L 94-99,240,39,93,.419,30,71,.423,9,22,.409,7,7,1.000,94
18394,2012-02-11,ORL,@,MIL,W 99-94,240,35,81,.432,20,44,.455,15,37,.405,14,21,.667,99
18395,2012-02-11,MIN,,NYK,L 98-100,240,37,84,.440,31,65,.477,6,19,.316,18,19,.947,98
18396,2012-02-11,NYK,@,MIN,W 100-98,240,40,84,.476,33,65,.508,7,19,.368,13,22,.591,100
18397,2012-02-11,BRK,,SAS,L 89-103,240,35,87,.402,28,63,.444,7,24,.292,12,15,.800,89
18398,2012-02-11,SAS,@,NJN,W 103-89,240,42,80,.525,35,58,.603,7,22,.318,12,17,.706,103
18399,2012-02-11,PHO,@,SAC,W 98-84,240,39,78,.500,31,55,.564,8,23,.348,12,15,.800,98
18400,2012-02-11,SAC,,PHO,L 84-98,240,27,77,.351,19,56,.339,8,21,.381,22,28,.786,84
18401,2012-02-10,CHA,,CHI,L 64-95,240,25,76,.329,24,68,.353,1,8,.125,13,19,.684,64
18402,2012-02-10,CHI,@,CHA,W 95-64,240,39,90,.433,33,75,.440,6,15,.400,11,20,.550,95
18403,2012-02-10,CLE,,MIL,L 112-113 (OT),265,43,88,.489,35,71,.493,8,17,.471,18,32,.563,112
18404,2012-02-10,MIL,@,CLE,W 113-112 (OT),265,40,98,.408,32,74,.432,8,24,.333,25,31,.806,113
18405,2012-02-10,DET,,NJN,W 109-92,240,43,79,.544,39,69,.565,4,10,.400,19,25,.760,109
18406,2012-02-10,BRK,@,DET,L 92-109,240,31,74,.419,26,55,.473,5,19,.263,25,31,.806,92
18407,2012-02-10,IND,@,MEM,L 92-98,240,30,78,.385,24,62,.387,6,16,.375,26,37,.703,92
18408,2012-02-10,MEM,,IND,W 98-92,240,34,73,.466,33,64,.516,1,9,.111,29,37,.784,98
18409,2012-02-10,DAL,@,MIN,W 104-97,240,39,90,.433,30,69,.435,9,21,.429,17,23,.739,104
18410,2012-02-10,MIN,,DAL,L 97-104,240,32,79,.405,26,56,.464,6,23,.261,27,31,.871,97
18411,2012-02-10,NOP,,POR,L 86-94,240,33,75,.440,30,59,.508,3,16,.188,17,25,.680,86
18412,2012-02-10,POR,@,NOH,W 94-86,240,35,68,.515,31,51,.608,4,17,.235,20,25,.800,94
18413,2012-02-10,LAL,@,NYK,L 85-92,240,30,80,.375,24,56,.429,6,24,.250,19,23,.826,85
18414,2012-02-10,NYK,,LAL,W 92-85,240,33,77,.429,28,56,.500,5,21,.238,21,34,.618,92
18415,2012-02-10,ATL,@,ORL,W 89-87 (OT),265,36,82,.439,30,65,.462,6,17,.353,11,18,.611,89
18416,2012-02-10,ORL,,ATL,L 87-89 (OT),265,35,83,.422,26,59,.441,9,24,.375,8,14,.571,87
18417,2012-02-10,LAC,@,PHI,W 78-77,240,33,85,.388,31,66,.470,2,19,.105,10,15,.667,78
18418,2012-02-10,PHI,,LAC,L 77-78,240,29,71,.408,25,56,.446,4,15,.267,15,23,.652,77
18419,2012-02-10,BOS,@,TOR,L 74-86,240,29,65,.446,26,55,.473,3,10,.300,13,18,.722,74
18420,2012-02-10,TOR,,BOS,W 86-74,240,33,75,.440,28,56,.500,5,19,.263,15,20,.750,86
18421,2012-02-10,OKC,@,UTA,W 101-87,240,35,74,.473,31,54,.574,4,20,.200,27,32,.844,101
18422,2012-02-10,UTA,,OKC,L 87-101,240,38,80,.475,35,71,.493,3,9,.333,8,13,.615,87
18423,2012-02-10,MIA,@,WAS,W 106-89,240,40,81,.494,35,66,.530,5,15,.333,21,23,.913,106
18424,2012-02-10,WAS,,MIA,L 89-106,240,34,89,.382,30,68,.441,4,21,.190,17,28,.607,89
18425,2012-02-09,BOS,,LAL,L 87-88 (OT),265,38,97,.392,32,78,.410,6,19,.316,5,5,1.000,87
18426,2012-02-09,LAL,@,BOS,W 88-87 (OT),265,36,91,.396,35,76,.461,1,15,.067,15,20,.750,88
18427,2012-02-09,DEN,,GSW,L 101-109,240,37,85,.435,28,61,.459,9,24,.375,18,27,.667,101
18428,2012-02-09,GSW,@,DEN,W 109-101,240,41,79,.519,28,54,.519,13,25,.520,14,22,.636,109
18429,2012-02-09,HOU,@,PHO,W 96-89,240,42,86,.488,34,70,.486,8,16,.500,4,6,.667,96
18430,2012-02-09,PHO,,HOU,L 89-96,240,35,74,.473,26,47,.553,9,27,.333,10,16,.625,89
18431,2012-02-09,OKC,@,SAC,L 101-106,240,37,77,.481,30,59,.508,7,18,.389,20,26,.769,101
18432,2012-02-09,SAC,,OKC,W 106-101,240,40,99,.404,33,79,.418,7,20,.350,19,26,.731,106
18433,2012-02-08,ATL,,IND,W 97-87,240,35,76,.461,26,55,.473,9,21,.429,18,24,.750,97
18434,2012-02-08,IND,@,ATL,L 87-97,240,33,75,.440,28,61,.459,5,14,.357,16,23,.696,87
18435,2012-02-08,CLE,,LAC,W 99-92,240,36,71,.507,29,53,.547,7,18,.389,20,26,.769,99
18436,2012-02-08,LAC,@,CLE,L 92-99,240,32,78,.410,29,63,.460,3,15,.200,25,29,.862,92
18437,2012-02-08,DAL,@,DEN,W 105-95,240,44,90,.489,35,62,.565,9,28,.321,8,9,.889,105
18438,2012-02-08,DEN,,DAL,L 95-105,240,33,72,.458,24,46,.522,9,26,.346,20,27,.741,95
18439,2012-02-08,MEM,,MIN,W 85-80,240,35,94,.372,31,83,.373,4,11,.364,11,15,.733,85
18440,2012-02-08,MIN,@,MEM,L 80-85,240,31,79,.392,27,60,.450,4,19,.211,14,19,.737,80
18441,2012-02-08,DET,@,NJN,W 99-92,240,39,73,.534,37,64,.578,2,9,.222,19,29,.655,99
18442,2012-02-08,BRK,,DET,L 92-99,240,33,78,.423,23,51,.451,10,27,.370,16,20,.800,92
18443,2012-02-08,CHI,@,NOH,W 90-67,240,39,85,.459,35,69,.507,4,16,.250,8,12,.667,90
18444,2012-02-08,NOP,,CHI,L 67-90,240,28,75,.373,27,72,.375,1,3,.333,10,17,.588,67
18445,2012-02-08,MIA,@,ORL,L 89-102,240,36,76,.474,31,61,.508,5,15,.333,12,17,.706,89
18446,2012-02-08,ORL,,MIA,W 102-89,240,35,83,.422,18,41,.439,17,42,.405,15,21,.714,102
18447,2012-02-08,PHI,,SAS,L 90-100,240,38,93,.409,31,79,.392,7,14,.500,7,11,.636,90
18448,2012-02-08,SAS,@,PHI,W 100-90,240,37,84,.440,32,69,.464,5,15,.333,21,26,.808,100
18449,2012-02-08,HOU,@,POR,W 103-96,240,41,78,.526,31,55,.564,10,23,.435,11,19,.579,103
18450,2012-02-08,POR,,HOU,L 96-103,240,35,74,.473,28,56,.500,7,18,.389,19,22,.864,96
18451,2012-02-08,MIL,@,TOR,W 105-99,240,33,72,.458,21,47,.447,12,25,.480,27,37,.730,105
18452,2012-02-08,TOR,,MIL,L 99-105,240,37,90,.411,28,66,.424,9,24,.375,16,17,.941,99
18453,2012-02-08,NYK,@,WAS,W 107-93,240,37,81,.457,30,53,.566,7,28,.250,26,33,.788,107
18454,2012-02-08,WAS,,NYK,L 93-107,240,38,83,.458,36,66,.545,2,17,.118,15,19,.789,93
18455,2012-02-07,BOS,,CHA,W 94-84,240,41,81,.506,37,58,.638,4,23,.174,8,8,1.000,94
18456,2012-02-07,CHA,@,BOS,L 84-94,240,32,71,.451,28,55,.509,4,16,.250,16,20,.800,84
18457,2012-02-07,GSW,,OKC,L 116-119,240,44,80,.550,35,59,.593,9,21,.429,19,23,.826,116
18458,2012-02-07,OKC,@,GSW,W 119-116,240,44,84,.524,33,58,.569,11,26,.423,20,21,.952,119
18459,2012-02-07,IND,,UTA,W 104-99,240,41,87,.471,37,73,.507,4,14,.286,18,22,.818,104
18460,2012-02-07,UTA,@,IND,L 99-104,240,37,78,.474,33,68,.485,4,10,.400,21,23,.913,99
18461,2012-02-07,CLE,@,MIA,L 91-107,240,32,82,.390,25,63,.397,7,19,.368,20,30,.667,91
18462,2012-02-07,MIA,,CLE,W 107-91,240,39,84,.464,33,67,.493,6,17,.353,23,26,.885,107
18463,2012-02-07,MIL,,PHO,L 105-107,240,39,81,.481,30,61,.492,9,20,.450,18,20,.900,105
18464,2012-02-07,PHO,@,MIL,W 107-105,240,45,94,.479,36,69,.522,9,25,.360,8,8,1.000,107
18465,2012-02-07,MIN,,SAC,W 86-84,240,32,79,.405,28,65,.431,4,14,.286,18,28,.643,86
18466,2012-02-07,SAC,@,MIN,L 84-86,240,31,82,.378,23,59,.390,8,23,.348,14,21,.667,84
18467,2012-02-06,ATL,,PHO,L 90-99,240,33,84,.393,27,60,.450,6,24,.250,18,21,.857,90
18468,2012-02-06,PHO,@,ATL,W 99-90,240,41,79,.519,30,55,.545,11,24,.458,6,7,.857,99
18469,2012-02-06,DEN,,HOU,L 90-99,240,34,78,.436,31,56,.554,3,22,.136,19,33,.576,90
18470,2012-02-06,HOU,@,DEN,W 99-90,240,35,81,.432,25,62,.403,10,19,.526,19,24,.792,99
18471,2012-02-06,MEM,,SAS,L 84-89,240,31,83,.373,27,70,.386,4,13,.308,18,21,.857,84
18472,2012-02-06,SAS,@,MEM,W 89-84,240,34,73,.466,27,57,.474,7,16,.438,14,21,.667,89
18473,2012-02-06,CHI,@,NJN,W 108-87,240,40,72,.556,31,57,.544,9,15,.600,19,23,.826,108
18474,2012-02-06,BRK,,CHI,L 87-108,240,32,79,.405,29,62,.468,3,17,.176,20,26,.769,87
18475,2012-02-06,NOP,,SAC,L 92-100,240,34,81,.420,31,72,.431,3,9,.333,21,26,.808,92
18476,2012-02-06,SAC,@,NOH,W 100-92,240,37,78,.474,29,54,.537,8,24,.333,18,25,.720,100
18477,2012-02-06,NYK,,UTA,W 99-88,240,35,73,.479,26,45,.578,9,28,.321,20,31,.645,99
18478,2012-02-06,UTA,@,NYK,L 88-99,240,33,76,.434,31,65,.477,2,11,.182,20,26,.769,88
18479,2012-02-06,LAC,@,ORL,W 107-102 (OT),265,36,82,.439,23,51,.451,13,31,.419,22,25,.880,107
18480,2012-02-06,ORL,,LAC,L 102-107 (OT),265,40,86,.465,29,56,.518,11,30,.367,11,16,.688,102
18481,2012-02-06,LAL,@,PHI,L 90-95,240,34,81,.420,27,57,.474,7,24,.292,15,20,.750,90
18482,2012-02-06,PHI,,LAL,W 95-90,240,38,81,.469,30,64,.469,8,17,.471,11,17,.647,95
18483,2012-02-06,OKC,@,POR,W 111-107 (OT),265,43,95,.453,37,73,.507,6,22,.273,19,22,.864,111
18484,2012-02-06,POR,,OKC,L 107-111 (OT),265,41,97,.423,36,77,.468,5,20,.250,20,26,.769,107
18485,2012-02-06,TOR,@,WAS,L 108-111 (OT),265,34,85,.400,21,59,.356,13,26,.500,27,34,.794,108
18486,2012-02-06,WAS,,TOR,W 111-108 (OT),265,39,80,.488,36,71,.507,3,9,.333,30,41,.732,111
18487,2012-02-05,BOS,,MEM,W 98-80,240,36,73,.493,29,53,.547,7,20,.350,19,21,.905,98
18488,2012-02-05,MEM,@,BOS,L 80-98,240,32,87,.368,29,73,.397,3,14,.214,13,16,.813,80
18489,2012-02-05,MIA,,TOR,W 95-89,240,31,69,.449,27,57,.474,4,12,.333,29,34,.853,95
18490,2012-02-05,TOR,@,MIA,L 89-95,240,34,79,.430,28,57,.491,6,22,.273,15,21,.714,89
18491,2012-02-04,ATL,,PHI,L 87-98,240,32,74,.432,27,59,.458,5,15,.333,18,27,.667,87
18492,2012-02-04,PHI,@,ATL,W 98-87,240,44,88,.500,40,79,.506,4,9,.444,6,9,.667,98
18493,2012-02-04,CLE,,DAL,W 91-88,240,37,93,.398,31,70,.443,6,23,.261,11,15,.733,91
18494,2012-02-04,DAL,@,CLE,L 88-91,240,32,67,.478,26,54,.481,6,13,.462,18,27,.667,88
18495,2012-02-04,DET,,NOH,W 89-87,240,35,78,.449,33,68,.485,2,10,.200,17,23,.739,89
18496,2012-02-04,NOP,@,DET,L 87-89,240,34,72,.472,30,60,.500,4,12,.333,15,18,.833,87
18497,2012-02-04,IND,,ORL,L 81-85,240,29,85,.341,25,63,.397,4,22,.182,19,21,.905,81
18498,2012-02-04,ORL,@,IND,W 85-81,240,29,72,.403,20,47,.426,9,25,.360,18,23,.783,85
18499,2012-02-04,CHI,@,MIL,W 113-90,240,48,90,.533,34,60,.567,14,30,.467,3,4,.750,113
18500,2012-02-04,MIL,,CHI,L 90-113,240,37,93,.398,36,81,.444,1,12,.083,15,19,.789,90
18501,2012-02-04,HOU,@,MIN,L 91-100,240,39,91,.429,37,81,.457,2,10,.200,11,14,.786,91
18502,2012-02-04,MIN,,HOU,W 100-91,240,37,82,.451,31,62,.500,6,20,.300,20,23,.870,100
18503,2012-02-04,BRK,@,NYK,L 92-99,240,30,72,.417,20,46,.435,10,26,.385,22,26,.846,92
18504,2012-02-04,NYK,,NJN,W 99-92,240,37,83,.446,35,69,.507,2,14,.143,23,26,.885,99
18505,2012-02-04,CHA,@,PHO,L 89-95,240,33,75,.440,24,56,.429,9,19,.474,14,19,.737,89
18506,2012-02-04,PHO,,CHA,W 95-89,240,34,85,.400,24,63,.381,10,22,.455,17,24,.708,95
18507,2012-02-04,DEN,@,POR,L 97-117,240,35,79,.443,30,57,.526,5,22,.227,22,24,.917,97
18508,2012-02-04,POR,,DEN,W 117-97,240,46,86,.535,31,53,.585,15,33,.455,10,12,.833,117
18509,2012-02-04,GSW,@,SAC,L 106-114 (OT),265,39,90,.433,23,61,.377,16,29,.552,12,13,.923,106
18510,2012-02-04,SAC,,GSW,W 114-106 (OT),265,43,98,.439,33,76,.434,10,22,.455,18,21,.857,114
18511,2012-02-04,OKC,@,SAS,L 96-107,240,36,77,.468,29,56,.518,7,21,.333,17,28,.607,96
18512,2012-02-04,SAS,,OKC,W 107-96,240,37,88,.420,25,65,.385,12,23,.522,21,25,.840,107
18513,2012-02-04,LAL,@,UTA,L 87-96,240,29,75,.387,25,61,.410,4,14,.286,25,30,.833,87
18514,2012-02-04,UTA,,LAL,W 96-87,240,39,87,.448,35,75,.467,4,12,.333,14,20,.700,96
18515,2012-02-04,LAC,@,WAS,W 107-81,240,45,83,.542,34,60,.567,11,23,.478,6,17,.353,107
18516,2012-02-04,WAS,,LAC,L 81-107,240,30,80,.375,23,62,.371,7,18,.389,14,23,.609,81
18517,2012-02-03,BOS,,NYK,W 91-89,240,31,76,.408,21,56,.375,10,20,.500,19,25,.760,91
18518,2012-02-03,NYK,@,BOS,L 89-91,240,34,80,.425,31,65,.477,3,15,.200,18,21,.857,89
18519,2012-02-03,DAL,,IND,L 87-98,240,35,83,.422,29,67,.433,6,16,.375,11,13,.846,87
18520,2012-02-03,IND,@,DAL,W 98-87,240,37,87,.425,25,62,.403,12,25,.480,12,16,.750,98
18521,2012-02-03,DEN,,LAL,L 89-93,240,33,75,.440,28,52,.538,5,23,.217,18,23,.783,89
18522,2012-02-03,LAL,@,DEN,W 93-89,240,37,78,.474,33,65,.508,4,13,.308,15,25,.600,93
18523,2012-02-03,DET,,MIL,W 88-80,240,34,81,.420,30,67,.448,4,14,.286,16,19,.842,88
18524,2012-02-03,MIL,@,DET,L 80-88,240,26,74,.351,23,57,.404,3,17,.176,25,33,.758,80
18525,2012-02-03,HOU,,PHO,W 99-81,240,39,89,.438,35,74,.473,4,15,.267,17,17,1.000,99
18526,2012-02-03,PHO,@,HOU,L 81-99,240,34,83,.410,30,64,.469,4,19,.211,9,14,.643,81
18527,2012-02-03,MIN,@,NJN,W 108-105,240,36,82,.439,29,66,.439,7,16,.438,29,32,.906,108
18528,2012-02-03,BRK,,MIN,L 105-108,240,38,86,.442,28,65,.431,10,21,.476,19,24,.792,105
18529,2012-02-03,MEM,@,OKC,L 94-101,240,37,87,.425,33,74,.446,4,13,.308,16,20,.800,94
18530,2012-02-03,OKC,,MEM,W 101-94,240,34,71,.479,27,54,.500,7,17,.412,26,33,.788,101
18531,2012-02-03,CLE,@,ORL,L 94-102,240,33,90,.367,26,72,.361,7,18,.389,21,27,.778,94
18532,2012-02-03,ORL,,CLE,W 102-94,240,34,80,.425,25,54,.463,9,26,.346,25,36,.694,102
18533,2012-02-03,MIA,@,PHI,W 99-79,240,40,77,.519,32,64,.500,8,13,.615,11,20,.550,99
18534,2012-02-03,PHI,,MIA,L 79-99,240,32,81,.395,27,69,.391,5,12,.417,10,14,.714,79
18535,2012-02-03,TOR,,WAS,W 106-89,240,42,93,.452,39,80,.488,3,13,.231,19,28,.679,106
18536,2012-02-03,WAS,@,TOR,L 89-106,240,33,87,.379,28,68,.412,5,19,.263,18,25,.720,89
18537,2012-02-02,ATL,,MEM,L 77-96,240,33,75,.440,28,60,.467,5,15,.333,6,9,.667,77
18538,2012-02-02,MEM,@,ATL,W 96-77,240,41,85,.482,39,78,.500,2,7,.286,12,19,.632,96
18539,2012-02-02,GSW,,UTA,W 119-101,240,45,96,.469,37,72,.514,8,24,.333,21,25,.840,119
18540,2012-02-02,UTA,@,GSW,L 101-119,240,36,79,.456,33,67,.493,3,12,.250,26,34,.765,101
18541,2012-02-02,DEN,@,LAC,W 112-91,240,39,73,.534,27,52,.519,12,21,.571,22,25,.880,112
18542,2012-02-02,LAC,,DEN,L 91-112,240,39,85,.459,31,58,.534,8,27,.296,5,12,.417,91
18543,2012-02-02,CHI,@,NYK,W 105-102,240,39,74,.527,33,62,.532,6,12,.500,21,29,.724,105
18544,2012-02-02,NYK,,CHI,L 102-105,240,44,90,.489,40,74,.541,4,16,.250,10,14,.714,102
18545,2012-02-02,POR,@,SAC,L 92-95,240,40,88,.455,36,70,.514,4,18,.222,8,16,.500,92
18546,2012-02-02,SAC,,POR,W 95-92,240,34,76,.447,29,59,.492,5,17,.294,22,29,.759,95
18547,2012-02-02,NOP,@,SAS,L 81-93,240,33,74,.446,30,66,.455,3,8,.375,12,16,.750,81
18548,2012-02-02,SAS,,NOH,W 93-81,240,34,74,.459,30,55,.545,4,19,.211,21,27,.778,93
18549,2012-02-01,BOS,,TOR,W 100-64,240,39,75,.520,27,51,.529,12,24,.500,10,12,.833,100
18550,2012-02-01,TOR,@,BOS,L 64-100,240,25,73,.342,19,59,.322,6,14,.429,8,18,.444,64
18551,2012-02-01,DAL,,OKC,L 86-95,240,30,84,.357,26,65,.400,4,19,.211,22,25,.880,86
18552,2012-02-01,OKC,@,DAL,W 95-86,240,33,81,.407,28,61,.459,5,20,.250,24,33,.727,95
18553,2012-02-01,MIA,@,MIL,L 97-105,240,34,73,.466,25,53,.472,9,20,.450,20,24,.833,97
18554,2012-02-01,MIL,,MIA,W 105-97,240,39,88,.443,29,65,.446,10,23,.435,17,25,.680,105
18555,2012-02-01,IND,@,MIN,W 109-99,240,38,84,.452,31,69,.449,7,15,.467,26,34,.765,109
18556,2012-02-01,MIN,,IND,L 99-109,240,34,91,.374,31,74,.419,3,17,.176,28,37,.757,99
18557,2012-02-01,DET,@,NJN,L 96-99,240,40,82,.488,35,64,.547,5,18,.278,11,14,.786,96
18558,2012-02-01,BRK,,DET,W 99-96,240,38,79,.481,30,56,.536,8,23,.348,15,25,.600,99
18559,2012-02-01,NOP,,PHO,L 103-120,240,40,77,.519,31,61,.508,9,16,.563,14,17,.824,103
18560,2012-02-01,PHO,@,NOH,W 120-103,240,41,78,.526,35,63,.556,6,15,.400,32,39,.821,120
18561,2012-02-01,ORL,,WAS,W 109-103,240,33,73,.452,20,43,.465,13,30,.433,30,39,.769,109
18562,2012-02-01,WAS,@,ORL,L 103-109,240,42,92,.457,30,69,.435,12,23,.522,7,9,.778,103
18563,2012-02-01,CHI,@,PHI,L 82-98,240,32,74,.432,25,57,.439,7,17,.412,11,16,.688,82
18564,2012-02-01,PHI,,CHI,W 98-82,240,40,84,.476,36,73,.493,4,11,.364,14,19,.737,98
18565,2012-02-01,CHA,@,POR,L 68-112,240,26,80,.325,25,71,.352,1,9,.111,15,19,.789,68
18566,2012-02-01,POR,,CHA,W 112-68,240,44,80,.550,37,66,.561,7,14,.500,17,20,.850,112
18567,2012-02-01,HOU,@,SAS,L 91-99,240,36,79,.456,27,57,.474,9,22,.409,10,13,.769,91
18568,2012-02-01,SAS,,HOU,W 99-91,240,35,76,.461,28,58,.483,7,18,.389,22,31,.710,99
18569,2012-02-01,LAC,@,UTA,W 107-105,240,42,87,.483,37,65,.569,5,22,.227,18,23,.783,107
18570,2012-02-01,UTA,,LAC,L 105-107,240,38,81,.469,35,70,.500,3,11,.273,26,36,.722,105
18571,2012-01-31,BOS,@,CLE,W 93-90,240,37,73,.507,32,59,.542,5,14,.357,14,19,.737,93
18572,2012-01-31,CLE,,BOS,L 90-93,240,34,75,.453,27,58,.466,7,17,.412,15,21,.714,90
18573,2012-01-31,GSW,,SAC,W 93-90,240,37,91,.407,29,67,.433,8,24,.333,11,13,.846,93
18574,2012-01-31,SAC,@,GSW,L 90-93,240,35,82,.427,29,66,.439,6,16,.375,14,19,.737,90
18575,2012-01-31,IND,,NJN,W 106-99,240,38,73,.521,34,62,.548,4,11,.364,26,36,.722,106
18576,2012-01-31,BRK,@,IND,L 99-106,240,35,74,.473,23,45,.511,12,29,.414,17,23,.739,99
18577,2012-01-31,CHA,@,LAL,L 73-106,240,31,89,.348,29,80,.363,2,9,.222,9,13,.692,73
18578,2012-01-31,LAL,,CHA,W 106-73,240,42,76,.553,30,50,.600,12,26,.462,10,11,.909,106
18579,2012-01-31,DEN,@,MEM,L 97-100 (OT),265,35,80,.438,28,57,.491,7,23,.304,20,27,.741,97
18580,2012-01-31,MEM,,DEN,W 100-97 (OT),265,33,86,.384,27,74,.365,6,12,.500,28,35,.800,100
18581,2012-01-31,DET,@,NYK,L 86-113,240,32,71,.451,29,62,.468,3,9,.333,19,25,.760,86
18582,2012-01-31,NYK,,DET,W 113-86,240,42,70,.600,33,52,.635,9,18,.500,20,25,.800,113
18583,2012-01-31,ATL,@,TOR,W 100-77,240,41,80,.513,34,62,.548,7,18,.389,11,13,.846,100
18584,2012-01-31,TOR,,ATL,L 77-100,240,27,73,.370,23,53,.434,4,20,.200,19,23,.826,77
18585,2012-01-30,HOU,,MIN,L 108-120,240,40,85,.471,33,66,.500,7,19,.368,21,30,.700,108
18586,2012-01-30,MIN,@,HOU,W 120-108,240,43,74,.581,37,57,.649,6,17,.353,28,31,.903,120
18587,2012-01-30,LAC,,OKC,W 112-100,240,45,80,.563,32,55,.582,13,25,.520,9,15,.600,112
18588,2012-01-30,OKC,@,LAC,L 100-112,240,38,78,.487,29,56,.518,9,22,.409,15,23,.652,100
18589,2012-01-30,MEM,,SAS,L 73-83,240,27,73,.370,24,64,.375,3,9,.333,16,20,.800,73
18590,2012-01-30,SAS,@,MEM,W 83-73,240,32,80,.400,22,56,.393,10,24,.417,9,15,.600,83
18591,2012-01-30,MIA,,NOH,W 109-95,240,43,78,.551,37,63,.587,6,15,.400,17,21,.810,109
18592,2012-01-30,NOP,@,MIA,L 95-109,240,40,75,.533,36,62,.581,4,13,.308,11,19,.579,95
18593,2012-01-30,DET,@,MIL,L 82-103,240,32,83,.386,31,74,.419,1,9,.111,17,20,.850,82
18594,2012-01-30,MIL,,DET,W 103-82,240,36,70,.514,26,53,.491,10,17,.588,21,26,.808,103
18595,2012-01-30,ORL,@,PHI,L 69-74,240,26,78,.333,19,56,.339,7,22,.318,10,22,.455,69
18596,2012-01-30,PHI,,ORL,W 74-69,240,30,80,.375,26,65,.400,4,15,.267,10,19,.526,74
18597,2012-01-30,DAL,@,PHO,W 122-99,240,48,87,.552,34,60,.567,14,27,.519,12,18,.667,122
18598,2012-01-30,PHO,,DAL,L 99-122,240,35,80,.438,23,59,.390,12,21,.571,17,20,.850,99
18599,2012-01-30,POR,@,UTA,L 89-93,240,37,80,.463,32,60,.533,5,20,.250,10,13,.769,89
18600,2012-01-30,UTA,,POR,W 93-89,240,32,84,.381,29,72,.403,3,12,.250,26,38,.684,93
18601,2012-01-30,CHI,@,WAS,W 98-88,240,34,75,.453,28,55,.509,6,20,.300,24,31,.774,98
18602,2012-01-30,WAS,,CHI,L 88-98,240,37,92,.402,34,78,.436,3,14,.214,11,13,.846,88
18603,2012-01-29,BOS,,CLE,L 87-88,240,36,69,.522,31,58,.534,5,11,.455,10,14,.714,87
18604,2012-01-29,CLE,@,BOS,W 88-87,240,34,79,.430,31,66,.470,3,13,.231,17,20,.850,88
18605,2012-01-29,DAL,,SAS,W 101-100 (OT),265,44,100,.440,40,80,.500,4,20,.200,9,12,.750,101
18606,2012-01-29,SAS,@,DAL,L 100-101 (OT),265,39,94,.415,27,69,.391,12,25,.480,10,19,.526,100
18607,2012-01-29,DEN,,LAC,L 105-109,240,42,85,.494,36,67,.537,6,18,.333,15,20,.750,105
18608,2012-01-29,LAC,@,DEN,W 109-105,240,39,86,.453,25,56,.446,14,30,.467,17,26,.654,109
18609,2012-01-29,CHI,@,MIA,L 93-97,240,35,81,.432,32,70,.457,3,11,.273,20,28,.714,93
18610,2012-01-29,MIA,,CHI,W 97-93,240,32,78,.410,29,70,.414,3,8,.375,30,40,.750,97
18611,2012-01-29,LAL,@,MIN,W 106-101,240,40,79,.506,32,60,.533,8,19,.421,18,23,.783,106
18612,2012-01-29,MIN,,LAL,L 101-106,240,40,104,.385,35,83,.422,5,21,.238,16,23,.696,101
18613,2012-01-29,BRK,,TOR,L 73-94,240,27,74,.365,20,52,.385,7,22,.318,12,18,.667,73
18614,2012-01-29,TOR,@,NJN,W 94-73,240,35,68,.515,32,54,.593,3,14,.214,21,29,.724,94
18615,2012-01-29,ATL,@,NOH,W 94-72,240,36,81,.444,24,58,.414,12,23,.522,10,17,.588,94
18616,2012-01-29,NOP,,ATL,L 72-94,240,27,73,.370,24,63,.381,3,10,.300,15,19,.789,72
18617,2012-01-29,IND,@,ORL,W 106-85,240,45,88,.511,37,71,.521,8,17,.471,8,11,.727,106
18618,2012-01-29,ORL,,IND,L 85-106,240,31,64,.484,21,41,.512,10,23,.435,13,29,.448,85
18619,2012-01-28,CHA,,WAS,L 99-102,240,39,83,.470,35,72,.486,4,11,.364,17,29,.586,99
18620,2012-01-28,WAS,@,CHA,W 102-99,240,40,76,.526,34,65,.523,6,11,.545,16,21,.762,102
18621,2012-01-28,HOU,,NYK,W 97-84,240,38,77,.494,34,65,.523,4,12,.333,17,22,.773,97
18622,2012-01-28,NYK,@,HOU,L 84-97,240,34,89,.382,29,63,.460,5,26,.192,11,15,.733,84
18623,2012-01-28,LAL,@,MIL,L 89-100,240,36,82,.439,30,63,.476,6,19,.316,11,17,.647,89
18624,2012-01-28,MIL,,LAL,W 100-89,240,40,80,.500,35,61,.574,5,19,.263,15,16,.938,100
18625,2012-01-28,DET,@,PHI,L 74-95,240,29,83,.349,26,72,.361,3,11,.273,13,17,.765,74
18626,2012-01-28,PHI,,DET,W 95-74,240,38,78,.487,29,63,.460,9,15,.600,10,15,.667,95
18627,2012-01-28,MEM,@,PHO,L 84-86,240,33,76,.434,32,73,.438,1,3,.333,17,20,.850,84
18628,2012-01-28,PHO,,MEM,W 86-84,240,32,88,.364,27,70,.386,5,18,.278,17,24,.708,86
18629,2012-01-28,SAC,@,UTA,L 93-96,240,37,80,.463,31,67,.463,6,13,.462,13,14,.929,93
18630,2012-01-28,UTA,,SAC,W 96-93,240,35,79,.443,28,61,.459,7,18,.389,19,23,.826,96
18631,2012-01-27,BOS,,IND,W 94-87,240,38,83,.458,32,69,.464,6,14,.429,12,14,.857,94
18632,2012-01-27,IND,@,BOS,L 87-94,240,28,80,.350,27,61,.443,1,19,.053,30,31,.968,87
18633,2012-01-27,CHI,,MIL,W 107-100,240,41,90,.456,36,73,.493,5,17,.294,20,33,.606,107
18634,2012-01-27,MIL,@,CHI,L 100-107,240,39,92,.424,32,68,.471,7,24,.292,15,16,.938,100
18635,2012-01-27,CLE,,NJN,L 96-99,240,38,81,.469,32,62,.516,6,19,.316,14,24,.583,96
18636,2012-01-27,BRK,@,CLE,W 99-96,240,36,79,.456,25,51,.490,11,28,.393,16,21,.762,99
18637,2012-01-27,DAL,,UTA,W 116-101,240,45,82,.549,34,63,.540,11,19,.579,15,22,.682,116
18638,2012-01-27,UTA,@,DAL,L 101-116,240,39,84,.464,34,72,.472,5,12,.417,18,22,.818,101
18639,2012-01-27,DEN,,TOR,W 96-81,240,32,70,.457,24,43,.558,8,27,.296,24,32,.750,96
18640,2012-01-27,TOR,@,DEN,L 81-96,240,32,82,.390,25,63,.397,7,19,.368,10,14,.714,81
18641,2012-01-27,ATL,@,DET,W 107-101 (OT),265,40,82,.488,30,66,.455,10,16,.625,17,25,.680,107
18642,2012-01-27,DET,,ATL,L 101-107 (OT),265,38,93,.409,31,77,.403,7,16,.438,18,22,.818,101
18643,2012-01-27,GSW,,OKC,L 109-120,240,41,87,.471,29,59,.492,12,28,.429,15,19,.789,109
18644,2012-01-27,OKC,@,GSW,W 120-109,240,42,88,.477,38,71,.535,4,17,.235,32,37,.865,120
18645,2012-01-27,HOU,,WAS,W 103-76,240,38,90,.422,33,75,.440,5,15,.333,22,30,.733,103
18646,2012-01-27,WAS,@,HOU,L 76-103,240,32,88,.364,31,80,.388,1,8,.125,11,16,.688,76
18647,2012-01-27,MIA,,NYK,W 99-89,240,37,80,.463,35,70,.500,2,10,.200,23,26,.885,99
18648,2012-01-27,NYK,@,MIA,L 89-99,240,30,84,.357,12,41,.293,18,43,.419,11,14,.786,89
18649,2012-01-27,MIN,,SAS,W 87-79,240,36,82,.439,34,73,.466,2,9,.222,13,18,.722,87
18650,2012-01-27,SAS,@,MIN,L 79-87,240,31,75,.413,24,59,.407,7,16,.438,10,11,.909,79
18651,2012-01-27,NOP,,ORL,W 93-67,240,41,81,.506,36,67,.537,5,14,.357,6,16,.375,93
18652,2012-01-27,ORL,@,NOH,L 67-93,240,24,61,.393,18,40,.450,6,21,.286,13,21,.619,67
18653,2012-01-27,CHA,@,PHI,L 72-89,240,27,70,.386,23,55,.418,4,15,.267,14,21,.667,72
18654,2012-01-27,PHI,,CHA,W 89-72,240,35,78,.449,29,63,.460,6,15,.400,13,16,.813,89
18655,2012-01-27,PHO,@,POR,L 71-109,240,29,78,.372,25,65,.385,4,13,.308,9,18,.500,71
18656,2012-01-27,POR,,PHO,W 109-71,240,43,91,.473,36,71,.507,7,20,.350,16,19,.842,109
18657,2012-01-26,LAC,,MEM,W 98-91,240,35,72,.486,26,50,.520,9,22,.409,19,27,.704,98
18658,2012-01-26,MEM,@,LAC,L 91-98,240,30,84,.357,24,66,.364,6,18,.333,25,31,.806,91
18659,2012-01-26,BOS,@,ORL,W 91-83,240,34,73,.466,24,52,.462,10,21,.476,13,19,.684,91
18660,2012-01-26,ORL,,BOS,L 83-91,240,30,79,.380,25,62,.403,5,17,.294,18,31,.581,83
18661,2012-01-25,CHI,,IND,L 90-95,240,36,90,.400,33,77,.429,3,13,.231,15,21,.714,90
18662,2012-01-25,IND,@,CHI,W 95-90,240,38,80,.475,33,70,.471,5,10,.500,14,21,.667,95
18663,2012-01-25,CLE,,NYK,W 91-81,240,34,78,.436,25,58,.431,9,20,.450,14,26,.538,91
18664,2012-01-25,NYK,@,CLE,L 81-91,240,32,76,.421,29,56,.518,3,20,.150,14,20,.700,81
18665,2012-01-25,DAL,,MIN,L 90-105,240,39,95,.411,33,73,.452,6,22,.273,6,10,.600,90
18666,2012-01-25,MIN,@,DAL,W 105-90,240,34,77,.442,25,56,.446,9,21,.429,28,33,.848,105
18667,2012-01-25,DET,,MIA,L 98-101,240,36,72,.500,29,50,.580,7,22,.318,19,25,.760,98
18668,2012-01-25,MIA,@,DET,W 101-98,240,37,71,.521,32,56,.571,5,15,.333,22,25,.880,101
18669,2012-01-25,GSW,,POR,W 101-93,240,41,79,.519,30,59,.508,11,20,.550,8,14,.571,101
18670,2012-01-25,POR,@,GSW,L 93-101,240,34,83,.410,26,62,.419,8,21,.381,17,20,.850,93
18671,2012-01-25,HOU,,MIL,L 99-105,240,38,93,.409,30,62,.484,8,31,.258,15,20,.750,99
18672,2012-01-25,MIL,@,HOU,W 105-99,240,39,91,.429,25,62,.403,14,29,.483,13,17,.765,105
18673,2012-01-25,LAC,@,LAL,L 91-96,240,37,87,.425,29,64,.453,8,23,.348,9,14,.643,91
18674,2012-01-25,LAL,,LAC,W 96-91,240,32,66,.485,24,50,.480,8,16,.500,24,32,.750,96
18675,2012-01-25,NOP,@,OKC,L 91-101,240,35,75,.467,34,68,.500,1,7,.143,20,21,.952,91
18676,2012-01-25,OKC,,NOH,W 101-91,240,34,64,.531,29,51,.569,5,13,.385,28,33,.848,101
18677,2012-01-25,BRK,@,PHI,W 97-90 (OT),265,37,82,.451,25,55,.455,12,27,.444,11,14,.786,97
18678,2012-01-25,PHI,,NJN,L 90-97 (OT),265,35,79,.443,30,65,.462,5,14,.357,15,19,.789,90
18679,2012-01-25,DEN,@,SAC,W 122-93,240,50,91,.549,48,78,.615,2,13,.154,20,25,.800,122
18680,2012-01-25,SAC,,DEN,L 93-122,240,34,78,.436,25,58,.431,9,20,.450,16,22,.727,93
18681,2012-01-25,ATL,@,SAS,L 83-105,240,35,80,.438,29,63,.460,6,17,.353,7,10,.700,83
18682,2012-01-25,SAS,,ATL,W 105-83,240,42,82,.512,31,59,.525,11,23,.478,10,15,.667,105
18683,2012-01-25,TOR,@,UTA,W 111-106 (2OT),290,43,96,.448,33,68,.485,10,28,.357,15,19,.789,111
18684,2012-01-25,UTA,,TOR,L 106-111 (2OT),290,39,90,.433,35,72,.486,4,18,.222,24,36,.667,106
18685,2012-01-25,CHA,@,WAS,L 75-92,240,28,78,.359,27,69,.391,1,9,.111,18,25,.720,75
18686,2012-01-25,WAS,,CHA,W 92-75,240,39,83,.470,36,73,.493,3,10,.300,11,16,.688,92
18687,2012-01-24,CHA,,NYK,L 78-111,240,27,82,.329,24,71,.338,3,11,.273,21,22,.955,78
18688,2012-01-24,NYK,@,CHA,W 111-78,240,39,78,.500,32,59,.542,7,19,.368,26,33,.788,111
18689,2012-01-24,IND,,ORL,L 83-102,240,31,78,.397,28,67,.418,3,11,.273,18,18,1.000,83
18690,2012-01-24,ORL,@,IND,W 102-83,240,38,83,.458,25,51,.490,13,32,.406,13,19,.684,102
18691,2012-01-24,CLE,@,MIA,L 85-92,240,34,68,.500,28,52,.538,6,16,.375,11,17,.647,85
18692,2012-01-24,MIA,,CLE,W 92-85,240,32,70,.457,27,52,.519,5,18,.278,23,26,.885,92
18693,2012-01-24,PHO,,TOR,L 96-99,240,39,82,.476,34,66,.515,5,16,.313,13,17,.765,96
18694,2012-01-24,TOR,@,PHO,W 99-96,240,34,82,.415,26,67,.388,8,15,.533,23,25,.920,99
18695,2012-01-24,MEM,@,POR,L 84-97,240,34,90,.378,31,76,.408,3,14,.214,13,17,.765,84
18696,2012-01-24,POR,,MEM,W 97-84,240,31,72,.431,26,50,.520,5,22,.227,30,36,.833,97
18697,2012-01-23,BOS,,ORL,W 87-56,240,33,78,.423,31,65,.477,2,13,.154,19,19,1.000,87
18698,2012-01-23,ORL,@,BOS,L 56-87,240,16,65,.246,12,49,.245,4,16,.250,20,30,.667,56
18699,2012-01-23,CHI,,NJN,W 110-95,240,43,75,.573,36,56,.643,7,19,.368,17,23,.739,110
18700,2012-01-23,BRK,@,CHI,L 95-110,240,37,77,.481,30,58,.517,7,19,.368,14,21,.667,95
18701,2012-01-23,DAL,,PHO,W 93-87,240,33,81,.407,25,56,.446,8,25,.320,19,29,.655,93
18702,2012-01-23,PHO,@,DAL,L 87-93,240,31,83,.373,25,63,.397,6,20,.300,19,22,.864,87
18703,2012-01-23,GSW,,MEM,L 90-91,240,38,76,.500,29,51,.569,9,25,.360,5,8,.625,90
18704,2012-01-23,MEM,@,GSW,W 91-90,240,36,85,.424,34,72,.472,2,13,.154,17,23,.739,91
18705,2012-01-23,ATL,@,MIL,W 97-92,240,38,83,.458,35,72,.486,3,11,.273,18,21,.857,97
18706,2012-01-23,MIL,,ATL,L 92-97,240,37,92,.402,32,75,.427,5,17,.294,13,17,.765,92
18707,2012-01-23,HOU,@,MIN,W 107-92,240,39,86,.453,32,65,.492,7,21,.333,22,28,.786,107
18708,2012-01-23,MIN,,HOU,L 92-107,240,33,80,.413,28,68,.412,5,12,.417,21,27,.778,92
18709,2012-01-23,NOP,,SAS,L 102-104,240,42,83,.506,36,71,.507,6,12,.500,12,13,.923,102
18710,2012-01-23,SAS,@,NOH,W 104-102,240,41,75,.547,34,59,.576,7,16,.438,15,20,.750,104
18711,2012-01-23,DET,@,OKC,L 79-99,240,28,82,.341,24,68,.353,4,14,.286,19,27,.704,79
18712,2012-01-23,OKC,,DET,W 99-79,240,41,77,.532,34,61,.557,7,16,.438,10,14,.714,99
18713,2012-01-23,PHI,,WAS,W 103-83,240,43,83,.518,37,67,.552,6,16,.375,11,20,.550,103
18714,2012-01-23,WAS,@,PHI,L 83-103,240,32,74,.432,32,67,.478,0,7,.000,19,27,.704,83
18715,2012-01-23,POR,,SAC,W 101-89,240,41,88,.466,34,69,.493,7,19,.368,12,21,.571,101
18716,2012-01-23,SAC,@,POR,L 89-101,240,32,80,.400,25,62,.403,7,18,.389,18,25,.720,89
18717,2012-01-22,LAC,,TOR,W 103-91,240,35,72,.486,27,51,.529,8,21,.381,25,40,.625,103
18718,2012-01-22,TOR,@,LAC,L 91-103,240,29,81,.358,21,62,.339,8,19,.421,25,31,.806,91
18719,2012-01-22,IND,@,LAL,W 98-96,240,36,77,.468,26,59,.441,10,18,.556,16,19,.842,98
18720,2012-01-22,LAL,,IND,L 96-98,240,36,86,.419,34,77,.442,2,9,.222,22,33,.667,96
18721,2012-01-22,MIA,,MIL,L 82-91,240,25,67,.373,22,55,.400,3,12,.250,29,35,.829,82
18722,2012-01-22,MIL,@,MIA,W 91-82,240,28,80,.350,23,50,.460,5,30,.167,30,34,.882,91
18723,2012-01-22,CHA,@,NJN,L 87-97,240,37,79,.468,32,65,.492,5,14,.357,8,15,.533,87
18724,2012-01-22,BRK,,CHA,W 97-87,240,38,86,.442,31,59,.525,7,27,.259,14,15,.933,97
18725,2012-01-22,BOS,@,WAS,W 100-94,240,37,72,.514,32,60,.533,5,12,.417,21,30,.700,100
18726,2012-01-22,WAS,,BOS,L 94-100,240,37,77,.481,35,62,.565,2,15,.133,18,21,.857,94
18727,2012-01-21,ATL,,CLE,W 121-94,240,46,83,.554,35,59,.593,11,24,.458,18,24,.750,121
18728,2012-01-21,CLE,@,ATL,L 94-121,240,34,70,.486,27,50,.540,7,20,.350,19,27,.704,94
18729,2012-01-21,CHA,@,CHI,L 89-95,240,35,74,.473,33,63,.524,2,11,.182,17,23,.739,89
18730,2012-01-21,CHI,,CHA,W 95-89,240,40,85,.471,34,70,.486,6,15,.400,9,15,.600,95
18731,2012-01-21,DET,,POR,W 94-91,240,30,67,.448,23,52,.442,7,15,.467,27,32,.844,94
18732,2012-01-21,POR,@,DET,L 91-94,240,34,81,.420,31,61,.508,3,20,.150,20,24,.833,91
18733,2012-01-21,HOU,,SAS,W 105-102,240,44,79,.557,38,57,.667,6,22,.273,11,12,.917,105
18734,2012-01-21,SAS,@,HOU,L 102-105,240,42,94,.447,35,72,.486,7,22,.318,11,15,.733,102
18735,2012-01-21,MEM,,SAC,W 128-95,240,50,92,.543,42,76,.553,8,16,.500,20,27,.741,128
18736,2012-01-21,SAC,@,MEM,L 95-128,240,36,87,.414,30,68,.441,6,19,.316,17,22,.773,95
18737,2012-01-21,MIA,,PHI,W 113-92,240,44,81,.543,37,65,.569,7,16,.438,18,21,.857,113
18738,2012-01-21,PHI,@,MIA,L 92-113,240,37,83,.446,29,68,.426,8,15,.533,10,15,.667,92
18739,2012-01-21,BRK,,OKC,L 74-84,240,27,87,.310,24,64,.375,3,23,.130,17,19,.895,74
18740,2012-01-21,OKC,@,NJN,W 84-74,240,32,77,.416,28,60,.467,4,17,.235,16,24,.667,84
18741,2012-01-21,DAL,@,NOH,W 83-81,240,32,79,.405,28,53,.528,4,26,.154,15,20,.750,83
18742,2012-01-21,NOP,,DAL,L 81-83,240,29,79,.367,27,60,.450,2,19,.105,21,32,.656,81
18743,2012-01-21,DEN,@,NYK,W 119-114 (2OT),290,41,98,.418,35,74,.473,6,24,.250,31,43,.721,119
18744,2012-01-21,NYK,,DEN,L 114-119 (2OT),290,44,97,.454,33,64,.516,11,33,.333,15,21,.714,114
18745,2012-01-21,MIN,@,UTA,L 98-108,240,37,83,.446,29,62,.468,8,21,.381,16,21,.762,98
18746,2012-01-21,UTA,,MIN,W 108-98,240,41,79,.519,36,64,.563,5,15,.333,21,29,.724,108
18747,2012-01-20,BOS,,PHO,L 71-79,240,30,74,.405,26,64,.406,4,10,.400,7,9,.778,71
18748,2012-01-20,PHO,@,BOS,W 79-71,240,31,69,.449,26,50,.520,5,19,.263,12,16,.750,79
18749,2012-01-20,CHI,@,CLE,W 114-75,240,46,83,.554,40,74,.541,6,9,.667,16,17,.941,114
18750,2012-01-20,CLE,,CHI,L 75-114,240,27,89,.303,20,75,.267,7,14,.500,14,19,.737,75
18751,2012-01-20,DET,,MEM,L 81-98,240,29,66,.439,25,56,.446,4,10,.400,19,26,.731,81
18752,2012-01-20,MEM,@,DET,W 98-81,240,39,68,.574,34,59,.576,5,9,.556,15,20,.750,98
18753,2012-01-20,GSW,,IND,L 91-94,240,37,80,.463,27,57,.474,10,23,.435,7,8,.875,91
18754,2012-01-20,IND,@,GSW,W 94-91,240,35,83,.422,27,67,.403,8,16,.500,16,21,.762,94
18755,2012-01-20,LAC,,MIN,L 98-101,240,33,71,.465,22,50,.440,11,21,.524,21,28,.750,98
18756,2012-01-20,MIN,@,LAC,W 101-98,240,36,81,.444,30,66,.455,6,15,.400,23,33,.697,101
18757,2012-01-20,MIL,@,NYK,W 100-86,240,39,82,.476,31,60,.517,8,22,.364,14,20,.700,100
18758,2012-01-20,NYK,,MIL,L 86-100,240,27,73,.370,21,51,.412,6,22,.273,26,33,.788,86
18759,2012-01-20,LAL,@,ORL,L 80-92,240,29,76,.382,23,56,.411,6,20,.300,16,22,.727,80
18760,2012-01-20,ORL,,LAL,W 92-80,240,32,77,.416,20,50,.400,12,27,.444,16,26,.615,92
18761,2012-01-20,ATL,@,PHI,L 76-90,240,32,74,.432,27,59,.458,5,15,.333,7,8,.875,76
18762,2012-01-20,PHI,,ATL,W 90-76,240,35,84,.417,31,67,.463,4,17,.235,16,19,.842,90
18763,2012-01-20,SAC,@,SAS,W 88-86,240,36,83,.434,31,62,.500,5,21,.238,11,19,.579,88
18764,2012-01-20,SAS,,SAC,L 86-88,240,31,82,.378,26,57,.456,5,25,.200,19,21,.905,86
18765,2012-01-20,POR,@,TOR,W 94-84,240,33,82,.402,28,67,.418,5,15,.333,23,31,.742,94
18766,2012-01-20,TOR,,POR,L 84-94,240,30,82,.366,25,67,.373,5,15,.333,19,25,.760,84
18767,2012-01-20,DEN,@,WAS,W 108-104,240,39,79,.494,29,58,.500,10,21,.476,20,30,.667,108
18768,2012-01-20,WAS,,DEN,L 104-108,240,40,95,.421,29,69,.420,11,26,.423,13,17,.765,104
18769,2012-01-19,HOU,,NOH,W 90-88 (OT),265,35,88,.398,26,61,.426,9,27,.333,11,13,.846,90
18770,2012-01-19,NOP,@,HOU,L 88-90 (OT),265,37,94,.394,34,83,.410,3,11,.273,11,16,.688,88
18771,2012-01-19,LAL,@,MIA,L 87-98,240,34,81,.420,28,61,.459,6,20,.300,13,16,.813,87
18772,2012-01-19,MIA,,LAL,W 98-87,240,38,85,.447,29,67,.433,9,18,.500,13,18,.722,98
18773,2012-01-19,DAL,@,UTA,W 94-91,240,37,71,.521,32,51,.627,5,20,.250,15,19,.789,94
18774,2012-01-19,UTA,,DAL,L 91-94,240,31,80,.388,28,68,.412,3,12,.250,26,29,.897,91
18775,2012-01-18,ATL,,POR,W 92-89,240,33,71,.465,28,60,.467,5,11,.455,21,27,.778,92
18776,2012-01-18,POR,@,ATL,L 89-92,240,35,92,.380,30,73,.411,5,19,.263,14,20,.700,89
18777,2012-01-18,BOS,,TOR,W 96-73,240,34,71,.479,28,55,.509,6,16,.375,22,32,.688,96
18778,2012-01-18,TOR,@,BOS,L 73-96,240,26,69,.377,22,54,.407,4,15,.267,17,20,.850,73
18779,2012-01-18,DAL,@,LAC,L 89-91,240,34,81,.420,25,61,.410,9,20,.450,12,18,.667,89
18780,2012-01-18,LAC,,DAL,W 91-89,240,37,87,.425,29,65,.446,8,22,.364,9,17,.529,91
18781,2012-01-18,DET,@,MIN,L 85-93,240,35,79,.443,30,68,.441,5,11,.455,10,21,.476,85
18782,2012-01-18,MIN,,DET,W 93-85,240,30,75,.400,22,52,.423,8,23,.348,25,34,.735,93
18783,2012-01-18,GSW,@,NJN,L 100-107,240,37,72,.514,29,56,.518,8,16,.500,18,27,.667,100
18784,2012-01-18,BRK,,GSW,W 107-100,240,37,75,.493,26,46,.565,11,29,.379,22,25,.880,107
18785,2012-01-18,MEM,@,NOH,W 93-87,240,36,73,.493,30,59,.508,6,14,.429,15,17,.882,93
18786,2012-01-18,NOP,,MEM,L 87-93,240,34,70,.486,29,58,.500,5,12,.417,14,16,.875,87
18787,2012-01-18,NYK,,PHO,L 88-91,240,32,86,.372,28,71,.394,4,15,.267,20,30,.667,88
18788,2012-01-18,PHO,@,NYK,W 91-88,240,36,79,.456,29,67,.433,7,12,.583,12,16,.750,91
18789,2012-01-18,ORL,,SAS,L 83-85 (OT),265,29,87,.333,25,66,.379,4,21,.190,21,27,.778,83
18790,2012-01-18,SAS,@,ORL,W 85-83 (OT),265,36,84,.429,34,67,.507,2,17,.118,11,18,.611,85
18791,2012-01-18,DEN,@,PHI,W 108-104 (OT),265,43,89,.483,36,71,.507,7,18,.389,15,22,.682,108
18792,2012-01-18,PHI,,DEN,L 104-108 (OT),265,43,98,.439,39,84,.464,4,14,.286,14,19,.737,104
18793,2012-01-18,IND,@,SAC,L 88-92,240,34,78,.436,33,65,.508,1,13,.077,19,27,.704,88
18794,2012-01-18,SAC,,IND,W 92-88,240,28,93,.301,20,62,.323,8,31,.258,28,41,.683,92
18795,2012-01-18,OKC,@,WAS,L 102-105,240,37,77,.481,33,58,.569,4,19,.211,24,30,.800,102
18796,2012-01-18,WAS,,OKC,W 105-102,240,33,86,.384,25,65,.385,8,21,.381,31,43,.721,105
18797,2012-01-17,CHI,,PHO,W 118-97,240,47,88,.534,42,78,.538,5,10,.500,19,24,.792,118
18798,2012-01-17,PHO,@,CHI,L 97-118,240,38,74,.514,33,63,.524,5,11,.455,16,19,.842,97
18799,2012-01-17,CLE,,GSW,L 95-105,240,35,82,.427,30,67,.448,5,15,.333,20,28,.714,95
18800,2012-01-17,GSW,@,CLE,W 105-95,240,41,94,.436,32,75,.427,9,19,.474,14,19,.737,105
18801,2012-01-17,DET,@,HOU,L 80-97,240,34,83,.410,30,70,.429,4,13,.308,8,9,.889,80
18802,2012-01-17,HOU,,DET,W 97-80,240,40,81,.494,32,62,.516,8,19,.421,9,12,.750,97
18803,2012-01-17,MIA,,SAS,W 120-98,240,46,79,.582,30,53,.566,16,26,.615,12,19,.632,120
18804,2012-01-17,SAS,@,MIA,L 98-120,240,38,80,.475,28,55,.509,10,25,.400,12,17,.706,98
18805,2012-01-17,DEN,@,MIL,W 105-95,240,32,75,.427,20,50,.400,12,25,.480,29,37,.784,105
18806,2012-01-17,MIL,,DEN,L 95-105,240,38,91,.418,31,68,.456,7,23,.304,12,14,.857,95
18807,2012-01-17,CHA,@,ORL,L 89-96,240,36,77,.468,31,60,.517,5,17,.294,12,17,.706,89
18808,2012-01-17,ORL,,CHA,W 96-89,240,36,78,.462,29,56,.518,7,22,.318,17,26,.654,96
18809,2012-01-17,LAC,@,UTA,L 79-108,240,31,85,.365,27,65,.415,4,20,.200,13,21,.619,79
18810,2012-01-17,UTA,,LAC,W 108-79,240,39,82,.476,36,74,.486,3,8,.375,27,31,.871,108
18811,2012-01-16,ATL,,TOR,W 93-84,240,32,71,.451,27,58,.466,5,13,.385,24,31,.774,93
18812,2012-01-16,TOR,@,ATL,L 84-93,240,33,78,.423,30,66,.455,3,12,.250,15,22,.682,84
18813,2012-01-16,BOS,,OKC,L 88-97,240,34,87,.391,28,73,.384,6,14,.429,14,16,.875,88
18814,2012-01-16,OKC,@,BOS,W 97-88,240,36,80,.450,29,61,.475,7,19,.368,18,19,.947,97
18815,2012-01-16,CHA,,CLE,L 94-102,240,38,86,.442,34,69,.493,4,17,.235,14,26,.538,94
18816,2012-01-16,CLE,@,CHA,W 102-94,240,39,80,.488,35,65,.538,4,15,.267,20,29,.690,102
18817,2012-01-16,LAC,,NJN,W 101-91,240,37,80,.463,29,59,.492,8,21,.381,19,35,.543,101
18818,2012-01-16,BRK,@,LAC,L 91-101,240,33,78,.423,25,54,.463,8,24,.333,17,26,.654,91
18819,2012-01-16,DAL,@,LAL,L 70-73,240,28,80,.350,24,54,.444,4,26,.154,10,16,.625,70
18820,2012-01-16,LAL,,DAL,W 73-70,240,29,76,.382,28,66,.424,1,10,.100,14,19,.737,73
18821,2012-01-16,CHI,@,MEM,L 86-102,240,33,78,.423,32,66,.485,1,12,.083,19,25,.760,86
18822,2012-01-16,MEM,,CHI,W 102-86,240,47,87,.540,44,77,.571,3,10,.300,5,9,.556,102
18823,2012-01-16,MIN,,SAC,W 99-86,240,37,80,.463,27,54,.500,10,26,.385,15,19,.789,99
18824,2012-01-16,SAC,@,MIN,L 86-99,240,35,79,.443,31,62,.500,4,17,.235,12,20,.600,86
18825,2012-01-16,NOP,,POR,L 77-84,240,28,68,.412,28,59,.475,0,9,.000,21,28,.750,77
18826,2012-01-16,POR,@,NOH,W 84-77,240,34,72,.472,28,52,.538,6,20,.300,10,15,.667,84
18827,2012-01-16,NYK,,ORL,L 93-102,240,30,73,.411,25,53,.472,5,20,.250,28,33,.848,93
18828,2012-01-16,ORL,@,NYK,W 102-93,240,36,71,.507,19,36,.528,17,35,.486,13,22,.591,102
18829,2012-01-16,MIL,@,PHI,L 82-94,240,35,75,.467,32,61,.525,3,14,.214,9,14,.643,82
18830,2012-01-16,PHI,,MIL,W 94-82,240,37,84,.440,26,61,.426,11,23,.478,9,13,.692,94
18831,2012-01-16,HOU,@,WAS,W 114-106,240,42,87,.483,37,71,.521,5,16,.313,25,26,.962,114
18832,2012-01-16,WAS,,HOU,L 106-114,240,39,80,.488,36,69,.522,3,11,.273,25,32,.781,106
18833,2012-01-15,DEN,,UTA,L 96-106,240,32,75,.427,26,59,.441,6,16,.375,26,39,.667,96
18834,2012-01-15,UTA,@,DEN,W 106-96,240,44,85,.518,40,73,.548,4,12,.333,14,20,.700,106
18835,2012-01-15,DET,,GSW,L 91-99,240,31,74,.419,24,55,.436,7,19,.368,22,26,.846,91
18836,2012-01-15,GSW,@,DET,W 99-91,240,38,73,.521,35,58,.603,3,15,.200,20,27,.741,99
18837,2012-01-15,PHO,@,SAS,L 91-102,240,38,91,.418,33,76,.434,5,15,.333,10,14,.714,91
18838,2012-01-15,SAS,,PHO,W 102-91,240,40,81,.494,35,62,.565,5,19,.263,17,23,.739,102
18839,2012-01-14,ATL,,MIN,W 93-91,240,32,78,.410,25,57,.439,7,21,.333,22,27,.815,93
18840,2012-01-14,MIN,@,ATL,L 91-93,240,38,85,.447,34,64,.531,4,21,.190,11,12,.917,91
18841,2012-01-14,CHA,,GSW,W 112-100,240,38,76,.500,31,63,.492,7,13,.538,29,38,.763,112
18842,2012-01-14,GSW,@,CHA,L 100-112,240,35,84,.417,30,64,.469,5,20,.250,25,32,.781,100
18843,2012-01-14,CHI,,TOR,W 77-64,240,33,82,.402,29,67,.433,4,15,.267,7,12,.583,77
18844,2012-01-14,TOR,@,CHI,L 64-77,240,30,86,.349,27,76,.355,3,10,.300,1,7,.143,64
18845,2012-01-14,DAL,,SAC,W 99-60,240,37,81,.457,30,65,.462,7,16,.438,18,25,.720,99
18846,2012-01-14,SAC,@,DAL,L 60-99,240,22,86,.256,20,65,.308,2,21,.095,14,18,.778,60
18847,2012-01-14,HOU,,POR,W 107-105 (OT),265,39,93,.419,34,75,.453,5,18,.278,24,28,.857,107
18848,2012-01-14,POR,@,HOU,L 105-107 (OT),265,37,90,.411,28,64,.438,9,26,.346,22,31,.710,105
18849,2012-01-14,BOS,@,IND,L 83-97,240,32,83,.386,27,68,.397,5,15,.333,14,18,.778,83
18850,2012-01-14,IND,,BOS,W 97-83,240,35,94,.372,30,78,.385,5,16,.313,22,23,.957,97
18851,2012-01-14,LAC,,LAL,W 102-94,240,35,85,.412,26,64,.406,9,21,.429,23,30,.767,102
18852,2012-01-14,LAL,@,LAC,L 94-102,240,35,77,.455,30,65,.462,5,12,.417,19,25,.760,94
18853,2012-01-14,MEM,,NOH,W 108-99,240,35,78,.449,30,68,.441,5,10,.500,33,41,.805,108
18854,2012-01-14,NOP,@,MEM,L 99-108,240,35,75,.467,31,65,.477,4,10,.400,25,31,.806,99
18855,2012-01-14,NYK,@,OKC,L 92-104,240,34,83,.410,29,64,.453,5,19,.263,19,23,.826,92
18856,2012-01-14,OKC,,NYK,W 104-92,240,34,71,.479,27,53,.509,7,18,.389,29,34,.853,104
18857,2012-01-14,BRK,@,UTA,L 94-107,240,32,74,.432,23,47,.489,9,27,.333,21,27,.778,94
18858,2012-01-14,UTA,,NJN,W 107-94,240,42,81,.519,39,73,.534,3,8,.375,20,26,.769,107
18859,2012-01-14,PHI,@,WAS,W 103-90,240,37,86,.430,31,70,.443,6,16,.375,23,27,.852,103
18860,2012-01-14,WAS,,PHI,L 90-103,240,38,88,.432,35,74,.473,3,14,.214,11,17,.647,90
18861,2012-01-13,BOS,,CHI,L 79-88,240,31,75,.413,25,61,.410,6,14,.429,11,13,.846,79
18862,2012-01-13,CHI,@,BOS,W 88-79,240,34,76,.447,30,63,.476,4,13,.308,16,21,.762,88
18863,2012-01-13,CHA,,DET,L 81-98,240,33,74,.446,32,66,.485,1,8,.125,14,16,.875,81
18864,2012-01-13,DET,@,CHA,W 98-81,240,40,82,.488,33,68,.485,7,14,.500,11,16,.688,98
18865,2012-01-13,DAL,,MIL,W 102-76,240,39,75,.520,29,53,.547,10,22,.455,14,18,.778,102
18866,2012-01-13,MIL,@,DAL,L 76-102,240,29,78,.372,24,54,.444,5,24,.208,13,16,.813,76
18867,2012-01-13,DEN,,MIA,W 117-104,240,43,78,.551,31,53,.585,12,25,.480,19,26,.731,117
18868,2012-01-13,MIA,@,DEN,L 104-117,240,38,81,.469,31,65,.477,7,16,.438,21,29,.724,104
18869,2012-01-13,HOU,,SAC,W 103-89,240,40,89,.449,32,68,.471,8,21,.381,15,19,.789,103
18870,2012-01-13,SAC,@,HOU,L 89-103,240,35,80,.438,31,60,.517,4,20,.200,15,16,.938,89
18871,2012-01-13,CLE,@,LAL,L 92-97,240,32,85,.376,24,61,.393,8,24,.333,20,25,.800,92
18872,2012-01-13,LAL,,CLE,W 97-92,240,37,76,.487,32,62,.516,5,14,.357,18,23,.783,97
18873,2012-01-13,MIN,@,NOH,W 87-80,240,24,70,.343,18,45,.400,6,25,.240,33,38,.868,87
18874,2012-01-13,NOP,,MIN,L 80-87,240,34,90,.378,30,74,.405,4,16,.250,8,16,.500,80
18875,2012-01-13,PHI,,WAS,W 120-89,240,47,85,.553,35,67,.522,12,18,.667,14,19,.737,120
18876,2012-01-13,WAS,@,PHI,L 89-120,240,36,81,.444,32,64,.500,4,17,.235,13,20,.650,89
18877,2012-01-13,BRK,@,PHO,W 110-103,240,40,80,.500,25,48,.521,15,32,.469,15,19,.789,110
18878,2012-01-13,PHO,,NJN,L 103-110,240,41,79,.519,33,57,.579,8,22,.364,13,16,.813,103
18879,2012-01-13,POR,@,SAS,L 83-99,240,34,84,.405,29,66,.439,5,18,.278,10,14,.714,83
18880,2012-01-13,SAS,,POR,W 99-83,240,38,74,.514,32,57,.561,6,17,.353,17,25,.680,99
18881,2012-01-13,IND,@,TOR,W 95-90,240,30,66,.455,27,58,.466,3,8,.375,32,38,.842,95
18882,2012-01-13,TOR,,IND,L 90-95,240,33,74,.446,29,57,.509,4,17,.235,20,32,.625,90
18883,2012-01-12,ATL,,CHA,W 111-81,240,42,90,.467,36,71,.507,6,19,.316,21,28,.750,111
18884,2012-01-12,CHA,@,ATL,L 81-111,240,33,78,.423,32,70,.457,1,8,.125,14,16,.875,81
18885,2012-01-12,GSW,,ORL,L 109-117,240,43,82,.524,33,59,.559,10,23,.435,13,19,.684,109
18886,2012-01-12,ORL,@,GSW,W 117-109,240,35,68,.515,24,45,.533,11,23,.478,36,55,.655,117
18887,2012-01-12,MEM,,NYK,W 94-83,240,34,75,.453,28,63,.444,6,12,.500,20,30,.667,94
18888,2012-01-12,NYK,@,MEM,L 83-94,240,31,83,.373,20,57,.351,11,26,.423,10,11,.909,83
18889,2012-01-12,DET,@,MIL,L 93-102,240,33,74,.446,30,69,.435,3,5,.600,24,24,1.000,93
18890,2012-01-12,MIL,,DET,W 102-93,240,37,78,.474,26,56,.464,11,22,.500,17,17,1.000,102
18891,2012-01-12,CLE,@,PHO,W 101-90,240,39,89,.438,29,70,.414,10,19,.526,13,21,.619,101
18892,2012-01-12,PHO,,CLE,L 90-101,240,34,75,.453,26,54,.481,8,21,.381,14,20,.700,90
18893,2012-01-11,BOS,,DAL,L 85-90,240,29,64,.453,25,53,.472,4,11,.364,23,32,.719,85
18894,2012-01-11,DAL,@,BOS,W 90-85,240,35,79,.443,29,63,.460,6,16,.375,14,25,.560,90
18895,2012-01-11,CHI,,WAS,W 78-64,240,33,90,.367,30,78,.385,3,12,.250,9,16,.563,78
18896,2012-01-11,WAS,@,CHI,L 64-78,240,26,84,.310,23,75,.307,3,9,.333,9,12,.750,64
18897,2012-01-11,DEN,,NJN,W 123-115,240,44,74,.595,33,56,.589,11,18,.611,24,30,.800,123
18898,2012-01-11,BRK,@,DEN,L 115-123,240,43,83,.518,23,48,.479,20,35,.571,9,12,.750,115
18899,2012-01-11,ATL,@,IND,L 84-96,240,30,80,.375,25,67,.373,5,13,.385,19,27,.704,84
18900,2012-01-11,IND,,ATL,W 96-84,240,39,85,.459,33,71,.465,6,14,.429,12,16,.750,96
18901,2012-01-11,LAC,,MIA,W 95-89 (OT),265,36,86,.419,30,69,.435,6,17,.353,17,23,.739,95
18902,2012-01-11,MIA,@,LAC,L 89-95 (OT),265,32,81,.395,27,65,.415,5,16,.313,20,34,.588,89
18903,2012-01-11,NOP,,OKC,L 85-95,240,36,80,.450,35,64,.547,1,16,.063,12,17,.706,85
18904,2012-01-11,OKC,@,NOH,W 95-85,240,35,73,.479,28,53,.528,7,20,.350,18,26,.692,95
18905,2012-01-11,NYK,,PHI,W 85-79,240,32,77,.416,26,55,.473,6,22,.273,15,19,.789,85
18906,2012-01-11,PHI,@,NYK,L 79-85,240,32,81,.395,29,66,.439,3,15,.200,12,18,.667,79
18907,2012-01-11,ORL,@,POR,W 107-104,240,41,70,.586,25,43,.581,16,27,.593,9,19,.474,107
18908,2012-01-11,POR,,ORL,L 104-107,240,41,86,.477,31,61,.508,10,25,.400,12,13,.923,104
18909,2012-01-11,HOU,@,SAS,L 95-101 (OT),265,41,96,.427,38,75,.507,3,21,.143,10,12,.833,95
18910,2012-01-11,SAS,,HOU,W 101-95 (OT),265,42,92,.457,37,76,.487,5,16,.313,12,17,.706,101
18911,2012-01-11,SAC,@,TOR,W 98-91,240,30,81,.370,23,57,.404,7,24,.292,31,34,.912,98
18912,2012-01-11,TOR,,SAC,L 91-98,240,34,80,.425,28,60,.467,6,20,.300,17,21,.810,91
18913,2012-01-11,LAL,@,UTA,W 90-87 (OT),265,35,82,.427,31,73,.425,4,9,.444,16,19,.842,90
18914,2012-01-11,UTA,,LAL,L 87-90 (OT),265,36,93,.387,32,79,.405,4,14,.286,11,16,.688,87
18915,2012-01-10,CHA,,HOU,L 70-82,240,30,88,.341,29,75,.387,1,13,.077,9,11,.818,70
18916,2012-01-10,HOU,@,CHA,W 82-70,240,32,83,.386,26,66,.394,6,17,.353,12,16,.750,82
18917,2012-01-10,DAL,@,DET,W 100-86,240,38,69,.551,34,54,.630,4,15,.267,20,27,.741,100
18918,2012-01-10,DET,,DAL,L 86-100,240,30,69,.435,24,56,.429,6,13,.462,20,25,.800,86
18919,2012-01-10,GSW,,MIA,W 111-106 (OT),265,38,95,.400,29,68,.426,9,27,.333,26,30,.867,111
18920,2012-01-10,MIA,@,GSW,L 106-111 (OT),265,39,85,.459,37,74,.500,2,11,.182,26,40,.650,106
18921,2012-01-10,LAL,,PHO,W 99-83,240,39,80,.488,37,63,.587,2,17,.118,19,23,.826,99
18922,2012-01-10,PHO,@,LAL,L 83-99,240,34,80,.425,27,60,.450,7,20,.350,8,12,.667,83
18923,2012-01-10,MEM,,OKC,L 95-100,240,39,85,.459,34,73,.466,5,12,.417,12,20,.600,95
18924,2012-01-10,OKC,@,MEM,W 100-95,240,34,74,.459,28,59,.475,6,15,.400,26,32,.813,100
18925,2012-01-10,MIL,,SAS,W 106-103,240,44,85,.518,35,71,.493,9,14,.643,9,10,.900,106
18926,2012-01-10,SAS,@,MIL,L 103-106,240,45,75,.600,41,61,.672,4,14,.286,9,16,.563,103
18927,2012-01-10,CHI,@,MIN,W 111-100,240,43,81,.531,32,61,.525,11,20,.550,14,21,.667,111
18928,2012-01-10,MIN,,CHI,L 100-111,240,33,78,.423,25,56,.446,8,22,.364,26,32,.813,100
18929,2012-01-10,PHI,,SAC,W 112-85,240,47,83,.566,42,70,.600,5,13,.385,13,19,.684,112
18930,2012-01-10,SAC,@,PHI,L 85-112,240,34,86,.395,30,67,.448,4,19,.211,13,21,.619,85
18931,2012-01-10,LAC,@,POR,L 97-105,240,37,83,.446,31,60,.517,6,23,.261,17,24,.708,97
18932,2012-01-10,POR,,LAC,W 105-97,240,37,72,.514,32,58,.552,5,14,.357,26,32,.813,105
18933,2012-01-10,CLE,@,UTA,L 105-113,240,35,78,.449,31,58,.534,4,20,.200,31,43,.721,105
18934,2012-01-10,UTA,,CLE,W 113-105,240,45,76,.592,42,66,.636,3,10,.300,20,29,.690,113
18935,2012-01-10,TOR,@,WAS,L 78-93,240,30,76,.395,26,56,.464,4,20,.200,14,17,.824,78
18936,2012-01-10,WAS,,TOR,W 93-78,240,40,82,.488,36,69,.522,4,13,.308,9,17,.529,93
18937,2012-01-09,CHI,,DET,W 92-68,240,34,74,.459,31,58,.534,3,16,.188,21,25,.840,92
18938,2012-01-09,DET,@,CHI,L 68-92,240,28,71,.394,27,67,.403,1,4,.250,11,14,.786,68
18939,2012-01-09,DEN,,NOH,L 81-94,240,29,71,.408,21,48,.438,8,23,.348,15,21,.714,81
18940,2012-01-09,NOP,@,DEN,W 94-81,240,39,75,.520,33,65,.508,6,10,.600,10,14,.714,94
18941,2012-01-09,ATL,@,NJN,W 106-101,240,42,78,.538,33,57,.579,9,21,.429,13,19,.684,106
18942,2012-01-09,BRK,,ATL,L 101-106,240,36,77,.468,25,55,.455,11,22,.500,18,21,.857,101
18943,2012-01-09,CHA,@,NYK,L 87-91,240,34,82,.415,27,63,.429,7,19,.368,12,15,.800,87
18944,2012-01-09,NYK,,CHA,W 91-87,240,30,79,.380,29,69,.420,1,10,.100,30,40,.750,91
18945,2012-01-09,IND,@,PHI,L 86-96,240,30,82,.366,26,69,.377,4,13,.308,22,30,.733,86
18946,2012-01-09,PHI,,IND,W 96-86,240,38,76,.500,32,59,.542,6,17,.353,14,19,.737,96
18947,2012-01-09,MIN,@,TOR,L 87-97,240,27,80,.338,20,56,.357,7,24,.292,26,33,.788,87
18948,2012-01-09,TOR,,MIN,W 97-87,240,34,77,.442,31,58,.534,3,19,.158,26,28,.929,97
18949,2012-01-08,LAL,,MEM,W 90-82,240,35,74,.473,29,55,.527,6,19,.316,14,21,.667,90
18950,2012-01-08,MEM,@,LAL,L 82-90,240,38,93,.409,37,84,.440,1,9,.111,5,10,.500,82
18951,2012-01-08,OKC,,SAS,W 108-96,240,38,75,.507,31,56,.554,7,19,.368,25,29,.862,108
18952,2012-01-08,SAS,@,OKC,L 96-108,240,35,84,.417,28,72,.389,7,12,.583,19,25,.760,96
18953,2012-01-08,MIL,@,PHO,L 93-109,240,37,86,.430,34,71,.479,3,15,.200,16,24,.667,93
18954,2012-01-08,PHO,,MIL,W 109-93,240,43,77,.558,33,55,.600,10,22,.455,13,17,.765,109
18955,2012-01-08,CLE,@,POR,L 78-98,240,29,79,.367,26,55,.473,3,24,.125,17,24,.708,78
18956,2012-01-08,POR,,CLE,W 98-78,240,38,92,.413,32,69,.464,6,23,.261,16,18,.889,98
18957,2012-01-08,ORL,@,SAC,W 104-97,240,37,87,.425,27,55,.491,10,32,.313,20,31,.645,104
18958,2012-01-08,SAC,,ORL,L 97-104,240,38,73,.521,35,53,.660,3,20,.150,18,24,.750,97
18959,2012-01-08,MIN,@,WAS,W 93-72,240,36,80,.450,26,54,.481,10,26,.385,11,15,.733,93
18960,2012-01-08,WAS,,MIN,L 72-93,240,30,87,.345,27,77,.351,3,10,.300,9,16,.563,72
18961,2012-01-07,ATL,,CHI,W 109-94,240,47,83,.566,38,71,.535,9,12,.750,6,6,1.000,109
18962,2012-01-07,CHI,@,ATL,L 94-109,240,36,82,.439,30,68,.441,6,14,.429,16,20,.800,94
18963,2012-01-07,DAL,,NOH,W 96-81,240,32,74,.432,24,55,.436,8,19,.421,24,29,.828,96
18964,2012-01-07,NOP,@,DAL,L 81-96,240,26,64,.406,20,53,.377,6,11,.545,23,28,.821,81
18965,2012-01-07,DET,,NYK,L 80-103,240,29,78,.372,20,52,.385,9,26,.346,13,22,.591,80
18966,2012-01-07,NYK,@,DET,W 103-80,240,39,83,.470,31,55,.564,8,28,.286,17,20,.850,103
18967,2012-01-07,GSW,,UTA,L 87-88,240,29,70,.414,22,51,.431,7,19,.368,22,24,.917,87
18968,2012-01-07,UTA,@,GSW,W 88-87,240,32,81,.395,28,65,.431,4,16,.250,20,28,.714,88
18969,2012-01-07,HOU,,OKC,L 95-98,240,38,87,.437,33,73,.452,5,14,.357,14,15,.933,95
18970,2012-01-07,OKC,@,HOU,W 98-95,240,36,85,.424,29,64,.453,7,21,.333,19,22,.864,98
18971,2012-01-07,CHA,@,IND,L 77-99,240,29,89,.326,24,73,.329,5,16,.313,14,21,.667,77
18972,2012-01-07,IND,,CHA,W 99-77,240,39,77,.506,37,68,.544,2,9,.222,19,26,.731,99
18973,2012-01-07,LAC,,MIL,W 92-86,240,31,69,.449,27,50,.540,4,19,.211,26,40,.650,92
18974,2012-01-07,MIL,@,LAC,L 86-92,240,29,80,.363,23,60,.383,6,20,.300,22,27,.815,86
18975,2012-01-07,MIA,@,NJN,W 101-90,240,38,76,.500,33,61,.541,5,15,.333,20,24,.833,101
18976,2012-01-07,BRK,,MIA,L 90-101,240,28,83,.337,18,50,.360,10,33,.303,24,32,.750,90
18977,2012-01-07,PHI,,TOR,W 97-62,240,36,83,.434,31,62,.500,5,21,.238,20,27,.741,97
18978,2012-01-07,TOR,@,PHI,L 62-97,240,27,85,.318,26,73,.356,1,12,.083,7,12,.583,62
18979,2012-01-07,DEN,@,SAS,L 117-121,240,46,81,.568,38,65,.585,8,16,.500,17,26,.654,117
18980,2012-01-07,SAS,,DEN,W 121-117,240,49,89,.551,40,69,.580,9,20,.450,14,18,.778,121
18981,2012-01-06,BOS,,IND,L 74-87,240,26,66,.394,21,52,.404,5,14,.357,17,24,.708,74
18982,2012-01-06,IND,@,BOS,W 87-74,240,32,80,.400,24,66,.364,8,14,.571,15,18,.833,87
18983,2012-01-06,ATL,@,CHA,W 102-96 (OT),265,42,95,.442,35,75,.467,7,20,.350,11,16,.688,102
18984,2012-01-06,CHA,,ATL,L 96-102 (OT),265,40,87,.460,33,69,.478,7,18,.389,9,13,.692,96
18985,2012-01-06,GSW,@,LAL,L 90-97,240,38,77,.494,34,63,.540,4,14,.286,10,19,.526,90
18986,2012-01-06,LAL,,GSW,W 97-90,240,37,77,.481,34,66,.515,3,11,.273,20,29,.690,97
18987,2012-01-06,CLE,@,MIN,W 98-87,240,37,80,.463,29,63,.460,8,17,.471,16,22,.727,98
18988,2012-01-06,MIN,,CLE,L 87-98,240,31,79,.392,27,59,.458,4,20,.200,21,31,.677,87
18989,2012-01-06,DEN,@,NOH,W 96-88,240,37,79,.468,32,58,.552,5,21,.238,17,22,.773,96
18990,2012-01-06,NOP,,DEN,L 88-96,240,36,77,.468,28,60,.467,8,17,.471,8,10,.800,88
18991,2012-01-06,HOU,@,OKC,L 94-109,240,36,78,.462,33,65,.508,3,13,.231,19,27,.704,94
18992,2012-01-06,OKC,,HOU,W 109-94,240,42,80,.525,36,66,.545,6,14,.429,19,25,.760,109
18993,2012-01-06,CHI,@,ORL,W 97-83,240,38,86,.442,30,72,.417,8,14,.571,13,17,.765,97
18994,2012-01-06,ORL,,CHI,L 83-97,240,30,75,.400,23,55,.418,7,20,.350,16,21,.762,83
18995,2012-01-06,DET,@,PHI,L 73-96,240,31,86,.360,31,76,.408,0,10,.000,11,14,.786,73
18996,2012-01-06,PHI,,DET,W 96-73,240,39,85,.459,34,67,.507,5,18,.278,13,16,.813,96
18997,2012-01-06,PHO,,POR,W 102-77,240,37,79,.468,30,59,.508,7,20,.350,21,25,.840,102
18998,2012-01-06,POR,@,PHO,L 77-102,240,25,77,.325,23,58,.397,2,19,.105,25,35,.714,77
18999,2012-01-06,BRK,@,TOR,W 97-85,240,31,80,.388,16,49,.327,15,31,.484,20,27,.741,97
19000,2012-01-06,TOR,,NJN,L 85-97,240,33,73,.452,27,56,.482,6,17,.353,13,19,.684,85
19001,2012-01-06,MEM,@,UTA,L 85-94,240,33,80,.413,29,63,.460,4,17,.235,15,21,.714,85
19002,2012-01-06,UTA,,MEM,W 94-85,240,36,71,.507,34,63,.540,2,8,.250,20,30,.667,94
19003,2012-01-06,NYK,@,WAS,W 99-96,240,39,89,.438,33,71,.465,6,18,.333,15,21,.714,99
19004,2012-01-06,WAS,,NYK,L 96-99,240,41,85,.482,35,71,.493,6,14,.429,8,13,.615,96
19005,2012-01-05,ATL,,MIA,L 109-116 (3OT),315,36,94,.383,30,72,.417,6,22,.273,31,46,.674,109
19006,2012-01-05,MIA,@,ATL,W 116-109 (3OT),315,45,102,.441,37,74,.500,8,28,.286,18,23,.783,116
19007,2012-01-05,LAL,@,POR,L 96-107,240,37,79,.468,37,68,.544,0,11,.000,22,27,.815,96
19008,2012-01-05,POR,,LAL,W 107-96,240,41,89,.461,36,77,.468,5,12,.417,20,26,.769,107
19009,2012-01-05,MIL,@,SAC,L 100-103,240,39,76,.513,30,57,.526,9,19,.474,13,21,.619,100
19010,2012-01-05,SAC,,MIL,W 103-100,240,37,91,.407,33,70,.471,4,21,.190,25,30,.833,103
19011,2012-01-05,DAL,@,SAS,L 71-93,240,27,77,.351,26,58,.448,1,19,.053,16,21,.762,71
19012,2012-01-05,SAS,,DAL,W 93-71,240,34,86,.395,18,53,.340,16,33,.485,9,16,.563,93
19013,2012-01-04,BOS,,NJN,W 89-70,240,35,71,.493,29,55,.527,6,16,.375,13,21,.619,89
19014,2012-01-04,BRK,@,BOS,L 70-89,240,30,74,.405,26,54,.481,4,20,.200,6,10,.600,70
19015,2012-01-04,DAL,,PHO,W 98-89,240,38,91,.418,30,69,.435,8,22,.364,14,21,.667,98
19016,2012-01-04,PHO,@,DAL,L 89-98,240,37,82,.451,32,65,.492,5,17,.294,10,15,.667,89
19017,2012-01-04,DEN,,SAC,W 110-83,240,46,76,.605,43,67,.642,3,9,.333,15,22,.682,110
19018,2012-01-04,SAC,@,DEN,L 83-110,240,30,93,.323,28,72,.389,2,21,.095,21,24,.875,83
19019,2012-01-04,CHI,@,DET,W 99-83,240,40,76,.526,35,64,.547,5,12,.417,14,21,.667,99
19020,2012-01-04,DET,,CHI,L 83-99,240,36,88,.409,35,82,.427,1,6,.167,10,12,.833,83
19021,2012-01-04,HOU,@,LAC,L 89-117,240,35,76,.461,28,60,.467,7,16,.438,12,17,.706,89
19022,2012-01-04,LAC,,HOU,W 117-89,240,47,82,.573,41,66,.621,6,16,.375,17,24,.708,117
19023,2012-01-04,IND,@,MIA,L 83-118,240,24,69,.348,19,50,.380,5,19,.263,30,39,.769,83
19024,2012-01-04,MIA,,IND,W 118-83,240,42,80,.525,34,59,.576,8,21,.381,26,28,.929,118
19025,2012-01-04,MEM,@,MIN,W 90-86,240,33,80,.413,30,71,.423,3,9,.333,21,25,.840,90
19026,2012-01-04,MIN,,MEM,L 86-90,240,33,82,.402,26,61,.426,7,21,.333,13,24,.542,86
19027,2012-01-04,NOP,,PHI,L 93-101,240,35,79,.443,32,69,.464,3,10,.300,20,25,.800,93
19028,2012-01-04,PHI,@,NOH,W 101-93,240,41,86,.477,37,70,.529,4,16,.250,15,18,.833,101
19029,2012-01-04,CHA,@,NYK,W 118-110,240,47,85,.553,40,74,.541,7,11,.636,17,21,.810,118
19030,2012-01-04,NYK,,CHA,L 110-118,240,42,85,.494,31,56,.554,11,29,.379,15,20,.750,110
19031,2012-01-04,ORL,,WAS,W 103-85,240,39,85,.459,31,66,.470,8,19,.421,17,25,.680,103
19032,2012-01-04,WAS,@,ORL,L 85-103,240,34,93,.366,32,81,.395,2,12,.167,15,18,.833,85
19033,2012-01-04,GSW,@,SAS,L 95-101,240,37,80,.463,28,60,.467,9,20,.450,12,19,.632,95
19034,2012-01-04,SAS,,GSW,W 101-95,240,37,78,.474,27,61,.443,10,17,.588,17,24,.708,101
19035,2012-01-04,CLE,@,TOR,L 77-92,240,24,81,.296,17,58,.293,7,23,.304,22,26,.846,77
19036,2012-01-04,TOR,,CLE,W 92-77,240,36,77,.468,26,50,.520,10,27,.370,10,13,.769,92
19037,2012-01-03,ATL,@,CHI,L 74-76,240,28,80,.350,24,65,.369,4,15,.267,14,25,.560,74
19038,2012-01-03,CHI,,ATL,W 76-74,240,26,77,.338,22,60,.367,4,17,.235,20,26,.769,76
19039,2012-01-03,CHA,@,CLE,L 101-115,240,40,90,.444,36,76,.474,4,14,.286,17,19,.895,101
19040,2012-01-03,CLE,,CHA,W 115-101,240,45,90,.500,35,69,.507,10,21,.476,15,26,.577,115
19041,2012-01-03,HOU,@,LAL,L 99-108,240,41,96,.427,30,65,.462,11,31,.355,6,7,.857,99
19042,2012-01-03,LAL,,HOU,W 108-99,240,41,78,.526,36,64,.563,5,14,.357,21,27,.778,108
19043,2012-01-03,MEM,,SAC,W 113-96,240,50,91,.549,48,83,.578,2,8,.250,11,16,.688,113
19044,2012-01-03,SAC,@,MEM,L 96-113,240,34,83,.410,25,59,.424,9,24,.375,19,23,.826,96
19045,2012-01-03,OKC,,POR,L 93-103,240,36,83,.434,31,63,.492,5,20,.250,16,21,.762,93
19046,2012-01-03,POR,@,OKC,W 103-93,240,34,76,.447,28,61,.459,6,15,.400,29,36,.806,103
19047,2012-01-03,MIL,@,UTA,L 73-85,240,29,95,.305,27,74,.365,2,21,.095,13,16,.813,73
19048,2012-01-03,UTA,,MIL,W 85-73,240,32,66,.485,29,53,.547,3,13,.231,18,28,.643,85
19049,2012-01-02,BOS,,WAS,W 100-92,240,38,83,.458,28,63,.444,10,20,.500,14,21,.667,100
19050,2012-01-02,WAS,@,BOS,L 92-100,240,35,83,.422,32,72,.444,3,11,.273,19,23,.826,92
19051,2012-01-02,DAL,,OKC,W 100-87,240,39,80,.488,34,64,.531,5,16,.313,17,20,.850,100
19052,2012-01-02,OKC,@,DAL,L 87-100,240,31,77,.403,26,58,.448,5,19,.263,20,26,.769,87
19053,2012-01-02,DEN,,MIL,W 91-86,240,33,83,.398,29,64,.453,4,19,.211,21,27,.778,91
19054,2012-01-02,MIL,@,DEN,L 86-91,240,37,88,.420,32,69,.464,5,19,.263,7,11,.636,86
19055,2012-01-02,DET,,ORL,W 89-78,240,31,62,.500,29,54,.537,2,8,.250,25,33,.758,89
19056,2012-01-02,ORL,@,DET,L 78-89,240,28,63,.444,20,41,.488,8,22,.364,14,21,.667,78
19057,2012-01-02,ATL,@,MIA,W 100-92,240,39,82,.476,30,66,.455,9,16,.563,13,20,.650,100
19058,2012-01-02,MIA,,ATL,L 92-100,240,34,73,.466,29,60,.483,5,13,.385,19,28,.679,92
19059,2012-01-02,MIN,,SAS,W 106-96,240,41,71,.577,29,50,.580,12,21,.571,12,15,.800,106
19060,2012-01-02,SAS,@,MIN,L 96-106,240,36,82,.439,29,62,.468,7,20,.350,17,21,.810,96
19061,2012-01-02,IND,@,NJN,W 108-94,240,41,78,.526,28,57,.491,13,21,.619,13,18,.722,108
19062,2012-01-02,BRK,,IND,L 94-108,240,33,89,.371,26,61,.426,7,28,.250,21,26,.808,94
19063,2012-01-02,NYK,,TOR,L 85-90,240,28,78,.359,18,43,.419,10,35,.286,19,25,.760,85
19064,2012-01-02,TOR,@,NYK,W 90-85,240,30,68,.441,23,51,.451,7,17,.412,23,29,.793,90
19065,2012-01-02,GSW,@,PHO,L 91-102,240,36,72,.500,29,55,.527,7,17,.412,12,20,.600,91
19066,2012-01-02,PHO,,GSW,W 102-91,240,39,87,.448,31,64,.484,8,23,.348,16,21,.762,102
19067,2012-01-02,NOP,@,UTA,L 90-94,240,37,74,.500,34,64,.531,3,10,.300,13,16,.813,90
19068,2012-01-02,UTA,,NOH,W 94-90,240,37,76,.487,32,61,.525,5,15,.333,15,23,.652,94
19069,2012-01-01,CHI,,MEM,W 104-64,240,39,84,.464,34,71,.479,5,13,.385,21,29,.724,104
19070,2012-01-01,MEM,@,CHI,L 64-104,240,26,84,.310,25,75,.333,1,9,.111,11,14,.786,64
19071,2012-01-01,CLE,,NJN,W 98-82,240,38,78,.487,22,52,.423,16,26,.615,6,11,.545,98
19072,2012-01-01,BRK,@,CLE,L 82-98,240,27,71,.380,20,49,.408,7,22,.318,21,28,.750,82
19073,2012-01-01,DEN,,LAL,W 99-90,240,33,71,.465,31,53,.585,2,18,.111,31,37,.838,99
19074,2012-01-01,LAL,@,DEN,L 90-99,240,35,88,.398,31,65,.477,4,23,.174,16,24,.667,90
19075,2012-01-01,LAC,,POR,W 93-88,240,36,75,.480,30,51,.588,6,24,.250,15,24,.625,93
19076,2012-01-01,POR,@,LAC,L 88-93,240,33,78,.423,29,63,.460,4,15,.267,18,22,.818,88
19077,2012-01-01,CHA,@,MIA,L 90-129,240,35,92,.380,29,74,.392,6,18,.333,14,21,.667,90
19078,2012-01-01,MIA,,CHA,W 129-90,240,48,80,.600,41,69,.594,7,11,.636,26,31,.839,129
19079,2012-01-01,DAL,@,MIN,L 82-99,240,29,77,.377,22,53,.415,7,24,.292,17,21,.810,82
19080,2012-01-01,MIN,,DAL,W 99-82,240,36,85,.424,26,63,.413,10,22,.455,17,24,.708,99
19081,2012-01-01,ORL,,TOR,W 102-96,240,37,75,.493,25,48,.521,12,27,.444,16,24,.667,102
19082,2012-01-01,TOR,@,ORL,L 96-102,240,32,70,.457,27,57,.474,5,13,.385,27,29,.931,96
19083,2012-01-01,NOP,@,SAC,L 80-96,240,36,89,.404,36,74,.486,0,15,.000,8,16,.500,80
19084,2012-01-01,SAC,,NOH,W 96-80,240,35,85,.412,27,62,.435,8,23,.348,18,21,.857,96
19085,2012-01-01,BOS,@,WAS,W 94-86,240,37,74,.500,32,62,.516,5,12,.417,15,23,.652,94
19086,2012-01-01,WAS,,BOS,L 86-94,240,32,78,.410,30,62,.484,2,16,.125,20,23,.870,86
19087,2011-12-31,DET,,IND,W 96-88,240,39,82,.476,31,67,.463,8,15,.533,10,13,.769,96
19088,2011-12-31,IND,@,DET,L 88-96,240,30,76,.395,25,61,.410,5,15,.333,23,28,.821,88
19089,2011-12-31,GSW,,PHI,L 79-107,240,34,89,.382,30,72,.417,4,17,.235,7,12,.583,79
19090,2011-12-31,PHI,@,GSW,W 107-79,240,39,79,.494,28,59,.475,11,20,.550,18,31,.581,107
19091,2011-12-31,ATL,@,HOU,L 84-95,240,35,80,.438,31,64,.484,4,16,.250,10,16,.625,84
19092,2011-12-31,HOU,,ATL,W 95-84,240,38,82,.463,29,63,.460,9,19,.474,10,13,.769,95
19093,2011-12-31,DEN,@,LAL,L 89-92,240,34,80,.425,27,54,.500,7,26,.269,14,22,.636,89
19094,2011-12-31,LAL,,DEN,W 92-89,240,39,86,.453,37,62,.597,2,24,.083,12,15,.800,92
19095,2011-12-31,OKC,,PHO,W 107-97,240,41,77,.532,32,55,.582,9,22,.409,16,18,.889,107
19096,2011-12-31,PHO,@,OKC,L 97-107,240,35,88,.398,27,62,.435,8,26,.308,19,23,.826,97
19097,2011-12-31,NYK,@,SAC,W 114-92,240,40,89,.449,30,61,.492,10,28,.357,24,27,.889,114
19098,2011-12-31,SAC,,NYK,L 92-114,240,30,86,.349,24,64,.375,6,22,.273,26,41,.634,92
19099,2011-12-31,SAS,,UTA,W 104-89,240,36,74,.486,26,58,.448,10,16,.625,22,31,.710,104
19100,2011-12-31,UTA,@,SAS,L 89-104,240,33,89,.371,31,73,.425,2,16,.125,21,25,.840,89
19101,2011-12-30,ATL,,NJN,W 105-98,240,37,77,.481,33,62,.532,4,15,.267,27,38,.711,105
19102,2011-12-30,BRK,@,ATL,L 98-105,240,38,82,.463,29,62,.468,9,20,.450,13,14,.929,98
19103,2011-12-30,BOS,,DET,W 96-85,240,35,67,.522,28,51,.549,7,16,.438,19,19,1.000,96
19104,2011-12-30,DET,@,BOS,L 85-96,240,34,79,.430,31,63,.492,3,16,.188,14,15,.933,85
19105,2011-12-30,CHA,,ORL,L 79-100,240,30,83,.361,25,68,.368,5,15,.333,14,18,.778,79
19106,2011-12-30,ORL,@,CHA,W 100-79,240,37,84,.440,25,56,.446,12,28,.429,14,24,.583,100
19107,2011-12-30,DAL,,TOR,W 99-86,240,32,72,.444,25,47,.532,7,25,.280,28,38,.737,99
19108,2011-12-30,TOR,@,DAL,L 86-99,240,33,72,.458,27,58,.466,6,14,.429,14,18,.778,86
19109,2011-12-30,CLE,@,IND,L 91-98 (OT),265,34,88,.386,29,63,.460,5,25,.200,18,31,.581,91
19110,2011-12-30,IND,,CLE,W 98-91 (OT),265,36,94,.383,34,84,.405,2,10,.200,24,32,.750,98
19111,2011-12-30,CHI,@,LAC,W 114-101,240,39,78,.500,32,61,.525,7,17,.412,29,34,.853,114
19112,2011-12-30,LAC,,CHI,L 101-114,240,41,80,.513,34,65,.523,7,15,.467,12,20,.600,101
19113,2011-12-30,HOU,@,MEM,L 93-113,240,34,79,.430,23,50,.460,11,29,.379,14,18,.778,93
19114,2011-12-30,MEM,,HOU,W 113-93,240,45,80,.563,45,75,.600,0,5,.000,23,33,.697,113
19115,2011-12-30,MIL,,WAS,W 102-81,240,39,73,.534,31,53,.585,8,20,.400,16,25,.640,102
19116,2011-12-30,WAS,@,MIL,L 81-102,240,30,85,.353,23,67,.343,7,18,.389,14,19,.737,81
19117,2011-12-30,MIA,@,MIN,W 103-101,240,46,93,.495,43,79,.544,3,14,.214,8,14,.571,103
19118,2011-12-30,MIN,,MIA,L 101-103,240,39,83,.470,28,54,.519,11,29,.379,12,20,.600,101
19119,2011-12-30,NOP,,PHO,L 78-93,240,26,90,.289,23,76,.303,3,14,.214,23,28,.821,78
19120,2011-12-30,PHO,@,NOH,W 93-78,240,33,78,.423,26,55,.473,7,23,.304,20,22,.909,93
19121,2011-12-30,PHI,@,UTA,L 99-102,240,37,77,.481,33,64,.516,4,13,.308,21,29,.724,99
19122,2011-12-30,UTA,,PHI,W 102-99,240,35,79,.443,29,63,.460,6,16,.375,26,33,.788,102
19123,2011-12-29,HOU,,SAS,W 105-85,240,43,85,.506,34,59,.576,9,26,.346,10,13,.769,105
19124,2011-12-29,SAS,@,HOU,L 85-105,240,35,93,.376,33,76,.434,2,17,.118,13,20,.650,85
19125,2011-12-29,LAL,,NYK,W 99-82,240,38,73,.521,29,57,.509,9,16,.563,14,22,.636,99
19126,2011-12-29,NYK,@,LAL,L 82-99,240,21,67,.313,15,45,.333,6,22,.273,34,41,.829,82
19127,2011-12-29,DAL,@,OKC,L 102-104,240,38,90,.422,29,64,.453,9,26,.346,17,21,.810,102
19128,2011-12-29,OKC,,DAL,W 104-102,240,37,63,.587,31,49,.633,6,14,.429,24,32,.750,104
19129,2011-12-29,BRK,@,ORL,L 78-94,240,29,77,.377,23,60,.383,6,17,.353,14,21,.667,78
19130,2011-12-29,ORL,,NJN,W 94-78,240,36,81,.444,27,60,.450,9,21,.429,13,25,.520,94
19131,2011-12-29,DEN,@,POR,L 102-111,240,35,87,.402,31,67,.463,4,20,.200,28,33,.848,102
19132,2011-12-29,POR,,DEN,W 111-102,240,41,79,.519,33,59,.559,8,20,.400,21,23,.913,111
19133,2011-12-29,CHI,@,SAC,W 108-98,240,43,80,.538,37,68,.544,6,12,.500,16,21,.762,108
19134,2011-12-29,SAC,,CHI,L 98-108,240,35,83,.422,27,66,.409,8,17,.471,20,34,.588,98
19135,2011-12-28,ATL,,WAS,W 101-83,240,32,75,.427,23,52,.442,9,23,.391,28,35,.800,101
19136,2011-12-28,WAS,@,ATL,L 83-101,240,30,77,.390,24,61,.393,6,16,.375,17,22,.773,83
19137,2011-12-28,CHA,,MIA,L 95-96,240,39,82,.476,32,64,.500,7,18,.389,10,16,.625,95
19138,2011-12-28,MIA,@,CHA,W 96-95,240,36,78,.462,35,72,.486,1,6,.167,23,28,.821,96
19139,2011-12-28,DEN,,UTA,W 117-100,240,46,86,.535,40,67,.597,6,19,.316,19,26,.731,117
19140,2011-12-28,UTA,@,DEN,L 100-117,240,38,79,.481,31,63,.492,7,16,.438,17,25,.680,100
19141,2011-12-28,CLE,@,DET,W 105-89,240,40,70,.571,33,58,.569,7,12,.583,18,22,.818,105
19142,2011-12-28,DET,,CLE,L 89-105,240,36,81,.444,27,60,.450,9,21,.429,8,11,.727,89
19143,2011-12-28,GSW,,NYK,W 92-78,240,35,77,.455,29,61,.475,6,16,.375,16,24,.667,92
19144,2011-12-28,NYK,@,GSW,L 78-92,240,28,70,.400,24,49,.490,4,21,.190,18,25,.720,78
19145,2011-12-28,MEM,,OKC,L 95-98,240,34,87,.391,32,71,.451,2,16,.125,25,33,.758,95
19146,2011-12-28,OKC,@,MEM,W 98-95,240,29,77,.377,19,52,.365,10,25,.400,30,38,.789,98
19147,2011-12-28,BOS,@,NOH,L 78-97,240,29,78,.372,22,61,.361,7,17,.412,13,18,.722,78
19148,2011-12-28,NOP,,BOS,W 97-78,240,36,79,.456,32,67,.478,4,12,.333,21,25,.840,97
19149,2011-12-28,PHI,@,PHO,W 103-83,240,41,86,.477,34,69,.493,7,17,.412,14,18,.778,103
19150,2011-12-28,PHO,,PHI,L 83-103,240,33,80,.413,31,69,.449,2,11,.182,15,18,.833,83
19151,2011-12-28,LAC,@,SAS,L 90-115,240,29,74,.392,22,54,.407,7,20,.350,25,33,.758,90
19152,2011-12-28,SAS,,LAC,W 115-90,240,45,80,.563,35,61,.574,10,19,.526,15,15,1.000,115
19153,2011-12-28,IND,@,TOR,W 90-85,240,32,81,.395,25,65,.385,7,16,.438,19,22,.864,90
19154,2011-12-28,TOR,,IND,L 85-90,240,36,79,.456,30,64,.469,6,15,.400,7,13,.538,85
19155,2011-12-27,LAL,,UTA,W 96-71,240,30,71,.423,24,55,.436,6,16,.375,30,37,.811,96
19156,2011-12-27,UTA,@,LAL,L 71-96,240,29,90,.322,28,77,.364,1,13,.077,12,17,.706,71
19157,2011-12-27,BOS,@,MIA,L 107-115,240,37,72,.514,25,53,.472,12,19,.632,21,27,.778,107
19158,2011-12-27,MIA,,BOS,W 115-107,240,42,75,.560,36,65,.554,6,10,.600,25,35,.714,115
19159,2011-12-27,MIL,,MIN,W 98-95,240,40,94,.426,38,78,.487,2,16,.125,16,20,.800,98
19160,2011-12-27,MIN,@,MIL,L 95-98,240,28,70,.400,22,56,.393,6,14,.429,33,45,.733,95
19161,2011-12-27,ATL,@,NJN,W 106-70,240,38,86,.442,26,63,.413,12,23,.522,18,21,.857,106
19162,2011-12-27,BRK,,ATL,L 70-106,240,22,71,.310,17,47,.362,5,24,.208,21,26,.808,70
19163,2011-12-27,POR,,SAC,W 101-79,240,38,85,.447,35,67,.522,3,18,.167,22,28,.786,101
19164,2011-12-27,SAC,@,POR,L 79-101,240,31,82,.378,28,66,.424,3,16,.188,14,22,.636,79
19165,2011-12-26,CHA,,MIL,W 96-95,240,38,86,.442,34,67,.507,4,19,.211,16,21,.762,96
19166,2011-12-26,MIL,@,CHA,L 95-96,240,34,84,.405,26,61,.426,8,23,.348,19,23,.826,95
19167,2011-12-26,CLE,,TOR,L 96-104,240,35,85,.412,29,65,.446,6,20,.300,20,28,.714,96
19168,2011-12-26,TOR,@,CLE,W 104-96,240,42,79,.532,33,58,.569,9,21,.429,11,13,.846,104
19169,2011-12-26,DAL,,DEN,L 93-115,240,32,76,.421,24,49,.490,8,27,.296,21,27,.778,93
19170,2011-12-26,DEN,@,DAL,W 115-93,240,39,79,.494,29,52,.558,10,27,.370,27,34,.794,115
19171,2011-12-26,CHI,@,GSW,L 91-99,240,34,82,.415,26,58,.448,8,24,.333,15,22,.682,91
19172,2011-12-26,GSW,,CHI,W 99-91,240,36,77,.468,32,62,.516,4,15,.267,23,31,.742,99
19173,2011-12-26,DET,@,IND,L 79-91,240,27,75,.360,20,56,.357,7,19,.368,18,21,.857,79
19174,2011-12-26,IND,,DET,W 91-79,240,32,87,.368,25,72,.347,7,15,.467,20,25,.800,91
19175,2011-12-26,MIN,,OKC,L 100-104,240,39,87,.448,36,65,.554,3,22,.136,19,26,.731,100
19176,2011-12-26,OKC,@,MIN,W 104-100,240,35,78,.449,30,62,.484,5,16,.313,29,31,.935,104
19177,2011-12-26,HOU,@,ORL,L 95-104,240,36,82,.439,30,55,.545,6,27,.222,17,20,.850,95
19178,2011-12-26,ORL,,HOU,W 104-95,240,44,83,.530,35,61,.574,9,22,.409,7,10,.700,104
19179,2011-12-26,NOP,@,PHO,W 85-84,240,35,79,.443,33,63,.524,2,16,.125,13,21,.619,85
19180,2011-12-26,PHO,,NOH,L 84-85,240,32,81,.395,27,56,.482,5,25,.200,15,19,.789,84
19181,2011-12-26,PHI,@,POR,L 103-107,240,40,83,.482,32,64,.500,8,19,.421,15,19,.789,103
19182,2011-12-26,POR,,PHI,W 107-103,240,40,97,.412,31,78,.397,9,19,.474,18,23,.783,107
19183,2011-12-26,LAL,@,SAC,L 91-100,240,37,88,.420,36,72,.500,1,16,.063,16,19,.842,91
19184,2011-12-26,SAC,,LAL,W 100-91,240,35,75,.467,26,57,.456,9,18,.500,21,35,.600,100
19185,2011-12-26,MEM,@,SAS,L 82-95,240,34,73,.466,31,66,.470,3,7,.429,11,19,.579,82
19186,2011-12-26,SAS,,MEM,W 95-82,240,35,88,.398,25,55,.455,10,33,.303,15,22,.682,95
19187,2011-12-26,BRK,@,WAS,W 90-84,240,34,86,.395,28,60,.467,6,26,.231,16,20,.800,90
19188,2011-12-26,WAS,,NJN,L 84-90,240,31,74,.419,30,67,.448,1,7,.143,21,34,.618,84
19189,2011-12-25,DAL,,MIA,L 94-105,240,31,82,.378,22,54,.407,9,28,.321,23,30,.767,94
19190,2011-12-25,MIA,@,DAL,W 105-94,240,38,78,.487,34,71,.479,4,7,.571,25,36,.694,105
19191,2011-12-25,GSW,,LAC,L 86-105,240,32,82,.390,27,61,.443,5,21,.238,17,24,.708,86
19192,2011-12-25,LAC,@,GSW,W 105-86,240,37,81,.457,29,58,.500,8,23,.348,23,38,.605,105
19193,2011-12-25,CHI,@,LAL,W 88-87,240,36,89,.404,29,74,.392,7,15,.467,9,14,.643,88
19194,2011-12-25,LAL,,CHI,L 87-88,240,36,76,.474,32,60,.533,4,16,.250,11,20,.550,87
19195,2011-12-25,BOS,@,NYK,L 104-106,240,39,76,.513,37,71,.521,2,5,.400,24,31,.774,104
19196,2011-12-25,NYK,,BOS,W 106-104,240,35,74,.473,26,54,.481,9,20,.450,27,34,.794,106
19197,2011-12-25,OKC,,ORL,W 97-89,240,34,72,.472,24,53,.453,10,19,.526,19,26,.731,97
19198,2011-12-25,ORL,@,OKC,L 89-97,240,30,81,.370,22,53,.415,8,28,.286,21,26,.808,89
19199,2011-04-13,BOS,,NYK,W 112-102,240,48,85,.565,40,68,.588,8,17,.471,8,13,.615,112
19200,2011-04-13,NYK,@,BOS,L 102-112,240,39,85,.459,32,62,.516,7,23,.304,17,21,.810,102
19201,2011-04-13,ATL,@,CHA,L 85-96,240,34,79,.430,33,71,.465,1,8,.125,16,20,.800,85
19202,2011-04-13,CHA,,ATL,W 96-85,240,40,80,.500,37,70,.529,3,10,.300,13,16,.813,96
19203,2011-04-13,CHI,,NJN,W 97-92,240,34,79,.430,27,58,.466,7,21,.333,22,27,.815,97
19204,2011-04-13,BRK,@,CHI,L 92-97,240,36,80,.450,30,65,.462,6,15,.400,14,16,.875,92
19205,2011-04-13,CLE,,WAS,W 100-93,240,35,83,.422,30,62,.484,5,21,.238,25,29,.862,100
19206,2011-04-13,WAS,@,CLE,L 93-100,240,39,90,.433,35,78,.449,4,12,.333,11,15,.733,93
19207,2011-04-13,DAL,,NOH,W 121-89,240,40,73,.548,27,45,.600,13,28,.464,28,34,.824,121
19208,2011-04-13,NOP,@,DAL,L 89-121,240,34,79,.430,28,65,.431,6,14,.429,15,17,.882,89
19209,2011-04-13,GSW,,POR,W 110-86,240,45,88,.511,35,65,.538,10,23,.435,10,15,.667,110
19210,2011-04-13,POR,@,GSW,L 86-110,240,28,83,.337,17,57,.298,11,26,.423,19,25,.760,86
19211,2011-04-13,LAC,,MEM,W 110-103,240,44,81,.543,41,66,.621,3,15,.200,19,27,.704,110
19212,2011-04-13,MEM,@,LAC,L 103-110,240,36,84,.429,29,69,.420,7,15,.467,24,28,.857,103
19213,2011-04-13,HOU,@,MIN,W 121-102,240,42,84,.500,30,53,.566,12,31,.387,25,32,.781,121
19214,2011-04-13,MIN,,HOU,L 102-121,240,41,92,.446,37,79,.468,4,13,.308,16,21,.762,102
19215,2011-04-13,MIL,@,OKC,W 110-106 (OT),265,40,88,.455,33,70,.471,7,18,.389,23,27,.852,110
19216,2011-04-13,OKC,,MIL,L 106-110 (OT),265,42,88,.477,34,68,.500,8,20,.400,14,18,.778,106
19217,2011-04-13,IND,@,ORL,L 74-92,240,27,88,.307,18,63,.286,9,25,.360,11,16,.688,74
19218,2011-04-13,ORL,,IND,W 92-74,240,32,73,.438,24,47,.511,8,26,.308,20,25,.800,92
19219,2011-04-13,DET,@,PHI,W 104-100,240,37,76,.487,31,59,.525,6,17,.353,24,31,.774,104
19220,2011-04-13,PHI,,DET,L 100-104,240,39,91,.429,31,67,.463,8,24,.333,14,16,.875,100
19221,2011-04-13,PHO,,SAS,W 106-103,240,37,92,.402,29,73,.397,8,19,.421,24,29,.828,106
19222,2011-04-13,SAS,@,PHO,L 103-106,240,35,82,.427,30,61,.492,5,21,.238,28,37,.757,103
19223,2011-04-13,LAL,@,SAC,W 116-108 (OT),265,45,91,.495,39,75,.520,6,16,.375,20,22,.909,116
19224,2011-04-13,SAC,,LAL,L 108-116 (OT),265,45,99,.455,38,75,.507,7,24,.292,11,19,.579,108
19225,2011-04-13,MIA,@,TOR,W 97-79,240,37,81,.457,24,55,.436,13,26,.500,10,14,.714,97
19226,2011-04-13,TOR,,MIA,L 79-97,240,28,64,.438,27,56,.482,1,8,.125,22,34,.647,79
19227,2011-04-13,DEN,@,UTA,L 103-107,240,39,77,.506,36,63,.571,3,14,.214,22,26,.846,103
19228,2011-04-13,UTA,,DEN,W 107-103,240,39,77,.506,31,62,.500,8,15,.533,21,26,.808,107
19229,2011-04-12,LAL,,SAS,W 102-93,240,36,79,.456,31,60,.517,5,19,.263,25,28,.893,102
19230,2011-04-12,SAS,@,LAL,L 93-102,240,31,88,.352,22,63,.349,9,25,.360,22,24,.917,93
19231,2011-04-12,CHI,@,NYK,W 103-90,240,36,83,.434,29,63,.460,7,20,.350,24,27,.889,103
19232,2011-04-12,NYK,,CHI,L 90-103,240,34,83,.410,26,52,.500,8,31,.258,14,17,.824,90
19233,2011-04-12,MEM,@,POR,L 89-102,240,36,79,.456,30,67,.448,6,12,.500,11,18,.611,89
19234,2011-04-12,POR,,MEM,W 102-89,240,36,80,.450,27,62,.435,9,18,.500,21,23,.913,102
19235,2011-04-11,ATL,,MIA,L 90-98,240,37,83,.446,33,71,.465,4,12,.333,12,21,.571,90
19236,2011-04-11,MIA,@,ATL,W 98-90,240,36,69,.522,30,52,.577,6,17,.353,20,24,.833,98
19237,2011-04-11,DEN,,GSW,W 134-111,240,50,94,.532,40,71,.563,10,23,.435,24,35,.686,134
19238,2011-04-11,GSW,@,DEN,L 111-134,240,40,90,.444,27,65,.415,13,25,.520,18,21,.857,111
19239,2011-04-11,CLE,@,DET,W 110-101,240,39,84,.464,33,65,.508,6,19,.316,26,34,.765,110
19240,2011-04-11,DET,,CLE,L 101-110,240,38,74,.514,34,65,.523,4,9,.444,21,28,.750,101
19241,2011-04-11,DAL,@,HOU,W 98-91 (OT),265,38,83,.458,34,66,.515,4,17,.235,18,20,.900,98
19242,2011-04-11,HOU,,DAL,L 91-98 (OT),265,35,96,.365,27,69,.391,8,27,.296,13,16,.813,91
19243,2011-04-11,MIL,,TOR,W 93-86,240,32,76,.421,29,59,.492,3,17,.176,26,30,.867,93
19244,2011-04-11,TOR,@,MIL,L 86-93,240,30,81,.370,27,69,.391,3,12,.250,23,31,.742,86
19245,2011-04-11,CHA,@,NJN,W 105-103,240,45,79,.570,41,66,.621,4,13,.308,11,16,.688,105
19246,2011-04-11,BRK,,CHA,L 103-105,240,43,79,.544,39,69,.565,4,10,.400,13,14,.929,103
19247,2011-04-11,NOP,,UTA,L 78-90,240,28,74,.378,24,63,.381,4,11,.364,18,26,.692,78
19248,2011-04-11,UTA,@,NOH,W 90-78,240,37,67,.552,31,51,.608,6,16,.375,10,15,.667,90
19249,2011-04-11,ORL,@,PHI,W 95-85,240,35,80,.438,24,55,.436,11,25,.440,14,21,.667,95
19250,2011-04-11,PHI,,ORL,L 85-95,240,35,82,.427,30,65,.462,5,17,.294,10,11,.909,85
19251,2011-04-11,MIN,@,PHO,L 127-135 (OT),265,52,95,.547,45,79,.570,7,16,.438,16,20,.800,127
19252,2011-04-11,PHO,,MIN,W 135-127 (OT),265,50,92,.543,32,63,.508,18,29,.621,17,23,.739,135
19253,2011-04-11,OKC,@,SAC,W 120-112,240,43,75,.573,41,65,.631,2,10,.200,32,37,.865,120
19254,2011-04-11,SAC,,OKC,L 112-120,240,35,85,.412,31,65,.477,4,20,.200,38,42,.905,112
19255,2011-04-11,BOS,@,WAS,L 94-95 (OT),265,32,84,.381,30,77,.390,2,7,.286,28,34,.824,94
19256,2011-04-11,WAS,,BOS,W 95-94 (OT),265,34,85,.400,32,80,.400,2,5,.400,25,32,.781,95
19257,2011-04-10,CHA,,DET,L 101-112,240,42,78,.538,34,60,.567,8,18,.444,9,20,.450,101
19258,2011-04-10,DET,@,CHA,W 112-101,240,45,81,.556,37,62,.597,8,19,.421,14,19,.737,112
19259,2011-04-10,DAL,,PHO,W 115-90,240,45,89,.506,34,62,.548,11,27,.407,14,18,.778,115
19260,2011-04-10,PHO,@,DAL,L 90-115,240,35,82,.427,33,62,.532,2,20,.100,18,33,.545,90
19261,2011-04-10,GSW,,SAC,L 103-104,240,42,101,.416,36,79,.456,6,22,.273,13,18,.722,103
19262,2011-04-10,SAC,@,GSW,W 104-103,240,37,82,.451,31,64,.484,6,18,.333,24,30,.800,104
19263,2011-04-10,IND,,NYK,L 109-110,240,39,88,.443,34,74,.459,5,14,.357,26,33,.788,109
19264,2011-04-10,NYK,@,IND,W 110-109,240,31,80,.388,19,42,.452,12,38,.316,36,43,.837,110
19265,2011-04-10,LAL,,OKC,L 106-120,240,38,81,.469,31,66,.470,7,15,.467,23,28,.821,106
19266,2011-04-10,OKC,@,LAL,W 120-106,240,40,72,.556,32,55,.582,8,17,.471,32,35,.914,120
19267,2011-04-10,MEM,,NOH,W 111-89,240,41,68,.603,36,56,.643,5,12,.417,24,33,.727,111
19268,2011-04-10,NOP,@,MEM,L 89-111,240,33,80,.413,25,63,.397,8,17,.471,15,25,.600,89
19269,2011-04-10,BOS,@,MIA,L 77-100,240,29,64,.453,23,51,.451,6,13,.462,13,16,.813,77
19270,2011-04-10,MIA,,BOS,W 100-77,240,38,75,.507,32,57,.561,6,18,.333,18,26,.692,100
19271,2011-04-10,CHI,@,ORL,W 102-99,240,36,60,.600,29,47,.617,7,13,.538,23,26,.885,102
19272,2011-04-10,ORL,,CHI,L 99-102,240,35,81,.432,23,57,.404,12,24,.500,17,21,.810,99
19273,2011-04-10,BRK,@,TOR,L 92-99,240,34,88,.386,32,75,.427,2,13,.154,22,27,.815,92
19274,2011-04-10,TOR,,NJN,W 99-92,240,39,76,.513,38,70,.543,1,6,.167,20,28,.714,99
19275,2011-04-09,DEN,,MIN,W 130-106,240,46,88,.523,27,50,.540,19,38,.500,19,34,.559,130
19276,2011-04-09,MIN,@,DEN,L 106-130,240,39,85,.459,28,53,.528,11,32,.344,17,20,.850,106
19277,2011-04-09,HOU,,LAC,W 99-78,240,38,81,.469,28,57,.491,10,24,.417,13,18,.722,99
19278,2011-04-09,LAC,@,HOU,L 78-99,240,33,95,.347,26,77,.338,7,18,.389,5,10,.500,78
19279,2011-04-09,CLE,@,MIL,L 101-108,240,37,77,.481,30,60,.500,7,17,.412,20,24,.833,101
19280,2011-04-09,MIL,,CLE,W 108-101,240,41,81,.506,31,58,.534,10,23,.435,16,20,.800,108
19281,2011-04-09,SAS,,UTA,W 111-102,240,41,71,.577,33,51,.647,8,20,.400,21,31,.677,111
19282,2011-04-09,UTA,@,SAS,L 102-111,240,43,80,.538,39,68,.574,4,12,.333,12,18,.667,102
19283,2011-04-09,ATL,@,WAS,L 83-115,240,33,76,.434,28,67,.418,5,9,.556,12,14,.857,83
19284,2011-04-09,WAS,,ATL,W 115-83,240,46,86,.535,44,81,.543,2,5,.400,21,29,.724,115
19285,2011-04-08,BOS,,WAS,W 104-88,240,36,71,.507,35,59,.593,1,12,.083,31,35,.886,104
19286,2011-04-08,WAS,@,BOS,L 88-104,240,35,77,.455,34,70,.486,1,7,.143,17,26,.654,88
19287,2011-04-08,CHI,@,CLE,W 93-82,240,39,80,.488,35,64,.547,4,16,.250,11,15,.733,93
19288,2011-04-08,CLE,,CHI,L 82-93,240,36,82,.439,34,67,.507,2,15,.133,8,11,.727,82
19289,2011-04-08,DAL,,LAC,W 107-96,240,43,85,.506,39,70,.557,4,15,.267,17,28,.607,107
19290,2011-04-08,LAC,@,DAL,L 96-107,240,38,76,.500,32,58,.552,6,18,.333,14,20,.700,96
19291,2011-04-08,DET,,MIL,W 110-100,240,40,80,.500,38,69,.551,2,11,.182,28,31,.903,110
19292,2011-04-08,MIL,@,DET,L 100-110,240,41,89,.461,38,71,.535,3,18,.167,15,17,.882,100
19293,2011-04-08,ATL,@,IND,L 102-114,240,36,76,.474,31,63,.492,5,13,.385,25,36,.694,102
19294,2011-04-08,IND,,ATL,W 114-102,240,42,86,.488,38,73,.521,4,13,.308,26,33,.788,114
19295,2011-04-08,MEM,,SAC,W 101-96,240,38,84,.452,37,76,.487,1,8,.125,24,35,.686,101
19296,2011-04-08,SAC,@,MEM,L 96-101,240,40,95,.421,37,77,.481,3,18,.167,13,18,.722,96
19297,2011-04-08,CHA,@,MIA,L 103-112,240,41,86,.477,36,70,.514,5,16,.313,16,21,.762,103
19298,2011-04-08,MIA,,CHA,W 112-103,240,39,69,.565,36,60,.600,3,9,.333,31,35,.886,112
19299,2011-04-08,BRK,,NYK,L 93-116,240,39,82,.476,33,63,.524,6,19,.316,9,15,.600,93
19300,2011-04-08,NYK,@,NJN,W 116-93,240,43,87,.494,28,51,.549,15,36,.417,15,19,.789,116
19301,2011-04-08,NOP,,PHO,W 109-97,240,45,81,.556,37,66,.561,8,15,.533,11,18,.611,109
19302,2011-04-08,PHO,@,NOH,L 97-109,240,36,72,.500,30,56,.536,6,16,.375,19,24,.792,97
19303,2011-04-08,DEN,@,OKC,L 89-104,240,31,77,.403,26,59,.441,5,18,.278,22,30,.733,89
19304,2011-04-08,OKC,,DEN,W 104-89,240,38,82,.463,31,63,.492,7,19,.368,21,29,.724,104
19305,2011-04-08,PHI,,TOR,W 98-93,240,36,75,.480,33,64,.516,3,11,.273,23,31,.742,98
19306,2011-04-08,TOR,@,PHI,L 93-98,240,34,73,.466,29,59,.492,5,14,.357,20,23,.870,93
19307,2011-04-08,LAL,@,POR,L 86-93,240,34,86,.395,23,61,.377,11,25,.440,7,14,.500,86
19308,2011-04-08,POR,,LAL,W 93-86,240,35,77,.455,29,56,.518,6,21,.286,17,20,.850,93
19309,2011-04-07,BOS,@,CHI,L 81-97,240,28,73,.384,26,63,.413,2,10,.200,23,26,.885,81
19310,2011-04-07,CHI,,BOS,W 97-81,240,37,78,.474,28,56,.500,9,22,.409,14,15,.933,97
19311,2011-04-07,POR,@,UTA,W 98-87,240,36,79,.456,28,61,.459,8,18,.444,18,19,.947,98
19312,2011-04-07,UTA,,POR,L 87-98,240,31,74,.419,25,54,.463,6,20,.300,19,22,.864,87
19313,2011-04-06,CHA,,ORL,L 102-111 (OT),265,39,84,.464,33,73,.452,6,11,.545,18,20,.900,102
19314,2011-04-06,ORL,@,CHA,W 111-102 (OT),265,41,76,.539,27,41,.659,14,35,.400,15,18,.833,111
19315,2011-04-06,DAL,,DEN,L 96-104,240,39,80,.488,34,58,.586,5,22,.227,13,20,.650,96
19316,2011-04-06,DEN,@,DAL,W 104-96,240,41,86,.477,33,63,.524,8,23,.348,14,18,.778,104
19317,2011-04-06,DET,,NJN,W 116-109,240,43,78,.551,42,71,.592,1,7,.143,29,32,.906,116
19318,2011-04-06,BRK,@,DET,L 109-116,240,40,82,.488,32,63,.508,8,19,.421,21,28,.750,109
19319,2011-04-06,GSW,,LAL,W 95-87,240,36,93,.387,29,68,.426,7,25,.280,16,19,.842,95
19320,2011-04-06,LAL,@,GSW,L 87-95,240,33,77,.429,28,58,.483,5,19,.263,16,27,.593,87
19321,2011-04-06,IND,,WAS,W 136-112,240,50,84,.595,37,60,.617,13,24,.542,23,29,.793,136
19322,2011-04-06,WAS,@,IND,L 112-136,240,40,87,.460,35,77,.455,5,10,.500,27,36,.750,112
19323,2011-04-06,MIA,,MIL,L 85-90,240,30,74,.405,22,51,.431,8,23,.348,17,21,.810,85
19324,2011-04-06,MIL,@,MIA,W 90-85,240,34,76,.447,27,56,.482,7,20,.350,15,15,1.000,90
19325,2011-04-06,MIN,,PHO,L 98-108,240,38,87,.437,32,74,.432,6,13,.462,16,18,.889,98
19326,2011-04-06,PHO,@,MIN,W 108-98,240,44,84,.524,39,61,.639,5,23,.217,15,18,.833,108
19327,2011-04-06,HOU,@,NOH,L 93-101,240,36,78,.462,27,54,.500,9,24,.375,12,13,.923,93
19328,2011-04-06,NOP,,HOU,W 101-93,240,37,81,.457,32,71,.451,5,10,.500,22,26,.846,101
19329,2011-04-06,LAC,@,OKC,L 108-112,240,42,83,.506,36,70,.514,6,13,.462,18,26,.692,108
19330,2011-04-06,OKC,,LAC,W 112-108,240,41,95,.432,36,76,.474,5,19,.263,25,29,.862,112
19331,2011-04-06,NYK,@,PHI,W 97-92,240,36,87,.414,25,56,.446,11,31,.355,14,19,.737,97
19332,2011-04-06,PHI,,NYK,L 92-97,240,38,92,.413,36,74,.486,2,18,.111,14,22,.636,92
19333,2011-04-06,SAC,@,SAS,L 92-124,240,37,93,.398,30,73,.411,7,20,.350,11,15,.733,92
19334,2011-04-06,SAS,,SAC,W 124-92,240,46,76,.605,34,57,.596,12,19,.632,20,25,.800,124
19335,2011-04-06,CLE,@,TOR,W 104-96,240,36,79,.456,31,64,.484,5,15,.333,27,39,.692,104
19336,2011-04-06,TOR,,CLE,L 96-104,240,35,80,.438,30,63,.476,5,17,.294,21,32,.656,96
19337,2011-04-05,ATL,,SAS,L 90-97,240,35,72,.486,32,59,.542,3,13,.231,17,20,.850,90
19338,2011-04-05,SAS,@,ATL,W 97-90,240,37,74,.500,36,66,.545,1,8,.125,22,26,.846,97
19339,2011-04-05,BOS,,PHI,W 99-82,240,40,76,.526,36,66,.545,4,10,.400,15,19,.789,99
19340,2011-04-05,PHI,@,BOS,L 82-99,240,33,84,.393,29,74,.392,4,10,.400,12,17,.706,82
19341,2011-04-05,CHI,,PHO,W 97-94,240,36,78,.462,28,59,.475,8,19,.421,17,24,.708,97
19342,2011-04-05,PHO,@,CHI,L 94-97,240,38,88,.432,30,65,.462,8,23,.348,10,12,.833,94
19343,2011-04-05,CHA,@,CLE,L 89-99,240,32,82,.390,28,67,.418,4,15,.267,21,27,.778,89
19344,2011-04-05,CLE,,CHA,W 99-89,240,37,82,.451,29,58,.500,8,24,.333,17,20,.850,99
19345,2011-04-05,DEN,,OKC,L 94-101,240,36,82,.439,31,70,.443,5,12,.417,17,26,.654,94
19346,2011-04-05,OKC,@,DEN,W 101-94,240,35,79,.443,31,61,.508,4,18,.222,27,35,.771,101
19347,2011-04-05,HOU,,SAC,L 101-104,240,40,94,.426,33,69,.478,7,25,.280,14,21,.667,101
19348,2011-04-05,SAC,@,HOU,W 104-101,240,44,83,.530,43,72,.597,1,11,.091,15,18,.833,104
19349,2011-04-05,LAL,,UTA,L 85-86,240,31,82,.378,27,62,.435,4,20,.200,19,25,.760,85
19350,2011-04-05,UTA,@,LAL,W 86-85,240,34,85,.400,29,72,.403,5,13,.385,13,23,.565,86
19351,2011-04-05,LAC,@,MEM,W 82-81,240,32,78,.410,28,64,.438,4,14,.286,14,22,.636,82
19352,2011-04-05,MEM,,LAC,L 81-82,240,34,86,.395,33,77,.429,1,9,.111,12,18,.667,81
19353,2011-04-05,MIN,@,NJN,L 105-107,240,39,79,.494,31,64,.484,8,15,.533,19,27,.704,105
19354,2011-04-05,BRK,,MIN,W 107-105,240,42,89,.472,33,69,.478,9,20,.450,14,20,.700,107
19355,2011-04-05,NYK,,TOR,W 131-118,240,45,78,.577,30,51,.588,15,27,.556,26,34,.765,131
19356,2011-04-05,TOR,@,NYK,L 118-131,240,45,92,.489,42,85,.494,3,7,.429,25,33,.758,118
19357,2011-04-05,MIL,@,ORL,L 72-78,240,27,75,.360,21,55,.382,6,20,.300,12,17,.706,72
19358,2011-04-05,ORL,,MIL,W 78-72,240,26,67,.388,24,46,.522,2,21,.095,24,36,.667,78
19359,2011-04-05,GSW,@,POR,W 108-87,240,41,82,.500,34,66,.515,7,16,.438,19,22,.864,108
19360,2011-04-05,POR,,GSW,L 87-108,240,34,83,.410,31,62,.500,3,21,.143,16,18,.889,87
19361,2011-04-05,DET,@,WAS,L 105-107,240,43,98,.439,38,81,.469,5,17,.294,14,20,.700,105
19362,2011-04-05,WAS,,DET,W 107-105,240,38,77,.494,35,67,.522,3,10,.300,28,35,.800,107
19363,2011-04-03,BOS,,DET,W 101-90,240,41,64,.641,34,53,.642,7,11,.636,12,17,.706,101
19364,2011-04-03,DET,@,BOS,L 90-101,240,34,80,.425,26,59,.441,8,21,.381,14,17,.824,90
19365,2011-04-03,CHA,,WAS,L 91-97,240,34,79,.430,30,71,.423,4,8,.500,19,21,.905,91
19366,2011-04-03,WAS,@,CHA,W 97-91,240,39,88,.443,37,78,.474,2,10,.200,17,25,.680,97
19367,2011-04-03,ATL,@,HOU,L 109-114,240,43,81,.531,38,66,.576,5,15,.333,18,20,.900,109
19368,2011-04-03,HOU,,ATL,W 114-109,240,43,75,.573,40,60,.667,3,15,.200,25,29,.862,114
19369,2011-04-03,DEN,@,LAL,W 95-90,240,36,82,.439,29,65,.446,7,17,.412,16,28,.571,95
19370,2011-04-03,LAL,,DEN,L 90-95,240,36,84,.429,32,66,.485,4,18,.222,14,20,.700,90
19371,2011-04-03,MIA,@,NJN,W 108-94,240,42,75,.560,37,60,.617,5,15,.333,19,32,.594,108
19372,2011-04-03,BRK,,MIA,L 94-108,240,34,85,.400,26,57,.456,8,28,.286,18,25,.720,94
19373,2011-04-03,IND,@,NOH,L 96-108,240,37,81,.457,28,55,.509,9,26,.346,13,19,.684,96
19374,2011-04-03,NOP,,IND,W 108-96,240,42,82,.512,37,67,.552,5,15,.333,19,24,.792,108
19375,2011-04-03,CLE,@,NYK,L 107-123,240,42,79,.532,33,57,.579,9,22,.409,14,24,.583,107
19376,2011-04-03,NYK,,CLE,W 123-107,240,41,85,.482,31,61,.508,10,24,.417,31,33,.939,123
19377,2011-04-03,DAL,@,POR,L 96-104,240,34,70,.486,25,46,.543,9,24,.375,19,26,.731,96
19378,2011-04-03,POR,,DAL,W 104-96,240,39,73,.534,34,58,.586,5,15,.333,21,25,.840,104
19379,2011-04-03,SAC,,UTA,W 106-97,240,41,79,.519,35,64,.547,6,15,.400,18,22,.818,106
19380,2011-04-03,UTA,@,SAC,L 97-106,240,38,81,.469,32,68,.471,6,13,.462,15,20,.750,97
19381,2011-04-03,PHO,@,SAS,L 97-114,240,40,85,.471,35,71,.493,5,14,.357,12,14,.857,97
19382,2011-04-03,SAS,,PHO,W 114-97,240,43,89,.483,28,60,.467,15,29,.517,13,18,.722,114
19383,2011-04-03,ORL,@,TOR,L 98-102,240,37,75,.493,28,54,.519,9,21,.429,15,27,.556,98
19384,2011-04-03,TOR,,ORL,W 102-98,240,40,79,.506,35,69,.507,5,10,.500,17,22,.773,102
19385,2011-04-02,CHI,,TOR,W 113-106,240,41,85,.482,36,72,.500,5,13,.385,26,28,.929,113
19386,2011-04-02,TOR,@,CHI,L 106-113,240,41,81,.506,38,74,.514,3,7,.429,21,24,.875,106
19387,2011-04-02,DAL,@,GSW,L 92-99,240,37,90,.411,32,65,.492,5,25,.200,13,20,.650,92
19388,2011-04-02,GSW,,DAL,W 99-92,240,35,78,.449,28,57,.491,7,21,.333,22,24,.917,99
19389,2011-04-02,LAC,,OKC,W 98-92,240,33,74,.446,28,61,.459,5,13,.385,27,38,.711,98
19390,2011-04-02,OKC,@,LAC,L 92-98,240,34,82,.415,30,68,.441,4,14,.286,20,24,.833,92
19391,2011-04-02,MEM,,MIN,W 106-89,240,46,90,.511,41,78,.526,5,12,.417,9,13,.692,106
19392,2011-04-02,MIN,@,MEM,L 89-106,240,35,72,.486,29,53,.547,6,19,.316,13,16,.813,89
19393,2011-04-02,MIL,,PHI,W 93-87 (OT),265,36,74,.486,33,65,.508,3,9,.333,18,24,.750,93
19394,2011-04-02,PHI,@,MIL,L 87-93 (OT),265,35,87,.402,31,73,.425,4,14,.286,13,18,.722,87
19395,2011-04-01,ATL,,BOS,W 88-83,240,29,79,.367,25,63,.397,4,16,.250,26,30,.867,88
19396,2011-04-01,BOS,@,ATL,L 83-88,240,33,74,.446,27,62,.435,6,12,.500,11,20,.550,83
19397,2011-04-01,CHI,@,DET,W 101-96,240,38,74,.514,32,55,.582,6,19,.316,19,26,.731,101
19398,2011-04-01,DET,,CHI,L 96-101,240,39,75,.520,36,66,.545,3,9,.333,15,21,.714,96
19399,2011-04-01,HOU,,SAS,W 119-114 (OT),265,42,94,.447,33,71,.465,9,23,.391,26,29,.897,119
19400,2011-04-01,SAS,@,HOU,L 114-119 (OT),265,45,88,.511,40,69,.580,5,19,.263,19,28,.679,114
19401,2011-04-01,IND,,MIL,W 89-88,240,36,78,.462,33,67,.493,3,11,.273,14,19,.737,89
19402,2011-04-01,MIL,@,IND,L 88-89,240,34,80,.425,28,58,.483,6,22,.273,14,21,.667,88
19403,2011-04-01,MIA,@,MIN,W 111-92,240,42,77,.545,38,64,.594,4,13,.308,23,30,.767,111
19404,2011-04-01,MIN,,MIA,L 92-111,240,34,81,.420,24,58,.414,10,23,.435,14,19,.737,92
19405,2011-04-01,MEM,@,NOH,W 93-81,240,37,73,.507,32,65,.492,5,8,.625,14,19,.737,93
19406,2011-04-01,NOP,,MEM,L 81-93,240,31,69,.449,27,56,.482,4,13,.308,15,18,.833,81
19407,2011-04-01,CHA,@,ORL,L 77-89,240,33,73,.452,32,64,.500,1,9,.111,10,13,.769,77
19408,2011-04-01,ORL,,CHA,W 89-77,240,30,71,.423,21,42,.500,9,29,.310,20,24,.833,89
19409,2011-04-01,BRK,@,PHI,L 90-115,240,37,85,.435,34,73,.466,3,12,.250,13,20,.650,90
19410,2011-04-01,PHI,,NJN,W 115-90,240,45,80,.563,39,66,.591,6,14,.429,19,22,.864,115
19411,2011-04-01,LAC,@,PHO,L 98-111,240,36,81,.444,25,54,.463,11,27,.407,15,26,.577,98
19412,2011-04-01,PHO,,LAC,W 111-98,240,41,79,.519,36,65,.554,5,14,.357,24,33,.727,111
19413,2011-04-01,OKC,@,POR,L 91-98,240,32,78,.410,25,51,.490,7,27,.259,20,23,.870,91
19414,2011-04-01,POR,,OKC,W 98-91,240,34,79,.430,29,62,.468,5,17,.294,25,27,.926,98
19415,2011-04-01,DEN,@,SAC,W 99-90,240,39,80,.488,35,66,.530,4,14,.286,17,22,.773,99
19416,2011-04-01,SAC,,DEN,L 90-99,240,33,83,.398,31,62,.500,2,21,.095,22,34,.647,90
19417,2011-04-01,LAL,@,UTA,W 96-85,240,34,71,.479,27,53,.509,7,18,.389,21,30,.700,96
19418,2011-04-01,UTA,,LAL,L 85-96,240,34,82,.415,32,72,.444,2,10,.200,15,18,.833,85
19419,2011-04-01,CLE,@,WAS,L 107-115,240,38,82,.463,33,60,.550,5,22,.227,26,32,.813,107
19420,2011-04-01,WAS,,CLE,W 115-107,240,46,94,.489,42,86,.488,4,8,.500,19,32,.594,115
19421,2011-03-31,DAL,@,LAL,L 82-110,240,30,83,.361,24,57,.421,6,26,.231,16,23,.696,82
19422,2011-03-31,LAL,,DAL,W 110-82,240,38,85,.447,32,69,.464,6,16,.375,28,39,.718,110
19423,2011-03-31,BOS,@,SAS,W 107-97,240,46,84,.548,44,73,.603,2,11,.182,13,16,.813,107
19424,2011-03-31,SAS,,BOS,L 97-107,240,39,90,.433,31,61,.508,8,29,.276,11,14,.786,97
19425,2011-03-30,ATL,,ORL,W 85-82,240,33,70,.471,27,55,.491,6,15,.400,13,15,.867,85
19426,2011-03-30,ORL,@,ATL,L 82-85,240,32,77,.416,25,54,.463,7,23,.304,11,21,.524,82
19427,2011-03-30,CHA,,CLE,W 98-97,240,42,75,.560,40,67,.597,2,8,.250,12,17,.706,98
19428,2011-03-30,CLE,@,CHA,L 97-98,240,36,69,.522,29,55,.527,7,14,.500,18,21,.857,97
19429,2011-03-30,DEN,,SAC,W 104-90,240,38,81,.469,32,59,.542,6,22,.273,22,32,.688,104
19430,2011-03-30,SAC,@,DEN,L 90-104,240,36,79,.456,30,58,.517,6,21,.286,12,16,.750,90
19431,2011-03-30,DET,@,IND,L 101-111,240,42,83,.506,41,75,.547,1,8,.125,16,20,.800,101
19432,2011-03-30,IND,,DET,W 111-101,240,41,86,.477,35,61,.574,6,25,.240,23,25,.920,111
19433,2011-03-30,DAL,@,LAC,W 106-100,240,41,85,.482,32,64,.500,9,21,.429,15,26,.577,106
19434,2011-03-30,LAC,,DAL,L 100-106,240,35,75,.467,30,51,.588,5,24,.208,25,31,.806,100
19435,2011-03-30,GSW,@,MEM,L 91-110,240,39,83,.470,33,62,.532,6,21,.286,7,11,.636,91
19436,2011-03-30,MEM,,GSW,W 110-91,240,48,85,.565,46,81,.568,2,4,.500,12,19,.632,110
19437,2011-03-30,CHI,@,MIN,W 108-91,240,41,81,.506,33,62,.532,8,19,.421,18,20,.900,108
19438,2011-03-30,MIN,,CHI,L 91-108,240,35,85,.412,30,68,.441,5,17,.294,16,21,.762,91
19439,2011-03-30,NOP,,POR,W 95-91,240,34,73,.466,29,58,.500,5,15,.333,22,29,.759,95
19440,2011-03-30,POR,@,NOH,L 91-95,240,37,74,.500,32,60,.533,5,14,.357,12,16,.750,91
19441,2011-03-30,BRK,@,NYK,L 116-120,240,41,86,.477,34,69,.493,7,17,.412,27,33,.818,116
19442,2011-03-30,NYK,,NJN,W 120-116,240,46,92,.500,39,69,.565,7,23,.304,21,26,.808,120
19443,2011-03-30,HOU,@,PHI,L 97-108,240,34,83,.410,26,65,.400,8,18,.444,21,22,.955,97
19444,2011-03-30,PHI,,HOU,W 108-97,240,46,85,.541,41,72,.569,5,13,.385,11,12,.917,108
19445,2011-03-30,OKC,@,PHO,W 116-98,240,43,80,.538,35,62,.565,8,18,.444,22,30,.733,116
19446,2011-03-30,PHO,,OKC,L 98-116,240,36,80,.450,32,66,.485,4,14,.286,22,29,.759,98
19447,2011-03-30,MIL,@,TOR,W 104-98,240,38,77,.494,29,58,.500,9,19,.474,19,26,.731,104
19448,2011-03-30,TOR,,MIL,L 98-104,240,39,76,.513,34,63,.540,5,13,.385,15,16,.938,98
19449,2011-03-30,MIA,@,WAS,W 123-107,240,41,71,.577,31,52,.596,10,19,.526,31,39,.795,123
19450,2011-03-30,WAS,,MIA,L 107-123,240,38,77,.494,29,61,.475,9,16,.563,22,31,.710,107
19451,2011-03-29,CLE,,MIA,W 102-90,240,35,63,.556,26,46,.565,9,17,.529,23,35,.657,102
19452,2011-03-29,MIA,@,CLE,L 90-102,240,33,78,.423,23,53,.434,10,25,.400,14,22,.636,90
19453,2011-03-29,HOU,@,NJN,W 112-87,240,46,99,.465,35,76,.461,11,23,.478,9,10,.900,112
19454,2011-03-29,BRK,,HOU,L 87-112,240,37,89,.416,31,73,.425,6,16,.375,7,10,.700,87
19455,2011-03-29,GSW,@,OKC,L 114-115 (OT),265,44,104,.423,33,78,.423,11,26,.423,15,17,.882,114
19456,2011-03-29,OKC,,GSW,W 115-114 (OT),265,40,88,.455,33,67,.493,7,21,.333,28,33,.848,115
19457,2011-03-29,PHO,@,SAC,L 113-116,240,47,94,.500,42,73,.575,5,21,.238,14,21,.667,113
19458,2011-03-29,SAC,,PHO,W 116-113,240,48,90,.533,39,70,.557,9,20,.450,11,20,.550,116
19459,2011-03-28,CHA,,MIL,W 87-86,240,33,68,.485,30,57,.526,3,11,.273,18,26,.692,87
19460,2011-03-28,MIL,@,CHA,L 86-87,240,35,90,.389,30,67,.448,5,23,.217,11,13,.846,86
19461,2011-03-28,CHI,,PHI,L 85-97,240,33,80,.413,32,71,.451,1,9,.111,18,30,.600,85
19462,2011-03-28,PHI,@,CHI,W 97-85,240,39,86,.453,35,72,.486,4,14,.286,15,21,.714,97
19463,2011-03-28,BOS,@,IND,L 100-107,240,34,62,.548,30,51,.588,4,11,.364,28,36,.778,100
19464,2011-03-28,IND,,BOS,W 107-100,240,42,77,.545,36,62,.581,6,15,.400,17,22,.773,107
19465,2011-03-28,NYK,,ORL,W 113-106 (OT),265,35,81,.432,23,46,.500,12,35,.343,31,41,.756,113
19466,2011-03-28,ORL,@,NYK,L 106-113 (OT),265,36,80,.450,25,48,.521,11,32,.344,23,32,.719,106
19467,2011-03-28,POR,@,SAS,W 100-92,240,34,65,.523,26,48,.542,8,17,.471,24,31,.774,100
19468,2011-03-28,SAS,,POR,L 92-100,240,38,79,.481,32,54,.593,6,25,.240,10,20,.500,92
19469,2011-03-28,UTA,,WAS,L 95-100 (OT),265,39,93,.419,32,69,.464,7,24,.292,10,21,.476,95
19470,2011-03-28,WAS,@,UTA,W 100-95 (OT),265,36,92,.391,30,66,.455,6,26,.231,22,29,.759,100
19471,2011-03-27,ATL,@,CLE,W 99-83,240,37,74,.500,32,60,.533,5,14,.357,20,27,.741,99
19472,2011-03-27,CLE,,ATL,L 83-99,240,32,87,.368,27,67,.403,5,20,.250,14,20,.700,83
19473,2011-03-27,GSW,,WAS,W 114-104,240,45,95,.474,34,71,.479,11,24,.458,13,19,.684,114
19474,2011-03-27,WAS,@,GSW,L 104-114,240,37,89,.416,33,73,.452,4,16,.250,26,30,.867,104
19475,2011-03-27,LAL,,NOH,W 102-84,240,41,85,.482,38,68,.559,3,17,.176,17,21,.810,102
19476,2011-03-27,NOP,@,LAL,L 84-102,240,35,87,.402,32,70,.457,3,17,.176,11,15,.733,84
19477,2011-03-27,MEM,,SAS,W 111-104,240,42,77,.545,36,63,.571,6,14,.429,21,30,.700,111
19478,2011-03-27,SAS,@,MEM,L 104-111,240,39,77,.506,30,56,.536,9,21,.429,17,24,.708,104
19479,2011-03-27,HOU,@,MIA,L 119-125,240,43,89,.483,34,68,.500,9,21,.429,24,28,.857,119
19480,2011-03-27,MIA,,HOU,W 125-119,240,46,92,.500,41,75,.547,5,17,.294,28,34,.824,125
19481,2011-03-27,BOS,@,MIN,W 85-82,240,30,75,.400,26,60,.433,4,15,.267,21,26,.808,85
19482,2011-03-27,MIN,,BOS,L 82-85,240,30,80,.375,23,63,.365,7,17,.412,15,23,.652,82
19483,2011-03-27,OKC,,POR,W 99-90,240,32,75,.427,23,51,.451,9,24,.375,26,29,.897,99
19484,2011-03-27,POR,@,OKC,L 90-99,240,35,81,.432,33,69,.478,2,12,.167,18,24,.750,90
19485,2011-03-27,PHI,,SAC,L 111-114 (OT),265,40,91,.440,35,77,.455,5,14,.357,26,36,.722,111
19486,2011-03-27,SAC,@,PHI,W 114-111 (OT),265,38,85,.447,29,70,.414,9,15,.600,29,36,.806,114
19487,2011-03-27,DAL,@,PHO,W 91-83,240,32,84,.381,22,58,.379,10,26,.385,17,21,.810,91
19488,2011-03-27,PHO,,DAL,L 83-91,240,34,80,.425,33,64,.516,1,16,.063,14,23,.609,83
19489,2011-03-26,ATL,,NJN,W 98-87,240,39,78,.500,35,60,.583,4,18,.222,16,22,.727,98
19490,2011-03-26,BRK,@,ATL,L 87-98,240,38,79,.481,35,66,.530,3,13,.231,8,9,.889,87
19491,2011-03-26,CHA,,NYK,W 114-106,240,43,91,.473,38,73,.521,5,18,.278,23,28,.821,114
19492,2011-03-26,NYK,@,CHA,L 106-114,240,35,88,.398,29,60,.483,6,28,.214,30,35,.857,106
19493,2011-03-26,DET,,IND,W 100-88,240,39,76,.513,31,62,.500,8,14,.571,14,21,.667,100
19494,2011-03-26,IND,@,DET,L 88-100,240,36,76,.474,27,58,.466,9,18,.500,7,19,.368,88
19495,2011-03-26,LAC,,TOR,W 94-90,240,39,84,.464,38,75,.507,1,9,.111,15,23,.652,94
19496,2011-03-26,TOR,@,LAC,L 90-94,240,33,85,.388,29,70,.414,4,15,.267,20,29,.690,90
19497,2011-03-26,CHI,@,MIL,W 95-87,240,36,72,.500,33,58,.569,3,14,.214,20,27,.741,95
19498,2011-03-26,MIL,,CHI,L 87-95,240,31,79,.392,25,65,.385,6,14,.429,19,21,.905,87
19499,2011-03-26,DAL,@,UTA,W 94-77,240,30,66,.455,22,47,.468,8,19,.421,26,32,.813,94
19500,2011-03-26,UTA,,DAL,L 77-94,240,32,76,.421,29,64,.453,3,12,.250,10,17,.588,77
19501,2011-03-25,BOS,,CHA,L 81-83,240,29,71,.408,26,56,.464,3,15,.200,20,26,.769,81
19502,2011-03-25,CHA,@,BOS,W 83-81,240,30,69,.435,29,58,.500,1,11,.091,22,25,.880,83
19503,2011-03-25,CHI,,MEM,W 99-96,240,34,82,.415,28,65,.431,6,17,.353,25,31,.806,99
19504,2011-03-25,MEM,@,CHI,L 96-99,240,36,73,.493,34,58,.586,2,15,.133,22,30,.733,96
19505,2011-03-25,CLE,,DET,W 97-91,240,38,82,.463,32,64,.500,6,18,.333,15,20,.750,97
19506,2011-03-25,DET,@,CLE,L 91-97,240,37,87,.425,33,74,.446,4,13,.308,13,20,.650,91
19507,2011-03-25,DEN,,WAS,W 114-94,240,42,85,.494,31,59,.525,11,26,.423,19,24,.792,114
19508,2011-03-25,WAS,@,DEN,L 94-114,240,37,88,.420,34,77,.442,3,11,.273,17,21,.810,94
19509,2011-03-25,GSW,,TOR,W 138-100,240,51,83,.614,41,66,.621,10,17,.588,26,32,.813,138
19510,2011-03-25,TOR,@,GSW,L 100-138,240,38,81,.469,32,68,.471,6,13,.462,18,26,.692,100
19511,2011-03-25,IND,,SAC,L 93-110,240,32,91,.352,28,66,.424,4,25,.160,25,30,.833,93
19512,2011-03-25,SAC,@,IND,W 110-93,240,48,100,.480,41,84,.488,7,16,.438,7,10,.700,110
19513,2011-03-25,LAC,@,LAL,L 104-112,240,42,84,.500,37,67,.552,5,17,.294,15,18,.833,104
19514,2011-03-25,LAL,,LAC,W 112-104,240,39,78,.500,33,60,.550,6,18,.333,28,39,.718,112
19515,2011-03-25,MIA,,PHI,W 111-99,240,41,83,.494,34,63,.540,7,20,.350,22,28,.786,111
19516,2011-03-25,PHI,@,MIA,L 99-111,240,40,86,.465,33,67,.493,7,19,.368,12,14,.857,99
19517,2011-03-25,MIL,@,NYK,W 102-96,240,39,77,.506,30,59,.508,9,18,.500,15,19,.789,102
19518,2011-03-25,NYK,,MIL,L 96-102,240,36,90,.400,32,71,.451,4,19,.211,20,23,.870,96
19519,2011-03-25,MIN,@,OKC,L 103-111,240,40,84,.476,34,74,.459,6,10,.600,17,20,.850,103
19520,2011-03-25,OKC,,MIN,W 111-103,240,44,84,.524,40,71,.563,4,13,.308,19,28,.679,111
19521,2011-03-25,BRK,@,ORL,L 85-95,240,36,78,.462,27,59,.458,9,19,.474,4,6,.667,85
19522,2011-03-25,ORL,,NJN,W 95-85,240,37,73,.507,26,46,.565,11,27,.407,10,23,.435,95
19523,2011-03-25,NOP,@,PHO,W 106-100,240,43,86,.500,36,71,.507,7,15,.467,13,18,.722,106
19524,2011-03-25,PHO,,NOH,L 100-106,240,35,71,.493,24,52,.462,11,19,.579,19,25,.760,100
19525,2011-03-25,POR,,SAS,W 98-96,240,40,86,.465,33,60,.550,7,26,.269,11,14,.786,98
19526,2011-03-25,SAS,@,POR,L 96-98,240,39,76,.513,28,53,.528,11,23,.478,7,10,.700,96
19527,2011-03-24,DAL,,MIN,W 104-96,240,42,85,.494,34,58,.586,8,27,.296,12,15,.800,104
19528,2011-03-24,MIN,@,DAL,L 96-104,240,39,80,.488,31,62,.500,8,18,.444,10,12,.833,96
19529,2011-03-24,NOP,@,UTA,W 121-117 (OT),265,43,86,.500,36,73,.493,7,13,.538,28,35,.800,121
19530,2011-03-24,UTA,,NOH,L 117-121 (OT),265,44,86,.512,36,68,.529,8,18,.444,21,25,.840,117
19531,2011-03-23,BOS,,MEM,L 87-90,240,29,69,.420,22,54,.407,7,15,.467,22,23,.957,87
19532,2011-03-23,MEM,@,BOS,W 90-87,240,37,83,.446,34,77,.442,3,6,.500,13,19,.684,90
19533,2011-03-23,CHA,,IND,L 88-111,240,32,72,.444,29,62,.468,3,10,.300,21,29,.724,88
19534,2011-03-23,IND,@,CHA,W 111-88,240,39,72,.542,33,58,.569,6,14,.429,27,34,.794,111
19535,2011-03-23,CLE,,NJN,L 94-98 (OT),265,34,91,.374,32,79,.405,2,12,.167,24,35,.686,94
19536,2011-03-23,BRK,@,CLE,W 98-94 (OT),265,32,94,.340,26,75,.347,6,19,.316,28,37,.757,98
19537,2011-03-23,DEN,,SAS,W 115-112,240,39,77,.506,27,56,.482,12,21,.571,25,39,.641,115
19538,2011-03-23,SAS,@,DEN,L 112-115,240,38,88,.432,25,56,.446,13,32,.406,23,26,.885,112
19539,2011-03-23,DET,,MIA,L 94-100,240,35,71,.493,31,58,.534,4,13,.308,20,26,.769,94
19540,2011-03-23,MIA,@,DET,W 100-94,240,31,64,.484,25,45,.556,6,19,.316,32,39,.821,100
19541,2011-03-23,GSW,@,HOU,L 112-131,240,47,92,.511,40,77,.519,7,15,.467,11,18,.611,112
19542,2011-03-23,HOU,,GSW,W 131-112,240,46,91,.505,34,65,.523,12,26,.462,27,35,.771,131
19543,2011-03-23,LAC,,WAS,W 127-119 (2OT),290,46,93,.495,37,67,.552,9,26,.346,26,33,.788,127
19544,2011-03-23,WAS,@,LAC,L 119-127 (2OT),290,49,102,.480,46,89,.517,3,13,.231,18,25,.720,119
19545,2011-03-23,MIL,,SAC,L 90-97,240,37,81,.457,31,63,.492,6,18,.333,10,12,.833,90
19546,2011-03-23,SAC,@,MIL,W 97-90,240,37,83,.446,34,72,.472,3,11,.273,20,27,.741,97
19547,2011-03-23,NYK,,ORL,L 99-111,240,34,84,.405,22,56,.393,12,28,.429,19,24,.792,99
19548,2011-03-23,ORL,@,NYK,W 111-99,240,37,76,.487,25,51,.490,12,25,.480,25,28,.893,111
19549,2011-03-23,OKC,,UTA,W 106-94,240,36,66,.545,32,56,.571,4,10,.400,30,36,.833,106
19550,2011-03-23,UTA,@,OKC,L 94-106,240,31,69,.449,25,53,.472,6,16,.375,26,32,.813,94
19551,2011-03-23,ATL,@,PHI,L 100-105,240,39,81,.481,31,63,.492,8,18,.444,14,15,.933,100
19552,2011-03-23,PHI,,ATL,W 105-100,240,41,84,.488,31,66,.470,10,18,.556,13,18,.722,105
19553,2011-03-23,PHO,,TOR,W 114-106,240,42,90,.467,30,62,.484,12,28,.429,18,22,.818,114
19554,2011-03-23,TOR,@,PHO,L 106-114,240,47,97,.485,44,85,.518,3,12,.250,9,12,.750,106
19555,2011-03-22,ATL,,CHI,L 81-114,240,29,64,.453,24,58,.414,5,6,.833,18,24,.750,81
19556,2011-03-22,CHI,@,ATL,W 114-81,240,43,79,.544,33,61,.541,10,18,.556,18,24,.750,114
19557,2011-03-22,LAL,,PHO,W 139-137 (3OT),315,53,120,.442,42,93,.452,11,27,.407,22,25,.880,139
19558,2011-03-22,PHO,@,LAL,L 137-139 (3OT),315,51,106,.481,34,65,.523,17,41,.415,18,22,.818,137
19559,2011-03-22,POR,,WAS,W 111-76,240,40,80,.500,35,60,.583,5,20,.250,26,31,.839,111
19560,2011-03-22,WAS,@,POR,L 76-111,240,26,70,.371,22,61,.361,4,9,.444,20,26,.769,76
19561,2011-03-21,CHI,,SAC,W 132-92,240,49,80,.613,37,63,.587,12,17,.706,22,31,.710,132
19562,2011-03-21,SAC,@,CHI,L 92-132,240,32,74,.432,27,62,.435,5,12,.417,23,27,.852,92
19563,2011-03-21,CLE,,ORL,L 86-97,240,32,81,.395,27,61,.443,5,20,.250,17,21,.810,86
19564,2011-03-21,ORL,@,CLE,W 97-86,240,36,77,.468,27,49,.551,9,28,.321,16,23,.696,97
19565,2011-03-21,DEN,,TOR,W 123-90,240,43,90,.478,36,67,.537,7,23,.304,30,37,.811,123
19566,2011-03-21,TOR,@,DEN,L 90-123,240,35,87,.402,29,69,.420,6,18,.333,14,18,.778,90
19567,2011-03-21,MEM,,UTA,W 103-85,240,45,89,.506,40,77,.519,5,12,.417,8,10,.800,103
19568,2011-03-21,UTA,@,MEM,L 85-103,240,32,66,.485,29,54,.537,3,12,.250,18,25,.720,85
19569,2011-03-21,IND,@,NJN,W 102-98,240,35,72,.486,30,56,.536,5,16,.313,27,30,.900,102
19570,2011-03-21,BRK,,IND,L 98-102,240,39,98,.398,31,72,.431,8,26,.308,12,18,.667,98
19571,2011-03-21,BOS,@,NYK,W 96-86,240,37,80,.463,36,70,.514,1,10,.100,21,26,.808,96
19572,2011-03-21,NYK,,BOS,L 86-96,240,30,74,.405,23,52,.442,7,22,.318,19,25,.760,86
19573,2011-03-21,GSW,@,SAS,L 96-111,240,38,84,.452,32,65,.492,6,19,.316,14,18,.778,96
19574,2011-03-21,SAS,,GSW,W 111-96,240,42,85,.494,31,53,.585,11,32,.344,16,19,.842,111
19575,2011-03-20,ATL,,DET,W 104-96,240,37,70,.529,30,55,.545,7,15,.467,23,31,.742,104
19576,2011-03-20,DET,@,ATL,L 96-104,240,39,78,.500,34,63,.540,5,15,.333,13,17,.765,96
19577,2011-03-20,DAL,,GSW,W 101-73,240,34,79,.430,22,46,.478,12,33,.364,21,25,.840,101
19578,2011-03-20,GSW,@,DAL,L 73-101,240,27,77,.351,22,57,.386,5,20,.250,14,20,.700,73
19579,2011-03-20,HOU,,UTA,W 110-108,240,33,82,.402,25,63,.397,8,19,.421,36,41,.878,110
19580,2011-03-20,UTA,@,HOU,L 108-110,240,42,97,.433,34,81,.420,8,16,.500,16,25,.640,108
19581,2011-03-20,LAC,,PHO,L 99-108,240,38,84,.452,29,64,.453,9,20,.450,14,17,.824,99
19582,2011-03-20,PHO,@,LAC,W 108-99,240,41,84,.488,31,62,.500,10,22,.455,16,19,.842,108
19583,2011-03-20,LAL,,POR,W 84-80,240,35,78,.449,32,61,.525,3,17,.176,11,12,.917,84
19584,2011-03-20,POR,@,LAL,L 80-84,240,32,83,.386,26,58,.448,6,25,.240,10,15,.667,80
19585,2011-03-20,MIL,,NYK,W 100-95,240,31,72,.431,24,53,.453,7,19,.368,31,37,.838,100
19586,2011-03-20,NYK,@,MIL,L 95-100,240,34,88,.386,25,66,.379,9,22,.409,18,22,.818,95
19587,2011-03-20,MIN,,SAC,L 95-127,240,35,79,.443,28,62,.452,7,17,.412,18,24,.750,95
19588,2011-03-20,SAC,@,MIN,W 127-95,240,51,91,.560,40,69,.580,11,22,.500,14,23,.609,127
19589,2011-03-20,OKC,,TOR,L 93-95,240,30,75,.400,25,58,.431,5,17,.294,28,35,.800,93
19590,2011-03-20,TOR,@,OKC,W 95-93,240,35,81,.432,29,67,.433,6,14,.429,19,24,.792,95
19591,2011-03-20,BRK,@,WAS,L 92-98,240,38,87,.437,35,70,.500,3,17,.176,13,18,.722,92
19592,2011-03-20,WAS,,NJN,W 98-92,240,42,81,.519,41,73,.562,1,8,.125,13,17,.765,98
19593,2011-03-19,CLE,@,LAC,L 92-100,240,36,75,.480,33,60,.550,3,15,.200,17,20,.850,92
19594,2011-03-19,LAC,,CLE,W 100-92,240,37,77,.481,28,60,.467,9,17,.529,17,18,.944,100
19595,2011-03-19,IND,@,MEM,L 78-99,240,26,73,.356,19,47,.404,7,26,.269,19,26,.731,78
19596,2011-03-19,MEM,,IND,W 99-78,240,44,85,.518,44,76,.579,0,9,.000,11,17,.647,99
19597,2011-03-19,DEN,@,MIA,L 98-103,240,34,78,.436,24,54,.444,10,24,.417,20,28,.714,98
19598,2011-03-19,MIA,,DEN,W 103-98,240,36,71,.507,30,51,.588,6,20,.300,25,29,.862,103
19599,2011-03-19,BOS,@,NOH,W 89-85,240,35,68,.515,32,58,.552,3,10,.300,16,19,.842,89
19600,2011-03-19,NOP,,BOS,L 85-89,240,33,73,.452,26,55,.473,7,18,.389,12,18,.667,85
19601,2011-03-19,PHI,@,POR,L 101-110,240,40,80,.500,32,63,.508,8,17,.471,13,15,.867,101
19602,2011-03-19,POR,,PHI,W 110-101,240,37,72,.514,26,49,.531,11,23,.478,25,29,.862,110
19603,2011-03-19,CHA,@,SAS,L 98-109,240,40,80,.500,38,74,.514,2,6,.333,16,20,.800,98
19604,2011-03-19,SAS,,CHA,W 109-98,240,39,74,.527,22,40,.550,17,34,.500,14,24,.583,109
19605,2011-03-18,ATL,,MIA,L 85-106,240,35,79,.443,32,67,.478,3,12,.250,12,22,.545,85
19606,2011-03-18,MIA,@,ATL,W 106-85,240,38,71,.535,27,49,.551,11,22,.500,19,26,.731,106
19607,2011-03-18,DAL,,SAS,L 91-97,240,36,73,.493,30,50,.600,6,23,.261,13,17,.765,91
19608,2011-03-18,SAS,@,DAL,W 97-91,240,36,83,.434,29,66,.439,7,17,.412,18,19,.947,97
19609,2011-03-18,DET,,NYK,W 99-95,240,40,84,.476,35,71,.493,5,13,.385,14,21,.667,99
19610,2011-03-18,NYK,@,DET,L 95-99,240,37,81,.457,25,50,.500,12,31,.387,9,11,.818,95
19611,2011-03-18,BOS,@,HOU,L 77-93,240,30,71,.423,29,61,.475,1,10,.100,16,25,.640,77
19612,2011-03-18,HOU,,BOS,W 93-77,240,32,73,.438,24,51,.471,8,22,.364,21,23,.913,93
19613,2011-03-18,CHI,@,IND,L 108-115 (OT),265,35,86,.407,29,59,.492,6,27,.222,32,42,.762,108
19614,2011-03-18,IND,,CHI,W 115-108 (OT),265,40,93,.430,35,80,.438,5,13,.385,30,35,.857,115
19615,2011-03-18,LAL,,MIN,W 106-98,240,40,84,.476,32,65,.492,8,19,.421,18,23,.783,106
19616,2011-03-18,MIN,@,LAL,L 98-106,240,39,88,.443,32,67,.478,7,21,.333,13,18,.722,98
19617,2011-03-18,MIL,,NJN,W 110-95,240,46,81,.568,36,64,.563,10,17,.588,8,9,.889,110
19618,2011-03-18,BRK,@,MIL,L 95-110,240,35,79,.443,27,56,.482,8,23,.348,17,24,.708,95
19619,2011-03-18,CHA,@,OKC,L 82-99,240,33,74,.446,28,57,.491,5,17,.294,11,18,.611,82
19620,2011-03-18,OKC,,CHA,W 99-82,240,38,72,.528,31,54,.574,7,18,.389,16,22,.727,99
19621,2011-03-18,DEN,@,ORL,L 82-85,240,28,78,.359,22,55,.400,6,23,.261,20,24,.833,82
19622,2011-03-18,ORL,,DEN,W 85-82,240,28,75,.373,19,50,.380,9,25,.360,20,31,.645,85
19623,2011-03-18,GSW,@,PHO,L 97-108,240,35,83,.422,29,64,.453,6,19,.316,21,27,.778,97
19624,2011-03-18,PHO,,GSW,W 108-97,240,38,86,.442,30,61,.492,8,25,.320,24,30,.800,108
19625,2011-03-18,PHI,@,SAC,W 102-80,240,44,99,.444,37,83,.446,7,16,.438,7,12,.583,102
19626,2011-03-18,SAC,,PHI,L 80-102,240,29,84,.345,24,62,.387,5,22,.227,17,28,.607,80
19627,2011-03-18,TOR,,WAS,W 116-107,240,38,76,.500,31,59,.525,7,17,.412,33,41,.805,116
19628,2011-03-18,WAS,@,TOR,L 107-116,240,41,86,.477,39,76,.513,2,10,.200,23,33,.697,107
19629,2011-03-17,CHI,@,NJN,W 84-73,240,33,81,.407,29,61,.475,4,20,.200,14,22,.636,84
19630,2011-03-17,BRK,,CHI,L 73-84,240,29,83,.349,26,64,.406,3,19,.158,12,18,.667,73
19631,2011-03-17,MEM,@,NYK,L 99-120,240,35,76,.461,31,64,.484,4,12,.333,25,30,.833,99
19632,2011-03-17,NYK,,MEM,W 120-99,240,41,79,.519,21,43,.488,20,36,.556,18,21,.857,120
19633,2011-03-17,CLE,@,POR,L 70-111,240,21,59,.356,18,44,.409,3,15,.200,25,30,.833,70
19634,2011-03-17,POR,,CLE,W 111-70,240,45,83,.542,34,56,.607,11,27,.407,10,13,.769,111
19635,2011-03-16,ATL,,DEN,L 87-102,240,34,82,.415,29,63,.460,5,19,.263,14,18,.778,87
19636,2011-03-16,DEN,@,ATL,W 102-87,240,39,73,.534,32,59,.542,7,14,.500,17,24,.708,102
19637,2011-03-16,BOS,,IND,W 92-80,240,30,64,.469,24,54,.444,6,10,.600,26,33,.788,92
19638,2011-03-16,IND,@,BOS,L 80-92,240,33,88,.375,28,74,.378,5,14,.357,9,13,.692,80
19639,2011-03-16,DET,,TOR,W 107-93,240,42,81,.519,34,60,.567,8,21,.381,15,23,.652,107
19640,2011-03-16,TOR,@,DET,L 93-107,240,39,78,.500,36,69,.522,3,9,.333,12,16,.750,93
19641,2011-03-16,DAL,@,GSW,W 112-106,240,40,77,.519,32,58,.552,8,19,.421,24,27,.889,112
19642,2011-03-16,GSW,,DAL,L 106-112,240,42,82,.512,33,58,.569,9,24,.375,13,19,.684,106
19643,2011-03-16,CHA,@,HOU,L 78-94,240,29,78,.372,27,67,.403,2,11,.182,18,21,.857,78
19644,2011-03-16,HOU,,CHA,W 94-78,240,36,87,.414,28,64,.438,8,23,.348,14,16,.875,94
19645,2011-03-16,LAC,,PHI,L 94-104,240,36,79,.456,32,66,.485,4,13,.308,18,34,.529,94
19646,2011-03-16,PHI,@,LAC,W 104-94,240,38,84,.452,30,67,.448,8,17,.471,20,24,.833,104
19647,2011-03-16,MIA,,OKC,L 85-96,240,30,78,.385,27,61,.443,3,17,.176,22,28,.786,85
19648,2011-03-16,OKC,@,MIA,W 96-85,240,35,88,.398,26,68,.382,9,20,.450,17,22,.773,96
19649,2011-03-16,MIL,,ORL,L 89-93 (OT),265,35,83,.422,29,60,.483,6,23,.261,13,17,.765,89
19650,2011-03-16,ORL,@,MIL,W 93-89 (OT),265,33,76,.434,26,49,.531,7,27,.259,20,35,.571,93
19651,2011-03-16,NOP,,PHO,W 100-95,240,38,80,.475,32,63,.508,6,17,.353,18,23,.783,100
19652,2011-03-16,PHO,@,NOH,L 95-100,240,35,81,.432,21,47,.447,14,34,.412,11,13,.846,95
19653,2011-03-16,CLE,@,SAC,W 97-93,240,38,74,.514,36,65,.554,2,9,.222,19,30,.633,97
19654,2011-03-16,SAC,,CLE,L 93-97,240,38,100,.380,29,77,.377,9,23,.391,8,13,.615,93
19655,2011-03-16,MIN,@,UTA,L 104-119,240,37,88,.420,31,68,.456,6,20,.300,24,32,.750,104
19656,2011-03-16,UTA,,MIN,W 119-104,240,46,84,.548,39,65,.600,7,19,.368,20,28,.714,119
19657,2011-03-15,ATL,,MIL,W 110-85,240,46,73,.630,35,54,.648,11,19,.579,7,8,.875,110
19658,2011-03-15,MIL,@,ATL,L 85-110,240,36,86,.419,33,76,.434,3,10,.300,10,13,.769,85
19659,2011-03-15,CHI,,WAS,W 98-79,240,36,90,.400,24,58,.414,12,32,.375,14,23,.609,98
19660,2011-03-15,WAS,@,CHI,L 79-98,240,31,72,.431,27,59,.458,4,13,.308,13,21,.619,79
19661,2011-03-15,IND,,NYK,W 119-117,240,46,88,.523,42,77,.545,4,11,.364,23,30,.767,119
19662,2011-03-15,NYK,@,IND,L 117-119,240,40,89,.449,27,62,.435,13,27,.481,24,30,.800,117
19663,2011-03-15,DAL,@,POR,L 101-104,240,40,67,.597,31,46,.674,9,21,.429,12,13,.923,101
19664,2011-03-15,POR,,DAL,W 104-101,240,40,85,.471,34,71,.479,6,14,.429,18,23,.783,104
19665,2011-03-14,HOU,,PHO,W 95-93,240,35,85,.412,29,66,.439,6,19,.316,19,25,.760,95
19666,2011-03-14,PHO,@,HOU,L 93-95,240,40,88,.455,35,73,.479,5,15,.333,8,11,.727,93
19667,2011-03-14,LAL,,ORL,W 97-84,240,39,89,.438,33,70,.471,6,19,.316,13,19,.684,97
19668,2011-03-14,ORL,@,LAL,L 84-97,240,32,68,.471,22,45,.489,10,23,.435,10,19,.526,84
19669,2011-03-14,LAC,@,MEM,L 82-105,240,32,80,.400,28,63,.444,4,17,.235,14,19,.737,82
19670,2011-03-14,MEM,,LAC,W 105-82,240,45,84,.536,39,72,.542,6,12,.500,9,13,.692,105
19671,2011-03-14,MIA,,SAS,W 110-80,240,42,78,.538,39,69,.565,3,9,.333,23,24,.958,110
19672,2011-03-14,SAS,@,MIA,L 80-110,240,31,81,.383,25,59,.424,6,22,.273,12,19,.632,80
19673,2011-03-14,BOS,@,NJN,L 79-88,240,35,85,.412,33,75,.440,2,10,.200,7,8,.875,79
19674,2011-03-14,BRK,,BOS,W 88-79,240,31,78,.397,20,53,.377,11,25,.440,15,24,.625,88
19675,2011-03-14,DEN,@,NOH,W 114-103,240,40,75,.533,23,46,.500,17,29,.586,17,22,.773,114
19676,2011-03-14,NOP,,DEN,L 103-114,240,40,85,.471,30,63,.476,10,22,.455,13,17,.765,103
19677,2011-03-14,GSW,@,SAC,L 119-129,240,43,86,.500,32,60,.533,11,26,.423,22,33,.667,119
19678,2011-03-14,SAC,,GSW,W 129-119,240,47,83,.566,39,66,.591,8,17,.471,27,33,.818,129
19679,2011-03-14,PHI,@,UTA,L 107-112 (OT),265,41,97,.423,33,76,.434,8,21,.381,17,20,.850,107
19680,2011-03-14,UTA,,PHI,W 112-107 (OT),265,40,86,.465,35,71,.493,5,15,.333,27,31,.871,112
19681,2011-03-14,OKC,@,WAS,W 116-89,240,42,86,.488,30,65,.462,12,21,.571,20,21,.952,116
19682,2011-03-14,WAS,,OKC,L 89-116,240,37,94,.394,37,85,.435,0,9,.000,15,23,.652,89
19683,2011-03-13,BOS,,MIL,W 87-56,240,33,72,.458,31,67,.463,2,5,.400,19,24,.792,87
19684,2011-03-13,MIL,@,BOS,L 56-87,240,22,70,.314,19,56,.339,3,14,.214,9,15,.600,56
19685,2011-03-13,CLE,,OKC,L 75-95,240,27,80,.338,22,66,.333,5,14,.357,16,26,.615,75
19686,2011-03-13,OKC,@,CLE,W 95-75,240,38,84,.452,31,61,.508,7,23,.304,12,14,.857,95
19687,2011-03-13,GSW,,MIN,W 100-77,240,38,87,.437,31,66,.470,7,21,.333,17,22,.773,100
19688,2011-03-13,MIN,@,GSW,L 77-100,240,26,71,.366,19,54,.352,7,17,.412,18,29,.621,77
19689,2011-03-13,IND,@,NYK,W 106-93,240,40,70,.571,35,58,.603,5,12,.417,21,27,.778,106
19690,2011-03-13,NYK,,IND,L 93-106,240,30,82,.366,23,52,.442,7,30,.233,26,34,.765,93
19691,2011-03-13,ORL,@,PHO,W 111-88,240,39,86,.453,31,62,.500,8,24,.333,25,36,.694,111
19692,2011-03-13,PHO,,ORL,L 88-111,240,31,80,.388,27,65,.415,4,15,.267,22,32,.688,88
19693,2011-03-13,CHA,@,TOR,W 95-90,240,35,68,.515,30,56,.536,5,12,.417,20,24,.833,95
19694,2011-03-13,TOR,,CHA,L 90-95,240,33,79,.418,29,62,.468,4,17,.235,20,31,.645,90
19695,2011-03-12,ATL,,POR,W 91-82,240,40,77,.519,34,63,.540,6,14,.429,5,10,.500,91
19696,2011-03-12,POR,@,ATL,L 82-91,240,27,77,.351,20,55,.364,7,22,.318,21,25,.840,82
19697,2011-03-12,CHI,,UTA,W 118-100,240,41,78,.526,23,46,.500,18,32,.563,18,28,.643,118
19698,2011-03-12,UTA,@,CHI,L 100-118,240,33,78,.423,29,68,.426,4,10,.400,30,35,.857,100
19699,2011-03-12,DAL,,LAL,L 91-96,240,37,86,.430,33,70,.471,4,16,.250,13,15,.867,91
19700,2011-03-12,LAL,@,DAL,W 96-91,240,37,83,.446,32,70,.457,5,13,.385,17,27,.630,96
19701,2011-03-12,DEN,,DET,W 131-101,240,46,82,.561,28,45,.622,18,37,.486,21,29,.724,131
19702,2011-03-12,DET,@,DEN,L 101-131,240,44,88,.500,38,72,.528,6,16,.375,7,7,1.000,101
19703,2011-03-12,HOU,,SAS,L 107-115,240,38,79,.481,29,57,.509,9,22,.409,22,25,.880,107
19704,2011-03-12,SAS,@,HOU,W 115-107,240,41,86,.477,35,69,.507,6,17,.353,27,34,.794,115
19705,2011-03-12,MEM,@,MIA,L 85-118,240,33,84,.393,32,74,.432,1,10,.100,18,25,.720,85
19706,2011-03-12,MIA,,MEM,W 118-85,240,40,69,.580,28,50,.560,12,19,.632,26,30,.867,118
19707,2011-03-12,MIL,,PHI,W 102-74,240,40,76,.526,31,59,.525,9,17,.529,13,19,.684,102
19708,2011-03-12,PHI,@,MIL,L 74-102,240,31,78,.397,25,62,.403,6,16,.375,6,8,.750,74
19709,2011-03-12,NOP,,SAC,W 115-103,240,42,81,.519,39,68,.574,3,13,.231,28,34,.824,115
19710,2011-03-12,SAC,@,NOH,L 103-115,240,40,84,.476,37,74,.500,3,10,.300,20,26,.769,103
19711,2011-03-12,LAC,@,WAS,W 122-101,240,43,83,.518,38,69,.551,5,14,.357,31,43,.721,122
19712,2011-03-12,WAS,,LAC,L 101-122,240,37,89,.416,34,73,.466,3,16,.188,24,29,.828,101
19713,2011-03-11,CHA,,POR,W 97-92,240,33,77,.429,28,65,.431,5,12,.417,26,30,.867,97
19714,2011-03-11,POR,@,CHA,L 92-97,240,37,82,.451,28,55,.509,9,27,.333,9,16,.563,92
19715,2011-03-11,ATL,@,CHI,L 76-94,240,31,72,.431,26,58,.448,5,14,.357,9,15,.600,76
19716,2011-03-11,CHI,,ATL,W 94-76,240,36,80,.450,32,60,.533,4,20,.200,18,19,.947,94
19717,2011-03-11,GSW,,ORL,W 123-120 (OT),265,46,93,.495,25,58,.431,21,35,.600,10,13,.769,123
19718,2011-03-11,ORL,@,GSW,L 120-123 (OT),265,40,84,.476,25,52,.481,15,32,.469,25,35,.714,120
19719,2011-03-11,MIN,,UTA,W 122-101,240,46,84,.548,36,67,.537,10,17,.588,20,25,.800,122
19720,2011-03-11,UTA,@,MIN,L 101-122,240,37,74,.500,27,59,.458,10,15,.667,17,27,.630,101
19721,2011-03-11,LAC,@,NJN,L 98-102 (OT),265,41,91,.451,37,74,.500,4,17,.235,12,20,.600,98
19722,2011-03-11,BRK,,LAC,W 102-98 (OT),265,42,88,.477,34,66,.515,8,22,.364,10,16,.625,102
19723,2011-03-11,DET,@,OKC,L 94-104,240,38,78,.487,32,66,.485,6,12,.500,12,17,.706,94
19724,2011-03-11,OKC,,DET,W 104-94,240,36,72,.500,27,54,.500,9,18,.500,23,27,.852,104
19725,2011-03-11,BOS,@,PHI,L 86-89,240,33,79,.418,30,68,.441,3,11,.273,17,20,.850,86
19726,2011-03-11,PHI,,BOS,W 89-86,240,33,80,.413,28,67,.418,5,13,.385,18,25,.720,89
19727,2011-03-11,SAC,@,SAS,L 103-108,240,40,88,.455,31,63,.492,9,25,.360,14,15,.933,103
19728,2011-03-11,SAS,,SAC,W 108-103,240,40,81,.494,32,63,.508,8,18,.444,20,25,.800,108
19729,2011-03-11,IND,@,TOR,L 98-108,240,35,78,.449,28,63,.444,7,15,.467,21,27,.778,98
19730,2011-03-11,TOR,,IND,W 108-98,240,43,81,.531,39,65,.600,4,16,.250,18,30,.600,108
19731,2011-03-10,DAL,,NYK,W 127-109,240,48,94,.511,37,70,.529,11,24,.458,20,24,.833,127
19732,2011-03-10,NYK,@,DAL,L 109-127,240,34,80,.425,28,62,.452,6,18,.333,35,37,.946,109
19733,2011-03-10,LAL,@,MIA,L 88-94,240,30,75,.400,23,59,.390,7,16,.438,21,26,.808,88
19734,2011-03-10,MIA,,LAL,W 94-88,240,37,81,.457,29,62,.468,8,19,.421,12,18,.667,94
19735,2011-03-10,DEN,@,PHO,W 116-97,240,46,89,.517,39,69,.565,7,20,.350,17,26,.654,116
19736,2011-03-10,PHO,,DEN,L 97-116,240,37,90,.411,32,68,.471,5,22,.227,18,25,.720,97
19737,2011-03-09,BOS,,LAC,L 103-108,240,37,84,.440,31,67,.463,6,17,.353,23,27,.852,103
19738,2011-03-09,LAC,@,BOS,W 108-103,240,39,75,.520,30,55,.545,9,20,.450,21,26,.808,108
19739,2011-03-09,CHA,,CHI,L 84-101,240,37,81,.457,34,70,.486,3,11,.273,7,11,.636,84
19740,2011-03-09,CHI,@,CHA,W 101-84,240,38,75,.507,27,52,.519,11,23,.478,14,19,.737,101
19741,2011-03-09,MEM,,NYK,L 108-110,240,36,67,.537,33,62,.532,3,5,.600,33,35,.943,108
19742,2011-03-09,NYK,@,MEM,W 110-108,240,47,88,.534,35,65,.538,12,23,.522,4,4,1.000,110
19743,2011-03-09,CLE,@,MIL,L 90-110,240,36,78,.462,31,66,.470,5,12,.417,13,15,.867,90
19744,2011-03-09,MIL,,CLE,W 110-90,240,43,78,.551,37,67,.552,6,11,.545,18,24,.750,110
19745,2011-03-09,IND,@,MIN,L 75-101,240,24,81,.296,20,58,.345,4,23,.174,23,34,.676,75
19746,2011-03-09,MIN,,IND,W 101-75,240,35,91,.385,30,73,.411,5,18,.278,26,35,.743,101
19747,2011-03-09,GSW,@,NJN,L 90-94,240,37,84,.440,31,70,.443,6,14,.429,10,15,.667,90
19748,2011-03-09,BRK,,GSW,W 94-90,240,38,87,.437,32,69,.464,6,18,.333,12,16,.750,94
19749,2011-03-09,DAL,@,NOH,L 92-93,240,31,69,.449,25,48,.521,6,21,.286,24,32,.750,92
19750,2011-03-09,NOP,,DAL,W 93-92,240,34,78,.436,30,66,.455,4,12,.333,21,29,.724,93
19751,2011-03-09,OKC,@,PHI,W 110-105 (OT),265,46,92,.500,40,74,.541,6,18,.333,12,16,.750,110
19752,2011-03-09,PHI,,OKC,L 105-110 (OT),265,39,93,.419,29,69,.420,10,24,.417,17,21,.810,105
19753,2011-03-09,ORL,@,SAC,W 106-102,240,39,79,.494,29,56,.518,10,23,.435,18,32,.563,106
19754,2011-03-09,SAC,,ORL,L 102-106,240,34,83,.410,29,69,.420,5,14,.357,29,39,.744,102
19755,2011-03-09,DET,@,SAS,L 104-111,240,42,93,.452,36,80,.450,6,13,.462,14,20,.700,104
19756,2011-03-09,SAS,,DET,W 111-104,240,45,70,.643,39,54,.722,6,16,.375,15,20,.750,111
19757,2011-03-09,TOR,,UTA,L 94-96,240,36,79,.456,32,70,.457,4,9,.444,18,24,.750,94
19758,2011-03-09,UTA,@,TOR,W 96-94,240,40,85,.471,34,67,.507,6,18,.333,10,14,.714,96
19759,2011-03-08,ATL,,LAL,L 87-101,240,33,83,.398,26,61,.426,7,22,.318,14,17,.824,87
19760,2011-03-08,LAL,@,ATL,W 101-87,240,39,79,.494,34,67,.507,5,12,.417,18,21,.857,101
19761,2011-03-08,CLE,,GSW,L 85-95,240,31,85,.365,27,67,.403,4,18,.222,19,23,.826,85
19762,2011-03-08,GSW,@,CLE,W 95-85,240,39,86,.453,31,68,.456,8,18,.444,9,10,.900,95
19763,2011-03-08,IND,,PHI,L 100-110,240,35,72,.486,32,61,.525,3,11,.273,27,31,.871,100
19764,2011-03-08,PHI,@,IND,W 110-100,240,47,92,.511,41,76,.539,6,16,.375,10,15,.667,110
19765,2011-03-08,MIA,,POR,L 96-105,240,37,72,.514,30,50,.600,7,22,.318,15,19,.789,96
19766,2011-03-08,POR,@,MIA,W 105-96,240,40,79,.506,33,62,.532,7,17,.412,18,19,.947,105
19767,2011-03-08,HOU,@,PHO,L 110-113,240,39,85,.459,31,66,.470,8,19,.421,24,32,.750,110
19768,2011-03-08,PHO,,HOU,W 113-110,240,44,81,.543,37,68,.544,7,13,.538,18,25,.720,113
19769,2011-03-08,MIL,@,WAS,W 95-76,240,36,82,.439,27,59,.458,9,23,.391,14,18,.778,95
19770,2011-03-08,WAS,,MIL,L 76-95,240,32,85,.376,30,73,.411,2,12,.167,10,19,.526,76
19771,2011-03-07,CHA,,LAC,L 87-92,240,35,78,.449,31,69,.449,4,9,.444,13,22,.591,87
19772,2011-03-07,LAC,@,CHA,W 92-87,240,31,74,.419,24,56,.429,7,18,.389,23,29,.793,92
19773,2011-03-07,CHI,,NOH,W 85-77,240,31,81,.383,27,61,.443,4,20,.200,19,22,.864,85
19774,2011-03-07,NOP,@,CHI,L 77-85,240,29,80,.363,25,67,.373,4,13,.308,15,18,.833,77
19775,2011-03-07,MEM,,OKC,W 107-101,240,44,85,.518,42,73,.575,2,12,.167,17,26,.654,107
19776,2011-03-07,OKC,@,MEM,L 101-107,240,42,81,.519,36,63,.571,6,18,.333,11,18,.611,101
19777,2011-03-07,DAL,@,MIN,W 108-105,240,38,84,.452,26,49,.531,12,35,.343,20,22,.909,108
19778,2011-03-07,MIN,,DAL,L 105-108,240,39,88,.443,28,65,.431,11,23,.478,16,26,.615,105
19779,2011-03-07,NYK,,UTA,W 131-109,240,46,82,.561,33,56,.589,13,26,.500,26,29,.897,131
19780,2011-03-07,UTA,@,NYK,L 109-131,240,41,91,.451,36,72,.500,5,19,.263,22,26,.846,109
19781,2011-03-07,ORL,,POR,L 85-89,240,33,71,.465,22,49,.449,11,22,.500,8,9,.889,85
19782,2011-03-07,POR,@,ORL,W 89-85,240,35,81,.432,27,56,.482,8,25,.320,11,17,.647,89
19783,2011-03-07,HOU,@,SAC,W 123-101,240,44,83,.530,35,60,.583,9,23,.391,26,27,.963,123
19784,2011-03-07,SAC,,HOU,L 101-123,240,45,95,.474,43,89,.483,2,6,.333,9,11,.818,101
19785,2011-03-06,ATL,,NYK,L 79-92,240,33,74,.446,27,57,.474,6,17,.353,7,9,.778,79
19786,2011-03-06,NYK,@,ATL,W 92-79,240,36,77,.468,26,54,.481,10,23,.435,10,15,.667,92
19787,2011-03-06,CLE,,NOH,L 81-96,240,28,76,.368,22,58,.379,6,18,.333,19,27,.704,81
19788,2011-03-06,NOP,@,CLE,W 96-81,240,39,75,.520,36,65,.554,3,10,.300,15,18,.833,96
19789,2011-03-06,DAL,,MEM,L 103-104,240,37,73,.507,27,52,.519,10,21,.476,19,23,.826,103
19790,2011-03-06,MEM,@,DAL,W 104-103,240,41,87,.471,38,72,.528,3,15,.200,19,24,.792,104
19791,2011-03-06,DET,,WAS,W 113-102,240,47,91,.516,40,73,.548,7,18,.389,12,14,.857,113
19792,2011-03-06,WAS,@,DET,L 102-113,240,36,82,.439,32,66,.485,4,16,.250,26,34,.765,102
19793,2011-03-06,CHI,@,MIA,W 87-86,240,34,74,.459,31,60,.517,3,14,.214,16,20,.800,87
19794,2011-03-06,MIA,,CHI,L 86-87,240,33,68,.485,30,59,.508,3,9,.333,17,23,.739,86
19795,2011-03-06,BOS,@,MIL,W 89-83,240,35,68,.515,30,58,.517,5,10,.500,14,15,.933,89
19796,2011-03-06,MIL,,BOS,L 83-89,240,33,80,.413,25,59,.424,8,21,.381,9,13,.692,83
19797,2011-03-06,OKC,,PHO,W 122-118 (OT),265,39,80,.488,32,61,.525,7,19,.368,37,47,.787,122
19798,2011-03-06,PHO,@,OKC,L 118-122 (OT),265,48,101,.475,34,70,.486,14,31,.452,8,14,.571,118
19799,2011-03-06,GSW,@,PHI,L 117-125 (OT),265,48,98,.490,44,79,.557,4,19,.211,17,18,.944,117
19800,2011-03-06,PHI,,GSW,W 125-117 (OT),265,48,97,.495,45,85,.529,3,12,.250,26,31,.839,125
19801,2011-03-06,LAL,@,SAS,W 99-83,240,42,90,.467,34,67,.507,8,23,.348,7,10,.700,99
19802,2011-03-06,SAS,,LAL,L 83-99,240,31,86,.360,24,65,.369,7,21,.333,14,19,.737,83
19803,2011-03-05,HOU,,IND,W 112-95,240,44,98,.449,37,77,.481,7,21,.333,17,22,.773,112
19804,2011-03-05,IND,@,HOU,L 95-112,240,38,92,.413,37,87,.425,1,5,.200,18,22,.818,95
19805,2011-03-05,DEN,@,LAC,L 94-100,240,40,102,.392,37,88,.420,3,14,.214,11,18,.611,94
19806,2011-03-05,LAC,,DEN,W 100-94,240,35,74,.473,27,55,.491,8,19,.421,22,27,.815,100
19807,2011-03-05,BRK,,TOR,W 137-136 (3OT),315,48,105,.457,36,76,.474,12,29,.414,29,39,.744,137
19808,2011-03-05,TOR,@,NJN,L 136-137 (3OT),315,47,111,.423,37,91,.407,10,20,.500,32,36,.889,136
19809,2011-03-05,CHA,@,POR,L 69-93,240,29,68,.426,28,58,.483,1,10,.100,10,13,.769,69
19810,2011-03-05,POR,,CHA,W 93-69,240,32,74,.432,24,53,.453,8,21,.381,21,25,.840,93
19811,2011-03-05,SAC,@,UTA,L 102-109 (OT),265,38,93,.409,31,79,.392,7,14,.500,19,30,.633,102
19812,2011-03-05,UTA,,SAC,W 109-102 (OT),265,40,88,.455,36,78,.462,4,10,.400,25,33,.758,109
19813,2011-03-05,MIN,@,WAS,L 96-103,240,40,90,.444,36,76,.474,4,14,.286,12,18,.667,96
19814,2011-03-05,WAS,,MIN,W 103-96,240,39,91,.429,31,73,.425,8,18,.444,17,28,.607,103
19815,2011-03-04,ATL,,OKC,L 104-111,240,39,82,.476,33,65,.508,6,17,.353,20,25,.800,104
19816,2011-03-04,OKC,@,ATL,W 111-104,240,42,83,.506,35,65,.538,7,18,.389,20,21,.952,111
19817,2011-03-04,BOS,,GSW,W 107-103,240,39,73,.534,32,55,.582,7,18,.389,22,24,.917,107
19818,2011-03-04,GSW,@,BOS,L 103-107,240,40,84,.476,35,65,.538,5,19,.263,18,21,.857,103
19819,2011-03-04,DAL,,IND,W 116-108,240,41,79,.519,34,60,.567,7,19,.368,27,34,.794,116
19820,2011-03-04,IND,@,DAL,L 108-116,240,38,78,.487,29,59,.492,9,19,.474,23,28,.821,108
19821,2011-03-04,CHA,@,LAL,L 84-92,240,37,93,.398,36,83,.434,1,10,.100,9,9,1.000,84
19822,2011-03-04,LAL,,CHA,W 92-84,240,34,89,.382,29,64,.453,5,25,.200,19,21,.905,92
19823,2011-03-04,MEM,,NOH,L 91-98,240,34,77,.442,27,55,.491,7,22,.318,16,23,.696,91
19824,2011-03-04,NOP,@,MEM,W 98-91,240,36,72,.500,30,61,.492,6,11,.545,20,24,.833,98
19825,2011-03-04,MIL,,PHO,L 88-102,240,35,84,.417,32,69,.464,3,15,.200,15,17,.882,88
19826,2011-03-04,PHO,@,MIL,W 102-88,240,38,76,.500,27,52,.519,11,24,.458,15,20,.750,102
19827,2011-03-04,BRK,,TOR,W 116-103,240,45,81,.556,38,63,.603,7,18,.389,19,25,.760,116
19828,2011-03-04,TOR,@,NJN,L 103-116,240,41,85,.482,39,75,.520,2,10,.200,19,24,.792,103
19829,2011-03-04,CLE,@,NYK,W 119-115,240,43,86,.500,31,65,.477,12,21,.571,21,29,.724,119
19830,2011-03-04,NYK,,CLE,L 115-119,240,42,77,.545,34,59,.576,8,18,.444,23,30,.767,115
19831,2011-03-04,CHI,@,ORL,W 89-81,240,34,83,.410,27,64,.422,7,19,.368,14,22,.636,89
19832,2011-03-04,ORL,,CHI,L 81-89,240,31,70,.443,25,47,.532,6,23,.261,13,23,.565,81
19833,2011-03-04,MIN,@,PHI,L 100-111,240,43,91,.473,39,78,.500,4,13,.308,10,11,.909,100
19834,2011-03-04,PHI,,MIN,W 111-100,240,44,84,.524,40,71,.563,4,13,.308,19,23,.826,111
19835,2011-03-04,MIA,@,SAS,L 95-125,240,37,78,.474,30,58,.517,7,20,.350,14,20,.700,95
19836,2011-03-04,SAS,,MIA,W 125-95,240,46,82,.561,29,54,.537,17,28,.607,16,23,.696,125
19837,2011-03-03,MIA,,ORL,L 96-99,240,35,75,.467,32,58,.552,3,17,.176,23,30,.767,96
19838,2011-03-03,ORL,@,MIA,W 99-96,240,34,71,.479,18,42,.429,16,29,.552,15,18,.833,99
19839,2011-03-03,DEN,@,UTA,W 103-101,240,37,78,.474,31,61,.508,6,17,.353,23,33,.697,103
19840,2011-03-03,UTA,,DEN,L 101-103,240,43,83,.518,38,70,.543,5,13,.385,10,12,.833,101
19841,2011-03-02,ATL,,CHI,W 83-80,240,33,82,.402,28,70,.400,5,12,.417,12,17,.706,83
19842,2011-03-02,CHI,@,ATL,L 80-83,240,30,73,.411,23,53,.434,7,20,.350,13,21,.619,80
19843,2011-03-02,BOS,,PHO,W 115-103,240,44,82,.537,40,70,.571,4,12,.333,23,34,.676,115
19844,2011-03-02,PHO,@,BOS,L 103-115,240,33,77,.429,21,54,.389,12,23,.522,25,33,.758,103
19845,2011-03-02,CLE,,SAS,L 99-109,240,36,91,.396,30,78,.385,6,13,.462,21,28,.750,99
19846,2011-03-02,SAS,@,CLE,W 109-99,240,44,83,.530,38,64,.594,6,19,.316,15,18,.833,109
19847,2011-03-02,CHA,@,DEN,L 80-120,240,29,79,.367,25,62,.403,4,17,.235,18,23,.783,80
19848,2011-03-02,DEN,,CHA,W 120-80,240,45,74,.608,37,53,.698,8,21,.381,22,27,.815,120
19849,2011-03-02,DET,,MIN,L 105-116,240,39,89,.438,34,64,.531,5,25,.200,22,31,.710,105
19850,2011-03-02,MIN,@,DET,W 116-105,240,40,76,.526,33,60,.550,7,16,.438,29,37,.784,116
19851,2011-03-02,HOU,@,LAC,L 103-106,240,38,91,.418,25,60,.417,13,31,.419,14,19,.737,103
19852,2011-03-02,LAC,,HOU,W 106-103,240,41,85,.482,39,76,.513,2,9,.222,22,27,.815,106
19853,2011-03-02,NOP,@,NYK,L 88-107,240,33,71,.465,30,57,.526,3,14,.214,19,26,.731,88
19854,2011-03-02,NYK,,NOH,W 107-88,240,42,77,.545,32,55,.582,10,22,.455,13,20,.650,107
19855,2011-03-02,IND,@,OKC,L 89-113,240,28,82,.341,25,69,.362,3,13,.231,30,39,.769,89
19856,2011-03-02,OKC,,IND,W 113-89,240,38,79,.481,29,59,.492,9,20,.450,28,34,.824,113
19857,2011-03-02,POR,@,SAC,W 107-102,240,40,87,.460,34,74,.459,6,13,.462,21,25,.840,107
19858,2011-03-02,SAC,,POR,L 102-107,240,42,79,.532,37,65,.569,5,14,.357,13,17,.765,102
19859,2011-03-02,GSW,@,WAS,W 106-102,240,36,85,.424,29,65,.446,7,20,.350,27,34,.794,106
19860,2011-03-02,WAS,,GSW,L 102-106,240,36,89,.404,32,73,.438,4,16,.250,26,36,.722,102
19861,2011-03-01,GSW,@,IND,L 100-109,240,38,89,.427,27,62,.435,11,27,.407,13,18,.722,100
19862,2011-03-01,IND,,GSW,W 109-100,240,37,87,.425,34,71,.479,3,16,.188,32,36,.889,109
19863,2011-03-01,MEM,,SAS,W 109-93,240,47,89,.528,47,84,.560,0,5,.000,15,16,.938,109
19864,2011-03-01,SAS,@,MEM,L 93-109,240,34,77,.442,26,51,.510,8,26,.308,17,23,.739,93
19865,2011-03-01,DET,@,MIL,L 90-92,240,36,89,.404,32,73,.438,4,16,.250,14,20,.700,90
19866,2011-03-01,MIL,,DET,W 92-90,240,35,83,.422,26,60,.433,9,23,.391,13,23,.565,92
19867,2011-03-01,LAL,@,MIN,W 90-79,240,30,80,.375,25,65,.385,5,15,.333,25,27,.926,90
19868,2011-03-01,MIN,,LAL,L 79-90,240,31,78,.397,27,62,.435,4,16,.250,13,16,.813,79
19869,2011-03-01,NYK,@,ORL,L 110-116,240,32,86,.372,25,56,.446,7,30,.233,39,47,.830,110
19870,2011-03-01,ORL,,NYK,W 116-110,240,36,69,.522,28,51,.549,8,18,.444,36,50,.720,116
19871,2011-03-01,DAL,@,PHI,W 101-93,240,41,77,.532,35,59,.593,6,18,.333,13,24,.542,101
19872,2011-03-01,PHI,,DAL,L 93-101,240,36,81,.444,29,62,.468,7,19,.368,14,24,.583,93
19873,2011-03-01,HOU,@,POR,W 103-87,240,44,76,.579,36,54,.667,8,22,.364,7,11,.636,103
19874,2011-03-01,POR,,HOU,L 87-103,240,32,74,.432,25,58,.431,7,16,.438,16,20,.800,87
19875,2011-03-01,NOP,@,TOR,L 90-96,240,36,82,.439,30,69,.435,6,13,.462,12,15,.800,90
19876,2011-03-01,TOR,,NOH,W 96-90,240,39,79,.494,35,69,.507,4,10,.400,14,15,.933,96
19877,2011-02-28,ATL,@,DEN,L 90-100,240,34,85,.400,32,66,.485,2,19,.105,20,25,.800,90
19878,2011-02-28,DEN,,ATL,W 100-90,240,40,82,.488,37,68,.544,3,14,.214,17,24,.708,100
19879,2011-02-28,BRK,,PHO,L 103-104 (OT),265,42,89,.472,35,68,.515,7,21,.333,12,16,.750,103
19880,2011-02-28,PHO,@,NJN,W 104-103 (OT),265,42,92,.457,33,67,.493,9,25,.360,11,13,.846,104
19881,2011-02-28,LAC,@,SAC,L 99-105,240,37,81,.457,31,64,.484,6,17,.353,19,27,.704,99
19882,2011-02-28,SAC,,LAC,W 105-99,240,38,80,.475,33,62,.532,5,18,.278,24,35,.686,105
19883,2011-02-28,BOS,@,UTA,W 107-102,240,39,82,.476,32,67,.478,7,15,.467,22,25,.880,107
19884,2011-02-28,UTA,,BOS,L 102-107,240,35,78,.449,34,71,.479,1,7,.143,31,37,.838,102
19885,2011-02-28,CHI,@,WAS,W 105-77,240,39,81,.481,31,58,.534,8,23,.348,19,22,.864,105
19886,2011-02-28,WAS,,CHI,L 77-105,240,31,87,.356,27,74,.365,4,13,.308,11,14,.786,77
19887,2011-02-27,CLE,,PHI,L 91-95,240,33,79,.418,30,65,.462,3,14,.214,22,33,.667,91
19888,2011-02-27,PHI,@,CLE,W 95-91,240,38,77,.494,33,66,.500,5,11,.455,14,20,.700,95
19889,2011-02-27,IND,,PHO,L 108-110 (OT),265,39,87,.448,28,64,.438,11,23,.478,19,23,.826,108
19890,2011-02-27,PHO,@,IND,W 110-108 (OT),265,45,102,.441,35,75,.467,10,27,.370,10,17,.588,110
19891,2011-02-27,MIA,,NYK,L 86-91,240,32,74,.432,26,52,.500,6,22,.273,16,22,.727,86
19892,2011-02-27,NYK,@,MIA,W 91-86,240,31,80,.388,23,50,.460,8,30,.267,21,23,.913,91
19893,2011-02-27,GSW,@,MIN,L 123-126,240,44,96,.458,31,64,.484,13,32,.406,22,24,.917,123
19894,2011-02-27,MIN,,GSW,W 126-123,240,42,94,.447,30,69,.435,12,25,.480,30,37,.811,126
19895,2011-02-27,HOU,@,NOH,W 91-89,240,31,74,.419,20,48,.417,11,26,.423,18,21,.857,91
19896,2011-02-27,NOP,,HOU,L 89-91,240,37,78,.474,33,65,.508,4,13,.308,11,14,.786,89
19897,2011-02-27,LAL,@,OKC,W 90-87,240,37,76,.487,33,61,.541,4,15,.267,12,18,.667,90
19898,2011-02-27,OKC,,LAL,L 87-90,240,34,76,.447,28,60,.467,6,16,.375,13,16,.813,87
19899,2011-02-27,CHA,@,ORL,L 86-100,240,34,85,.400,29,69,.420,5,16,.313,13,18,.722,86
19900,2011-02-27,ORL,,CHA,W 100-86,240,35,68,.515,25,40,.625,10,28,.357,20,32,.625,100
19901,2011-02-27,ATL,@,POR,W 90-83,240,29,69,.420,21,48,.438,8,21,.381,24,27,.889,90
19902,2011-02-27,POR,,ATL,L 83-90,240,32,82,.390,28,61,.459,4,21,.190,15,21,.714,83
19903,2011-02-27,MEM,@,SAS,L 88-95,240,33,89,.371,28,78,.359,5,11,.455,17,19,.895,88
19904,2011-02-27,SAS,,MEM,W 95-88,240,30,65,.462,21,44,.477,9,21,.429,26,33,.788,95
19905,2011-02-27,DAL,@,TOR,W 114-96,240,45,93,.484,37,69,.536,8,24,.333,16,22,.727,114
19906,2011-02-27,TOR,,DAL,L 96-114,240,41,84,.488,36,70,.514,5,14,.357,9,12,.750,96
19907,2011-02-26,DET,,UTA,W 120-116,240,43,86,.500,32,69,.464,11,17,.647,23,31,.742,120
19908,2011-02-26,UTA,@,DET,L 116-120,240,44,74,.595,39,61,.639,5,13,.385,23,34,.676,116
19909,2011-02-26,HOU,,NJN,W 123-108,240,42,82,.512,34,64,.531,8,18,.444,31,40,.775,123
19910,2011-02-26,BRK,@,HOU,L 108-123,240,37,92,.402,32,72,.444,5,20,.250,29,36,.806,108
19911,2011-02-26,BOS,@,LAC,W 99-92,240,30,73,.411,26,64,.406,4,9,.444,35,41,.854,99
19912,2011-02-26,LAC,,BOS,L 92-99,240,35,76,.461,30,58,.517,5,18,.278,17,21,.810,92
19913,2011-02-26,MEM,,SAC,W 120-92,240,52,95,.547,49,84,.583,3,11,.273,13,16,.813,120
19914,2011-02-26,SAC,@,MEM,L 92-120,240,38,85,.447,35,73,.479,3,12,.250,13,19,.684,92
19915,2011-02-26,CHI,@,MIL,W 83-75,240,32,78,.410,28,60,.467,4,18,.222,15,22,.682,83
19916,2011-02-26,MIL,,CHI,L 75-83,240,29,76,.382,24,62,.387,5,14,.357,12,14,.857,75
19917,2011-02-26,DAL,@,WAS,W 105-99,240,39,81,.481,33,64,.516,6,17,.353,21,31,.677,105
19918,2011-02-26,WAS,,DAL,L 99-105,240,44,95,.463,39,81,.481,5,14,.357,6,16,.375,99
19919,2011-02-25,CHA,,SAC,W 110-98,240,41,83,.494,38,73,.521,3,10,.300,25,35,.714,110
19920,2011-02-25,SAC,@,CHA,L 98-110,240,36,83,.434,29,68,.426,7,15,.467,19,21,.905,98
19921,2011-02-25,CLE,,NYK,W 115-109,240,39,92,.424,33,71,.465,6,21,.286,31,44,.705,115
19922,2011-02-25,NYK,@,CLE,L 109-115,240,39,93,.419,30,71,.423,9,22,.409,22,29,.759,109
19923,2011-02-25,ATL,@,GSW,W 95-79,240,40,84,.476,35,65,.538,5,19,.263,10,11,.909,95
19924,2011-02-25,GSW,,ATL,L 79-95,240,33,89,.371,31,77,.403,2,12,.167,11,13,.846,79
19925,2011-02-25,IND,,UTA,L 84-95,240,31,89,.348,29,75,.387,2,14,.143,20,26,.769,84
19926,2011-02-25,UTA,@,IND,W 95-84,240,40,90,.444,40,84,.476,0,6,.000,15,19,.789,95
19927,2011-02-25,LAC,@,LAL,L 95-108,240,31,82,.378,21,57,.368,10,25,.400,23,25,.920,95
19928,2011-02-25,LAL,,LAC,W 108-95,240,43,85,.506,35,69,.507,8,16,.500,14,16,.875,108
19929,2011-02-25,MIA,,WAS,W 121-113,240,41,78,.526,36,65,.554,5,13,.385,34,45,.756,121
19930,2011-02-25,WAS,@,MIA,L 113-121,240,43,91,.473,33,68,.485,10,23,.435,17,23,.739,113
19931,2011-02-25,MIN,,NOH,L 81-95,240,32,80,.400,27,60,.450,5,20,.250,12,14,.857,81
19932,2011-02-25,NOP,@,MIN,W 95-81,240,35,80,.438,26,54,.481,9,26,.346,16,18,.889,95
19933,2011-02-25,OKC,@,ORL,L 88-111,240,29,87,.333,19,62,.306,10,25,.400,20,28,.714,88
19934,2011-02-25,ORL,,OKC,W 111-88,240,41,82,.500,31,60,.517,10,22,.455,19,28,.679,111
19935,2011-02-25,DET,@,PHI,L 94-110,240,37,78,.474,33,67,.493,4,11,.364,16,22,.727,94
19936,2011-02-25,PHI,,DET,W 110-94,240,46,88,.523,41,73,.562,5,15,.333,13,15,.867,110
19937,2011-02-25,DEN,@,POR,L 106-107 (OT),265,36,86,.419,30,65,.462,6,21,.286,28,35,.800,106
19938,2011-02-25,POR,,DEN,W 107-106 (OT),265,40,92,.435,30,69,.435,10,23,.435,17,21,.810,107
19939,2011-02-25,BRK,@,SAS,L 96-106,240,37,85,.435,32,64,.500,5,21,.238,17,21,.810,96
19940,2011-02-25,SAS,,NJN,W 106-96,240,38,82,.463,30,63,.476,8,19,.421,22,26,.846,106
19941,2011-02-25,PHO,@,TOR,W 110-92,240,39,82,.476,33,61,.541,6,21,.286,26,33,.788,110
19942,2011-02-25,TOR,,PHO,L 92-110,240,38,75,.507,37,68,.544,1,7,.143,15,23,.652,92
19943,2011-02-24,CHI,,MIA,W 93-89,240,34,82,.415,30,61,.492,4,21,.190,21,25,.840,93
19944,2011-02-24,MIA,@,CHI,L 89-93,240,32,79,.405,30,67,.448,2,12,.167,23,27,.852,89
19945,2011-02-24,BOS,@,DEN,L 75-89,240,30,77,.390,27,60,.450,3,17,.176,12,15,.800,75
19946,2011-02-24,DEN,,BOS,W 89-75,240,34,75,.453,29,60,.483,5,15,.333,16,23,.696,89
19947,2011-02-23,CLE,,HOU,L 119-124,240,47,91,.516,34,69,.493,13,22,.591,12,15,.800,119
19948,2011-02-23,HOU,@,CLE,W 124-119,240,47,100,.470,37,73,.507,10,27,.370,20,28,.714,124
19949,2011-02-23,DAL,,UTA,W 118-99,240,44,76,.579,34,56,.607,10,20,.500,20,28,.714,118
19950,2011-02-23,UTA,@,DAL,L 99-118,240,35,77,.455,31,61,.508,4,16,.250,25,31,.806,99
19951,2011-02-23,DET,@,IND,L 101-102,240,40,82,.488,33,68,.485,7,14,.500,14,21,.667,101
19952,2011-02-23,IND,,DET,W 102-101,240,38,86,.442,35,69,.507,3,17,.176,23,26,.885,102
19953,2011-02-23,MEM,@,MIN,W 104-95,240,38,84,.452,33,68,.485,5,16,.313,23,30,.767,104
19954,2011-02-23,MIN,,MEM,L 95-104,240,34,92,.370,29,75,.387,5,17,.294,22,27,.815,95
19955,2011-02-23,LAC,@,NOH,L 87-98,240,33,70,.471,26,55,.473,7,15,.467,14,21,.667,87
19956,2011-02-23,NOP,,LAC,W 98-87,240,40,78,.513,37,67,.552,3,11,.273,15,21,.714,98
19957,2011-02-23,MIL,@,NYK,L 108-114,240,36,82,.439,25,59,.424,11,23,.478,25,32,.781,108
19958,2011-02-23,NYK,,MIL,W 114-108,240,40,80,.500,32,58,.552,8,22,.364,26,28,.929,114
19959,2011-02-23,ORL,,SAC,L 105-111,240,40,89,.449,32,61,.525,8,28,.286,17,20,.850,105
19960,2011-02-23,SAC,@,ORL,W 111-105,240,42,80,.525,36,68,.529,6,12,.500,21,27,.778,111
19961,2011-02-23,PHI,,WAS,W 117-94,240,40,78,.513,32,61,.525,8,17,.471,29,33,.879,117
19962,2011-02-23,WAS,@,PHI,L 94-117,240,37,88,.420,33,79,.418,4,9,.444,16,22,.727,94
19963,2011-02-23,ATL,@,PHO,L 97-105,240,39,81,.481,32,67,.478,7,14,.500,12,15,.800,97
19964,2011-02-23,PHO,,ATL,W 105-97,240,40,76,.526,27,50,.540,13,26,.500,12,16,.750,105
19965,2011-02-23,LAL,@,POR,W 106-101 (OT),265,41,83,.494,30,65,.462,11,18,.611,13,15,.867,106
19966,2011-02-23,POR,,LAL,L 101-106 (OT),265,38,79,.481,29,55,.527,9,24,.375,16,25,.640,101
19967,2011-02-23,OKC,@,SAS,L 105-109,240,37,91,.407,30,67,.448,7,24,.292,24,27,.889,105
19968,2011-02-23,SAS,,OKC,W 109-105,240,37,83,.446,24,62,.387,13,21,.619,22,28,.786,109
19969,2011-02-23,CHI,@,TOR,L 113-118,240,38,87,.437,31,72,.431,7,15,.467,30,37,.811,113
19970,2011-02-23,TOR,,CHI,W 118-113,240,43,74,.581,43,69,.623,0,5,.000,32,34,.941,118
19971,2011-02-22,CHA,,TOR,W 114-101,240,38,81,.469,34,67,.507,4,14,.286,34,42,.810,114
19972,2011-02-22,TOR,@,CHA,L 101-114,240,39,78,.500,37,69,.536,2,9,.222,21,26,.808,101
19973,2011-02-22,DEN,,MEM,W 120-107,240,41,83,.494,29,55,.527,12,28,.429,26,36,.722,120
19974,2011-02-22,MEM,@,DEN,L 107-120,240,42,78,.538,38,68,.559,4,10,.400,19,31,.613,107
19975,2011-02-22,DET,,HOU,L 100-108,240,41,93,.441,37,79,.468,4,14,.286,14,15,.933,100
19976,2011-02-22,HOU,@,DET,W 108-100,240,37,85,.435,29,62,.468,8,23,.348,26,28,.929,108
19977,2011-02-22,BOS,@,GSW,W 115-93,240,50,90,.556,43,73,.589,7,17,.412,8,11,.727,115
19978,2011-02-22,GSW,,BOS,L 93-115,240,33,84,.393,28,65,.431,5,19,.263,22,28,.786,93
19979,2011-02-22,ATL,@,LAL,L 80-104,240,30,82,.366,29,67,.433,1,15,.067,19,28,.679,80
19980,2011-02-22,LAL,,ATL,W 104-80,240,32,66,.485,26,51,.510,6,15,.400,34,40,.850,104
19981,2011-02-22,MIA,,SAC,W 117-97,240,51,90,.567,44,72,.611,7,18,.389,8,11,.727,117
19982,2011-02-22,SAC,@,MIA,L 97-117,240,40,84,.476,36,70,.514,4,14,.286,13,20,.650,97
19983,2011-02-22,MIL,,MIN,W 94-88,240,30,79,.380,23,49,.469,7,30,.233,27,31,.871,94
19984,2011-02-22,MIN,@,MIL,L 88-94,240,32,84,.381,28,66,.424,4,18,.222,20,31,.645,88
19985,2011-02-22,LAC,@,OKC,L 88-111,240,33,72,.458,28,61,.459,5,11,.455,17,29,.586,88
19986,2011-02-22,OKC,,LAC,W 111-88,240,37,78,.474,28,56,.500,9,22,.409,28,32,.875,111
19987,2011-02-22,IND,@,WAS,W 113-96,240,38,88,.432,35,72,.486,3,16,.188,34,45,.756,113
19988,2011-02-22,WAS,,IND,L 96-113,240,37,93,.398,35,83,.422,2,10,.200,20,26,.769,96
19989,2011-02-17,CHI,,SAS,W 109-99,240,43,80,.538,37,64,.578,6,16,.375,17,20,.850,109
19990,2011-02-17,SAS,@,CHI,L 99-109,240,39,80,.488,32,66,.485,7,14,.500,14,21,.667,99
19991,2011-02-17,DAL,@,PHO,W 112-106,240,43,82,.524,33,55,.600,10,27,.370,16,23,.696,112
19992,2011-02-17,PHO,,DAL,L 106-112,240,42,83,.506,37,64,.578,5,19,.263,17,22,.773,106
19993,2011-02-16,BOS,,NJN,W 94-80,240,31,72,.431,29,61,.475,2,11,.182,30,39,.769,94
19994,2011-02-16,BRK,@,BOS,L 80-94,240,31,80,.388,25,60,.417,6,20,.300,12,15,.800,80
19995,2011-02-16,CLE,,LAL,W 104-99,240,40,85,.471,35,69,.507,5,16,.313,19,22,.864,104
19996,2011-02-16,LAL,@,CLE,L 99-104,240,37,87,.425,32,72,.444,5,15,.333,20,23,.870,99
19997,2011-02-16,DAL,,SAC,W 116-100,240,50,90,.556,37,64,.578,13,26,.500,3,6,.500,116
19998,2011-02-16,SAC,@,DAL,L 100-116,240,35,71,.493,31,63,.492,4,8,.500,26,34,.765,100
19999,2011-02-16,DET,,IND,W 115-109 (OT),265,50,97,.515,48,88,.545,2,9,.222,13,19,.684,115
20000,2011-02-16,IND,@,DET,L 109-115 (OT),265,46,92,.500,39,74,.527,7,18,.389,10,16,.625,109
20001,2011-02-16,HOU,,PHI,L 105-114,240,45,97,.464,36,65,.554,9,32,.281,6,10,.600,105
20002,2011-02-16,PHI,@,HOU,W 114-105,240,48,87,.552,43,73,.589,5,14,.357,13,18,.722,114
20003,2011-02-16,DEN,@,MIL,W 94-87,240,35,76,.461,32,65,.492,3,11,.273,21,25,.840,94
20004,2011-02-16,MIL,,DEN,L 87-94,240,31,80,.388,28,57,.491,3,23,.130,22,28,.786,87
20005,2011-02-16,LAC,@,MIN,W 98-90,240,36,79,.456,30,53,.566,6,26,.231,20,31,.645,98
20006,2011-02-16,MIN,,LAC,L 90-98,240,29,82,.354,22,58,.379,7,24,.292,25,36,.694,90
20007,2011-02-16,ATL,@,NYK,L 90-102,240,37,84,.440,26,62,.419,11,22,.500,5,9,.556,90
20008,2011-02-16,NYK,,ATL,W 102-90,240,38,79,.481,29,56,.518,9,23,.391,17,21,.810,102
20009,2011-02-16,ORL,,WAS,W 101-76,240,38,84,.452,31,63,.492,7,21,.333,18,21,.857,101
20010,2011-02-16,WAS,@,ORL,L 76-101,240,29,83,.349,26,70,.371,3,13,.231,15,23,.652,76
20011,2011-02-16,NOP,@,POR,L 96-103,240,37,74,.500,34,61,.557,3,13,.231,19,24,.792,96
20012,2011-02-16,POR,,NOH,W 103-96,240,36,68,.529,30,49,.612,6,19,.316,25,30,.833,103
20013,2011-02-16,MIA,@,TOR,W 103-95,240,36,73,.493,34,62,.548,2,11,.182,29,37,.784,103
20014,2011-02-16,TOR,,MIA,L 95-103,240,36,87,.414,30,73,.411,6,14,.429,17,20,.850,95
20015,2011-02-16,GSW,@,UTA,W 107-100,240,42,77,.545,34,58,.586,8,19,.421,15,22,.682,107
20016,2011-02-16,UTA,,GSW,L 100-107,240,35,77,.455,32,63,.508,3,14,.214,27,30,.900,100
20017,2011-02-15,CHA,@,CHI,L 94-106,240,33,69,.478,31,58,.534,2,11,.182,26,30,.867,94
20018,2011-02-15,CHI,,CHA,W 106-94,240,38,76,.500,31,62,.500,7,14,.500,23,30,.767,106
20019,2011-02-15,GSW,,NOH,W 102-89,240,39,77,.506,29,58,.500,10,19,.526,14,17,.824,102
20020,2011-02-15,NOP,@,GSW,L 89-102,240,34,75,.453,31,65,.477,3,10,.300,18,23,.783,89
20021,2011-02-15,IND,,MIA,L 103-110,240,36,86,.419,28,68,.412,8,18,.444,23,29,.793,103
20022,2011-02-15,MIA,@,IND,W 110-103,240,43,88,.489,39,72,.542,4,16,.250,20,26,.769,110
20023,2011-02-15,MEM,,PHI,W 102-91,240,42,90,.467,36,76,.474,6,14,.429,12,19,.632,102
20024,2011-02-15,PHI,@,MEM,L 91-102,240,33,75,.440,30,62,.484,3,13,.231,22,26,.846,91
20025,2011-02-15,OKC,,SAC,W 126-96,240,45,90,.500,37,66,.561,8,24,.333,28,30,.933,126
20026,2011-02-15,SAC,@,OKC,L 96-126,240,35,87,.402,33,76,.434,2,11,.182,24,31,.774,96
20027,2011-02-15,PHO,,UTA,W 102-101,240,36,73,.493,24,44,.545,12,29,.414,18,24,.750,102
20028,2011-02-15,UTA,@,PHO,L 101-102,240,38,83,.458,32,69,.464,6,14,.429,19,22,.864,101
20029,2011-02-14,CHA,,LAL,W 109-89,240,42,82,.512,34,61,.557,8,21,.381,17,21,.810,109
20030,2011-02-14,LAL,@,CHA,L 89-109,240,35,80,.438,32,61,.525,3,19,.158,16,20,.800,89
20031,2011-02-14,ATL,@,DET,W 94-79,240,35,62,.565,28,46,.609,7,16,.438,17,19,.895,94
20032,2011-02-14,DET,,ATL,L 79-94,240,27,70,.386,17,51,.333,10,19,.526,15,19,.789,79
20033,2011-02-14,DEN,@,HOU,L 102-121,240,32,78,.410,27,58,.466,5,20,.250,33,44,.750,102
20034,2011-02-14,HOU,,DEN,W 121-102,240,44,89,.494,30,57,.526,14,32,.438,19,22,.864,121
20035,2011-02-14,LAC,@,MIL,L 78-102,240,26,70,.371,22,53,.415,4,17,.235,22,27,.815,78
20036,2011-02-14,MIL,,LAC,W 102-78,240,35,68,.515,24,42,.571,11,26,.423,21,30,.700,102
20037,2011-02-14,MIN,,POR,L 81-95,240,30,77,.390,22,59,.373,8,18,.444,13,17,.765,81
20038,2011-02-14,POR,@,MIN,W 95-81,240,37,84,.440,29,66,.439,8,18,.444,13,16,.813,95
20039,2011-02-14,BRK,,SAS,L 85-102,240,31,89,.348,25,71,.352,6,18,.333,17,21,.810,85
20040,2011-02-14,SAS,@,NJN,W 102-85,240,36,80,.450,29,64,.453,7,16,.438,23,31,.742,102
20041,2011-02-13,BOS,,MIA,W 85-82,240,30,71,.423,26,56,.464,4,15,.267,21,28,.750,85
20042,2011-02-13,MIA,@,BOS,L 82-85,240,31,74,.419,28,58,.483,3,16,.188,17,23,.739,82
20043,2011-02-13,CLE,,WAS,L 100-115,240,35,83,.422,24,60,.400,11,23,.478,19,31,.613,100
20044,2011-02-13,WAS,@,CLE,W 115-100,240,50,92,.543,45,79,.570,5,13,.385,10,14,.714,115
20045,2011-02-13,DET,,POR,L 100-105,240,35,68,.515,29,58,.500,6,10,.600,24,30,.800,100
20046,2011-02-13,POR,@,DET,W 105-100,240,35,64,.547,29,48,.604,6,16,.375,29,30,.967,105
20047,2011-02-13,GSW,,OKC,W 100-94,240,43,99,.434,36,76,.474,7,23,.304,7,9,.778,100
20048,2011-02-13,OKC,@,GSW,L 94-100,240,31,59,.525,23,41,.561,8,18,.444,24,28,.857,94
20049,2011-02-13,DEN,@,MEM,L 108-116,240,44,80,.550,39,64,.609,5,16,.313,15,21,.714,108
20050,2011-02-13,MEM,,DEN,W 116-108,240,44,79,.557,42,73,.575,2,6,.333,26,32,.813,116
20051,2011-02-13,LAL,@,ORL,L 75-89,240,33,84,.393,31,68,.456,2,16,.125,7,15,.467,75
20052,2011-02-13,ORL,,LAL,W 89-75,240,37,76,.487,30,53,.566,7,23,.304,8,10,.800,89
20053,2011-02-13,PHO,,SAC,L 108-113,240,42,90,.467,36,70,.514,6,20,.300,18,24,.750,108
20054,2011-02-13,SAC,@,PHO,W 113-108,240,43,94,.457,37,81,.457,6,13,.462,21,24,.875,113
20055,2011-02-13,LAC,@,TOR,L 93-98,240,32,77,.416,27,63,.429,5,14,.357,24,34,.706,93
20056,2011-02-13,TOR,,LAC,W 98-93,240,35,82,.427,33,69,.478,2,13,.154,26,32,.813,98
20057,2011-02-12,ATL,,CHA,L 86-88,240,33,82,.402,28,59,.475,5,23,.217,15,18,.833,86
20058,2011-02-12,CHA,@,ATL,W 88-86,240,33,78,.423,28,59,.475,5,19,.263,17,21,.810,88
20059,2011-02-12,DAL,@,HOU,W 106-102,240,43,78,.551,35,63,.556,8,15,.533,12,15,.800,106
20060,2011-02-12,HOU,,DAL,L 102-106,240,39,96,.406,28,67,.418,11,29,.379,13,17,.765,102
20061,2011-02-12,IND,@,MIL,W 103-97,240,33,69,.478,26,52,.500,7,17,.412,30,41,.732,103
20062,2011-02-12,MIL,,IND,L 97-103,240,36,85,.424,27,62,.435,9,23,.391,16,20,.800,97
20063,2011-02-12,MIN,,PHI,L 87-107,240,32,88,.364,28,65,.431,4,23,.174,19,22,.864,87
20064,2011-02-12,PHI,@,MIN,W 107-87,240,40,78,.513,35,66,.530,5,12,.417,22,26,.846,107
20065,2011-02-12,BRK,,NYK,L 95-105,240,33,79,.418,26,65,.400,7,14,.500,22,31,.710,95
20066,2011-02-12,NYK,@,NJN,W 105-95,240,37,86,.430,21,52,.404,16,34,.471,15,18,.833,105
20067,2011-02-12,CHI,@,NOH,W 97-88,240,35,68,.515,29,55,.527,6,13,.462,21,22,.955,97
20068,2011-02-12,NOP,,CHI,L 88-97,240,28,69,.406,22,54,.407,6,15,.400,26,39,.667,88
20069,2011-02-12,OKC,@,SAC,W 99-97,240,38,80,.475,36,67,.537,2,13,.154,21,32,.656,99
20070,2011-02-12,SAC,,OKC,L 97-99,240,38,84,.452,37,72,.514,1,12,.083,20,28,.714,97
20071,2011-02-12,SAS,@,WAS,W 118-94,240,45,77,.584,32,52,.615,13,25,.520,15,17,.882,118
20072,2011-02-12,WAS,,SAS,L 94-118,240,38,82,.463,35,71,.493,3,11,.273,15,24,.625,94
20073,2011-02-11,CHA,,NJN,L 89-94,240,29,68,.426,25,54,.463,4,14,.286,27,39,.692,89
20074,2011-02-11,BRK,@,CHA,W 94-89,240,35,86,.407,33,72,.458,2,14,.143,22,34,.647,94
20075,2011-02-11,CLE,,LAC,W 126-119 (OT),265,46,92,.500,38,72,.528,8,20,.400,26,32,.813,126
20076,2011-02-11,LAC,@,CLE,L 119-126 (OT),265,43,96,.448,35,73,.479,8,23,.348,25,32,.781,119
20077,2011-02-11,DET,,MIA,L 92-106,240,34,80,.425,26,56,.464,8,24,.333,16,19,.842,92
20078,2011-02-11,MIA,@,DET,W 106-92,240,38,75,.507,32,61,.525,6,14,.429,24,29,.828,106
20079,2011-02-11,IND,,MIN,W 116-105,240,41,81,.506,35,66,.530,6,15,.400,28,35,.800,116
20080,2011-02-11,MIN,@,IND,L 105-116,240,38,90,.422,33,73,.452,5,17,.294,24,30,.800,105
20081,2011-02-11,MEM,,MIL,W 89-86,240,32,74,.432,29,68,.426,3,6,.500,22,30,.733,89
20082,2011-02-11,MIL,@,MEM,L 86-89,240,28,77,.364,17,51,.333,11,26,.423,19,24,.792,86
20083,2011-02-11,LAL,@,NYK,W 113-96,240,45,84,.536,39,69,.565,6,15,.400,17,25,.680,113
20084,2011-02-11,NYK,,LAL,L 96-113,240,35,85,.412,30,65,.462,5,20,.250,21,24,.875,96
20085,2011-02-11,NOP,@,ORL,W 99-93,240,38,84,.452,32,63,.508,6,21,.286,17,21,.810,99
20086,2011-02-11,ORL,,NOH,L 93-99,240,36,78,.462,31,57,.544,5,21,.238,16,25,.640,93
20087,2011-02-11,PHI,,SAS,W 77-71,240,29,82,.354,24,69,.348,5,13,.385,14,17,.824,77
20088,2011-02-11,SAS,@,PHI,L 71-77,240,27,81,.333,24,64,.375,3,17,.176,14,18,.778,71
20089,2011-02-11,POR,@,TOR,W 102-96,240,38,70,.543,31,53,.585,7,17,.412,19,25,.760,102
20090,2011-02-11,TOR,,POR,L 96-102,240,37,72,.514,32,63,.508,5,9,.556,17,24,.708,96
20091,2011-02-11,PHO,@,UTA,W 95-83,240,36,89,.404,31,66,.470,5,23,.217,18,23,.783,95
20092,2011-02-11,UTA,,PHO,L 83-95,240,34,78,.436,27,61,.443,7,17,.412,8,12,.667,83
20093,2011-02-10,BOS,,LAL,L 86-92,240,33,82,.402,28,66,.424,5,16,.313,15,19,.789,86
20094,2011-02-10,LAL,@,BOS,W 92-86,240,35,73,.479,32,63,.508,3,10,.300,19,25,.760,92
20095,2011-02-10,DAL,@,DEN,L 120-121,240,45,84,.536,34,59,.576,11,25,.440,19,25,.760,120
20096,2011-02-10,DEN,,DAL,W 121-120,240,44,84,.524,29,53,.547,15,31,.484,18,24,.750,121
20097,2011-02-10,GSW,@,PHO,L 88-112,240,36,90,.400,30,70,.429,6,20,.300,10,17,.588,88
20098,2011-02-10,PHO,,GSW,W 112-88,240,44,84,.524,32,62,.516,12,22,.545,12,14,.857,112
20099,2011-02-09,CLE,,DET,L 94-103,240,37,72,.514,29,53,.547,8,19,.421,12,19,.632,94
20100,2011-02-09,DET,@,CLE,W 103-94,240,39,90,.433,30,71,.423,9,19,.474,16,22,.727,103
20101,2011-02-09,DEN,@,GSW,L 114-116,240,44,83,.530,34,59,.576,10,24,.417,16,22,.727,114
20102,2011-02-09,GSW,,DEN,W 116-114,240,47,92,.511,33,64,.516,14,28,.500,8,12,.667,116
20103,2011-02-09,CHA,@,IND,L 103-104,240,38,82,.463,32,65,.492,6,17,.353,21,27,.778,103
20104,2011-02-09,IND,,CHA,W 104-103,240,39,82,.476,34,71,.479,5,11,.455,21,26,.808,104
20105,2011-02-09,BRK,,NOH,W 103-101 (OT),265,38,81,.469,26,58,.448,12,23,.522,15,19,.789,103
20106,2011-02-09,NOP,@,NJN,L 101-103 (OT),265,40,85,.471,31,68,.456,9,17,.529,12,16,.750,101
20107,2011-02-09,LAC,@,NYK,W 116-108,240,47,86,.547,38,69,.551,9,17,.529,13,16,.813,116
20108,2011-02-09,NYK,,LAC,L 108-116,240,40,81,.494,34,55,.618,6,26,.231,22,23,.957,108
20109,2011-02-09,ORL,@,PHI,W 99-95,240,35,76,.461,25,50,.500,10,26,.385,19,26,.731,99
20110,2011-02-09,PHI,,ORL,L 95-99,240,37,88,.420,31,69,.449,6,19,.316,15,22,.682,95
20111,2011-02-09,DAL,@,SAC,W 102-100,240,38,81,.469,29,56,.518,9,25,.360,17,22,.773,102
20112,2011-02-09,SAC,,DAL,L 100-102,240,39,83,.470,36,70,.514,3,13,.231,19,23,.826,100
20113,2011-02-09,SAS,@,TOR,W 111-100,240,47,81,.580,41,67,.612,6,14,.429,11,19,.579,111
20114,2011-02-09,TOR,,SAS,L 100-111,240,42,84,.500,39,75,.520,3,9,.333,13,18,.722,100
20115,2011-02-09,CHI,@,UTA,W 91-86,240,33,83,.398,28,68,.412,5,15,.333,20,26,.769,91
20116,2011-02-09,UTA,,CHI,L 86-91,240,37,78,.474,36,70,.514,1,8,.125,11,21,.524,86
20117,2011-02-09,MIL,@,WAS,L 85-100,240,38,88,.432,34,74,.459,4,14,.286,5,12,.417,85
20118,2011-02-09,WAS,,MIL,W 100-85,240,36,76,.474,26,60,.433,10,16,.625,18,20,.900,100
20119,2011-02-08,ATL,,PHI,L 83-117,240,35,86,.407,32,68,.471,3,18,.167,10,15,.667,83
20120,2011-02-08,PHI,@,ATL,W 117-83,240,43,79,.544,40,66,.606,3,13,.231,28,34,.824,117
20121,2011-02-08,DET,,SAS,L 89-100,240,36,83,.434,33,72,.458,3,11,.273,14,19,.737,89
20122,2011-02-08,SAS,@,DET,W 100-89,240,37,70,.529,27,52,.519,10,18,.556,16,22,.727,100
20123,2011-02-08,HOU,,MIN,L 108-112,240,41,91,.451,34,63,.540,7,28,.250,19,23,.826,108
20124,2011-02-08,MIN,@,HOU,W 112-108,240,45,88,.511,37,70,.529,8,18,.444,14,18,.778,112
20125,2011-02-08,IND,@,MIA,L 112-117,240,44,86,.512,37,64,.578,7,22,.318,17,20,.850,112
20126,2011-02-08,MIA,,IND,W 117-112,240,44,83,.530,36,59,.610,8,24,.333,21,28,.750,117
20127,2011-02-08,MIL,,TOR,W 92-74,240,38,82,.463,36,69,.522,2,13,.154,14,20,.700,92
20128,2011-02-08,TOR,@,MIL,L 74-92,240,31,86,.360,31,76,.408,0,10,.000,12,13,.923,74
20129,2011-02-08,MEM,@,OKC,W 105-101 (OT),265,37,81,.457,35,76,.461,2,5,.400,29,39,.744,105
20130,2011-02-08,OKC,,MEM,L 101-105 (OT),265,35,85,.412,28,66,.424,7,19,.368,24,32,.750,101
20131,2011-02-08,LAC,@,ORL,L 85-101,240,31,79,.392,26,63,.413,5,16,.313,18,22,.818,85
20132,2011-02-08,ORL,,LAC,W 101-85,240,35,81,.432,25,51,.490,10,30,.333,21,34,.618,101
20133,2011-02-07,BOS,@,CHA,L 89-94,240,31,76,.408,26,62,.419,5,14,.357,22,27,.815,89
20134,2011-02-07,CHA,,BOS,W 94-89,240,33,79,.418,28,63,.444,5,16,.313,23,30,.767,94
20135,2011-02-07,CLE,@,DAL,L 96-99,240,40,91,.440,37,77,.481,3,14,.214,13,17,.765,96
20136,2011-02-07,DAL,,CLE,W 99-96,240,34,83,.410,27,61,.443,7,22,.318,24,27,.889,99
20137,2011-02-07,DEN,,HOU,L 103-108,240,35,77,.455,32,64,.500,3,13,.231,30,43,.698,103
20138,2011-02-07,HOU,@,DEN,W 108-103,240,36,83,.434,27,61,.443,9,22,.409,27,35,.771,108
20139,2011-02-07,GSW,,PHO,L 92-104,240,36,83,.434,34,65,.523,2,18,.111,18,26,.692,92
20140,2011-02-07,PHO,@,GSW,W 104-92,240,38,87,.437,25,57,.439,13,30,.433,15,20,.750,104
20141,2011-02-07,LAL,@,MEM,W 93-84,240,32,74,.432,24,58,.414,8,16,.500,21,35,.600,93
20142,2011-02-07,MEM,,LAL,L 84-93,240,33,83,.398,29,73,.397,4,10,.400,14,17,.824,84
20143,2011-02-07,MIN,@,NOH,W 104-92,240,34,79,.430,23,53,.434,11,26,.423,25,25,1.000,104
20144,2011-02-07,NOP,,MIN,L 92-104,240,35,84,.417,29,60,.483,6,24,.250,16,22,.727,92
20145,2011-02-07,CHI,@,POR,L 103-109,240,44,89,.494,40,73,.548,4,16,.250,11,18,.611,103
20146,2011-02-07,POR,,CHI,W 109-103,240,35,68,.515,33,60,.550,2,8,.250,37,40,.925,109
20147,2011-02-07,SAC,,UTA,L 104-107,240,38,81,.469,32,66,.485,6,15,.400,22,29,.759,104
20148,2011-02-07,UTA,@,SAC,W 107-104,240,43,88,.489,42,79,.532,1,9,.111,20,30,.667,107
20149,2011-02-06,BOS,,ORL,W 91-80,240,30,63,.476,27,54,.500,3,9,.333,28,34,.824,91
20150,2011-02-06,ORL,@,BOS,L 80-91,240,32,93,.344,29,69,.420,3,24,.125,13,16,.813,80
20151,2011-02-06,LAC,@,MIA,L 79-97,240,25,77,.325,19,53,.358,6,24,.250,23,33,.697,79
20152,2011-02-06,MIA,,LAC,W 97-79,240,34,77,.442,24,49,.490,10,28,.357,19,28,.679,97
20153,2011-02-06,IND,@,NJN,W 105-86,240,39,83,.470,30,61,.492,9,22,.409,18,22,.818,105
20154,2011-02-06,BRK,,IND,L 86-105,240,35,85,.412,31,69,.449,4,16,.250,12,21,.571,86
20155,2011-02-06,NYK,,PHI,W 117-103,240,46,77,.597,35,50,.700,11,27,.407,14,17,.824,117
20156,2011-02-06,PHI,@,NYK,L 103-117,240,39,72,.542,36,62,.581,3,10,.300,22,29,.759,103
20157,2011-02-05,CHA,,DAL,L 92-101,240,33,89,.371,28,68,.412,5,21,.238,21,24,.875,92
20158,2011-02-05,DAL,@,CHA,W 101-92,240,40,86,.465,33,64,.516,7,22,.318,14,17,.824,101
20159,2011-02-05,CLE,,POR,L 105-111,240,41,80,.513,31,57,.544,10,23,.435,13,16,.813,105
20160,2011-02-05,POR,@,CLE,W 111-105,240,42,78,.538,30,59,.508,12,19,.632,15,17,.882,111
20161,2011-02-05,CHI,@,GSW,L 90-101,240,38,80,.475,30,55,.545,8,25,.320,6,13,.462,90
20162,2011-02-05,GSW,,CHI,W 101-90,240,38,79,.481,32,61,.525,6,18,.333,19,23,.826,101
20163,2011-02-05,HOU,,MEM,W 95-93 (OT),265,34,86,.395,29,67,.433,5,19,.263,22,25,.880,95
20164,2011-02-05,MEM,@,HOU,L 93-95 (OT),265,36,88,.409,35,80,.438,1,8,.125,20,25,.800,93
20165,2011-02-05,DET,@,MIL,W 89-78,240,35,68,.515,33,60,.550,2,8,.250,17,24,.708,89
20166,2011-02-05,MIL,,DET,L 78-89,240,31,79,.392,27,62,.435,4,17,.235,12,13,.923,78
20167,2011-02-05,DEN,@,MIN,W 113-100,240,43,79,.544,32,52,.615,11,27,.407,16,22,.727,113
20168,2011-02-05,MIN,,DEN,L 100-113,240,37,95,.389,30,68,.441,7,27,.259,19,26,.731,100
20169,2011-02-05,LAL,@,NOH,W 101-95,240,36,76,.474,30,58,.517,6,18,.333,23,27,.852,101
20170,2011-02-05,NOP,,LAL,L 95-101,240,41,83,.494,32,62,.516,9,21,.429,4,4,1.000,95
20171,2011-02-05,OKC,@,UTA,W 121-105,240,43,76,.566,30,55,.545,13,21,.619,22,26,.846,121
20172,2011-02-05,UTA,,OKC,L 105-121,240,41,80,.513,38,62,.613,3,18,.167,20,27,.741,105
20173,2011-02-05,ATL,@,WAS,W 99-92,240,34,73,.466,29,60,.483,5,13,.385,26,35,.743,99
20174,2011-02-05,WAS,,ATL,L 92-99,240,39,77,.506,33,65,.508,6,12,.500,8,18,.444,92
20175,2011-02-04,ATL,,LAC,W 101-100,240,41,94,.436,34,67,.507,7,27,.259,12,13,.923,101
20176,2011-02-04,LAC,@,ATL,L 100-101,240,38,75,.507,32,57,.561,6,18,.333,18,28,.643,100
20177,2011-02-04,BOS,,DAL,L 97-101,240,40,79,.506,34,62,.548,6,17,.353,11,16,.688,97
20178,2011-02-04,DAL,@,BOS,W 101-97,240,39,79,.494,31,62,.500,8,17,.471,15,17,.882,101
20179,2011-02-04,CHA,,MIA,L 97-109,240,35,74,.473,26,54,.481,9,20,.450,18,23,.783,97
20180,2011-02-04,MIA,@,CHA,W 109-97,240,43,78,.551,34,59,.576,9,19,.474,14,19,.737,109
20181,2011-02-04,DEN,,UTA,L 106-113,240,35,80,.438,31,60,.517,4,20,.200,32,36,.889,106
20182,2011-02-04,UTA,@,DEN,W 113-106,240,44,95,.463,36,69,.522,8,26,.308,17,18,.944,113
20183,2011-02-04,DET,,NJN,W 92-82,240,40,83,.482,37,73,.507,3,10,.300,9,18,.500,92
20184,2011-02-04,BRK,@,DET,L 82-92,240,34,77,.442,30,61,.492,4,16,.250,10,14,.714,82
20185,2011-02-04,IND,,POR,W 100-87,240,31,77,.403,26,63,.413,5,14,.357,33,43,.767,100
20186,2011-02-04,POR,@,IND,L 87-100,240,32,88,.364,27,68,.397,5,20,.250,18,22,.818,87
20187,2011-02-04,CLE,@,MEM,L 105-112,240,38,80,.475,32,62,.516,6,18,.333,23,26,.885,105
20188,2011-02-04,MEM,,CLE,W 112-105,240,41,80,.513,38,72,.528,3,8,.375,27,30,.900,112
20189,2011-02-04,NYK,@,PHI,L 98-100,240,35,87,.402,27,60,.450,8,27,.296,20,26,.769,98
20190,2011-02-04,PHI,,NYK,W 100-98,240,39,83,.470,34,70,.486,5,13,.385,17,18,.944,100
20191,2011-02-04,OKC,@,PHO,W 111-107,240,42,82,.512,36,64,.563,6,18,.333,21,24,.875,111
20192,2011-02-04,PHO,,OKC,L 107-111,240,39,85,.459,26,52,.500,13,33,.394,16,23,.696,107
20193,2011-02-04,SAC,,SAS,L 100-113,240,40,92,.435,38,80,.475,2,12,.167,18,24,.750,100
20194,2011-02-04,SAS,@,SAC,W 113-100,240,48,84,.571,41,66,.621,7,18,.389,10,15,.667,113
20195,2011-02-04,MIN,@,TOR,L 100-111,240,35,85,.412,23,55,.418,12,30,.400,18,22,.818,100
20196,2011-02-04,TOR,,MIN,W 111-100,240,46,84,.548,43,73,.589,3,11,.273,16,18,.889,111
20197,2011-02-04,ORL,@,WAS,W 110-92,240,42,92,.457,30,61,.492,12,31,.387,14,23,.609,110
20198,2011-02-04,WAS,,ORL,L 92-110,240,38,84,.452,35,74,.473,3,10,.300,13,15,.867,92
20199,2011-02-03,GSW,,MIL,W 100-94,240,39,77,.506,27,53,.509,12,24,.500,10,13,.769,100
20200,2011-02-03,MIL,@,GSW,L 94-100,240,39,91,.429,33,68,.485,6,23,.261,10,12,.833,94
20201,2011-02-03,LAL,,SAS,L 88-89,240,34,80,.425,32,66,.485,2,14,.143,18,22,.818,88
20202,2011-02-03,SAS,@,LAL,W 89-88,240,35,85,.412,29,69,.420,6,16,.375,13,17,.765,89
20203,2011-02-03,MIA,@,ORL,W 104-100,240,36,72,.500,29,56,.518,7,16,.438,25,36,.694,104
20204,2011-02-03,ORL,,MIA,L 100-104,240,36,85,.424,24,52,.462,12,33,.364,16,31,.516,100
20205,2011-02-02,ATL,,TOR,W 100-87,240,42,76,.553,32,52,.615,10,24,.417,6,9,.667,100
20206,2011-02-02,TOR,@,ATL,L 87-100,240,34,78,.436,33,73,.452,1,5,.200,18,21,.857,87
20207,2011-02-02,CLE,,IND,L 112-117,240,34,75,.453,25,57,.439,9,18,.500,35,44,.795,112
20208,2011-02-02,IND,@,CLE,W 117-112,240,41,87,.471,32,68,.471,9,19,.474,26,32,.813,117
20209,2011-02-02,DEN,,POR,W 109-90,240,40,77,.519,32,57,.561,8,20,.400,21,26,.808,109
20210,2011-02-02,POR,@,DEN,L 90-109,240,32,75,.427,23,58,.397,9,17,.529,17,24,.708,90
20211,2011-02-02,CHA,@,DET,W 97-87,240,37,73,.507,34,63,.540,3,10,.300,20,25,.800,97
20212,2011-02-02,DET,,CHA,L 87-97,240,34,78,.436,27,59,.458,7,19,.368,12,17,.706,87
20213,2011-02-02,CHI,@,LAC,W 106-88,240,40,78,.513,28,52,.538,12,26,.462,14,20,.700,106
20214,2011-02-02,LAC,,CHI,L 88-106,240,36,77,.468,31,62,.500,5,15,.333,11,21,.524,88
20215,2011-02-02,MEM,@,MIN,W 102-84,240,43,88,.489,37,75,.493,6,13,.462,10,11,.909,102
20216,2011-02-02,MIN,,MEM,L 84-102,240,37,85,.435,32,66,.485,5,19,.263,5,10,.500,84
20217,2011-02-02,BRK,,PHI,L 92-106,240,37,80,.463,34,70,.486,3,10,.300,15,20,.750,92
20218,2011-02-02,PHI,@,NJN,W 106-92,240,41,92,.446,35,74,.473,6,18,.333,18,18,1.000,106
20219,2011-02-02,DAL,@,NYK,W 113-97,240,42,84,.500,31,59,.525,11,25,.440,18,21,.857,113
20220,2011-02-02,NYK,,DAL,L 97-113,240,37,88,.420,31,65,.477,6,23,.261,17,20,.850,97
20221,2011-02-02,NOP,@,OKC,L 93-104,240,37,83,.446,34,71,.479,3,12,.250,16,21,.762,93
20222,2011-02-02,OKC,,NOH,W 104-93,240,36,68,.529,26,44,.591,10,24,.417,22,30,.733,104
20223,2011-02-02,MIL,@,PHO,L 77-92,240,28,90,.311,23,67,.343,5,23,.217,16,20,.800,77
20224,2011-02-02,PHO,,MIL,W 92-77,240,36,72,.500,33,59,.559,3,13,.231,17,23,.739,92
20225,2011-02-02,HOU,@,UTA,W 97-96,240,34,76,.447,23,54,.426,11,22,.500,18,25,.720,97
20226,2011-02-02,UTA,,HOU,L 96-97,240,39,86,.453,38,75,.507,1,11,.091,17,23,.739,96
20227,2011-02-01,HOU,@,LAL,L 106-114 (OT),265,43,100,.430,33,62,.532,10,38,.263,10,11,.909,106
20228,2011-02-01,LAL,,HOU,W 114-106 (OT),265,44,91,.484,38,71,.535,6,20,.300,20,24,.833,114
20229,2011-02-01,NOP,,WAS,W 97-89,240,35,72,.486,31,60,.517,4,12,.333,23,30,.767,97
20230,2011-02-01,WAS,@,NOH,L 89-97,240,33,72,.458,29,58,.500,4,14,.286,19,27,.704,89
20231,2011-02-01,POR,,SAS,W 99-86,240,38,75,.507,36,62,.581,2,13,.154,21,24,.875,99
20232,2011-02-01,SAS,@,POR,L 86-99,240,35,82,.427,27,64,.422,8,18,.444,8,15,.533,86
20233,2011-02-01,BOS,@,SAC,W 95-90,240,38,85,.447,34,74,.459,4,11,.364,15,17,.882,95
20234,2011-02-01,SAC,,BOS,L 90-95,240,31,71,.437,25,60,.417,6,11,.545,22,27,.815,90
20235,2011-01-31,DAL,,WAS,W 102-92,240,34,71,.479,25,49,.510,9,22,.409,25,37,.676,102
20236,2011-01-31,WAS,@,DAL,L 92-102,240,34,86,.395,29,72,.403,5,14,.357,19,31,.613,92
20237,2011-01-31,IND,,TOR,W 104-93,240,36,81,.444,28,61,.459,8,20,.400,24,28,.857,104
20238,2011-01-31,TOR,@,IND,L 93-104,240,38,92,.413,37,86,.430,1,6,.167,16,21,.762,93
20239,2011-01-31,LAC,,MIL,W 105-98,240,39,75,.520,37,62,.597,2,13,.154,25,27,.926,105
20240,2011-01-31,MIL,@,LAC,L 98-105,240,37,75,.493,32,57,.561,5,18,.278,19,24,.792,98
20241,2011-01-31,MEM,,ORL,W 100-97,240,40,75,.533,36,65,.554,4,10,.400,16,23,.696,100
20242,2011-01-31,ORL,@,MEM,L 97-100,240,36,76,.474,28,44,.636,8,32,.250,17,23,.739,97
20243,2011-01-31,CLE,@,MIA,L 90-117,240,32,82,.390,28,69,.406,4,13,.308,22,27,.815,90
20244,2011-01-31,MIA,,CLE,W 117-90,240,43,88,.489,35,70,.500,8,18,.444,23,28,.821,117
20245,2011-01-31,DEN,@,NJN,L 99-115,240,33,65,.508,26,45,.578,7,20,.350,26,33,.788,99
20246,2011-01-31,BRK,,DEN,W 115-99,240,42,79,.532,33,64,.516,9,15,.600,22,26,.846,115
20247,2011-01-31,CHA,@,UTA,L 78-83,240,26,73,.356,20,53,.377,6,20,.300,20,27,.741,78
20248,2011-01-31,UTA,,CHA,W 83-78,240,34,76,.447,31,68,.456,3,8,.375,12,14,.857,83
20249,2011-01-30,GSW,,UTA,W 96-81,240,36,73,.493,28,53,.528,8,20,.400,16,20,.800,96
20250,2011-01-30,UTA,@,GSW,L 81-96,240,32,86,.372,28,74,.378,4,12,.333,13,18,.722,81
20251,2011-01-30,BOS,@,LAL,W 109-96,240,44,73,.603,35,56,.625,9,17,.529,12,18,.667,109
20252,2011-01-30,LAL,,BOS,L 96-109,240,36,81,.444,32,72,.444,4,9,.444,20,27,.741,96
20253,2011-01-30,DET,@,NYK,L 106-124,240,40,79,.506,28,57,.491,12,22,.545,14,21,.667,106
20254,2011-01-30,NYK,,DET,W 124-106,240,41,80,.513,35,62,.565,6,18,.333,36,41,.878,124
20255,2011-01-30,MIA,@,OKC,W 108-103,240,39,75,.520,31,57,.544,8,18,.444,22,32,.688,108
20256,2011-01-30,OKC,,MIA,L 103-108,240,34,84,.405,26,66,.394,8,18,.444,27,34,.794,103
20257,2011-01-30,CLE,@,ORL,L 87-103,240,33,76,.434,28,60,.467,5,16,.313,16,22,.727,87
20258,2011-01-30,ORL,,CLE,W 103-87,240,38,92,.413,29,61,.475,9,31,.290,18,28,.643,103
20259,2011-01-30,DEN,@,PHI,L 99-110,240,34,74,.459,24,55,.436,10,19,.526,21,24,.875,99
20260,2011-01-30,PHI,,DEN,W 110-99,240,43,78,.551,37,62,.597,6,16,.375,18,22,.818,110
20261,2011-01-30,NOP,@,PHO,L 102-104,240,40,95,.421,34,79,.430,6,16,.375,16,19,.842,102
20262,2011-01-30,PHO,,NOH,W 104-102,240,38,79,.481,29,54,.537,9,25,.360,19,21,.905,104
20263,2011-01-29,CHI,,IND,W 110-89,240,41,86,.477,35,69,.507,6,17,.353,22,25,.880,110
20264,2011-01-29,IND,@,CHI,L 89-110,240,33,81,.407,25,57,.439,8,24,.333,15,24,.625,89
20265,2011-01-29,ATL,@,DAL,L 91-102,240,35,76,.461,31,56,.554,4,20,.200,17,22,.773,91
20266,2011-01-29,DAL,,ATL,W 102-91,240,36,73,.493,28,52,.538,8,21,.381,22,27,.815,102
20267,2011-01-29,CHA,@,LAC,L 88-103,240,29,72,.403,26,59,.441,3,13,.231,27,36,.750,88
20268,2011-01-29,LAC,,CHA,W 103-88,240,37,86,.430,26,57,.456,11,29,.379,18,24,.750,103
20269,2011-01-29,MEM,,WAS,W 107-93,240,43,86,.500,41,79,.519,2,7,.286,19,23,.826,107
20270,2011-01-29,WAS,@,MEM,L 93-107,240,32,75,.427,26,60,.433,6,15,.400,23,28,.821,93
20271,2011-01-29,MIL,,NJN,W 91-81,240,32,75,.427,24,54,.444,8,21,.381,19,27,.704,91
20272,2011-01-29,BRK,@,MIL,L 81-91,240,31,77,.403,27,69,.391,4,8,.500,15,21,.714,81
20273,2011-01-29,MIN,,TOR,W 103-87,240,35,80,.438,24,52,.462,11,28,.393,22,30,.733,103
20274,2011-01-29,TOR,@,MIN,L 87-103,240,34,101,.337,31,87,.356,3,14,.214,16,22,.727,87
20275,2011-01-29,NOP,@,SAC,L 96-102,240,32,74,.432,28,58,.483,4,16,.250,28,30,.933,96
20276,2011-01-29,SAC,,NOH,W 102-96,240,41,82,.500,37,70,.529,4,12,.333,16,20,.800,102
20277,2011-01-29,HOU,@,SAS,L 95-108,240,40,86,.465,35,66,.530,5,20,.250,10,16,.625,95
20278,2011-01-29,SAS,,HOU,W 108-95,240,38,74,.514,30,58,.517,8,16,.500,24,27,.889,108
20279,2011-01-28,ATL,,NYK,W 111-102,240,42,82,.512,35,63,.556,7,19,.368,20,23,.870,111
20280,2011-01-28,NYK,@,ATL,L 102-111,240,41,87,.471,35,65,.538,6,22,.273,14,14,1.000,102
20281,2011-01-28,CHI,,ORL,W 99-90,240,37,87,.425,29,69,.420,8,18,.444,17,23,.739,99
20282,2011-01-28,ORL,@,CHI,L 90-99,240,32,78,.410,27,57,.474,5,21,.238,21,28,.750,90
20283,2011-01-28,CLE,,DEN,L 103-117,240,40,88,.455,32,62,.516,8,26,.308,15,23,.652,103
20284,2011-01-28,DEN,@,CLE,W 117-103,240,41,86,.477,31,63,.492,10,23,.435,25,35,.714,117
20285,2011-01-28,CHA,@,GSW,W 121-113 (OT),265,46,90,.511,36,64,.563,10,26,.385,19,31,.613,121
20286,2011-01-28,GSW,,CHA,L 113-121 (OT),265,41,88,.466,30,63,.476,11,25,.440,20,23,.870,113
20287,2011-01-28,IND,,NJN,W 124-92,240,50,80,.625,38,58,.655,12,22,.545,12,21,.571,124
20288,2011-01-28,BRK,@,IND,L 92-124,240,35,73,.479,32,66,.485,3,7,.429,19,25,.760,92
20289,2011-01-28,LAL,,SAC,L 95-100,240,33,80,.413,26,57,.456,7,23,.304,22,26,.846,95
20290,2011-01-28,SAC,@,LAL,W 100-95,240,42,82,.512,38,71,.535,4,11,.364,12,18,.667,100
20291,2011-01-28,DET,@,MIA,L 87-88,240,35,92,.380,27,68,.397,8,24,.333,9,11,.818,87
20292,2011-01-28,MIA,,DET,W 88-87,240,33,73,.452,28,49,.571,5,24,.208,17,22,.773,88
20293,2011-01-28,OKC,,WAS,W 124-117 (2OT),290,44,89,.494,39,68,.574,5,21,.238,31,41,.756,124
20294,2011-01-28,WAS,@,OKC,L 117-124 (2OT),290,46,108,.426,40,90,.444,6,18,.333,19,28,.679,117
20295,2011-01-28,MEM,@,PHI,W 99-94,240,37,82,.451,36,77,.468,1,5,.200,24,26,.923,99
20296,2011-01-28,PHI,,MEM,L 94-99,240,35,76,.461,22,56,.393,13,20,.650,11,15,.733,94
20297,2011-01-28,BOS,@,PHO,L 71-88,240,27,79,.342,25,61,.410,2,18,.111,15,23,.652,71
20298,2011-01-28,PHO,,BOS,W 88-71,240,32,74,.432,26,57,.456,6,17,.353,18,26,.692,88
20299,2011-01-28,MIL,@,TOR,W 116-110 (OT),265,42,76,.553,36,61,.590,6,15,.400,26,35,.743,116
20300,2011-01-28,TOR,,MIL,L 110-116 (OT),265,43,92,.467,42,82,.512,1,10,.100,23,28,.821,110
20301,2011-01-28,MIN,@,UTA,L 100-108,240,36,77,.468,28,57,.491,8,20,.400,20,24,.833,100
20302,2011-01-28,UTA,,MIN,W 108-100,240,41,93,.441,35,75,.467,6,18,.333,20,26,.769,108
20303,2011-01-27,DAL,,HOU,W 111-106,240,41,82,.500,35,66,.530,6,16,.375,23,25,.920,111
20304,2011-01-27,HOU,@,DAL,L 106-111,240,39,84,.464,31,62,.500,8,22,.364,20,25,.800,106
20305,2011-01-27,MIA,@,NYK,L 88-93,240,30,72,.417,25,53,.472,5,19,.263,23,33,.697,88
20306,2011-01-27,NYK,,MIA,W 93-88,240,30,83,.361,20,50,.400,10,33,.303,23,28,.821,93
20307,2011-01-27,BOS,@,POR,W 88-78,240,30,64,.469,25,47,.532,5,17,.294,23,33,.697,88
20308,2011-01-27,POR,,BOS,L 78-88,240,33,90,.367,29,74,.392,4,16,.250,8,13,.615,78
20309,2011-01-26,DEN,@,DET,W 109-100,240,38,80,.475,27,53,.509,11,27,.407,22,27,.815,109
20310,2011-01-26,DET,,DEN,L 100-109,240,35,79,.443,30,64,.469,5,15,.333,25,32,.781,100
20311,2011-01-26,GSW,,NOH,L 103-112,240,38,75,.507,34,62,.548,4,13,.308,23,26,.885,103
20312,2011-01-26,NOP,@,GSW,W 112-103,240,46,74,.622,41,61,.672,5,13,.385,15,19,.789,112
20313,2011-01-26,HOU,,LAC,W 96-83,240,36,87,.414,29,62,.468,7,25,.280,17,20,.850,96
20314,2011-01-26,LAC,@,HOU,L 83-96,240,32,88,.364,29,70,.414,3,18,.167,16,22,.727,83
20315,2011-01-26,IND,,ORL,L 96-111,240,35,85,.412,27,55,.491,8,30,.267,18,26,.692,96
20316,2011-01-26,ORL,@,IND,W 111-96,240,41,82,.500,25,48,.521,16,34,.471,13,19,.684,111
20317,2011-01-26,ATL,@,MIL,L 90-98,240,33,79,.418,26,60,.433,7,19,.368,17,23,.739,90
20318,2011-01-26,MIL,,ATL,W 98-90,240,35,81,.432,25,61,.410,10,20,.500,18,23,.783,98
20319,2011-01-26,MIN,,OKC,L 117-118 (OT),265,46,99,.465,39,80,.488,7,19,.368,18,25,.720,117
20320,2011-01-26,OKC,@,MIN,W 118-117 (OT),265,42,93,.452,34,72,.472,8,21,.381,26,27,.963,118
20321,2011-01-26,MEM,@,NJN,L 88-93,240,35,80,.438,33,68,.485,2,12,.167,16,21,.762,88
20322,2011-01-26,BRK,,MEM,W 93-88,240,36,82,.439,27,65,.415,9,17,.529,12,14,.857,93
20323,2011-01-26,CHA,@,PHO,W 114-107,240,40,79,.506,31,62,.500,9,17,.529,25,29,.862,114
20324,2011-01-26,PHO,,CHA,L 107-114,240,41,89,.461,25,57,.439,16,32,.500,9,10,.900,107
20325,2011-01-26,PHI,@,TOR,W 107-94,240,44,89,.494,40,74,.541,4,15,.267,15,17,.882,107
20326,2011-01-26,TOR,,PHI,L 94-107,240,37,76,.487,35,68,.515,2,8,.250,18,22,.818,94
20327,2011-01-26,SAS,@,UTA,W 112-105,240,41,80,.513,34,60,.567,7,20,.350,23,29,.793,112
20328,2011-01-26,UTA,,SAS,L 105-112,240,41,75,.547,39,63,.619,2,12,.167,21,28,.750,105
20329,2011-01-25,BOS,,CLE,W 112-95,240,42,84,.500,31,60,.517,11,24,.458,17,25,.680,112
20330,2011-01-25,CLE,@,BOS,L 95-112,240,37,80,.463,32,69,.464,5,11,.455,16,25,.640,95
20331,2011-01-25,DAL,,LAC,W 112-105,240,37,74,.500,27,50,.540,10,24,.417,28,30,.933,112
20332,2011-01-25,LAC,@,DAL,L 105-112,240,39,70,.557,29,50,.580,10,20,.500,17,28,.607,105
20333,2011-01-25,LAL,,UTA,W 120-91,240,44,71,.620,36,53,.679,8,18,.444,24,29,.828,120
20334,2011-01-25,UTA,@,LAL,L 91-120,240,36,86,.419,30,70,.429,6,16,.375,13,17,.765,91
20335,2011-01-25,CHA,@,SAC,W 94-89,240,32,71,.451,29,63,.460,3,8,.375,27,36,.750,94
20336,2011-01-25,SAC,,CHA,L 89-94,240,32,89,.360,31,77,.403,1,12,.083,24,29,.828,89
20337,2011-01-25,DEN,@,WAS,W 120-109,240,41,81,.506,29,58,.500,12,23,.522,26,32,.813,120
20338,2011-01-25,WAS,,DEN,L 109-120,240,42,82,.512,40,69,.580,2,13,.154,23,27,.852,109
20339,2011-01-24,CHI,,MIL,W 92-83,240,32,81,.395,26,63,.413,6,18,.333,22,25,.880,92
20340,2011-01-24,MIL,@,CHI,L 83-92,240,35,76,.461,30,63,.476,5,13,.385,8,11,.727,83
20341,2011-01-24,GSW,,SAS,L 102-113,240,39,85,.459,34,70,.486,5,15,.333,19,20,.950,102
20342,2011-01-24,SAS,@,GSW,W 113-102,240,41,82,.500,36,67,.537,5,15,.333,26,34,.765,113
20343,2011-01-24,HOU,@,MIN,W 129-125,240,43,87,.494,29,57,.509,14,30,.467,29,36,.806,129
20344,2011-01-24,MIN,,HOU,L 125-129,240,46,91,.505,36,71,.507,10,20,.500,23,28,.821,125
20345,2011-01-24,CLE,@,NJN,L 101-103,240,38,84,.452,33,70,.471,5,14,.357,20,24,.833,101
20346,2011-01-24,BRK,,CLE,W 103-101,240,37,83,.446,30,70,.429,7,13,.538,22,29,.759,103
20347,2011-01-24,NOP,,OKC,W 91-89,240,35,77,.455,31,62,.500,4,15,.267,17,23,.739,91
20348,2011-01-24,OKC,@,NOH,L 89-91,240,33,71,.465,27,55,.491,6,16,.375,17,20,.850,89
20349,2011-01-24,NYK,,WAS,W 115-106,240,42,91,.462,32,62,.516,10,29,.345,21,29,.724,115
20350,2011-01-24,WAS,@,NYK,L 106-115,240,40,83,.482,36,70,.514,4,13,.308,22,28,.786,106
20351,2011-01-24,DET,@,ORL,W 103-96,240,37,81,.457,30,67,.448,7,14,.500,22,33,.667,103
20352,2011-01-24,ORL,,DET,L 96-103,240,33,73,.452,26,46,.565,7,27,.259,23,34,.676,96
20353,2011-01-24,PHI,,PHO,W 105-95,240,44,81,.543,41,68,.603,3,13,.231,14,14,1.000,105
20354,2011-01-24,PHO,@,PHI,L 95-105,240,40,78,.513,35,61,.574,5,17,.294,10,12,.833,95
20355,2011-01-24,POR,,SAC,L 81-96,240,34,86,.395,29,71,.408,5,15,.333,8,11,.727,81
20356,2011-01-24,SAC,@,POR,W 96-81,240,38,76,.500,33,67,.493,5,9,.556,15,20,.750,96
20357,2011-01-24,MEM,@,TOR,W 100-98,240,41,93,.441,37,82,.451,4,11,.364,14,20,.700,100
20358,2011-01-24,TOR,,MEM,L 98-100,240,40,84,.476,40,71,.563,0,13,.000,18,24,.750,98
20359,2011-01-23,DEN,,IND,W 121-107,240,47,92,.511,36,72,.500,11,20,.550,16,21,.762,121
20360,2011-01-23,IND,@,DEN,L 107-121,240,37,87,.425,28,66,.424,9,21,.429,24,29,.828,107
20361,2011-01-22,ATL,@,CHA,W 103-87,240,37,73,.507,28,54,.519,9,19,.474,20,23,.870,103
20362,2011-01-22,CHA,,ATL,L 87-103,240,36,77,.468,30,59,.508,6,18,.333,9,12,.750,87
20363,2011-01-22,CHI,,CLE,W 92-79,240,34,82,.415,25,63,.397,9,19,.474,15,20,.750,92
20364,2011-01-22,CLE,@,CHI,L 79-92,240,27,84,.321,21,64,.328,6,20,.300,19,28,.679,79
20365,2011-01-22,DET,,PHO,W 75-74,240,29,81,.358,26,71,.366,3,10,.300,14,17,.824,75
20366,2011-01-22,PHO,@,DET,L 74-75,240,30,74,.405,23,47,.489,7,27,.259,7,9,.778,74
20367,2011-01-22,HOU,,ORL,L 104-118,240,37,95,.389,29,68,.426,8,27,.296,22,25,.880,104
20368,2011-01-22,ORL,@,HOU,W 118-104,240,46,87,.529,33,55,.600,13,32,.406,13,19,.684,118
20369,2011-01-22,GSW,@,LAC,L 109-113,240,39,85,.459,30,58,.517,9,27,.333,22,27,.815,109
20370,2011-01-22,LAC,,GSW,W 113-109,240,37,85,.435,30,52,.577,7,33,.212,32,40,.800,113
20371,2011-01-22,MIA,,TOR,W 120-103,240,42,80,.525,26,54,.481,16,26,.615,20,26,.769,120
20372,2011-01-22,TOR,@,MIA,L 103-120,240,38,81,.469,33,73,.452,5,8,.625,22,24,.917,103
20373,2011-01-22,MEM,@,MIL,W 94-81,240,37,72,.514,35,64,.547,2,8,.250,18,23,.783,94
20374,2011-01-22,MIL,,MEM,L 81-94,240,34,90,.378,29,70,.414,5,20,.250,8,12,.667,81
20375,2011-01-22,DAL,@,NJN,W 87-86,240,26,75,.347,18,54,.333,8,21,.381,27,29,.931,87
20376,2011-01-22,BRK,,DAL,L 86-87,240,32,72,.444,27,57,.474,5,15,.333,17,21,.810,86
20377,2011-01-22,NOP,,SAS,W 96-72,240,38,81,.469,26,66,.394,12,15,.800,8,15,.533,96
20378,2011-01-22,SAS,@,NOH,L 72-96,240,25,69,.362,21,54,.389,4,15,.267,18,25,.720,72
20379,2011-01-22,NYK,@,OKC,L 98-101,240,37,86,.430,28,60,.467,9,26,.346,15,21,.714,98
20380,2011-01-22,OKC,,NYK,W 101-98,240,34,88,.386,29,71,.408,5,17,.294,28,34,.824,101
20381,2011-01-22,PHI,,UTA,W 96-85,240,33,81,.407,27,66,.409,6,15,.400,24,31,.774,96
20382,2011-01-22,UTA,@,PHI,L 85-96,240,34,81,.420,30,65,.462,4,16,.250,13,17,.765,85
20383,2011-01-22,IND,@,POR,L 92-97,240,36,76,.474,30,58,.517,6,18,.333,14,18,.778,92
20384,2011-01-22,POR,,IND,W 97-92,240,35,83,.422,25,63,.397,10,20,.500,17,20,.850,97
20385,2011-01-22,BOS,@,WAS,L 83-85,240,34,79,.430,30,64,.469,4,15,.267,11,18,.611,83
20386,2011-01-22,WAS,,BOS,W 85-83,240,33,77,.429,32,68,.471,1,9,.111,18,26,.692,85
20387,2011-01-21,ATL,,NOH,L 59-100,240,23,79,.291,19,59,.322,4,20,.200,9,11,.818,59
20388,2011-01-21,NOP,@,ATL,W 100-59,240,36,75,.480,28,60,.467,8,15,.533,20,22,.909,100
20389,2011-01-21,BOS,,UTA,W 110-86,240,37,67,.552,28,46,.609,9,21,.429,27,31,.871,110
20390,2011-01-21,UTA,@,BOS,L 86-110,240,28,70,.400,24,57,.421,4,13,.308,26,34,.765,86
20391,2011-01-21,CLE,,MIL,L 88-102,240,26,68,.382,22,61,.361,4,7,.571,32,40,.800,88
20392,2011-01-21,MIL,@,CLE,W 102-88,240,39,77,.506,35,61,.574,4,16,.250,20,24,.833,102
20393,2011-01-21,DEN,,LAL,L 97-107,240,37,78,.474,30,57,.526,7,21,.333,16,20,.800,97
20394,2011-01-21,LAL,@,DEN,W 107-97,240,47,88,.534,43,72,.597,4,16,.250,9,14,.643,107
20395,2011-01-21,GSW,,SAC,W 119-112 (OT),265,49,95,.516,45,77,.584,4,18,.222,17,20,.850,119
20396,2011-01-21,SAC,@,GSW,L 112-119 (OT),265,42,94,.447,39,82,.476,3,12,.250,25,37,.676,112
20397,2011-01-21,HOU,@,MEM,L 110-115,240,38,83,.458,30,60,.500,8,23,.348,26,31,.839,110
20398,2011-01-21,MEM,,HOU,W 115-110,240,49,92,.533,49,88,.557,0,4,.000,17,21,.810,115
20399,2011-01-21,DET,@,NJN,L 74-89,240,25,75,.333,21,63,.333,4,12,.333,20,29,.690,74
20400,2011-01-21,BRK,,DET,W 89-74,240,36,72,.500,31,61,.508,5,11,.455,12,14,.857,89
20401,2011-01-21,ORL,,TOR,W 112-72,240,42,89,.472,33,62,.532,9,27,.333,19,27,.704,112
20402,2011-01-21,TOR,@,ORL,L 72-112,240,29,82,.354,25,67,.373,4,15,.267,10,17,.588,72
20403,2011-01-21,NYK,@,SAS,L 92-101,240,37,98,.378,31,83,.373,6,15,.400,12,12,1.000,92
20404,2011-01-21,SAS,,NYK,W 101-92,240,40,82,.488,36,65,.554,4,17,.235,17,25,.680,101
20405,2011-01-21,PHO,@,WAS,W 109-91,240,41,86,.477,30,62,.484,11,24,.458,16,19,.842,109
20406,2011-01-21,WAS,,PHO,L 91-109,240,37,91,.407,30,73,.411,7,18,.389,10,13,.769,91
20407,2011-01-20,CHA,,PHI,W 100-97,240,38,79,.481,34,68,.500,4,11,.364,20,26,.769,100
20408,2011-01-20,PHI,@,CHA,L 97-100,240,39,85,.459,36,71,.507,3,14,.214,16,22,.727,97
20409,2011-01-20,CHI,,DAL,W 82-77,240,31,84,.369,24,68,.353,7,16,.438,13,16,.813,82
20410,2011-01-20,DAL,@,CHI,L 77-82,240,26,73,.356,19,51,.373,7,22,.318,18,22,.818,77
20411,2011-01-20,LAC,@,POR,L 93-108,240,35,81,.432,26,55,.473,9,26,.346,14,21,.667,93
20412,2011-01-20,POR,,LAC,W 108-93,240,44,78,.564,37,62,.597,7,16,.438,13,19,.684,108
20413,2011-01-19,BOS,,DET,W 86-82,240,34,76,.447,30,62,.484,4,14,.286,14,25,.560,86
20414,2011-01-19,DET,@,BOS,L 82-86,240,31,74,.419,27,59,.458,4,15,.267,16,22,.727,82
20415,2011-01-19,CLE,,PHO,L 98-106,240,36,83,.434,27,62,.435,9,21,.429,17,20,.850,98
20416,2011-01-19,PHO,@,CLE,W 106-98,240,40,85,.471,34,66,.515,6,19,.316,20,21,.952,106
20417,2011-01-19,DAL,,LAL,W 109-100,240,44,80,.550,32,54,.593,12,26,.462,9,13,.692,109
20418,2011-01-19,LAL,@,DAL,L 100-109,240,44,81,.543,38,65,.585,6,16,.375,6,7,.857,100
20419,2011-01-19,DEN,,OKC,W 112-107,240,42,82,.512,38,66,.576,4,16,.250,24,33,.727,112
20420,2011-01-19,OKC,@,DEN,L 107-112,240,40,83,.482,37,68,.544,3,15,.200,24,29,.828,107
20421,2011-01-19,GSW,,IND,W 110-108,240,45,88,.511,39,72,.542,6,16,.375,14,19,.737,110
20422,2011-01-19,IND,@,GSW,L 108-110,240,37,81,.457,28,59,.475,9,22,.409,25,29,.862,108
20423,2011-01-19,HOU,,NYK,W 104-89,240,41,87,.471,33,56,.589,8,31,.258,14,16,.875,104
20424,2011-01-19,NYK,@,HOU,L 89-104,240,35,83,.422,27,59,.458,8,24,.333,11,15,.733,89
20425,2011-01-19,LAC,,MIN,W 126-111,240,44,89,.494,32,68,.471,12,21,.571,26,36,.722,126
20426,2011-01-19,MIN,@,LAC,L 111-126,240,41,82,.500,40,66,.606,1,16,.063,28,33,.848,111
20427,2011-01-19,MIL,,WAS,W 100-87,240,35,73,.479,30,63,.476,5,10,.500,25,32,.781,100
20428,2011-01-19,WAS,@,MIL,L 87-100,240,35,79,.443,33,68,.485,2,11,.182,15,20,.750,87
20429,2011-01-19,BRK,,UTA,W 103-95,240,34,69,.493,26,53,.491,8,16,.500,27,34,.794,103
20430,2011-01-19,UTA,@,NJN,L 95-103,240,32,77,.416,27,63,.429,5,14,.357,26,30,.867,95
20431,2011-01-19,MEM,@,NOH,L 102-103 (OT),265,42,91,.462,36,79,.456,6,12,.500,12,15,.800,102
20432,2011-01-19,NOP,,MEM,W 103-102 (OT),265,39,81,.481,35,69,.507,4,12,.333,21,28,.750,103
20433,2011-01-19,ORL,,PHI,W 99-98 (OT),265,34,75,.453,26,51,.510,8,24,.333,23,41,.561,99
20434,2011-01-19,PHI,@,ORL,L 98-99 (OT),265,36,84,.429,33,70,.471,3,14,.214,23,32,.719,98
20435,2011-01-19,POR,@,SAC,W 94-90 (OT),265,38,88,.432,32,72,.444,6,16,.375,12,13,.923,94
20436,2011-01-19,SAC,,POR,L 90-94 (OT),265,35,82,.427,30,64,.469,5,18,.278,15,22,.682,90
20437,2011-01-19,SAS,,TOR,W 104-95,240,38,83,.458,34,67,.507,4,16,.250,24,29,.828,104
20438,2011-01-19,TOR,@,SAS,L 95-104,240,36,82,.439,33,74,.446,3,8,.375,20,25,.800,95
20439,2011-01-18,CHA,@,CHI,W 83-82,240,35,87,.402,35,74,.473,0,13,.000,13,20,.650,83
20440,2011-01-18,CHI,,CHA,L 82-83,240,30,77,.390,24,65,.369,6,12,.500,16,21,.762,82
20441,2011-01-18,ATL,@,MIA,W 93-89 (OT),265,38,95,.400,31,64,.484,7,31,.226,10,14,.714,93
20442,2011-01-18,MIA,,ATL,L 89-93 (OT),265,28,77,.364,21,47,.447,7,30,.233,26,29,.897,89
20443,2011-01-17,ATL,,SAC,W 100-98,240,39,83,.470,34,63,.540,5,20,.250,17,20,.850,100
20444,2011-01-17,SAC,@,ATL,L 98-100,240,41,92,.446,40,83,.482,1,9,.111,15,22,.682,98
20445,2011-01-17,BOS,,ORL,W 109-106,240,42,70,.600,39,60,.650,3,10,.300,22,26,.846,109
20446,2011-01-17,ORL,@,BOS,L 106-109,240,34,74,.459,23,47,.489,11,27,.407,27,36,.750,106
20447,2011-01-17,DAL,@,DET,L 89-103,240,34,73,.466,25,48,.521,9,25,.360,12,17,.706,89
20448,2011-01-17,DET,,DAL,W 103-89,240,42,73,.575,38,61,.623,4,12,.333,15,19,.789,103
20449,2011-01-17,GSW,,NJN,W 109-100,240,41,83,.494,35,65,.538,6,18,.333,21,28,.750,109
20450,2011-01-17,BRK,@,GSW,L 100-109,240,39,80,.488,36,66,.545,3,14,.214,19,24,.792,100
20451,2011-01-17,HOU,,MIL,W 93-84,240,35,95,.368,34,84,.405,1,11,.091,22,28,.786,93
20452,2011-01-17,MIL,@,HOU,L 84-93,240,37,84,.440,32,69,.464,5,15,.333,5,11,.455,84
20453,2011-01-17,IND,@,LAC,L 107-114,240,34,74,.459,23,49,.469,11,25,.440,28,31,.903,107
20454,2011-01-17,LAC,,IND,W 114-107,240,44,81,.543,37,65,.569,7,16,.438,19,26,.731,114
20455,2011-01-17,LAL,,OKC,W 101-94,240,38,76,.500,31,62,.500,7,14,.500,18,26,.692,101
20456,2011-01-17,OKC,@,LAL,L 94-101,240,37,87,.425,35,65,.538,2,22,.091,18,22,.818,94
20457,2011-01-17,CHI,@,MEM,W 96-84,240,36,74,.486,25,51,.490,11,23,.478,13,19,.684,96
20458,2011-01-17,MEM,,CHI,L 84-96,240,29,77,.377,28,70,.400,1,7,.143,25,35,.714,84
20459,2011-01-17,NOP,,TOR,W 85-81,240,34,87,.391,32,75,.427,2,12,.167,15,19,.789,85
20460,2011-01-17,TOR,@,NOH,L 81-85,240,33,74,.446,31,61,.508,2,13,.154,13,20,.650,81
20461,2011-01-17,NYK,,PHO,L 121-129,240,45,92,.489,34,61,.557,11,31,.355,20,25,.800,121
20462,2011-01-17,PHO,@,NYK,W 129-121,240,45,91,.495,34,70,.486,11,21,.524,28,31,.903,129
20463,2011-01-17,CHA,@,PHI,L 92-96 (OT),265,34,95,.358,27,65,.415,7,30,.233,17,23,.739,92
20464,2011-01-17,PHI,,CHA,W 96-92 (OT),265,36,93,.387,30,79,.380,6,14,.429,18,25,.720,96
20465,2011-01-17,MIN,@,POR,L 102-113,240,38,88,.432,35,73,.479,3,15,.200,23,34,.676,102
20466,2011-01-17,POR,,MIN,W 113-102,240,38,84,.452,32,66,.485,6,18,.333,31,36,.861,113
20467,2011-01-17,UTA,@,WAS,L 101-108,240,36,80,.450,22,53,.415,14,27,.519,15,22,.682,101
20468,2011-01-17,WAS,,UTA,W 108-101,240,38,71,.535,32,57,.561,6,14,.429,26,31,.839,108
20469,2011-01-16,LAC,,LAL,W 99-92,240,38,87,.437,29,66,.439,9,21,.429,14,23,.609,99
20470,2011-01-16,LAL,@,LAC,L 92-99,240,31,75,.413,28,55,.509,3,20,.150,27,33,.818,92
20471,2011-01-16,DEN,@,SAS,L 97-110,240,37,86,.430,31,70,.443,6,16,.375,17,24,.708,97
20472,2011-01-16,SAS,,DEN,W 110-97,240,35,68,.515,24,46,.522,11,22,.500,29,37,.784,110
20473,2011-01-15,ATL,,HOU,L 106-112,240,43,87,.494,33,61,.541,10,26,.385,10,12,.833,106
20474,2011-01-15,HOU,@,ATL,W 112-106,240,47,87,.540,40,67,.597,7,20,.350,11,11,1.000,112
20475,2011-01-15,CHA,,NOH,L 81-88,240,28,69,.406,23,54,.426,5,15,.333,20,26,.769,81
20476,2011-01-15,NOP,@,CHA,W 88-81,240,32,71,.451,28,60,.467,4,11,.364,20,25,.800,88
20477,2011-01-15,CHI,,MIA,W 99-96,240,39,84,.464,32,65,.492,7,19,.368,14,17,.824,99
20478,2011-01-15,MIA,@,CHI,L 96-99,240,34,77,.442,21,49,.429,13,28,.464,15,20,.750,96
20479,2011-01-15,CLE,@,DEN,L 99-127,240,37,98,.378,33,79,.418,4,19,.211,21,28,.750,99
20480,2011-01-15,DEN,,CLE,W 127-99,240,49,84,.583,36,63,.571,13,21,.619,16,22,.727,127
20481,2011-01-15,DET,,SAC,W 110-106,240,43,77,.558,41,69,.594,2,8,.250,22,29,.759,110
20482,2011-01-15,SAC,@,DET,L 106-110,240,43,84,.512,37,71,.521,6,13,.462,14,27,.519,106
20483,2011-01-15,DAL,@,MEM,L 70-89,240,24,74,.324,18,43,.419,6,31,.194,16,23,.696,70
20484,2011-01-15,MEM,,DAL,W 89-70,240,36,76,.474,33,64,.516,3,12,.250,14,15,.933,89
20485,2011-01-15,MIN,,ORL,L 99-108,240,37,84,.440,30,63,.476,7,21,.333,18,22,.818,99
20486,2011-01-15,ORL,@,MIN,W 108-99,240,36,81,.444,25,52,.481,11,29,.379,25,29,.862,108
20487,2011-01-15,BRK,@,POR,L 89-96,240,38,76,.500,36,64,.563,2,12,.167,11,12,.917,89
20488,2011-01-15,POR,,NJN,W 96-89,240,36,79,.456,32,63,.508,4,16,.250,20,25,.800,96
20489,2011-01-15,TOR,@,WAS,L 95-98,240,40,85,.471,36,75,.480,4,10,.400,11,15,.733,95
20490,2011-01-15,WAS,,TOR,W 98-95,240,39,85,.459,34,73,.466,5,12,.417,15,17,.882,98
20491,2011-01-14,BOS,,CHA,W 99-94,240,36,69,.522,28,50,.560,8,19,.421,19,25,.760,99
20492,2011-01-14,CHA,@,BOS,L 94-99,240,32,76,.421,29,67,.433,3,9,.333,27,34,.794,94
20493,2011-01-14,GSW,,LAC,W 122-112,240,43,82,.524,29,56,.518,14,26,.538,22,24,.917,122
20494,2011-01-14,LAC,@,GSW,L 112-122,240,45,85,.529,42,71,.592,3,14,.214,19,26,.731,112
20495,2011-01-14,HOU,,NOH,L 105-110 (OT),265,37,84,.440,30,65,.462,7,19,.368,24,31,.774,105
20496,2011-01-14,NOP,@,HOU,W 110-105 (OT),265,39,82,.476,35,71,.493,4,11,.364,28,31,.903,110
20497,2011-01-14,CHI,@,IND,W 99-86,240,40,88,.455,33,68,.485,7,20,.350,12,19,.632,99
20498,2011-01-14,IND,,CHI,L 86-99,240,30,92,.326,23,74,.311,7,18,.389,19,24,.792,86
20499,2011-01-14,LAL,,NJN,W 100-88,240,35,71,.493,30,58,.517,5,13,.385,25,35,.714,100
20500,2011-01-14,BRK,@,LAL,L 88-100,240,36,85,.424,31,66,.470,5,19,.263,11,17,.647,88
20501,2011-01-14,NYK,,SAC,L 83-93,240,29,92,.315,20,64,.313,9,28,.321,16,20,.800,83
20502,2011-01-14,SAC,@,NYK,W 93-83,240,39,92,.424,34,79,.430,5,13,.385,10,13,.769,93
20503,2011-01-14,MIL,@,PHI,L 94-95,240,38,80,.475,33,66,.500,5,14,.357,13,17,.765,94
20504,2011-01-14,PHI,,MIL,W 95-94,240,36,63,.571,29,49,.592,7,14,.500,16,23,.696,95
20505,2011-01-14,PHO,,POR,W 115-111,240,42,78,.538,32,59,.542,10,19,.526,21,32,.656,115
20506,2011-01-14,POR,@,PHO,L 111-115,240,39,81,.481,31,64,.484,8,17,.471,25,33,.758,111
20507,2011-01-14,DAL,@,SAS,L 89-101,240,36,83,.434,30,70,.429,6,13,.462,11,18,.611,89
20508,2011-01-14,SAS,,DAL,W 101-89,240,36,80,.450,30,64,.469,6,16,.375,23,29,.793,101
20509,2011-01-14,DET,@,TOR,W 101-95,240,37,83,.446,31,70,.443,6,13,.462,21,28,.750,101
20510,2011-01-14,TOR,,DET,L 95-101,240,38,80,.475,34,63,.540,4,17,.235,15,23,.652,95
20511,2011-01-14,CLE,@,UTA,L 99-121,240,39,80,.488,30,59,.508,9,21,.429,12,21,.571,99
20512,2011-01-14,UTA,,CLE,W 121-99,240,47,90,.522,37,70,.529,10,20,.500,17,23,.739,121
20513,2011-01-13,DEN,,MIA,W 130-102,240,49,92,.533,34,61,.557,15,31,.484,17,22,.773,130
20514,2011-01-13,MIA,@,DEN,L 102-130,240,41,89,.461,31,66,.470,10,23,.435,10,18,.556,102
20515,2011-01-13,MIN,,WAS,W 109-97,240,40,89,.449,28,69,.406,12,20,.600,17,20,.850,109
20516,2011-01-13,WAS,@,MIN,L 97-109,240,37,78,.474,29,58,.500,8,20,.400,15,18,.833,97
20517,2011-01-13,OKC,,ORL,W 125-124,240,44,78,.564,37,64,.578,7,14,.500,30,37,.811,125
20518,2011-01-13,ORL,@,OKC,L 124-125,240,41,90,.456,27,62,.435,14,28,.500,28,37,.757,124
20519,2011-01-12,BOS,,SAC,W 119-95,240,50,96,.521,38,76,.500,12,20,.600,7,11,.636,119
20520,2011-01-12,SAC,@,BOS,L 95-119,240,36,70,.514,34,57,.596,2,13,.154,21,28,.750,95
20521,2011-01-12,CHA,,CHI,W 96-91,240,35,81,.432,29,60,.483,6,21,.286,20,27,.741,96
20522,2011-01-12,CHI,@,CHA,L 91-96,240,33,70,.471,29,59,.492,4,11,.364,21,27,.778,91
20523,2011-01-12,DET,,MEM,L 99-107,240,36,82,.439,30,61,.492,6,21,.286,21,26,.808,99
20524,2011-01-12,MEM,@,DET,W 107-99,240,37,71,.521,34,62,.548,3,9,.333,30,39,.769,107
20525,2011-01-12,GSW,,LAL,L 110-115,240,44,87,.506,31,57,.544,13,30,.433,9,11,.818,110
20526,2011-01-12,LAL,@,GSW,W 115-110,240,42,82,.512,37,66,.561,5,16,.313,26,29,.897,115
20527,2011-01-12,HOU,,OKC,L 112-118,240,47,96,.490,42,78,.538,5,18,.278,13,18,.722,112
20528,2011-01-12,OKC,@,HOU,W 118-112,240,43,84,.512,37,70,.529,6,14,.429,26,33,.788,118
20529,2011-01-12,DAL,@,IND,L 89-102,240,33,80,.413,24,58,.414,9,22,.409,14,19,.737,89
20530,2011-01-12,IND,,DAL,W 102-89,240,37,83,.446,29,59,.492,8,24,.333,20,22,.909,102
20531,2011-01-12,LAC,,MIA,W 111-105,240,42,84,.500,36,68,.529,6,16,.375,21,34,.618,111
20532,2011-01-12,MIA,@,LAC,L 105-111,240,37,88,.420,29,61,.475,8,27,.296,23,30,.767,105
20533,2011-01-12,MIL,,SAS,L 84-91,240,32,81,.395,29,72,.403,3,9,.333,17,20,.850,84
20534,2011-01-12,SAS,@,MIL,W 91-84,240,37,80,.463,30,62,.484,7,18,.389,10,13,.769,91
20535,2011-01-12,NOP,,ORL,W 92-89 (OT),265,38,87,.437,33,69,.478,5,18,.278,11,19,.579,92
20536,2011-01-12,ORL,@,NOH,L 89-92 (OT),265,36,92,.391,24,61,.393,12,31,.387,5,10,.500,89
20537,2011-01-12,BRK,@,PHO,L 109-118 (OT),265,42,88,.477,34,63,.540,8,25,.320,17,22,.773,109
20538,2011-01-12,PHO,,NJN,W 118-109 (OT),265,38,82,.463,31,63,.492,7,19,.368,35,42,.833,118
20539,2011-01-12,ATL,@,TOR,W 104-101,240,35,80,.438,26,50,.520,9,30,.300,25,31,.806,104
20540,2011-01-12,TOR,,ATL,L 101-104,240,44,81,.543,40,69,.580,4,12,.333,9,12,.750,101
20541,2011-01-12,NYK,@,UTA,L 125-131,240,39,77,.506,25,48,.521,14,29,.483,33,38,.868,125
20542,2011-01-12,UTA,,NYK,W 131-125,240,45,77,.584,35,55,.636,10,22,.455,31,39,.795,131
20543,2011-01-11,DEN,,PHO,W 132-98,240,44,79,.557,37,62,.597,7,17,.412,37,43,.860,132
20544,2011-01-11,PHO,@,DEN,L 98-132,240,32,87,.368,25,65,.385,7,22,.318,27,37,.730,98
20545,2011-01-11,CLE,@,LAL,L 57-112,240,23,77,.299,22,63,.349,1,14,.071,10,16,.625,57
20546,2011-01-11,LAL,,CLE,W 112-57,240,46,86,.535,36,66,.545,10,20,.500,10,15,.667,112
20547,2011-01-11,MIN,,SAS,L 96-107,240,34,90,.378,26,67,.388,8,23,.348,20,24,.833,96
20548,2011-01-11,SAS,@,MIN,W 107-96,240,37,79,.468,26,57,.456,11,22,.500,22,28,.786,107
20549,2011-01-11,IND,@,PHI,W 111-103,240,46,90,.511,38,74,.514,8,16,.500,11,11,1.000,111
20550,2011-01-11,PHI,,IND,L 103-111,240,41,86,.477,34,68,.500,7,18,.389,14,17,.824,103
20551,2011-01-11,NYK,@,POR,W 100-86,240,42,83,.506,37,71,.521,5,12,.417,11,15,.733,100
20552,2011-01-11,POR,,NYK,L 86-100,240,29,84,.345,25,66,.379,4,18,.222,24,28,.857,86
20553,2011-01-11,SAC,@,WAS,L 133-136 (OT),265,53,108,.491,46,88,.523,7,20,.350,20,25,.800,133
20554,2011-01-11,WAS,,SAC,W 136-133 (OT),265,47,95,.495,38,78,.487,9,17,.529,33,39,.846,136
20555,2011-01-10,BOS,,HOU,L 102-108,240,38,75,.507,33,62,.532,5,13,.385,21,23,.913,102
20556,2011-01-10,HOU,@,BOS,W 108-102,240,39,74,.527,29,54,.537,10,20,.500,20,26,.769,108
20557,2011-01-10,CHA,,MEM,W 96-82,240,37,72,.514,30,52,.577,7,20,.350,15,21,.714,96
20558,2011-01-10,MEM,@,CHA,L 82-96,240,34,87,.391,32,77,.416,2,10,.200,12,22,.545,82
20559,2011-01-10,CHI,,DET,W 95-82,240,35,77,.455,33,66,.500,2,11,.182,23,25,.920,95
20560,2011-01-10,DET,@,CHI,L 82-95,240,31,80,.388,26,62,.419,5,18,.278,15,22,.682,82
20561,2011-01-09,DEN,,NOH,L 87-96,240,30,74,.405,25,53,.472,5,21,.238,22,33,.667,87
20562,2011-01-09,NOP,@,DEN,W 96-87,240,35,74,.473,29,59,.492,6,15,.400,20,21,.952,96
20563,2011-01-09,GSW,@,LAC,L 91-105,240,32,82,.390,25,60,.417,7,22,.318,20,28,.714,91
20564,2011-01-09,LAC,,GSW,W 105-91,240,34,86,.395,30,69,.435,4,17,.235,33,43,.767,105
20565,2011-01-09,LAL,,NYK,W 109-87,240,38,91,.418,30,74,.405,8,17,.471,25,31,.806,109
20566,2011-01-09,NYK,@,LAL,L 87-109,240,31,86,.360,23,61,.377,8,25,.320,17,25,.680,87
20567,2011-01-09,CLE,@,PHO,L 100-108,240,35,95,.368,29,75,.387,6,20,.300,24,31,.774,100
20568,2011-01-09,PHO,,CLE,W 108-100,240,39,83,.470,26,55,.473,13,28,.464,17,23,.739,108
20569,2011-01-09,MIA,@,POR,W 107-100 (OT),265,45,79,.570,40,64,.625,5,15,.333,12,16,.750,107
20570,2011-01-09,POR,,MIA,L 100-107 (OT),265,38,91,.418,33,67,.493,5,24,.208,19,22,.864,100
20571,2011-01-09,MIN,@,SAS,L 91-94,240,38,96,.396,31,76,.408,7,20,.350,8,12,.667,91
20572,2011-01-09,SAS,,MIN,W 94-91,240,33,78,.423,26,57,.456,7,21,.333,21,25,.840,94
20573,2011-01-09,SAC,@,TOR,L 112-118,240,40,91,.440,35,75,.467,5,16,.313,27,34,.794,112
20574,2011-01-09,TOR,,SAC,W 118-112,240,48,82,.585,42,69,.609,6,13,.462,16,23,.696,118
20575,2011-01-08,ATL,,IND,W 108-93,240,36,84,.429,25,62,.403,11,22,.500,25,29,.862,108
20576,2011-01-08,IND,@,ATL,L 93-108,240,34,83,.410,29,66,.439,5,17,.294,20,23,.870,93
20577,2011-01-08,CHA,,WAS,W 104-89,240,39,79,.494,33,67,.493,6,12,.500,20,24,.833,104
20578,2011-01-08,WAS,@,CHA,L 89-104,240,36,82,.439,31,67,.463,5,15,.333,12,15,.800,89
20579,2011-01-08,BOS,@,CHI,L 79-90,240,28,74,.378,23,62,.371,5,12,.417,18,22,.818,79
20580,2011-01-08,CHI,,BOS,W 90-79,240,31,63,.492,28,54,.519,3,9,.333,25,35,.714,90
20581,2011-01-08,DAL,,ORL,L 107-117,240,41,76,.539,29,50,.580,12,26,.462,13,17,.765,107
20582,2011-01-08,ORL,@,DAL,W 117-107,240,42,81,.519,28,49,.571,14,32,.438,19,26,.731,117
20583,2011-01-08,DET,,PHI,W 112-109 (OT),265,41,92,.446,33,77,.429,8,15,.533,22,34,.647,112
20584,2011-01-08,PHI,@,DET,L 109-112 (OT),265,44,91,.484,39,77,.506,5,14,.357,16,23,.696,109
20585,2011-01-08,HOU,,UTA,L 99-103 (OT),265,34,90,.378,31,65,.477,3,25,.120,28,38,.737,99
20586,2011-01-08,UTA,@,HOU,W 103-99 (OT),265,41,87,.471,37,68,.544,4,19,.211,17,25,.680,103
20587,2011-01-08,MIL,@,NJN,W 115-92,240,42,72,.583,36,58,.621,6,14,.429,25,29,.862,115
20588,2011-01-08,BRK,,MIL,L 92-115,240,36,80,.450,33,74,.446,3,6,.500,17,26,.654,92
20589,2011-01-08,MEM,@,OKC,L 100-109,240,40,93,.430,39,78,.500,1,15,.067,19,30,.633,100
20590,2011-01-08,OKC,,MEM,W 109-100,240,35,74,.473,31,60,.517,4,14,.286,35,42,.833,109
20591,2011-01-07,BOS,,TOR,W 122-102,240,46,80,.575,35,59,.593,11,21,.524,19,28,.679,122
20592,2011-01-07,TOR,@,BOS,L 102-122,240,40,79,.506,34,63,.540,6,16,.375,16,23,.696,102
20593,2011-01-07,CLE,@,GSW,L 98-116,240,35,76,.461,31,63,.492,4,13,.308,24,36,.667,98
20594,2011-01-07,GSW,,CLE,W 116-98,240,41,85,.482,27,57,.474,14,28,.500,20,21,.952,116
20595,2011-01-07,IND,,SAS,L 87-90,240,33,88,.375,28,73,.384,5,15,.333,16,21,.762,87
20596,2011-01-07,SAS,@,IND,W 90-87,240,32,77,.416,26,59,.441,6,18,.333,20,27,.741,90
20597,2011-01-07,LAL,,NOH,W 101-97,240,39,77,.506,34,65,.523,5,12,.417,18,26,.692,101
20598,2011-01-07,NOP,@,LAL,L 97-101,240,33,76,.434,25,57,.439,8,19,.421,23,26,.885,97
20599,2011-01-07,MEM,,UTA,W 110-99,240,42,85,.494,37,74,.500,5,11,.455,21,28,.750,110
20600,2011-01-07,UTA,@,MEM,L 99-110,240,34,73,.466,27,52,.519,7,21,.333,24,31,.774,99
20601,2011-01-07,MIA,@,MIL,W 101-95 (OT),265,35,89,.393,30,77,.390,5,12,.417,26,32,.813,101
20602,2011-01-07,MIL,,MIA,L 95-101 (OT),265,36,81,.444,30,62,.484,6,19,.316,17,24,.708,95
20603,2011-01-07,MIN,,POR,L 98-108,240,37,76,.487,29,60,.483,8,16,.500,16,22,.727,98
20604,2011-01-07,POR,@,MIN,W 108-98,240,40,86,.465,31,63,.492,9,23,.391,19,22,.864,108
20605,2011-01-07,HOU,@,ORL,L 95-110,240,34,82,.415,29,64,.453,5,18,.278,22,28,.786,95
20606,2011-01-07,ORL,,HOU,W 110-95,240,45,87,.517,37,67,.552,8,20,.400,12,12,1.000,110
20607,2011-01-07,CHI,@,PHI,L 99-105,240,38,75,.507,35,60,.583,3,15,.200,20,26,.769,99
20608,2011-01-07,PHI,,CHI,W 105-99,240,40,71,.563,34,55,.618,6,16,.375,19,28,.679,105
20609,2011-01-07,NYK,@,PHO,W 121-96,240,46,92,.500,29,59,.492,17,33,.515,12,18,.667,121
20610,2011-01-07,PHO,,NYK,L 96-121,240,35,82,.427,29,58,.500,6,24,.250,20,28,.714,96
20611,2011-01-07,BRK,@,WAS,L 77-97,240,28,81,.346,21,60,.350,7,21,.333,14,17,.824,77
20612,2011-01-07,WAS,,NJN,W 97-77,240,34,77,.442,27,61,.443,7,16,.438,22,28,.786,97
20613,2011-01-06,DAL,,OKC,L 95-99,240,37,79,.468,31,59,.525,6,20,.300,15,20,.750,95
20614,2011-01-06,OKC,@,DAL,W 99-95,240,39,83,.470,35,68,.515,4,15,.267,17,26,.654,99
20615,2011-01-06,DEN,@,SAC,L 102-122,240,36,71,.507,32,55,.582,4,16,.250,26,30,.867,102
20616,2011-01-06,SAC,,DEN,W 122-102,240,44,78,.564,35,60,.583,9,18,.500,25,30,.833,122
20617,2011-01-05,BOS,,SAS,W 105-103,240,46,75,.613,41,66,.621,5,9,.556,8,15,.533,105
20618,2011-01-05,SAS,@,BOS,L 103-105,240,39,86,.453,30,64,.469,9,22,.409,16,17,.941,103
20619,2011-01-05,CLE,,TOR,L 105-120,240,34,67,.507,24,48,.500,10,19,.526,27,33,.818,105
20620,2011-01-05,TOR,@,CLE,W 120-105,240,50,88,.568,41,70,.586,9,18,.500,11,16,.688,120
20621,2011-01-05,HOU,,POR,L 100-103,240,33,70,.471,22,50,.440,11,20,.550,23,30,.767,100
20622,2011-01-05,POR,@,HOU,W 103-100,240,41,85,.482,34,66,.515,7,19,.368,14,19,.737,103
20623,2011-01-05,DEN,@,LAC,L 93-106,240,30,80,.375,22,61,.361,8,19,.421,25,31,.806,93
20624,2011-01-05,LAC,,DEN,W 106-93,240,39,91,.429,29,64,.453,10,27,.370,18,27,.667,106
20625,2011-01-05,CHA,@,MIN,W 108-105 (OT),265,43,98,.439,35,72,.486,8,26,.308,14,24,.583,108
20626,2011-01-05,MIN,,CHA,L 105-108 (OT),265,38,85,.447,28,60,.467,10,25,.400,19,30,.633,105
20627,2011-01-05,CHI,@,NJN,L 94-96,240,34,77,.442,28,58,.483,6,19,.316,20,30,.667,94
20628,2011-01-05,BRK,,CHI,W 96-94,240,38,77,.494,33,65,.508,5,12,.417,15,23,.652,96
20629,2011-01-05,GSW,@,NOH,W 110-103,240,39,81,.481,31,61,.508,8,20,.400,24,32,.750,110
20630,2011-01-05,NOP,,GSW,L 103-110,240,38,76,.500,32,60,.533,6,16,.375,21,33,.636,103
20631,2011-01-05,MIL,@,ORL,L 87-97,240,33,84,.393,27,70,.386,6,14,.429,15,32,.469,87
20632,2011-01-05,ORL,,MIL,W 97-87,240,35,77,.455,30,55,.545,5,22,.227,22,33,.667,97
20633,2011-01-05,PHI,,WAS,W 109-97,240,38,67,.567,34,58,.586,4,9,.444,29,38,.763,109
20634,2011-01-05,WAS,@,PHI,L 97-109,240,40,82,.488,35,70,.500,5,12,.417,12,18,.667,97
20635,2011-01-05,LAL,@,PHO,W 99-95,240,40,85,.471,34,62,.548,6,23,.261,13,20,.650,99
20636,2011-01-05,PHO,,LAL,L 95-99,240,36,74,.486,25,51,.490,11,23,.478,12,17,.706,95
20637,2011-01-05,ATL,@,UTA,W 110-87,240,40,79,.506,26,54,.481,14,25,.560,16,18,.889,110
20638,2011-01-05,UTA,,ATL,L 87-110,240,28,71,.394,21,57,.368,7,14,.500,24,31,.774,87
20639,2011-01-04,CHI,,TOR,W 111-91,240,44,83,.530,40,70,.571,4,13,.308,19,28,.679,111
20640,2011-01-04,TOR,@,CHI,L 91-111,240,35,78,.449,30,63,.476,5,15,.333,16,19,.842,91
20641,2011-01-04,DAL,,POR,W 84-81,240,33,77,.429,25,55,.455,8,22,.364,10,13,.769,84
20642,2011-01-04,POR,@,DAL,L 81-84,240,33,79,.418,29,63,.460,4,16,.250,11,17,.647,81
20643,2011-01-04,DET,@,LAL,L 83-108,240,32,72,.444,29,59,.492,3,13,.231,16,24,.667,83
20644,2011-01-04,LAL,,DET,W 108-83,240,42,89,.472,36,72,.500,6,17,.353,18,22,.818,108
20645,2011-01-04,MEM,,OKC,W 110-105,240,43,84,.512,41,77,.532,2,7,.286,22,30,.733,110
20646,2011-01-04,OKC,@,MEM,L 105-110,240,39,76,.513,34,63,.540,5,13,.385,22,25,.880,105
20647,2011-01-04,MIA,,MIL,W 101-89,240,33,74,.446,29,62,.468,4,12,.333,31,37,.838,101
20648,2011-01-04,MIL,@,MIA,L 89-101,240,29,73,.397,24,61,.393,5,12,.417,26,34,.765,89
20649,2011-01-04,NYK,,SAS,W 128-115,240,50,91,.549,42,64,.656,8,27,.296,20,23,.870,128
20650,2011-01-04,SAS,@,NYK,L 115-128,240,44,82,.537,39,64,.609,5,18,.278,22,30,.733,115
20651,2011-01-04,ATL,@,SAC,W 108-102,240,40,78,.513,32,60,.533,8,18,.444,20,24,.833,108
20652,2011-01-04,SAC,,ATL,L 102-108,240,43,96,.448,38,82,.463,5,14,.357,11,18,.611,102
20653,2011-01-03,BOS,,MIN,W 96-93,240,37,82,.451,32,66,.485,5,16,.313,17,20,.850,96
20654,2011-01-03,MIN,@,BOS,L 93-96,240,35,84,.417,30,67,.448,5,17,.294,18,22,.818,93
20655,2011-01-03,CHA,,MIA,L 82-96,240,30,79,.380,27,69,.391,3,10,.300,19,23,.826,82
20656,2011-01-03,MIA,@,CHA,W 96-82,240,37,76,.487,32,61,.525,5,15,.333,17,19,.895,96
20657,2011-01-03,DEN,,HOU,W 113-106,240,38,81,.469,35,73,.479,3,8,.375,34,40,.850,113
20658,2011-01-03,HOU,@,DEN,L 106-113,240,39,91,.429,26,61,.426,13,30,.433,15,21,.714,106
20659,2011-01-03,NOP,,PHI,W 84-77,240,31,69,.449,27,55,.491,4,14,.286,18,22,.818,84
20660,2011-01-03,PHI,@,NOH,L 77-84,240,30,88,.341,25,65,.385,5,23,.217,12,14,.857,77
20661,2011-01-03,GSW,@,ORL,L 90-110,240,36,88,.409,28,66,.424,8,22,.364,10,13,.769,90
20662,2011-01-03,ORL,,GSW,W 110-90,240,38,77,.494,23,45,.511,15,32,.469,19,25,.760,110
20663,2011-01-03,DET,@,UTA,L 97-102,240,37,81,.457,30,60,.500,7,21,.333,16,21,.762,97
20664,2011-01-03,UTA,,DET,W 102-97,240,34,72,.472,29,57,.509,5,15,.333,29,32,.906,102
20665,2011-01-02,CLE,,DAL,L 95-104,240,41,81,.506,36,64,.563,5,17,.294,8,13,.615,95
20666,2011-01-02,DAL,@,CLE,W 104-95,240,40,83,.482,30,56,.536,10,27,.370,14,22,.636,104
20667,2011-01-02,ATL,@,LAC,W 107-98,240,32,70,.457,24,52,.462,8,18,.444,35,40,.875,107
20668,2011-01-02,LAC,,ATL,L 98-107,240,37,80,.463,33,62,.532,4,18,.222,20,29,.690,98
20669,2011-01-02,LAL,,MEM,L 85-104,240,33,71,.465,27,53,.509,6,18,.333,13,18,.722,85
20670,2011-01-02,MEM,@,LAL,W 104-85,240,41,90,.456,35,78,.449,6,12,.500,16,20,.800,104
20671,2011-01-02,IND,@,NYK,L 92-98,240,37,99,.374,30,75,.400,7,24,.292,11,19,.579,92
20672,2011-01-02,NYK,,IND,W 98-92,240,31,73,.425,24,56,.429,7,17,.412,29,40,.725,98
20673,2011-01-02,HOU,@,POR,L 85-100,240,31,75,.413,27,55,.491,4,20,.200,19,24,.792,85
20674,2011-01-02,POR,,HOU,W 100-85,240,38,88,.432,31,67,.463,7,21,.333,17,19,.895,100
20675,2011-01-02,PHO,@,SAC,L 89-94,240,35,87,.402,28,60,.467,7,27,.259,12,15,.800,89
20676,2011-01-02,SAC,,PHO,W 94-89,240,34,84,.405,30,72,.417,4,12,.333,22,27,.815,94
20677,2011-01-02,BOS,@,TOR,W 93-79,240,38,70,.543,32,58,.552,6,12,.500,11,19,.579,93
20678,2011-01-02,TOR,,BOS,L 79-93,240,34,90,.378,33,76,.434,1,14,.071,10,22,.455,79
20679,2011-01-01,CHI,,CLE,W 100-91,240,35,80,.438,30,63,.476,5,17,.294,25,32,.781,100
20680,2011-01-01,CLE,@,CHI,L 91-100,240,33,82,.402,29,64,.453,4,18,.222,21,25,.840,91
20681,2011-01-01,DEN,,SAC,W 104-86,240,39,85,.459,33,71,.465,6,14,.429,20,26,.769,104
20682,2011-01-01,SAC,@,DEN,L 86-104,240,38,90,.422,34,75,.453,4,15,.267,6,15,.400,86
20683,2011-01-01,GSW,@,MIA,L 107-114,240,41,87,.471,28,60,.467,13,27,.481,12,16,.750,107
20684,2011-01-01,MIA,,GSW,W 114-107,240,35,71,.493,26,50,.520,9,21,.429,35,47,.745,114
20685,2011-01-01,DAL,@,MIL,L 87-99,240,30,80,.375,21,48,.438,9,32,.281,18,22,.818,87
20686,2011-01-01,MIL,,DAL,W 99-87,240,38,77,.494,34,61,.557,4,16,.250,19,25,.760,99
20687,2011-01-01,MIN,,NJN,W 103-88,240,37,73,.507,30,57,.526,7,16,.438,22,28,.786,103
20688,2011-01-01,BRK,@,MIN,L 88-103,240,33,73,.452,28,58,.483,5,15,.333,17,28,.607,88
20689,2011-01-01,OKC,@,SAS,L 74-101,240,28,85,.329,27,78,.346,1,7,.143,17,24,.708,74
20690,2011-01-01,SAS,,OKC,W 101-74,240,42,90,.467,37,74,.500,5,16,.313,12,16,.750,101
20691,2011-01-01,MEM,@,UTA,L 92-98,240,33,77,.429,28,59,.475,5,18,.278,21,27,.778,92
20692,2011-01-01,UTA,,MEM,W 98-92,240,36,74,.486,32,63,.508,4,11,.364,22,35,.629,98
20693,2011-01-01,NOP,@,WAS,W 92-81,240,36,78,.462,31,62,.500,5,16,.313,15,21,.714,92
20694,2011-01-01,WAS,,NOH,L 81-92,240,33,77,.429,28,58,.483,5,19,.263,10,11,.909,81
20695,2010-12-31,BOS,,NOH,L 81-83,240,34,76,.447,31,60,.517,3,16,.188,10,15,.667,81
20696,2010-12-31,NOP,@,BOS,W 83-81,240,33,76,.434,28,64,.438,5,12,.417,12,21,.571,83
20697,2010-12-31,CHA,,GSW,L 95-96,240,35,83,.422,30,67,.448,5,16,.313,20,28,.714,95
20698,2010-12-31,GSW,@,CHA,W 96-95,240,38,77,.494,28,53,.528,10,24,.417,10,16,.625,96
20699,2010-12-31,CHI,,NJN,W 90-81,240,30,76,.395,24,54,.444,6,22,.273,24,29,.828,90
20700,2010-12-31,BRK,@,CHI,L 81-90,240,30,77,.390,27,64,.422,3,13,.231,18,23,.783,81
20701,2010-12-31,HOU,,TOR,W 114-105,240,44,91,.484,39,74,.527,5,17,.294,21,28,.750,114
20702,2010-12-31,TOR,@,HOU,L 105-114,240,40,96,.417,36,81,.444,4,15,.267,21,27,.778,105
20703,2010-12-31,IND,,WAS,W 95-86,240,38,78,.487,33,59,.559,5,19,.263,14,18,.778,95
20704,2010-12-31,WAS,@,IND,L 86-95,240,31,80,.388,25,61,.410,6,19,.316,18,22,.818,86
20705,2010-12-31,LAL,,PHI,W 102-98,240,42,82,.512,38,68,.559,4,14,.286,14,19,.737,102
20706,2010-12-31,PHI,@,LAL,L 98-102,240,39,83,.470,30,63,.476,9,20,.450,11,16,.688,98
20707,2010-12-31,ATL,@,OKC,L 94-103,240,33,73,.452,28,55,.509,5,18,.278,23,29,.793,94
20708,2010-12-31,OKC,,ATL,W 103-94,240,39,81,.481,29,63,.460,10,18,.556,15,17,.882,103
20709,2010-12-31,DET,@,PHO,L 75-92,240,31,76,.408,26,56,.464,5,20,.250,8,18,.444,75
20710,2010-12-31,PHO,,DET,W 92-75,240,34,71,.479,22,44,.500,12,27,.444,12,18,.667,92
20711,2010-12-30,DAL,,SAS,L 93-99,240,35,82,.427,25,59,.424,10,23,.435,13,15,.867,93
20712,2010-12-30,SAS,@,DAL,W 99-93,240,35,76,.461,24,48,.500,11,28,.393,18,23,.783,99
20713,2010-12-30,NYK,@,ORL,L 103-112,240,38,82,.463,30,60,.500,8,22,.364,19,26,.731,103
20714,2010-12-30,ORL,,NYK,W 112-103,240,41,86,.477,32,59,.542,9,27,.333,21,32,.656,112
20715,2010-12-30,POR,,UTA,W 100-89,240,34,74,.459,27,57,.474,7,17,.412,25,32,.781,100
20716,2010-12-30,UTA,@,POR,L 89-100,240,30,62,.484,24,48,.500,6,14,.429,23,33,.697,89
20717,2010-12-29,ATL,,GSW,W 103-93,240,44,86,.512,36,67,.537,8,19,.421,7,12,.583,103
20718,2010-12-29,GSW,@,ATL,L 93-103,240,37,83,.446,29,59,.492,8,24,.333,11,15,.733,93
20719,2010-12-29,CHA,,CLE,W 101-92,240,34,76,.447,25,57,.439,9,19,.474,24,34,.706,101
20720,2010-12-29,CLE,@,CHA,L 92-101,240,32,79,.405,28,57,.491,4,22,.182,24,29,.828,92
20721,2010-12-29,BOS,@,DET,L 92-104,240,34,66,.515,28,51,.549,6,15,.400,18,19,.947,92
20722,2010-12-29,DET,,BOS,W 104-92,240,39,70,.557,29,55,.527,10,15,.667,16,21,.762,104
20723,2010-12-29,HOU,,MIA,L 119-125,240,39,93,.419,30,66,.455,9,27,.333,32,40,.800,119
20724,2010-12-29,MIA,@,HOU,W 125-119,240,43,74,.581,38,58,.655,5,16,.313,34,37,.919,125
20725,2010-12-29,LAC,,UTA,L 95-103,240,35,72,.486,27,50,.540,8,22,.364,17,26,.654,95
20726,2010-12-29,UTA,@,LAC,W 103-95,240,40,85,.471,35,70,.500,5,15,.333,18,21,.857,103
20727,2010-12-29,DEN,@,MIN,W 119-113,240,39,85,.459,31,63,.492,8,22,.364,33,43,.767,119
20728,2010-12-29,MIN,,DEN,L 113-119,240,42,86,.488,35,69,.507,7,17,.412,22,25,.880,113
20729,2010-12-29,LAL,@,NOH,W 103-88,240,41,70,.586,36,53,.679,5,17,.294,16,20,.800,103
20730,2010-12-29,NOP,,LAL,L 88-103,240,33,79,.418,29,63,.460,4,16,.250,18,22,.818,88
20731,2010-12-29,BRK,@,OKC,L 93-114,240,34,71,.479,32,64,.500,2,7,.286,23,27,.852,93
20732,2010-12-29,OKC,,NJN,W 114-93,240,45,82,.549,39,64,.609,6,18,.333,18,27,.667,114
20733,2010-12-29,PHI,@,PHO,W 123-110,240,45,82,.549,42,72,.583,3,10,.300,30,35,.857,123
20734,2010-12-29,PHO,,PHI,L 110-123,240,43,87,.494,34,67,.507,9,20,.450,15,17,.882,110
20735,2010-12-29,MEM,@,SAC,L 98-100,240,38,87,.437,37,84,.440,1,3,.333,21,28,.750,98
20736,2010-12-29,SAC,,MEM,W 100-98,240,35,76,.461,27,59,.458,8,17,.471,22,28,.786,100
20737,2010-12-29,IND,@,WAS,L 90-104,240,35,85,.412,27,64,.422,8,21,.381,12,18,.667,90
20738,2010-12-29,WAS,,IND,W 104-90,240,39,98,.398,30,77,.390,9,21,.429,17,24,.708,104
20739,2010-12-28,CHI,,MIL,W 90-77,240,36,76,.474,30,61,.492,6,15,.400,12,16,.750,90
20740,2010-12-28,MIL,@,CHI,L 77-90,240,27,84,.321,22,70,.314,5,14,.357,18,25,.720,77
20741,2010-12-28,CLE,,ORL,L 95-110,240,33,72,.458,27,53,.509,6,19,.316,23,33,.697,95
20742,2010-12-28,ORL,@,CLE,W 110-95,240,40,79,.506,21,48,.438,19,31,.613,11,15,.733,110
20743,2010-12-28,DAL,,TOR,L 76-84,240,31,75,.413,26,53,.491,5,22,.227,9,12,.750,76
20744,2010-12-28,TOR,@,DAL,W 84-76,240,33,69,.478,31,59,.525,2,10,.200,16,22,.727,84
20745,2010-12-28,DEN,,POR,W 95-77,240,34,75,.453,28,59,.475,6,16,.375,21,26,.808,95
20746,2010-12-28,POR,@,DEN,L 77-95,240,32,80,.400,26,67,.388,6,13,.462,7,8,.875,77
20747,2010-12-28,BOS,@,IND,W 95-83,240,37,73,.507,31,62,.500,6,11,.545,15,22,.682,95
20748,2010-12-28,IND,,BOS,L 83-95,240,29,78,.372,24,61,.393,5,17,.294,20,25,.800,83
20749,2010-12-28,MIA,,NYK,W 106-98,240,38,79,.481,35,66,.530,3,13,.231,27,34,.794,106
20750,2010-12-28,NYK,@,MIA,L 98-106,240,34,82,.415,27,58,.466,7,24,.292,23,32,.719,98
20751,2010-12-28,LAL,@,SAS,L 82-97,240,29,82,.354,21,59,.356,8,23,.348,16,22,.727,82
20752,2010-12-28,SAS,,LAL,W 97-82,240,37,87,.425,28,55,.509,9,32,.281,14,21,.667,97
20753,2010-12-27,CHA,,DET,W 105-100,240,40,76,.526,30,59,.508,10,17,.588,15,19,.789,105
20754,2010-12-27,DET,@,CHA,L 100-105,240,38,87,.437,27,68,.397,11,19,.579,13,16,.813,100
20755,2010-12-27,GSW,,PHI,W 110-95,240,39,83,.470,24,60,.400,15,23,.652,17,21,.810,110
20756,2010-12-27,PHI,@,GSW,L 95-110,240,38,88,.432,34,71,.479,4,17,.235,15,20,.750,95
20757,2010-12-27,HOU,,WAS,W 100-93,240,37,81,.457,31,61,.508,6,20,.300,20,25,.800,100
20758,2010-12-27,WAS,@,HOU,L 93-100,240,34,85,.400,31,77,.403,3,8,.375,22,29,.759,93
20759,2010-12-27,MEM,,TOR,W 96-85,240,35,69,.507,32,57,.561,3,12,.250,23,28,.821,96
20760,2010-12-27,TOR,@,MEM,L 85-96,240,38,76,.500,34,57,.596,4,19,.211,5,14,.357,85
20761,2010-12-27,ATL,@,MIL,W 95-80,240,38,75,.507,32,61,.525,6,14,.429,13,20,.650,95
20762,2010-12-27,MIL,,ATL,L 80-95,240,28,75,.373,24,60,.400,4,15,.267,20,26,.769,80
20763,2010-12-27,MIN,,NOH,W 113-98,240,41,77,.532,30,54,.556,11,23,.478,20,25,.800,113
20764,2010-12-27,NOP,@,MIN,L 98-113,240,36,85,.424,33,74,.446,3,11,.273,23,27,.852,98
20765,2010-12-27,BRK,,ORL,L 88-104,240,31,79,.392,27,68,.397,4,11,.364,22,29,.759,88
20766,2010-12-27,ORL,@,NJN,W 104-88,240,39,82,.476,27,52,.519,12,30,.400,14,19,.737,104
20767,2010-12-27,DAL,@,OKC,W 103-93,240,41,84,.488,30,61,.492,11,23,.478,10,11,.909,103
20768,2010-12-27,OKC,,DAL,L 93-103,240,34,81,.420,28,64,.438,6,17,.353,19,23,.826,93
20769,2010-12-27,LAC,@,SAC,W 100-99,240,40,83,.482,31,61,.508,9,22,.409,11,15,.733,100
20770,2010-12-27,SAC,,LAC,L 99-100,240,36,87,.414,23,61,.377,13,26,.500,14,17,.824,99
20771,2010-12-27,POR,@,UTA,W 96-91,240,33,70,.471,28,53,.528,5,17,.294,25,30,.833,96
20772,2010-12-27,UTA,,POR,L 91-96,240,32,74,.432,22,54,.407,10,20,.500,17,19,.895,91
20773,2010-12-26,CLE,,MIN,L 97-98,240,40,87,.460,30,61,.492,10,26,.385,7,13,.538,97
20774,2010-12-26,MIN,@,CLE,W 98-97,240,33,85,.388,21,62,.339,12,23,.522,20,22,.909,98
20775,2010-12-26,DEN,,PHI,L 89-95,240,30,75,.400,22,48,.458,8,27,.296,21,23,.913,89
20776,2010-12-26,PHI,@,DEN,W 95-89,240,36,91,.396,33,77,.429,3,14,.214,20,32,.625,95
20777,2010-12-26,CHI,@,DET,W 95-92 (OT),265,36,91,.396,32,79,.405,4,12,.333,19,28,.679,95
20778,2010-12-26,DET,,CHI,L 92-95 (OT),265,38,89,.427,35,76,.461,3,13,.231,13,16,.813,92
20779,2010-12-26,IND,,MEM,L 90-104,240,32,90,.356,25,65,.385,7,25,.280,19,27,.704,90
20780,2010-12-26,MEM,@,IND,W 104-90,240,39,88,.443,34,78,.436,5,10,.500,21,30,.700,104
20781,2010-12-26,LAC,,PHO,W 108-103,240,40,75,.533,33,54,.611,7,21,.333,21,34,.618,108
20782,2010-12-26,PHO,@,LAC,L 103-108,240,39,87,.448,30,62,.484,9,25,.360,16,18,.889,103
20783,2010-12-26,ATL,@,NOH,L 86-93,240,29,73,.397,20,49,.408,9,24,.375,19,24,.792,86
20784,2010-12-26,NOP,,ATL,W 93-86,240,41,84,.488,39,67,.582,2,17,.118,9,15,.600,93
20785,2010-12-26,SAS,,WAS,W 94-80,240,37,82,.451,27,58,.466,10,24,.417,10,12,.833,94
20786,2010-12-26,WAS,@,SAS,L 80-94,240,33,88,.375,28,73,.384,5,15,.333,9,11,.818,80
20787,2010-12-25,GSW,,POR,W 109-102,240,40,83,.482,30,61,.492,10,22,.455,19,21,.905,109
20788,2010-12-25,POR,@,GSW,L 102-109,240,41,97,.423,36,79,.456,5,18,.278,15,20,.750,102
20789,2010-12-25,LAL,,MIA,L 80-96,240,32,79,.405,26,60,.433,6,19,.316,10,15,.667,80
20790,2010-12-25,MIA,@,LAL,W 96-80,240,35,79,.443,26,54,.481,9,25,.360,17,20,.850,96
20791,2010-12-25,CHI,@,NYK,L 95-103,240,40,91,.440,36,77,.468,4,14,.286,11,20,.550,95
20792,2010-12-25,NYK,,CHI,W 103-95,240,42,79,.532,30,57,.526,12,22,.545,7,12,.583,103
20793,2010-12-25,DEN,@,OKC,L 106-114,240,37,70,.529,29,53,.547,8,17,.471,24,30,.800,106
20794,2010-12-25,OKC,,DEN,W 114-106,240,40,81,.494,34,64,.531,6,17,.353,28,35,.800,114
20795,2010-12-25,BOS,@,ORL,L 78-86,240,28,81,.346,24,64,.375,4,17,.235,18,21,.857,78
20796,2010-12-25,ORL,,BOS,W 86-78,240,28,71,.394,17,42,.405,11,29,.379,19,29,.655,86
20797,2010-12-23,ORL,,SAS,W 123-101,240,50,84,.595,37,59,.627,13,25,.520,10,17,.588,123
20798,2010-12-23,SAS,@,ORL,L 101-123,240,38,90,.422,30,68,.441,8,22,.364,17,25,.680,101
20799,2010-12-23,MIA,@,PHO,W 95-83,240,37,82,.451,32,64,.500,5,18,.278,16,17,.941,95
20800,2010-12-23,PHO,,MIA,L 83-95,240,30,75,.400,20,49,.408,10,26,.385,13,19,.684,83
20801,2010-12-23,MIL,@,SAC,W 84-79,240,35,81,.432,33,72,.458,2,9,.222,12,18,.667,84
20802,2010-12-23,SAC,,MIL,L 79-84,240,31,85,.365,24,64,.375,7,21,.333,10,15,.667,79
20803,2010-12-22,ATL,,CLE,W 98-84,240,42,83,.506,34,61,.557,8,22,.364,6,10,.600,98
20804,2010-12-22,CLE,@,ATL,L 84-98,240,34,81,.420,29,59,.492,5,22,.227,11,13,.846,84
20805,2010-12-22,BOS,,PHI,W 84-80,240,31,80,.388,25,60,.417,6,20,.300,16,21,.762,84
20806,2010-12-22,PHI,@,BOS,L 80-84,240,28,65,.431,26,55,.473,2,10,.200,22,31,.710,80
20807,2010-12-22,HOU,@,LAC,W 97-92,240,35,82,.427,26,53,.491,9,29,.310,18,23,.783,97
20808,2010-12-22,LAC,,HOU,L 92-97,240,35,87,.402,31,72,.431,4,15,.267,18,26,.692,92
20809,2010-12-22,MIN,,UTA,L 107-112,240,37,87,.425,27,67,.403,10,20,.500,23,29,.793,107
20810,2010-12-22,UTA,@,MIN,W 112-107,240,37,75,.493,36,65,.554,1,10,.100,37,44,.841,112
20811,2010-12-22,BRK,@,NOH,L 91-105,240,37,81,.457,33,66,.500,4,15,.267,13,14,.929,91
20812,2010-12-22,NOP,,NJN,W 105-91,240,41,76,.539,33,60,.550,8,16,.500,15,21,.714,105
20813,2010-12-22,NYK,,OKC,W 112-98,240,42,86,.488,32,65,.492,10,21,.476,18,21,.857,112
20814,2010-12-22,OKC,@,NYK,L 98-112,240,38,97,.392,35,80,.438,3,17,.176,19,25,.760,98
20815,2010-12-22,DEN,@,SAS,L 103-109,240,35,78,.449,27,53,.509,8,25,.320,25,29,.862,103
20816,2010-12-22,SAS,,DEN,W 109-103,240,40,76,.526,26,48,.542,14,28,.500,15,24,.625,109
20817,2010-12-22,DET,@,TOR,W 115-93,240,46,90,.511,38,67,.567,8,23,.348,15,19,.789,115
20818,2010-12-22,TOR,,DET,L 93-115,240,35,67,.522,30,53,.566,5,14,.357,18,23,.783,93
20819,2010-12-22,CHI,@,WAS,W 87-80,240,31,73,.425,29,57,.509,2,16,.125,23,29,.793,87
20820,2010-12-22,WAS,,CHI,L 80-87,240,30,79,.380,26,65,.400,4,14,.286,16,19,.842,80
20821,2010-12-21,CHA,,OKC,L 81-99,240,30,75,.400,26,61,.426,4,14,.286,17,26,.654,81
20822,2010-12-21,OKC,@,CHA,W 99-81,240,31,71,.437,24,55,.436,7,16,.438,30,36,.833,99
20823,2010-12-21,CHI,,PHI,W 121-76,240,49,76,.645,43,65,.662,6,11,.545,17,21,.810,121
20824,2010-12-21,PHI,@,CHI,L 76-121,240,28,80,.350,26,65,.400,2,15,.133,18,23,.783,76
20825,2010-12-21,LAL,,MIL,L 79-98,240,35,77,.455,33,64,.516,2,13,.154,7,13,.538,79
20826,2010-12-21,MIL,@,LAL,W 98-79,240,37,73,.507,29,59,.492,8,14,.571,16,18,.889,98
20827,2010-12-21,MEM,,NJN,L 94-101,240,35,88,.398,31,75,.413,4,13,.308,20,29,.690,94
20828,2010-12-21,BRK,@,MEM,W 101-94,240,40,76,.526,36,63,.571,4,13,.308,17,23,.739,101
20829,2010-12-21,DAL,@,ORL,W 105-99,240,38,76,.500,26,50,.520,12,26,.462,17,21,.810,105
20830,2010-12-21,ORL,,DAL,L 99-105,240,38,86,.442,27,57,.474,11,29,.379,12,12,1.000,99
20831,2010-12-21,GSW,@,SAC,W 117-109 (OT),265,42,89,.472,32,64,.500,10,25,.400,23,33,.697,117
20832,2010-12-21,SAC,,GSW,L 109-117 (OT),265,39,100,.390,32,77,.416,7,23,.304,24,28,.857,109
20833,2010-12-20,ATL,,ORL,W 91-81,240,33,80,.413,27,62,.435,6,18,.333,19,29,.655,91
20834,2010-12-20,ORL,@,ATL,L 81-91,240,25,71,.352,21,54,.389,4,17,.235,27,35,.771,81
20835,2010-12-20,CLE,,UTA,L 90-101,240,30,72,.417,18,44,.409,12,28,.429,18,25,.720,90
20836,2010-12-20,UTA,@,CLE,W 101-90,240,39,82,.476,29,59,.492,10,23,.435,13,16,.813,101
20837,2010-12-20,GSW,,HOU,L 112-121,240,43,84,.512,36,62,.581,7,22,.318,19,27,.704,112
20838,2010-12-20,HOU,@,GSW,W 121-112,240,42,84,.500,31,60,.517,11,24,.458,26,34,.765,121
20839,2010-12-20,IND,,NOH,W 94-93,240,34,80,.425,23,57,.404,11,23,.478,15,19,.789,94
20840,2010-12-20,NOP,@,IND,L 93-94,240,33,83,.398,29,68,.426,4,15,.267,23,32,.719,93
20841,2010-12-20,LAC,,MIN,W 113-90,240,43,83,.518,36,60,.600,7,23,.304,20,33,.606,113
20842,2010-12-20,MIN,@,LAC,L 90-113,240,32,80,.400,25,62,.403,7,18,.389,19,27,.704,90
20843,2010-12-20,DAL,@,MIA,W 98-96,240,33,74,.446,25,53,.472,8,21,.381,24,28,.857,98
20844,2010-12-20,MIA,,DAL,L 96-98,240,34,84,.405,23,53,.434,11,31,.355,17,25,.680,96
20845,2010-12-20,MIL,@,POR,L 80-106,240,30,79,.380,26,65,.400,4,14,.286,16,22,.727,80
20846,2010-12-20,POR,,MIL,W 106-80,240,39,78,.500,31,56,.554,8,22,.364,20,25,.800,106
20847,2010-12-20,PHO,@,SAS,L 110-118,240,46,86,.535,40,64,.625,6,22,.273,12,16,.750,110
20848,2010-12-20,SAS,,PHO,W 118-110,240,43,89,.483,35,60,.583,8,29,.276,24,30,.800,118
20849,2010-12-20,CHA,@,WAS,L 75-108,240,28,62,.452,26,53,.491,2,9,.222,17,25,.680,75
20850,2010-12-20,WAS,,CHA,W 108-75,240,38,73,.521,31,57,.544,7,16,.438,25,30,.833,108
20851,2010-12-19,BOS,,IND,W 99-88,240,41,76,.539,38,62,.613,3,14,.214,14,18,.778,99
20852,2010-12-19,IND,@,BOS,L 88-99,240,34,96,.354,30,78,.385,4,18,.222,16,18,.889,88
20853,2010-12-19,DET,,NOH,W 111-108 (OT),265,44,83,.530,34,60,.567,10,23,.435,13,23,.565,111
20854,2010-12-19,NOP,@,DET,L 108-111 (OT),265,39,87,.448,33,72,.458,6,15,.400,24,30,.800,108
20855,2010-12-19,ATL,@,NJN,L 82-89,240,29,74,.392,24,57,.421,5,17,.294,19,23,.826,82
20856,2010-12-19,BRK,,ATL,W 89-82,240,35,84,.417,31,71,.437,4,13,.308,15,19,.789,89
20857,2010-12-19,OKC,,PHO,L 110-113,240,33,77,.429,27,56,.482,6,21,.286,38,46,.826,110
20858,2010-12-19,PHO,@,OKC,W 113-110,240,42,73,.575,38,61,.623,4,12,.333,25,30,.833,113
20859,2010-12-19,HOU,@,SAC,W 102-93,240,37,83,.446,26,58,.448,11,25,.440,17,22,.773,102
20860,2010-12-19,SAC,,HOU,L 93-102,240,35,91,.385,28,77,.364,7,14,.500,16,19,.842,93
20861,2010-12-19,LAL,@,TOR,W 120-110,240,41,79,.519,34,60,.567,7,19,.368,31,39,.795,120
20862,2010-12-19,TOR,,LAL,L 110-120,240,41,87,.471,34,65,.523,7,22,.318,21,25,.840,110
20863,2010-12-18,CHI,,LAC,L 99-100,240,39,82,.476,33,67,.493,6,15,.400,15,23,.652,99
20864,2010-12-18,LAC,@,CHI,W 100-99,240,37,73,.507,29,56,.518,8,17,.471,18,30,.600,100
20865,2010-12-18,CLE,,NYK,W 109-102 (OT),265,42,102,.412,32,75,.427,10,27,.370,15,20,.750,109
20866,2010-12-18,NYK,@,CLE,L 102-109 (OT),265,39,95,.411,28,61,.459,11,34,.324,13,14,.929,102
20867,2010-12-18,DEN,,MIN,W 115-113,240,39,86,.453,29,59,.492,10,27,.370,27,33,.818,115
20868,2010-12-18,MIN,@,DEN,L 113-115,240,39,84,.464,33,62,.532,6,22,.273,29,35,.829,113
20869,2010-12-18,MIL,,UTA,L 86-95,240,32,71,.451,25,53,.472,7,18,.389,15,18,.833,86
20870,2010-12-18,UTA,@,MIL,W 95-86,240,35,83,.422,28,68,.412,7,15,.467,18,26,.692,95
20871,2010-12-18,ORL,,PHI,L 89-97,240,36,87,.414,33,72,.458,3,15,.200,14,22,.636,89
20872,2010-12-18,PHI,@,ORL,W 97-89,240,34,77,.442,31,66,.470,3,11,.273,26,31,.839,97
20873,2010-12-18,GSW,@,POR,L 95-96,240,36,81,.444,30,64,.469,6,17,.353,17,23,.739,95
20874,2010-12-18,POR,,GSW,W 96-95,240,38,78,.487,32,63,.508,6,15,.400,14,22,.636,96
20875,2010-12-18,MEM,@,SAS,L 106-112 (OT),265,42,95,.442,34,81,.420,8,14,.571,14,21,.667,106
20876,2010-12-18,SAS,,MEM,W 112-106 (OT),265,44,86,.512,34,63,.540,10,23,.435,14,19,.737,112
20877,2010-12-18,MIA,@,WAS,W 95-94,240,31,72,.431,23,50,.460,8,22,.364,25,32,.781,95
20878,2010-12-18,WAS,,MIA,L 94-95,240,37,87,.425,35,78,.449,2,9,.222,18,26,.692,94
20879,2010-12-17,ATL,,CHA,W 90-85,240,36,78,.462,30,53,.566,6,25,.240,12,13,.923,90
20880,2010-12-17,CHA,@,ATL,L 85-90,240,33,87,.379,31,73,.425,2,14,.143,17,20,.850,85
20881,2010-12-17,DAL,,PHO,W 106-91,240,39,86,.453,31,68,.456,8,18,.444,20,31,.645,106
20882,2010-12-17,PHO,@,DAL,L 91-106,240,35,89,.393,30,68,.441,5,21,.238,16,22,.727,91
20883,2010-12-17,DET,,LAC,L 88-109,240,33,82,.402,29,68,.426,4,14,.286,18,27,.667,88
20884,2010-12-17,LAC,@,DET,W 109-88,240,46,81,.568,36,62,.581,10,19,.526,7,13,.538,109
20885,2010-12-17,HOU,,MEM,W 103-87,240,39,81,.481,29,59,.492,10,22,.455,15,18,.833,103
20886,2010-12-17,MEM,@,HOU,L 87-103,240,31,85,.365,29,80,.363,2,5,.400,23,29,.793,87
20887,2010-12-17,CLE,@,IND,L 99-108,240,34,82,.415,28,69,.406,6,13,.462,25,34,.735,99
20888,2010-12-17,IND,,CLE,W 108-99,240,38,81,.469,29,59,.492,9,22,.409,23,31,.742,108
20889,2010-12-17,NOP,,UTA,W 100-71,240,38,75,.507,33,59,.559,5,16,.313,19,22,.864,100
20890,2010-12-17,UTA,@,NOH,L 71-100,240,29,81,.358,26,62,.419,3,19,.158,10,20,.500,71
20891,2010-12-17,MIA,@,NYK,W 113-91,240,45,82,.549,35,64,.547,10,18,.556,13,18,.722,113
20892,2010-12-17,NYK,,MIA,L 91-113,240,35,89,.393,27,65,.415,8,24,.333,13,23,.565,91
20893,2010-12-17,OKC,,SAC,W 102-87,240,39,81,.481,36,66,.545,3,15,.200,21,33,.636,102
20894,2010-12-17,SAC,@,OKC,L 87-102,240,35,82,.427,33,71,.465,2,11,.182,15,23,.652,87
20895,2010-12-17,LAL,@,PHI,W 93-81,240,33,79,.418,30,64,.469,3,15,.200,24,28,.857,93
20896,2010-12-17,PHI,,LAL,L 81-93,240,33,88,.375,30,67,.448,3,21,.143,12,14,.857,81
20897,2010-12-17,MIN,@,POR,L 102-107,240,41,92,.446,38,75,.507,3,17,.176,17,19,.895,102
20898,2010-12-17,POR,,MIN,W 107-102,240,42,83,.506,35,62,.565,7,21,.333,16,19,.842,107
20899,2010-12-17,BRK,@,TOR,L 92-98,240,36,80,.450,34,68,.500,2,12,.167,18,23,.783,92
20900,2010-12-17,TOR,,NJN,W 98-92,240,40,86,.465,33,68,.485,7,18,.389,11,16,.688,98
20901,2010-12-16,ATL,@,BOS,L 90-102,240,34,68,.500,31,58,.534,3,10,.300,19,24,.792,90
20902,2010-12-16,BOS,,ATL,W 102-90,240,44,83,.530,38,65,.585,6,18,.333,8,11,.727,102
20903,2010-12-16,DEN,,SAS,L 112-113,240,39,81,.481,32,67,.478,7,14,.500,27,35,.771,112
20904,2010-12-16,SAS,@,DEN,W 113-112,240,43,83,.518,34,57,.596,9,26,.346,18,25,.720,113
20905,2010-12-16,BRK,,WAS,W 97-89,240,30,74,.405,28,66,.424,2,8,.250,35,47,.745,97
20906,2010-12-16,WAS,@,NJN,L 89-97,240,31,78,.397,26,61,.426,5,17,.294,22,28,.786,89
20907,2010-12-15,DAL,,POR,W 103-98,240,40,74,.541,37,58,.638,3,16,.188,20,21,.952,103
20908,2010-12-15,POR,@,DAL,L 98-103,240,42,85,.494,39,71,.549,3,14,.214,11,18,.611,98
20909,2010-12-15,IND,,LAL,L 94-109,240,38,81,.469,32,60,.533,6,21,.286,12,16,.750,94
20910,2010-12-15,LAL,@,IND,W 109-94,240,42,82,.512,34,65,.523,8,17,.471,17,24,.708,109
20911,2010-12-15,CHA,@,MEM,L 80-113,240,28,68,.412,23,58,.397,5,10,.500,19,26,.731,80
20912,2010-12-15,MEM,,CHA,W 113-80,240,43,82,.524,39,67,.582,4,15,.267,23,29,.793,113
20913,2010-12-15,CLE,@,MIA,L 95-101,240,35,87,.402,26,54,.481,9,33,.273,16,20,.800,95
20914,2010-12-15,MIA,,CLE,W 101-95,240,32,70,.457,22,47,.468,10,23,.435,27,41,.659,101
20915,2010-12-15,NOP,,SAC,W 94-91,240,34,78,.436,30,67,.448,4,11,.364,22,30,.733,94
20916,2010-12-15,SAC,@,NOH,L 91-94,240,39,84,.464,33,64,.516,6,20,.300,7,12,.583,91
20917,2010-12-15,BOS,@,NYK,W 118-116,240,45,86,.523,38,72,.528,7,14,.500,21,21,1.000,118
20918,2010-12-15,NYK,,BOS,L 116-118,240,43,81,.531,34,58,.586,9,23,.391,21,26,.808,116
20919,2010-12-15,HOU,@,OKC,L 105-117,240,38,82,.463,29,60,.483,9,22,.409,20,28,.714,105
20920,2010-12-15,OKC,,HOU,W 117-105,240,41,71,.577,34,60,.567,7,11,.636,28,29,.966,117
20921,2010-12-15,LAC,@,PHI,L 91-105,240,33,83,.398,28,64,.438,5,19,.263,20,27,.741,91
20922,2010-12-15,PHI,,LAC,W 105-91,240,40,91,.440,34,74,.459,6,17,.353,19,23,.826,105
20923,2010-12-15,MIN,@,PHO,L 122-128,240,50,93,.538,42,71,.592,8,22,.364,14,19,.737,122
20924,2010-12-15,PHO,,MIN,W 128-122,240,44,87,.506,29,60,.483,15,27,.556,25,33,.758,128
20925,2010-12-15,MIL,@,SAS,L 90-92,240,35,79,.443,29,68,.426,6,11,.545,14,16,.875,90
20926,2010-12-15,SAS,,MIL,W 92-90,240,36,69,.522,33,61,.541,3,8,.375,17,25,.680,92
20927,2010-12-15,CHI,@,TOR,W 110-93,240,43,81,.531,36,63,.571,7,18,.389,17,24,.708,110
20928,2010-12-15,TOR,,CHI,L 93-110,240,38,86,.442,35,74,.473,3,12,.250,14,16,.875,93
20929,2010-12-14,CHA,,TOR,W 97-91,240,39,75,.520,38,69,.551,1,6,.167,18,29,.621,97
20930,2010-12-14,TOR,@,CHA,L 91-97,240,36,89,.404,28,63,.444,8,26,.308,11,21,.524,91
20931,2010-12-14,DEN,,ORL,W 111-94,240,43,80,.538,32,54,.593,11,26,.423,14,19,.737,111
20932,2010-12-14,ORL,@,DEN,L 94-111,240,34,78,.436,24,51,.471,10,27,.370,16,20,.800,94
20933,2010-12-14,ATL,@,DET,L 80-103,240,30,68,.441,24,54,.444,6,14,.429,14,20,.700,80
20934,2010-12-14,DET,,ATL,W 103-80,240,37,78,.474,27,56,.482,10,22,.455,19,21,.905,103
20935,2010-12-14,GSW,,MIN,W 108-99,240,39,77,.506,28,55,.509,11,22,.500,19,31,.613,108
20936,2010-12-14,MIN,@,GSW,L 99-108,240,39,85,.459,34,67,.507,5,18,.278,16,24,.667,99
20937,2010-12-14,HOU,,SAC,W 118-105,240,46,92,.500,36,69,.522,10,23,.435,16,21,.762,118
20938,2010-12-14,SAC,@,HOU,L 105-118,240,42,80,.525,38,69,.551,4,11,.364,17,22,.773,105
20939,2010-12-14,BRK,,PHI,L 77-82,240,28,82,.341,24,69,.348,4,13,.308,17,24,.708,77
20940,2010-12-14,PHI,@,NJN,W 82-77,240,30,74,.405,24,58,.414,6,16,.375,16,19,.842,82
20941,2010-12-14,LAL,@,WAS,W 103-89,240,34,75,.453,28,54,.519,6,21,.286,29,40,.725,103
20942,2010-12-14,WAS,,LAL,L 89-103,240,37,91,.407,34,72,.472,3,19,.158,12,16,.750,89
20943,2010-12-13,CHI,,IND,W 92-73,240,37,79,.468,29,61,.475,8,18,.444,10,20,.500,92
20944,2010-12-13,IND,@,CHI,L 73-92,240,30,84,.357,27,65,.415,3,19,.158,10,15,.667,73
20945,2010-12-13,DAL,,MIL,L 99-103,240,37,76,.487,32,56,.571,5,20,.250,20,27,.741,99
20946,2010-12-13,MIL,@,DAL,W 103-99,240,40,84,.476,31,71,.437,9,13,.692,14,20,.700,103
20947,2010-12-13,MEM,,POR,W 86-73,240,31,81,.383,25,67,.373,6,14,.429,18,26,.692,86
20948,2010-12-13,POR,@,MEM,L 73-86,240,29,79,.367,25,61,.410,4,18,.222,11,18,.611,73
20949,2010-12-13,MIA,,NOH,W 96-84,240,31,70,.443,27,56,.482,4,14,.286,30,38,.789,96
20950,2010-12-13,NOP,@,MIA,L 84-96,240,28,67,.418,27,54,.500,1,13,.077,27,34,.794,84
20951,2010-12-13,GSW,@,UTA,L 95-108,240,32,81,.395,21,56,.375,11,25,.440,20,31,.645,95
20952,2010-12-13,UTA,,GSW,W 108-95,240,39,79,.494,33,62,.532,6,17,.353,24,29,.828,108
20953,2010-12-12,LAC,,ORL,L 85-94,240,32,84,.381,28,61,.459,4,23,.174,17,25,.680,85
20954,2010-12-12,ORL,@,LAC,W 94-85,240,36,75,.480,30,52,.577,6,23,.261,16,26,.615,94
20955,2010-12-12,LAL,@,NJN,W 99-92,240,34,82,.415,27,66,.409,7,16,.438,24,29,.828,99
20956,2010-12-12,BRK,,LAL,L 92-99,240,36,89,.404,32,69,.464,4,20,.200,16,19,.842,92
20957,2010-12-12,DEN,@,NYK,L 125-129,240,42,83,.506,35,62,.565,7,21,.333,34,40,.850,125
20958,2010-12-12,NYK,,DEN,W 129-125,240,46,88,.523,33,58,.569,13,30,.433,24,26,.923,129
20959,2010-12-12,CLE,@,OKC,L 77-106,240,26,77,.338,21,62,.339,5,15,.333,20,32,.625,77
20960,2010-12-12,OKC,,CLE,W 106-77,240,41,77,.532,34,58,.586,7,19,.368,17,24,.708,106
20961,2010-12-12,NOP,@,PHI,L 70-88,240,24,79,.304,19,67,.284,5,12,.417,17,23,.739,70
20962,2010-12-12,PHI,,NOH,W 88-70,240,33,77,.429,26,60,.433,7,17,.412,15,22,.682,88
20963,2010-12-12,POR,@,SAS,L 78-95,240,33,87,.379,28,72,.389,5,15,.333,7,11,.636,78
20964,2010-12-12,SAS,,POR,W 95-78,240,32,74,.432,23,57,.404,9,17,.529,22,26,.846,95
20965,2010-12-11,ATL,,IND,W 97-83,240,33,73,.452,29,61,.475,4,12,.333,27,34,.794,97
20966,2010-12-11,IND,@,ATL,L 83-97,240,30,81,.370,22,53,.415,8,28,.286,15,16,.938,83
20967,2010-12-11,BOS,@,CHA,W 93-62,240,31,71,.437,23,50,.460,8,21,.381,23,28,.821,93
20968,2010-12-11,CHA,,BOS,L 62-93,240,24,71,.338,23,60,.383,1,11,.091,13,23,.565,62
20969,2010-12-11,CHI,,MIN,W 113-82,240,41,86,.477,31,69,.449,10,17,.588,21,27,.778,113
20970,2010-12-11,MIN,@,CHI,L 82-113,240,33,83,.398,26,64,.406,7,19,.368,9,13,.692,82
20971,2010-12-11,DAL,,UTA,W 103-97,240,33,66,.500,19,40,.475,14,26,.538,23,28,.821,103
20972,2010-12-11,UTA,@,DAL,L 97-103,240,36,81,.444,31,65,.477,5,16,.313,20,23,.870,97
20973,2010-12-11,DET,,TOR,L 116-120,240,47,89,.528,41,73,.562,6,16,.375,16,23,.696,116
20974,2010-12-11,TOR,@,DET,W 120-116,240,44,70,.629,35,56,.625,9,14,.643,23,29,.793,120
20975,2010-12-11,CLE,@,HOU,L 95-110,240,35,82,.427,29,65,.446,6,17,.353,19,22,.864,95
20976,2010-12-11,HOU,,CLE,W 110-95,240,39,80,.488,27,54,.500,12,26,.462,20,23,.870,110
20977,2010-12-11,LAC,,MEM,L 83-84,240,33,72,.458,26,58,.448,7,14,.500,10,12,.833,83
20978,2010-12-11,MEM,@,LAC,W 84-83,240,33,79,.418,29,68,.426,4,11,.364,14,18,.778,84
20979,2010-12-11,MIA,@,SAC,W 104-83,240,41,79,.519,34,65,.523,7,14,.500,15,24,.625,104
20980,2010-12-11,SAC,,MIA,L 83-104,240,33,90,.367,27,72,.375,6,18,.333,11,21,.524,83
20981,2010-12-10,CHI,,LAL,W 88-84,240,33,80,.413,25,63,.397,8,17,.471,14,17,.824,88
20982,2010-12-10,LAL,@,CHI,L 84-88,240,34,78,.436,31,65,.477,3,13,.231,13,18,.722,84
20983,2010-12-10,GSW,,MIA,L 84-106,240,31,83,.373,23,59,.390,8,24,.333,14,21,.667,84
20984,2010-12-10,MIA,@,GSW,W 106-84,240,41,78,.526,32,64,.500,9,14,.643,15,21,.714,106
20985,2010-12-10,CHA,@,IND,L 92-100,240,36,87,.414,33,70,.471,3,17,.176,17,25,.680,92
20986,2010-12-10,IND,,CHA,W 100-92,240,38,86,.442,25,55,.455,13,31,.419,11,18,.611,100
20987,2010-12-10,HOU,@,MIL,L 91-97,240,33,81,.407,27,63,.429,6,18,.333,19,22,.864,91
20988,2010-12-10,MIL,,HOU,W 97-91,240,38,79,.481,34,71,.479,4,8,.500,17,25,.680,97
20989,2010-12-10,DET,@,MIN,L 99-109,240,32,83,.386,28,71,.394,4,12,.333,31,36,.861,99
20990,2010-12-10,MIN,,DET,W 109-99,240,42,81,.519,35,65,.538,7,16,.438,18,22,.818,109
20991,2010-12-10,NOP,,OKC,L 92-97,240,35,74,.473,30,60,.500,5,14,.357,17,23,.739,92
20992,2010-12-10,OKC,@,NOH,W 97-92,240,35,70,.500,31,57,.544,4,13,.308,23,26,.885,97
20993,2010-12-10,PHO,,POR,L 94-101,240,37,83,.446,34,69,.493,3,14,.214,17,17,1.000,94
20994,2010-12-10,POR,@,PHO,W 101-94,240,35,71,.493,30,54,.556,5,17,.294,26,32,.813,101
20995,2010-12-10,ATL,@,SAS,L 92-108,240,36,80,.450,29,66,.439,7,14,.500,13,20,.650,92
20996,2010-12-10,SAS,,ATL,W 108-92,240,41,77,.532,31,56,.554,10,21,.476,16,25,.640,108
20997,2010-12-10,DEN,@,TOR,W 123-116,240,43,76,.566,31,50,.620,12,26,.462,25,28,.893,123
20998,2010-12-10,TOR,,DEN,L 116-123,240,46,90,.511,36,65,.554,10,25,.400,14,19,.737,116
20999,2010-12-10,ORL,@,UTA,L 105-117,240,38,80,.475,29,55,.527,9,25,.360,20,28,.714,105
21000,2010-12-10,UTA,,ORL,W 117-105,240,41,76,.539,31,60,.517,10,16,.625,25,32,.781,117
21001,2010-12-10,NYK,@,WAS,W 101-95,240,34,75,.453,27,57,.474,7,18,.389,26,30,.867,101
21002,2010-12-10,WAS,,NYK,L 95-101,240,35,84,.417,29,66,.439,6,18,.333,19,27,.704,95
21003,2010-12-09,DAL,,NJN,W 102-89,240,41,75,.547,37,59,.627,4,16,.250,16,19,.842,102
21004,2010-12-09,BRK,@,DAL,L 89-102,240,32,77,.416,28,62,.452,4,15,.267,21,26,.808,89
21005,2010-12-09,BOS,@,PHI,W 102-101,240,38,68,.559,31,56,.554,7,12,.583,19,21,.905,102
21006,2010-12-09,PHI,,BOS,L 101-102,240,37,81,.457,28,62,.452,9,19,.474,18,23,.783,101
21007,2010-12-09,ORL,@,POR,L 83-97,240,30,71,.423,24,49,.490,6,22,.273,17,24,.708,83
21008,2010-12-09,POR,,ORL,W 97-83,240,36,81,.444,31,66,.470,5,15,.333,20,28,.714,97
21009,2010-12-08,BOS,,DEN,W 105-89,240,38,68,.559,34,53,.642,4,15,.267,25,36,.694,105
21010,2010-12-08,DEN,@,BOS,L 89-105,240,33,78,.423,27,59,.458,6,19,.316,17,25,.680,89
21011,2010-12-08,CHI,@,CLE,W 88-83,240,35,78,.449,29,62,.468,6,16,.375,12,20,.600,88
21012,2010-12-08,CLE,,CHI,L 83-88,240,31,81,.383,21,51,.412,10,30,.333,11,18,.611,83
21013,2010-12-08,LAC,,LAL,L 86-87,240,32,80,.400,23,57,.404,9,23,.391,13,19,.684,86
21014,2010-12-08,LAL,@,LAC,W 87-86,240,34,80,.425,27,61,.443,7,19,.368,12,19,.632,87
21015,2010-12-08,IND,@,MIL,L 95-97,240,32,74,.432,23,50,.460,9,24,.375,22,31,.710,95
21016,2010-12-08,MIL,,IND,W 97-95,240,31,86,.360,28,73,.384,3,13,.231,32,40,.800,97
21017,2010-12-08,MIN,,OKC,L 103-111,240,39,93,.419,31,75,.413,8,18,.444,17,26,.654,103
21018,2010-12-08,OKC,@,MIN,W 111-103,240,40,77,.519,34,60,.567,6,17,.353,25,27,.926,111
21019,2010-12-08,DET,@,NOH,L 74-93,240,30,80,.375,26,60,.433,4,20,.200,10,18,.556,74
21020,2010-12-08,NOP,,DET,W 93-74,240,37,74,.500,31,60,.517,6,14,.429,13,21,.619,93
21021,2010-12-08,NYK,,TOR,W 113-110,240,43,89,.483,35,68,.515,8,21,.381,19,22,.864,113
21022,2010-12-08,TOR,@,NYK,L 110-113,240,41,86,.477,36,70,.514,5,16,.313,23,31,.742,110
21023,2010-12-08,MEM,@,PHO,W 104-98 (OT),265,42,85,.494,40,78,.513,2,7,.286,18,22,.818,104
21024,2010-12-08,PHO,,MEM,L 98-104 (OT),265,37,88,.420,30,58,.517,7,30,.233,17,27,.630,98
21025,2010-12-08,SAC,,WAS,W 116-91,240,45,83,.542,37,66,.561,8,17,.471,18,24,.750,116
21026,2010-12-08,WAS,@,SAC,L 91-116,240,31,75,.413,26,64,.406,5,11,.455,24,34,.706,91
21027,2010-12-08,GSW,@,SAS,L 94-111,240,37,82,.451,25,59,.424,12,23,.522,8,11,.727,94
21028,2010-12-08,SAS,,GSW,W 111-94,240,43,84,.512,31,58,.534,12,26,.462,13,18,.722,111
21029,2010-12-08,MIA,@,UTA,W 111-98,240,41,80,.513,32,60,.533,9,20,.450,20,25,.800,111
21030,2010-12-08,UTA,,MIA,L 98-111,240,38,75,.507,37,61,.607,1,14,.071,21,27,.778,98
21031,2010-12-07,ATL,,NJN,W 116-101,240,47,78,.603,41,62,.661,6,16,.375,16,28,.571,116
21032,2010-12-07,BRK,@,ATL,L 101-116,240,33,71,.465,26,55,.473,7,16,.438,28,37,.757,101
21033,2010-12-07,CHA,,DEN,W 100-98,240,39,78,.500,30,58,.517,9,20,.450,13,20,.650,100
21034,2010-12-07,DEN,@,CHA,L 98-100,240,31,73,.425,20,47,.426,11,26,.423,25,32,.781,98
21035,2010-12-07,DAL,,GSW,W 105-100,240,39,87,.448,32,67,.478,7,20,.350,20,27,.741,105
21036,2010-12-07,GSW,@,DAL,L 100-105,240,42,90,.467,32,70,.457,10,20,.500,6,13,.462,100
21037,2010-12-07,DET,@,HOU,L 83-97,240,30,72,.417,24,55,.436,6,17,.353,17,21,.810,83
21038,2010-12-07,HOU,,DET,W 97-83,240,33,72,.458,26,58,.448,7,14,.500,24,31,.774,97
21039,2010-12-07,LAL,,WAS,W 115-108,240,40,89,.449,33,64,.516,7,25,.280,28,35,.800,115
21040,2010-12-07,WAS,@,LAL,L 108-115,240,38,76,.500,27,49,.551,11,27,.407,21,26,.808,108
21041,2010-12-07,CLE,@,PHI,L 97-117,240,39,78,.500,32,61,.525,7,17,.412,12,17,.706,97
21042,2010-12-07,PHI,,CLE,W 117-97,240,42,81,.519,34,58,.586,8,23,.348,25,30,.833,117
21043,2010-12-07,PHO,@,POR,L 99-106,240,37,73,.507,29,57,.509,8,16,.500,17,21,.810,99
21044,2010-12-07,POR,,PHO,W 106-99,240,33,74,.446,25,50,.500,8,24,.333,32,33,.970,106
21045,2010-12-06,CHI,,OKC,W 99-90,240,42,87,.483,37,76,.487,5,11,.455,10,17,.588,99
21046,2010-12-06,OKC,@,CHI,L 90-99,240,29,82,.354,25,63,.397,4,19,.211,28,31,.903,90
21047,2010-12-06,IND,,TOR,W 124-100,240,47,85,.553,34,59,.576,13,26,.500,17,20,.850,124
21048,2010-12-06,TOR,@,IND,L 100-124,240,42,100,.420,36,82,.439,6,18,.333,10,15,.667,100
21049,2010-12-06,LAC,,SAC,W 98-91,240,36,81,.444,29,63,.460,7,18,.389,19,23,.826,98
21050,2010-12-06,SAC,@,LAC,L 91-98,240,31,85,.365,28,69,.406,3,16,.188,26,32,.813,91
21051,2010-12-06,MIA,@,MIL,W 88-78,240,35,72,.486,30,64,.469,5,8,.625,13,18,.722,88
21052,2010-12-06,MIL,,MIA,L 78-88,240,27,78,.346,23,63,.365,4,15,.267,20,25,.800,78
21053,2010-12-06,MIN,@,NYK,L 114-121,240,41,78,.526,31,57,.544,10,21,.476,22,27,.815,114
21054,2010-12-06,NYK,,MIN,W 121-114,240,45,85,.529,32,55,.582,13,30,.433,18,23,.783,121
21055,2010-12-06,ATL,@,ORL,W 80-74,240,33,85,.388,28,71,.394,5,14,.357,9,12,.750,80
21056,2010-12-06,ORL,,ATL,L 74-80,240,28,74,.378,24,52,.462,4,22,.182,14,21,.667,74
21057,2010-12-06,MEM,@,UTA,L 85-94,240,33,79,.418,32,68,.471,1,11,.091,18,23,.783,85
21058,2010-12-06,UTA,,MEM,W 94-85,240,34,81,.420,26,59,.441,8,22,.364,18,20,.900,94
21059,2010-12-05,DEN,,MEM,W 108-107,240,39,86,.453,34,66,.515,5,20,.250,25,33,.758,108
21060,2010-12-05,MEM,@,DEN,L 107-108,240,45,86,.523,39,71,.549,6,15,.400,11,17,.647,107
21061,2010-12-05,CLE,@,DET,L 92-102,240,35,84,.417,29,64,.453,6,20,.300,16,22,.727,92
21062,2010-12-05,DET,,CLE,W 102-92,240,38,81,.469,29,61,.475,9,20,.450,17,21,.810,102
21063,2010-12-05,BOS,@,NJN,W 100-75,240,39,77,.506,36,62,.581,3,15,.200,19,29,.655,100
21064,2010-12-05,BRK,,BOS,L 75-100,240,27,72,.375,22,57,.386,5,15,.333,16,24,.667,75
21065,2010-12-05,GSW,@,OKC,L 109-114,240,42,93,.452,35,73,.479,7,20,.350,18,21,.857,109
21066,2010-12-05,OKC,,GSW,W 114-109,240,37,85,.435,34,73,.466,3,12,.250,37,40,.925,114
21067,2010-12-05,PHO,,WAS,W 125-108,240,47,81,.580,39,60,.650,8,21,.381,23,35,.657,125
21068,2010-12-05,WAS,@,PHO,L 108-125,240,45,89,.506,39,71,.549,6,18,.333,12,15,.800,108
21069,2010-12-05,LAC,@,POR,L 91-100,240,29,71,.408,22,46,.478,7,25,.280,26,43,.605,91
21070,2010-12-05,POR,,LAC,W 100-91,240,31,78,.397,24,65,.369,7,13,.538,31,36,.861,100
21071,2010-12-05,NOP,@,SAS,L 84-109,240,33,75,.440,30,67,.448,3,8,.375,15,19,.789,84
21072,2010-12-05,SAS,,NOH,W 109-84,240,41,70,.586,30,48,.625,11,22,.500,16,23,.696,109
21073,2010-12-05,NYK,@,TOR,W 116-99,240,43,88,.489,31,61,.508,12,27,.444,18,21,.857,116
21074,2010-12-05,TOR,,NYK,L 99-116,240,40,87,.460,32,68,.471,8,19,.421,11,22,.500,99
21075,2010-12-04,CHI,,HOU,W 119-116 (OT),265,47,94,.500,39,75,.520,8,19,.421,17,24,.708,119
21076,2010-12-04,HOU,@,CHI,L 116-119 (OT),265,40,89,.449,31,66,.470,9,23,.391,27,36,.750,116
21077,2010-12-04,ATL,@,MIA,L 77-89,240,32,80,.400,27,63,.429,5,17,.294,8,12,.667,77
21078,2010-12-04,MIA,,ATL,W 89-77,240,34,72,.472,31,64,.484,3,8,.375,18,23,.783,89
21079,2010-12-04,MIL,,ORL,W 96-85,240,36,77,.468,35,69,.507,1,8,.125,23,43,.535,96
21080,2010-12-04,ORL,@,MIL,L 85-96,240,34,82,.415,28,60,.467,6,22,.273,11,16,.688,85
21081,2010-12-04,CLE,@,MIN,L 95-129,240,34,88,.386,29,67,.433,5,21,.238,22,25,.880,95
21082,2010-12-04,MIN,,CLE,W 129-95,240,48,81,.593,30,55,.545,18,26,.692,15,18,.833,129
21083,2010-12-04,CHA,@,PHI,L 91-109,240,33,77,.429,28,62,.452,5,15,.333,20,26,.769,91
21084,2010-12-04,PHI,,CHA,W 109-91,240,41,79,.519,30,58,.517,11,21,.524,16,19,.842,109
21085,2010-12-04,DAL,@,SAC,W 105-103,240,38,76,.500,33,59,.559,5,17,.294,24,29,.828,105
21086,2010-12-04,SAC,,DAL,L 103-105,240,40,83,.482,29,64,.453,11,19,.579,12,16,.750,103
21087,2010-12-03,ATL,,PHI,W 93-88,240,33,79,.418,29,67,.433,4,12,.333,23,28,.821,93
21088,2010-12-03,PHI,@,ATL,L 88-93,240,36,83,.434,33,71,.465,3,12,.250,13,19,.684,88
21089,2010-12-03,BOS,,CHI,W 104-92,240,43,81,.531,42,72,.583,1,9,.111,17,22,.773,104
21090,2010-12-03,CHI,@,BOS,L 92-104,240,31,74,.419,26,61,.426,5,13,.385,25,34,.735,92
21091,2010-12-03,CHA,,NJN,W 91-84 (OT),265,31,86,.360,24,71,.338,7,15,.467,22,32,.688,91
21092,2010-12-03,BRK,@,CHA,L 84-91 (OT),265,29,91,.319,24,66,.364,5,25,.200,21,25,.840,84
21093,2010-12-03,DEN,,LAC,W 109-104,240,27,67,.403,17,43,.395,10,24,.417,45,59,.763,109
21094,2010-12-03,LAC,@,DEN,L 104-109,240,39,90,.433,33,70,.471,6,20,.300,20,29,.690,104
21095,2010-12-03,DET,,ORL,L 91-104,240,34,70,.486,25,52,.481,9,18,.500,14,19,.737,91
21096,2010-12-03,ORL,@,DET,W 104-91,240,43,72,.597,36,50,.720,7,22,.318,11,15,.733,104
21097,2010-12-03,LAL,,SAC,W 113-80,240,47,83,.566,44,69,.638,3,14,.214,16,22,.727,113
21098,2010-12-03,SAC,@,LAL,L 80-113,240,31,77,.403,26,61,.426,5,16,.313,13,22,.591,80
21099,2010-12-03,HOU,@,MEM,W 127-111,240,44,74,.595,28,51,.549,16,23,.696,23,26,.885,127
21100,2010-12-03,MEM,,HOU,L 111-127,240,40,77,.519,37,65,.569,3,12,.250,28,33,.848,111
21101,2010-12-03,NOP,,NYK,L 92-100,240,33,77,.429,30,63,.476,3,14,.214,23,30,.767,92
21102,2010-12-03,NYK,@,NOH,W 100-92,240,39,83,.470,26,53,.491,13,30,.433,9,12,.750,100
21103,2010-12-03,IND,@,PHO,L 97-105,240,37,79,.468,26,53,.491,11,26,.423,12,16,.750,97
21104,2010-12-03,PHO,,IND,W 105-97,240,35,78,.449,24,56,.429,11,22,.500,24,33,.727,105
21105,2010-12-03,MIN,@,SAS,L 101-107,240,39,94,.415,36,82,.439,3,12,.250,20,25,.800,101
21106,2010-12-03,SAS,,MIN,W 107-101,240,34,75,.453,28,52,.538,6,23,.261,33,37,.892,107
21107,2010-12-03,OKC,@,TOR,L 99-111,240,38,87,.437,31,69,.449,7,18,.389,16,19,.842,99
21108,2010-12-03,TOR,,OKC,W 111-99,240,45,82,.549,42,67,.627,3,15,.200,18,24,.750,111
21109,2010-12-03,DAL,@,UTA,W 93-81,240,40,76,.526,34,57,.596,6,19,.316,7,11,.636,93
21110,2010-12-03,UTA,,DAL,L 81-93,240,29,74,.392,26,60,.433,3,14,.214,20,30,.667,81
21111,2010-12-03,POR,@,WAS,L 79-83,240,31,93,.333,25,72,.347,6,21,.286,11,12,.917,79
21112,2010-12-03,WAS,,POR,W 83-79,240,30,72,.417,28,60,.467,2,12,.167,21,26,.808,83
21113,2010-12-02,CLE,,MIA,L 90-118,240,27,76,.355,20,57,.351,7,19,.368,29,37,.784,90
21114,2010-12-02,MIA,@,CLE,W 118-90,240,47,83,.566,37,59,.627,10,24,.417,14,21,.667,118
21115,2010-12-02,GSW,,PHO,L 101-107,240,41,82,.500,32,64,.500,9,18,.500,10,17,.588,101
21116,2010-12-02,PHO,@,GSW,W 107-101,240,40,73,.548,34,55,.618,6,18,.333,21,22,.955,107
21117,2010-12-01,ATL,,MEM,W 112-109,240,42,79,.532,35,67,.522,7,12,.583,21,26,.808,112
21118,2010-12-01,MEM,@,ATL,L 109-112,240,44,84,.524,41,74,.554,3,10,.300,18,24,.750,109
21119,2010-12-01,BOS,,POR,W 99-95,240,36,63,.571,30,49,.612,6,14,.429,21,26,.808,99
21120,2010-12-01,POR,@,BOS,L 95-99,240,34,74,.459,27,57,.474,7,17,.412,20,23,.870,95
21121,2010-12-01,CHI,,ORL,L 78-107,240,30,71,.423,26,60,.433,4,11,.364,14,21,.667,78
21122,2010-12-01,ORL,@,CHI,W 107-78,240,37,76,.487,27,55,.491,10,21,.476,23,24,.958,107
21123,2010-12-01,DAL,,MIN,W 100-86,240,36,87,.414,26,63,.413,10,24,.417,18,23,.783,100
21124,2010-12-01,MIN,@,DAL,L 86-100,240,32,82,.390,28,68,.412,4,14,.286,18,23,.783,86
21125,2010-12-01,DEN,,MIL,W 105-94,240,34,75,.453,28,54,.519,6,21,.286,31,41,.756,105
21126,2010-12-01,MIL,@,DEN,L 94-105,240,32,80,.400,25,58,.431,7,22,.318,23,32,.719,94
21127,2010-12-01,HOU,,LAL,W 109-99,240,40,79,.506,30,57,.526,10,22,.455,19,21,.905,109
21128,2010-12-01,LAL,@,HOU,L 99-109,240,37,82,.451,32,66,.485,5,16,.313,20,23,.870,99
21129,2010-12-01,LAC,,SAS,W 90-85,240,37,75,.493,30,53,.566,7,22,.318,9,18,.500,90
21130,2010-12-01,SAS,@,LAC,L 85-90,240,32,90,.356,23,60,.383,9,30,.300,12,17,.706,85
21131,2010-12-01,DET,@,MIA,L 72-97,240,28,76,.368,23,57,.404,5,19,.263,11,19,.579,72
21132,2010-12-01,MIA,,DET,W 97-72,240,39,76,.513,33,64,.516,6,12,.500,13,21,.619,97
21133,2010-12-01,BRK,,OKC,L 120-123 (3OT),315,43,93,.462,35,77,.455,8,16,.500,26,32,.813,120
21134,2010-12-01,OKC,@,NJN,W 123-120 (3OT),315,43,101,.426,38,89,.427,5,12,.417,32,41,.780,123
21135,2010-12-01,CHA,@,NOH,L 73-89,240,29,71,.408,26,60,.433,3,11,.273,12,19,.632,73
21136,2010-12-01,NOP,,CHA,W 89-73,240,36,77,.468,30,59,.508,6,18,.333,11,17,.647,89
21137,2010-12-01,TOR,,WAS,W 127-108,240,51,88,.580,45,77,.584,6,11,.545,19,27,.704,127
21138,2010-12-01,WAS,@,TOR,L 108-127,240,38,83,.458,35,74,.473,3,9,.333,29,41,.707,108
21139,2010-12-01,IND,@,UTA,L 88-110,240,30,66,.455,21,42,.500,9,24,.375,19,25,.760,88
21140,2010-12-01,UTA,,IND,W 110-88,240,45,98,.459,37,73,.507,8,25,.320,12,15,.800,110
21141,2010-11-30,BOS,@,CLE,W 106-87,240,44,87,.506,39,74,.527,5,13,.385,13,23,.565,106
21142,2010-11-30,CLE,,BOS,L 87-106,240,32,82,.390,27,67,.403,5,15,.333,18,24,.750,87
21143,2010-11-30,GSW,,SAS,L 98-118,240,41,87,.471,36,69,.522,5,18,.278,11,18,.611,98
21144,2010-11-30,SAS,@,GSW,W 118-98,240,42,91,.462,35,70,.500,7,21,.333,27,31,.871,118
21145,2010-11-30,LAL,@,MEM,L 96-98,240,34,78,.436,27,56,.482,7,22,.318,21,25,.840,96
21146,2010-11-30,MEM,,LAL,W 98-96,240,39,80,.488,31,68,.456,8,12,.667,12,16,.750,98
21147,2010-11-30,BRK,@,NYK,L 100-111,240,38,82,.463,31,68,.456,7,14,.500,17,22,.773,100
21148,2010-11-30,NYK,,NJN,W 111-100,240,41,80,.513,37,61,.607,4,19,.211,25,29,.862,111
21149,2010-11-30,DET,@,ORL,L 79-90,240,32,75,.427,28,59,.475,4,16,.250,11,12,.917,79
21150,2010-11-30,ORL,,DET,W 90-79,240,34,73,.466,24,49,.490,10,24,.417,12,18,.667,90
21151,2010-11-30,PHI,,POR,W 88-79,240,31,66,.470,25,52,.481,6,14,.429,20,26,.769,88
21152,2010-11-30,POR,@,PHI,L 79-88,240,30,81,.370,25,63,.397,5,18,.278,14,17,.824,79
21153,2010-11-30,IND,@,SAC,W 107-98,240,36,79,.456,30,60,.500,6,19,.316,29,34,.853,107
21154,2010-11-30,SAC,,IND,L 98-107,240,39,88,.443,34,68,.500,5,20,.250,15,23,.652,98
21155,2010-11-29,DAL,,HOU,W 101-91,240,39,79,.494,33,63,.524,6,16,.375,17,19,.895,101
21156,2010-11-29,HOU,@,DAL,L 91-101,240,29,81,.358,20,58,.345,9,23,.391,24,28,.857,91
21157,2010-11-29,MIA,,WAS,W 105-94,240,34,74,.459,30,62,.484,4,12,.333,33,42,.786,105
21158,2010-11-29,WAS,@,MIA,L 94-105,240,35,84,.417,32,67,.478,3,17,.176,21,29,.724,94
21159,2010-11-29,NOP,@,OKC,L 89-95,240,36,82,.439,30,68,.441,6,14,.429,11,17,.647,89
21160,2010-11-29,OKC,,NOH,W 95-89,240,31,82,.378,24,62,.387,7,20,.350,26,29,.897,95
21161,2010-11-29,MIL,@,UTA,L 88-109,240,26,75,.347,16,52,.308,10,23,.435,26,34,.765,88
21162,2010-11-29,UTA,,MIL,W 109-88,240,46,84,.548,41,67,.612,5,17,.294,12,14,.857,109
21163,2010-11-28,DEN,,PHO,W 138-133,240,43,83,.518,27,53,.509,16,30,.533,36,52,.692,138
21164,2010-11-28,PHO,@,DEN,L 133-138,240,52,102,.510,39,70,.557,13,32,.406,16,24,.667,133
21165,2010-11-28,DET,,NYK,L 116-125 (2OT),290,42,92,.457,37,79,.468,5,13,.385,27,28,.964,116
21166,2010-11-28,NYK,@,DET,W 125-116 (2OT),290,41,88,.466,26,50,.520,15,38,.395,28,34,.824,125
21167,2010-11-28,HOU,,OKC,W 99-98,240,38,84,.452,28,67,.418,10,17,.588,13,20,.650,99
21168,2010-11-28,OKC,@,HOU,L 98-99,240,39,79,.494,34,67,.507,5,12,.417,15,23,.652,98
21169,2010-11-28,LAC,,UTA,L 97-109,240,33,72,.458,25,53,.472,8,19,.421,23,30,.767,97
21170,2010-11-28,UTA,@,LAC,W 109-97,240,41,70,.586,33,49,.673,8,21,.381,19,25,.760,109
21171,2010-11-28,IND,@,LAL,W 95-92,240,38,88,.432,34,65,.523,4,23,.174,15,19,.789,95
21172,2010-11-28,LAL,,IND,L 92-95,240,34,88,.386,27,65,.415,7,23,.304,17,21,.810,92
21173,2010-11-28,BRK,,POR,W 98-96,240,31,59,.525,24,45,.533,7,14,.500,29,35,.829,98
21174,2010-11-28,POR,@,NJN,L 96-98,240,33,78,.423,26,65,.400,7,13,.538,23,30,.767,96
21175,2010-11-28,NOP,,SAS,L 95-109,240,36,72,.500,31,61,.508,5,11,.455,18,24,.750,95
21176,2010-11-28,SAS,@,NOH,W 109-95,240,40,82,.488,31,57,.544,9,25,.360,20,25,.800,109
21177,2010-11-28,ATL,@,TOR,W 96-78,240,37,79,.468,29,61,.475,8,18,.444,14,20,.700,96
21178,2010-11-28,TOR,,ATL,L 78-96,240,30,75,.400,29,63,.460,1,12,.083,17,21,.810,78
21179,2010-11-27,CLE,,MEM,W 92-86,240,35,83,.422,27,60,.450,8,23,.348,14,22,.636,92
21180,2010-11-27,MEM,@,CLE,L 86-92,240,36,85,.424,30,71,.423,6,14,.429,8,11,.727,86
21181,2010-11-27,DAL,,MIA,W 106-95,240,40,87,.460,33,70,.471,7,17,.412,19,22,.864,106
21182,2010-11-27,MIA,@,DAL,L 95-106,240,31,75,.413,26,60,.433,5,15,.333,28,35,.800,95
21183,2010-11-27,CHA,@,MIL,L 101-104,240,32,67,.478,30,51,.588,2,16,.125,35,41,.854,101
21184,2010-11-27,MIL,,CHA,W 104-101,240,33,72,.458,23,46,.500,10,26,.385,28,34,.824,104
21185,2010-11-27,GSW,@,MIN,W 104-94,240,40,79,.506,28,61,.459,12,18,.667,12,17,.706,104
21186,2010-11-27,MIN,,GSW,L 94-104,240,32,81,.395,27,63,.429,5,18,.278,25,31,.806,94
21187,2010-11-27,ATL,@,NYK,W 99-90,240,39,89,.438,29,63,.460,10,26,.385,11,14,.786,99
21188,2010-11-27,NYK,,ATL,L 90-99,240,35,74,.473,31,59,.525,4,15,.267,16,19,.842,90
21189,2010-11-27,BRK,@,PHI,L 86-102,240,33,81,.407,30,72,.417,3,9,.333,17,20,.850,86
21190,2010-11-27,PHI,,NJN,W 102-86,240,43,84,.512,38,71,.535,5,13,.385,11,18,.611,102
21191,2010-11-27,CHI,@,SAC,W 96-85,240,33,77,.429,30,66,.455,3,11,.273,27,33,.818,96
21192,2010-11-27,SAC,,CHI,L 85-96,240,33,81,.407,28,67,.418,5,14,.357,14,17,.824,85
21193,2010-11-27,ORL,@,WAS,W 100-99,240,36,78,.462,28,57,.491,8,21,.381,20,27,.741,100
21194,2010-11-27,WAS,,ORL,L 99-100,240,36,80,.450,29,64,.453,7,16,.438,20,27,.741,99
21195,2010-11-26,BOS,,TOR,W 110-101,240,41,76,.539,37,63,.587,4,13,.308,24,30,.800,110
21196,2010-11-26,TOR,@,BOS,L 101-110,240,37,82,.451,30,67,.448,7,15,.467,20,29,.690,101
21197,2010-11-26,CHA,,HOU,W 99-89,240,39,85,.459,33,68,.485,6,17,.353,15,20,.750,99
21198,2010-11-26,HOU,@,CHA,L 89-99,240,33,79,.418,24,51,.471,9,28,.321,14,23,.609,89
21199,2010-11-26,CHI,@,DEN,L 97-98,240,33,83,.398,29,63,.460,4,20,.200,27,35,.771,97
21200,2010-11-26,DEN,,CHI,W 98-97,240,36,77,.468,30,59,.508,6,18,.333,20,25,.800,98
21201,2010-11-26,DET,,MIL,W 103-89,240,41,73,.562,34,59,.576,7,14,.500,14,17,.824,103
21202,2010-11-26,MIL,@,DET,L 89-103,240,34,88,.386,32,74,.432,2,14,.143,19,26,.731,89
21203,2010-11-26,IND,,OKC,L 106-110 (OT),265,40,91,.440,32,68,.471,8,23,.348,18,24,.750,106
21204,2010-11-26,OKC,@,IND,W 110-106 (OT),265,35,90,.389,31,71,.437,4,19,.211,36,41,.878,110
21205,2010-11-26,GSW,@,MEM,L 111-116,240,41,84,.488,32,64,.500,9,20,.450,20,23,.870,111
21206,2010-11-26,MEM,,GSW,W 116-111,240,42,80,.525,34,65,.523,8,15,.533,24,29,.828,116
21207,2010-11-26,MIA,,PHI,W 99-90,240,35,78,.449,29,62,.468,6,16,.375,23,29,.793,99
21208,2010-11-26,PHI,@,MIA,L 90-99,240,35,74,.473,27,54,.500,8,20,.400,12,21,.571,90
21209,2010-11-26,CLE,@,ORL,L 100-111,240,40,85,.471,32,64,.500,8,21,.381,12,20,.600,100
21210,2010-11-26,ORL,,CLE,W 111-100,240,40,72,.556,26,41,.634,14,31,.452,17,28,.607,111
21211,2010-11-26,LAC,@,PHO,L 108-116,240,42,83,.506,31,59,.525,11,24,.458,13,19,.684,108
21212,2010-11-26,PHO,,LAC,W 116-108,240,39,82,.476,27,57,.474,12,25,.480,26,33,.788,116
21213,2010-11-26,NOP,@,POR,W 97-78,240,34,66,.515,26,52,.500,8,14,.571,21,30,.700,97
21214,2010-11-26,POR,,NOH,L 78-97,240,30,76,.395,24,58,.414,6,18,.333,12,14,.857,78
21215,2010-11-26,DAL,@,SAS,W 103-94,240,39,74,.527,34,58,.586,5,16,.313,20,31,.645,103
21216,2010-11-26,SAS,,DAL,L 94-103,240,31,69,.449,24,50,.480,7,19,.368,25,27,.926,94
21217,2010-11-26,LAL,@,UTA,L 96-102,240,33,79,.418,29,64,.453,4,15,.267,26,31,.839,96
21218,2010-11-26,UTA,,LAL,W 102-96,240,39,79,.494,32,62,.516,7,17,.412,17,19,.895,102
21219,2010-11-25,ATL,,WAS,W 116-96,240,42,88,.477,35,70,.500,7,18,.389,25,27,.926,116
21220,2010-11-25,WAS,@,ATL,L 96-116,240,34,88,.386,30,71,.423,4,17,.235,24,26,.923,96
21221,2010-11-25,LAC,,SAC,W 100-82,240,35,69,.507,33,56,.589,2,13,.154,28,36,.778,100
21222,2010-11-25,SAC,@,LAC,L 82-100,240,29,71,.408,25,60,.417,4,11,.364,20,32,.625,82
21223,2010-11-24,BOS,,NJN,W 89-83,240,35,78,.449,30,66,.455,5,12,.417,14,23,.609,89
21224,2010-11-24,BRK,@,BOS,L 83-89,240,31,67,.463,27,53,.509,4,14,.286,17,22,.773,83
21225,2010-11-24,CHA,,NYK,L 95-99,240,39,87,.448,37,75,.493,2,12,.167,15,21,.714,95
21226,2010-11-24,NYK,@,CHA,W 99-95,240,36,75,.480,24,50,.480,12,25,.480,15,20,.750,99
21227,2010-11-24,CLE,,MIL,W 83-81,240,32,76,.421,26,55,.473,6,21,.286,13,19,.684,83
21228,2010-11-24,MIL,@,CLE,L 81-83,240,31,82,.378,26,68,.382,5,14,.357,14,22,.636,81
21229,2010-11-24,GSW,@,HOU,L 101-111,240,42,90,.467,37,71,.521,5,19,.263,12,18,.667,101
21230,2010-11-24,HOU,,GSW,W 111-101,240,31,64,.484,21,44,.477,10,20,.500,39,51,.765,111
21231,2010-11-24,DET,@,MEM,L 84-105,240,32,80,.400,29,70,.414,3,10,.300,17,20,.850,84
21232,2010-11-24,MEM,,DET,W 105-84,240,45,86,.523,43,76,.566,2,10,.200,13,17,.765,105
21233,2010-11-24,MIN,,SAS,L 109-113 (OT),265,42,89,.472,35,75,.467,7,14,.500,18,24,.750,109
21234,2010-11-24,SAS,@,MIN,W 113-109 (OT),265,37,93,.398,27,61,.443,10,32,.313,29,36,.806,113
21235,2010-11-24,DAL,@,OKC,W 111-103,240,36,81,.444,27,54,.500,9,27,.333,30,34,.882,111
21236,2010-11-24,OKC,,DAL,L 103-111,240,40,83,.482,34,68,.500,6,15,.400,17,23,.739,103
21237,2010-11-24,MIA,@,ORL,L 95-104,240,34,82,.415,30,64,.469,4,18,.222,23,29,.793,95
21238,2010-11-24,ORL,,MIA,W 104-95,240,36,70,.514,30,51,.588,6,19,.316,26,39,.667,104
21239,2010-11-24,CHI,@,PHO,W 123-115 (2OT),290,50,104,.481,44,85,.518,6,19,.316,17,27,.630,123
21240,2010-11-24,PHO,,CHI,L 115-123 (2OT),290,43,101,.426,36,77,.468,7,24,.292,22,30,.733,115
21241,2010-11-24,PHI,@,TOR,L 90-106,240,35,81,.432,31,69,.449,4,12,.333,16,19,.842,90
21242,2010-11-24,TOR,,PHI,W 106-90,240,38,79,.481,29,58,.500,9,21,.429,21,27,.778,106
21243,2010-11-24,NOP,@,UTA,L 87-105,240,29,69,.420,25,50,.500,4,19,.211,25,32,.781,87
21244,2010-11-24,UTA,,NOH,W 105-87,240,40,82,.488,34,68,.500,6,14,.429,19,19,1.000,105
21245,2010-11-23,DAL,,DET,W 88-84,240,30,78,.385,24,58,.414,6,20,.300,22,27,.815,88
21246,2010-11-23,DET,@,DAL,L 84-88,240,31,73,.425,28,65,.431,3,8,.375,19,26,.731,84
21247,2010-11-23,CLE,@,IND,L 89-100,240,35,83,.422,32,76,.421,3,7,.429,16,22,.727,89
21248,2010-11-23,IND,,CLE,W 100-89,240,35,80,.438,23,53,.434,12,27,.444,18,21,.857,100
21249,2010-11-23,CHI,@,LAL,L 91-98,240,34,86,.395,30,66,.455,4,20,.200,19,26,.731,91
21250,2010-11-23,LAL,,CHI,W 98-91,240,32,81,.395,22,56,.393,10,25,.400,24,27,.889,98
21251,2010-11-23,ATL,@,NJN,L 101-107 (OT),265,41,89,.461,32,74,.432,9,15,.600,10,13,.769,101
21252,2010-11-23,BRK,,ATL,W 107-101 (OT),265,38,80,.475,32,61,.525,6,19,.316,25,33,.758,107
21253,2010-11-23,CHA,@,NYK,L 107-110,240,44,90,.489,38,75,.507,6,15,.400,13,18,.722,107
21254,2010-11-23,NYK,,CHA,W 110-107,240,38,73,.521,28,48,.583,10,25,.400,24,25,.960,110
21255,2010-11-23,PHI,@,WAS,L 114-116 (OT),265,43,93,.462,37,80,.463,6,13,.462,22,31,.710,114
21256,2010-11-23,WAS,,PHI,W 116-114 (OT),265,43,98,.439,33,75,.440,10,23,.435,20,26,.769,116
21257,2010-11-22,ATL,,BOS,L 76-99,240,28,81,.346,22,65,.338,6,16,.375,14,17,.824,76
21258,2010-11-22,BOS,@,ATL,W 99-76,240,40,75,.533,35,64,.547,5,11,.455,14,18,.778,99
21259,2010-11-22,DEN,@,GSW,W 106-89,240,35,75,.467,23,54,.426,12,21,.571,24,26,.923,106
21260,2010-11-22,GSW,,DEN,L 89-106,240,35,87,.402,29,61,.475,6,26,.231,13,16,.813,89
21261,2010-11-22,HOU,,PHO,L 116-123,240,49,100,.490,43,74,.581,6,26,.231,12,15,.800,116
21262,2010-11-22,PHO,@,HOU,W 123-116,240,42,78,.538,35,65,.538,7,13,.538,32,38,.842,123
21263,2010-11-22,LAC,,NOH,W 99-95,240,38,75,.507,32,56,.571,6,19,.316,17,34,.500,99
21264,2010-11-22,NOP,@,LAC,L 95-99,240,37,78,.474,31,58,.534,6,20,.300,15,23,.652,95
21265,2010-11-22,IND,@,MIA,W 93-77,240,37,90,.411,29,67,.433,8,23,.348,11,13,.846,93
21266,2010-11-22,MIA,,IND,L 77-93,240,24,62,.387,20,42,.476,4,20,.200,25,38,.658,77
21267,2010-11-22,MIN,@,OKC,L 107-117,240,44,88,.500,36,71,.507,8,17,.471,11,16,.688,107
21268,2010-11-22,OKC,,MIN,W 117-107,240,40,73,.548,35,60,.583,5,13,.385,32,40,.800,117
21269,2010-11-22,ORL,@,SAS,L 97-106,240,39,80,.488,30,62,.484,9,18,.500,10,14,.714,97
21270,2010-11-22,SAS,,ORL,W 106-97,240,38,77,.494,26,58,.448,12,19,.632,18,23,.783,106
21271,2010-11-22,SAC,@,UTA,L 83-94,240,29,81,.358,24,65,.369,5,16,.313,20,27,.741,83
21272,2010-11-22,UTA,,SAC,W 94-83,240,34,76,.447,31,67,.463,3,9,.333,23,33,.697,94
21273,2010-11-21,DET,,WAS,W 115-110 (OT),265,45,92,.489,38,77,.494,7,15,.467,18,28,.643,115
21274,2010-11-21,WAS,@,DET,L 110-115 (OT),265,48,89,.539,43,70,.614,5,19,.263,9,15,.600,110
21275,2010-11-21,GSW,@,LAL,L 89-117,240,32,91,.352,29,71,.408,3,20,.150,22,26,.846,89
21276,2010-11-21,LAL,,GSW,W 117-89,240,44,79,.557,35,57,.614,9,22,.409,20,25,.800,117
21277,2010-11-21,NOP,@,SAC,W 75-71,240,28,87,.322,24,75,.320,4,12,.333,15,16,.938,75
21278,2010-11-21,SAC,,NOH,L 71-75,240,29,75,.387,25,62,.403,4,13,.308,9,15,.600,71
21279,2010-11-21,BOS,@,TOR,L 101-102,240,34,71,.479,29,58,.500,5,13,.385,28,38,.737,101
21280,2010-11-21,TOR,,BOS,W 102-101,240,34,76,.447,30,61,.492,4,15,.267,30,39,.769,102
21281,2010-11-20,ATL,,DAL,L 93-98,240,39,81,.481,32,56,.571,7,25,.280,8,10,.800,93
21282,2010-11-20,DAL,@,ATL,W 98-93,240,39,82,.476,33,69,.478,6,13,.462,14,16,.875,98
21283,2010-11-20,CHA,,PHO,W 123-105,240,50,87,.575,41,68,.603,9,19,.474,14,19,.737,123
21284,2010-11-20,PHO,@,CHA,L 105-123,240,34,74,.459,29,53,.547,5,21,.238,32,39,.821,105
21285,2010-11-20,DEN,,NJN,W 107-103,240,38,80,.475,31,67,.463,7,13,.538,24,32,.750,107
21286,2010-11-20,BRK,@,DEN,L 103-107,240,36,89,.404,30,70,.429,6,19,.316,25,31,.806,103
21287,2010-11-20,IND,,ORL,L 86-90,240,35,89,.393,30,62,.484,5,27,.185,11,19,.579,86
21288,2010-11-20,ORL,@,IND,W 90-86,240,31,69,.449,22,48,.458,9,21,.429,19,28,.679,90
21289,2010-11-20,LAC,,NYK,L 115-124,240,43,79,.544,36,64,.563,7,15,.467,22,29,.759,115
21290,2010-11-20,NYK,@,LAC,W 124-115,240,35,76,.461,24,52,.462,11,24,.458,43,51,.843,124
21291,2010-11-20,MEM,,MIA,W 97-95,240,38,80,.475,37,69,.536,1,11,.091,20,27,.741,97
21292,2010-11-20,MIA,@,MEM,L 95-97,240,38,79,.481,28,57,.491,10,22,.455,9,12,.750,95
21293,2010-11-20,MIL,,OKC,L 81-82,240,29,78,.372,26,60,.433,3,18,.167,20,27,.741,81
21294,2010-11-20,OKC,@,MIL,W 82-81,240,27,73,.370,19,59,.322,8,14,.571,20,25,.800,82
21295,2010-11-20,POR,,UTA,L 94-103,240,35,92,.380,31,70,.443,4,22,.182,20,22,.909,94
21296,2010-11-20,UTA,@,POR,W 103-94,240,36,75,.480,26,56,.464,10,19,.526,21,21,1.000,103
21297,2010-11-20,CLE,@,SAS,L 92-116,240,38,80,.475,33,70,.471,5,10,.500,11,18,.611,92
21298,2010-11-20,SAS,,CLE,W 116-92,240,43,81,.531,31,56,.554,12,25,.480,18,22,.818,116
21299,2010-11-19,BOS,,OKC,L 84-89,240,33,68,.485,32,60,.533,1,8,.125,17,27,.630,84
21300,2010-11-19,OKC,@,BOS,W 89-84,240,28,65,.431,22,56,.393,6,9,.667,27,32,.844,89
21301,2010-11-19,CHI,@,DAL,W 88-83,240,34,76,.447,29,57,.509,5,19,.263,15,23,.652,88
21302,2010-11-19,DAL,,CHI,L 83-88,240,30,75,.400,25,55,.455,5,20,.250,18,25,.720,83
21303,2010-11-19,GSW,,NYK,L 119-125,240,47,91,.516,34,67,.507,13,24,.542,12,17,.706,119
21304,2010-11-19,NYK,@,GSW,W 125-119,240,44,77,.571,34,54,.630,10,23,.435,27,32,.844,125
21305,2010-11-19,CHA,@,MIA,L 87-95,240,33,71,.465,29,54,.537,4,17,.235,17,22,.773,87
21306,2010-11-19,MIA,,CHA,W 95-87,240,34,80,.425,29,63,.460,5,17,.294,22,27,.815,95
21307,2010-11-19,LAL,@,MIN,W 112-95,240,40,85,.471,30,66,.455,10,19,.526,22,26,.846,112
21308,2010-11-19,MIN,,LAL,L 95-112,240,36,91,.396,30,65,.462,6,26,.231,17,21,.810,95
21309,2010-11-19,CLE,@,NOH,L 101-108,240,30,86,.349,21,61,.344,9,25,.360,32,34,.941,101
21310,2010-11-19,NOP,,CLE,W 108-101,240,39,85,.459,32,60,.533,7,25,.280,23,30,.767,108
21311,2010-11-19,MIL,@,PHI,L 79-90,240,26,77,.338,26,65,.400,0,12,.000,27,31,.871,79
21312,2010-11-19,PHI,,MIL,W 90-79,240,30,74,.405,24,57,.421,6,17,.353,24,28,.857,90
21313,2010-11-19,BRK,@,SAC,L 81-86,240,32,70,.457,30,59,.508,2,11,.182,15,19,.789,81
21314,2010-11-19,SAC,,NJN,W 86-81,240,33,77,.429,29,66,.439,4,11,.364,16,23,.696,86
21315,2010-11-19,HOU,@,TOR,L 96-106,240,34,78,.436,26,58,.448,8,20,.400,20,22,.909,96
21316,2010-11-19,TOR,,HOU,W 106-96,240,41,84,.488,37,73,.507,4,11,.364,20,30,.667,106
21317,2010-11-19,SAS,@,UTA,W 94-82,240,36,82,.439,31,62,.500,5,20,.250,17,24,.708,94
21318,2010-11-19,UTA,,SAS,L 82-94,240,31,74,.419,28,60,.467,3,14,.214,17,23,.739,82
21319,2010-11-19,MEM,@,WAS,L 86-89,240,36,82,.439,32,68,.471,4,14,.286,10,18,.556,86
21320,2010-11-19,WAS,,MEM,W 89-86,240,28,74,.378,25,58,.431,3,16,.188,30,35,.857,89
21321,2010-11-18,IND,,LAC,W 107-80,240,39,77,.506,25,51,.490,14,26,.538,15,20,.750,107
21322,2010-11-18,LAC,@,IND,L 80-107,240,27,81,.333,25,72,.347,2,9,.222,24,33,.727,80
21323,2010-11-18,ORL,,PHO,W 105-89,240,40,74,.541,30,49,.612,10,25,.400,15,23,.652,105
21324,2010-11-18,PHO,@,ORL,L 89-105,240,31,68,.456,28,50,.560,3,18,.167,24,33,.727,89
21325,2010-11-18,DEN,@,POR,L 83-86,240,25,65,.385,15,39,.385,10,26,.385,23,28,.821,83
21326,2010-11-18,POR,,DEN,W 86-83,240,34,85,.400,27,63,.429,7,22,.318,11,22,.500,86
21327,2010-11-17,BOS,,WAS,W 114-83,240,50,76,.658,42,63,.667,8,13,.615,6,13,.462,114
21328,2010-11-17,WAS,@,BOS,L 83-114,240,31,80,.388,25,58,.431,6,22,.273,15,20,.750,83
21329,2010-11-17,DET,,LAL,L 90-103,240,35,89,.393,31,73,.425,4,16,.250,16,21,.762,90
21330,2010-11-17,LAL,@,DET,W 103-90,240,37,83,.446,30,67,.448,7,16,.438,22,24,.917,103
21331,2010-11-17,MIA,,PHO,W 123-96,240,47,86,.547,40,67,.597,7,19,.368,22,25,.880,123
21332,2010-11-17,PHO,@,MIA,L 96-123,240,32,72,.444,27,53,.509,5,19,.263,27,37,.730,96
21333,2010-11-17,LAC,@,MIN,L 111-113,240,42,87,.483,34,64,.531,8,23,.348,19,25,.760,111
21334,2010-11-17,MIN,,LAC,W 113-111,240,39,73,.534,29,54,.537,10,19,.526,25,28,.893,113
21335,2010-11-17,DAL,@,NOH,L 97-99,240,35,69,.507,28,51,.549,7,18,.389,20,23,.870,97
21336,2010-11-17,NOP,,DAL,W 99-97,240,40,82,.488,32,68,.471,8,14,.571,11,16,.688,99
21337,2010-11-17,HOU,@,OKC,L 99-116,240,36,77,.468,31,62,.500,5,15,.333,22,31,.710,99
21338,2010-11-17,OKC,,HOU,W 116-99,240,43,86,.500,38,74,.514,5,12,.417,25,29,.862,116
21339,2010-11-17,PHI,,TOR,L 86-94,240,32,87,.368,31,79,.392,1,8,.125,21,28,.750,86
21340,2010-11-17,TOR,@,PHI,W 94-86,240,34,73,.466,32,61,.525,2,12,.167,24,29,.828,94
21341,2010-11-17,NYK,@,SAC,W 113-106,240,37,71,.521,31,56,.554,6,15,.400,33,39,.846,113
21342,2010-11-17,SAC,,NYK,L 106-113,240,40,89,.449,36,74,.486,4,15,.267,22,26,.846,106
21343,2010-11-17,CHI,@,SAS,L 94-103,240,39,92,.424,33,75,.440,6,17,.353,10,14,.714,94
21344,2010-11-17,SAS,,CHI,W 103-94,240,41,85,.482,35,72,.486,6,13,.462,15,22,.682,103
21345,2010-11-17,BRK,@,UTA,L 88-98,240,32,85,.376,28,64,.438,4,21,.190,20,25,.800,88
21346,2010-11-17,UTA,,NJN,W 98-88,240,33,82,.402,32,70,.457,1,12,.083,31,37,.838,98
21347,2010-11-16,CLE,,PHI,W 101-93,240,37,80,.463,29,60,.483,8,20,.400,19,25,.760,101
21348,2010-11-16,PHI,@,CLE,L 93-101,240,34,79,.430,28,66,.424,6,13,.462,19,22,.864,93
21349,2010-11-16,DEN,,NYK,W 120-118,240,42,86,.488,37,72,.514,5,14,.357,31,47,.660,120
21350,2010-11-16,NYK,@,DEN,L 118-120,240,43,98,.439,34,67,.507,9,31,.290,23,33,.697,118
21351,2010-11-16,CHI,@,HOU,W 95-92,240,36,74,.486,28,62,.452,8,12,.667,15,28,.536,95
21352,2010-11-16,HOU,,CHI,L 92-95,240,34,71,.479,29,56,.518,5,15,.333,19,25,.760,92
21353,2010-11-16,ATL,@,IND,W 102-92,240,37,74,.500,29,59,.492,8,15,.533,20,23,.870,102
21354,2010-11-16,IND,,ATL,L 92-102,240,31,70,.443,27,52,.519,4,18,.222,26,30,.867,92
21355,2010-11-16,MEM,,POR,L 99-100,240,36,75,.480,29,56,.518,7,19,.368,20,27,.741,99
21356,2010-11-16,POR,@,MEM,W 100-99,240,40,87,.460,33,68,.485,7,19,.368,13,15,.867,100
21357,2010-11-16,LAL,@,MIL,W 118-107,240,42,78,.538,32,62,.516,10,16,.625,24,29,.828,118
21358,2010-11-16,MIL,,LAL,L 107-118,240,41,89,.461,32,65,.492,9,24,.375,16,27,.593,107
21359,2010-11-16,TOR,@,WAS,L 94-109,240,35,86,.407,31,75,.413,4,11,.364,20,26,.769,94
21360,2010-11-16,WAS,,TOR,W 109-94,240,45,80,.563,39,65,.600,6,15,.400,13,19,.684,109
21361,2010-11-15,CHA,,MIN,W 113-110,240,38,73,.521,31,59,.525,7,14,.500,30,40,.750,113
21362,2010-11-15,MIN,@,CHA,L 110-113,240,43,93,.462,34,73,.466,9,20,.450,15,23,.652,110
21363,2010-11-15,DAL,,NOH,W 98-95,240,34,69,.493,23,42,.548,11,27,.407,19,27,.704,98
21364,2010-11-15,NOP,@,DAL,L 95-98,240,34,77,.442,23,52,.442,11,25,.440,16,24,.667,95
21365,2010-11-15,DET,@,GSW,L 97-101,240,33,74,.446,26,55,.473,7,19,.368,24,36,.667,97
21366,2010-11-15,GSW,,DET,W 101-97,240,36,85,.424,29,67,.433,7,18,.389,22,27,.815,101
21367,2010-11-15,LAC,,NJN,L 96-110,240,30,76,.395,22,52,.423,8,24,.333,28,38,.737,96
21368,2010-11-15,BRK,@,LAC,W 110-96,240,43,72,.597,37,57,.649,6,15,.400,18,19,.947,110
21369,2010-11-15,MEM,@,ORL,L 72-89,240,29,80,.363,26,66,.394,3,14,.214,11,20,.550,72
21370,2010-11-15,ORL,,MEM,W 89-72,240,28,64,.438,22,47,.468,6,17,.353,27,34,.794,89
21371,2010-11-15,DEN,@,PHO,L 94-100,240,37,89,.416,34,72,.472,3,17,.176,17,25,.680,94
21372,2010-11-15,PHO,,DEN,W 100-94,240,38,89,.427,34,69,.493,4,20,.200,20,25,.800,100
21373,2010-11-15,OKC,@,UTA,W 115-108,240,38,75,.507,32,60,.533,6,15,.400,33,34,.971,115
21374,2010-11-15,UTA,,OKC,L 108-115,240,42,83,.506,36,67,.537,6,16,.375,18,22,.818,108
21375,2010-11-14,ATL,,MIN,W 111-105,240,36,80,.450,31,69,.449,5,11,.455,34,39,.872,111
21376,2010-11-14,MIN,@,ATL,L 105-111,240,37,78,.474,29,57,.509,8,21,.381,23,31,.742,105
21377,2010-11-14,LAL,,PHO,L 116-121,240,47,96,.490,38,73,.521,9,23,.391,13,17,.765,116
21378,2010-11-14,PHO,@,LAL,W 121-116,240,43,84,.512,21,44,.477,22,40,.550,13,19,.684,121
21379,2010-11-14,HOU,@,NYK,W 104-96,240,36,80,.450,30,62,.484,6,18,.333,26,36,.722,104
21380,2010-11-14,NYK,,HOU,L 96-104,240,38,87,.437,35,71,.493,3,16,.188,17,24,.708,96
21381,2010-11-14,OKC,,SAS,L 104-117,240,38,84,.452,34,71,.479,4,13,.308,24,30,.800,104
21382,2010-11-14,SAS,@,OKC,W 117-104,240,36,88,.409,25,68,.368,11,20,.550,34,38,.895,117
21383,2010-11-14,DET,@,SAC,W 100-94,240,41,76,.539,38,67,.567,3,9,.333,15,19,.789,100
21384,2010-11-14,SAC,,DET,L 94-100,240,39,86,.453,37,68,.544,2,18,.111,14,21,.667,94
21385,2010-11-13,CHA,,UTA,L 95-96,240,35,79,.443,27,58,.466,8,21,.381,17,24,.708,95
21386,2010-11-13,UTA,@,CHA,W 96-95,240,35,79,.443,31,65,.477,4,14,.286,22,29,.759,96
21387,2010-11-13,CHI,,WAS,W 103-96,240,34,76,.447,25,53,.472,9,23,.391,26,34,.765,103
21388,2010-11-13,WAS,@,CHI,L 96-103,240,40,89,.449,28,69,.406,12,20,.600,4,8,.500,96
21389,2010-11-13,CLE,,IND,L 85-99,240,32,83,.386,30,68,.441,2,15,.133,19,23,.826,85
21390,2010-11-13,IND,@,CLE,W 99-85,240,36,79,.456,26,54,.481,10,25,.400,17,17,1.000,99
21391,2010-11-13,BOS,@,MEM,W 116-110 (OT),265,45,78,.577,38,66,.576,7,12,.583,19,26,.731,116
21392,2010-11-13,MEM,,BOS,L 110-116 (OT),265,44,83,.530,42,74,.568,2,9,.222,20,24,.833,110
21393,2010-11-13,MIA,,TOR,W 109-100,240,40,79,.506,37,69,.536,3,10,.300,26,36,.722,109
21394,2010-11-13,TOR,@,MIA,L 100-109,240,37,82,.451,32,63,.508,5,19,.263,21,29,.724,100
21395,2010-11-13,GSW,@,MIL,L 72-79,240,28,82,.341,18,60,.300,10,22,.455,6,10,.600,72
21396,2010-11-13,MIL,,GSW,W 79-72,240,28,83,.337,22,67,.328,6,16,.375,17,21,.810,79
21397,2010-11-13,BRK,,ORL,L 90-91,240,35,71,.493,27,53,.509,8,18,.444,12,15,.800,90
21398,2010-11-13,ORL,@,NJN,W 91-90,240,32,77,.416,24,52,.462,8,25,.320,19,26,.731,91
21399,2010-11-13,NOP,,POR,W 107-87,240,37,77,.481,29,53,.547,8,24,.333,25,27,.926,107
21400,2010-11-13,POR,@,NOH,L 87-107,240,33,81,.407,29,64,.453,4,17,.235,17,19,.895,87
21401,2010-11-13,PHI,@,SAS,L 93-116,240,34,82,.415,30,73,.411,4,9,.444,21,24,.875,93
21402,2010-11-13,SAS,,PHI,W 116-93,240,41,85,.482,33,67,.493,8,18,.444,26,31,.839,116
21403,2010-11-12,ATL,,UTA,L 86-90,240,35,71,.493,30,52,.577,5,19,.263,11,21,.524,86
21404,2010-11-12,UTA,@,ATL,W 90-86,240,36,84,.429,32,72,.444,4,12,.333,14,19,.737,90
21405,2010-11-12,DAL,,PHI,W 99-90,240,35,79,.443,29,57,.509,6,22,.273,23,29,.793,99
21406,2010-11-12,PHI,@,DAL,L 90-99,240,37,83,.446,35,67,.522,2,16,.125,14,23,.609,90
21407,2010-11-12,HOU,@,IND,W 102-99,240,39,78,.500,32,60,.533,7,18,.389,17,25,.680,102
21408,2010-11-12,IND,,HOU,L 99-102,240,40,89,.449,31,67,.463,9,22,.409,10,13,.769,99
21409,2010-11-12,DET,@,LAC,W 113-107 (OT),265,39,82,.476,28,64,.438,11,18,.611,24,36,.667,113
21410,2010-11-12,LAC,,DET,L 107-113 (OT),265,37,80,.463,33,60,.550,4,20,.200,29,38,.763,107
21411,2010-11-12,MIN,,NYK,W 112-103,240,44,101,.436,36,81,.444,8,20,.400,16,21,.762,112
21412,2010-11-12,NYK,@,MIN,L 103-112,240,35,92,.380,24,63,.381,11,29,.379,22,25,.880,103
21413,2010-11-12,OKC,,POR,W 110-108,240,40,73,.548,34,61,.557,6,12,.500,24,26,.923,110
21414,2010-11-12,POR,@,OKC,L 108-110,240,41,76,.539,34,61,.557,7,15,.467,19,24,.792,108
21415,2010-11-12,ORL,,TOR,L 106-110,240,39,74,.527,27,50,.540,12,24,.500,16,29,.552,106
21416,2010-11-12,TOR,@,ORL,W 110-106,240,40,80,.500,34,67,.507,6,13,.462,24,31,.774,110
21417,2010-11-12,PHO,,SAC,W 103-89,240,41,79,.519,37,67,.552,4,12,.333,17,27,.630,103
21418,2010-11-12,SAC,@,PHO,L 89-103,240,36,88,.409,31,70,.443,5,18,.278,12,19,.632,89
21419,2010-11-12,CHA,@,WAS,W 93-85,240,34,69,.493,27,53,.509,7,16,.438,18,24,.750,93
21420,2010-11-12,WAS,,CHA,L 85-93,240,36,86,.419,31,65,.477,5,21,.238,8,10,.800,85
21421,2010-11-11,CHI,,GSW,W 120-90,240,46,84,.548,39,65,.600,7,19,.368,21,23,.913,120
21422,2010-11-11,GSW,@,CHI,L 90-120,240,39,95,.411,32,72,.444,7,23,.304,5,7,.714,90
21423,2010-11-11,DEN,,LAL,W 118-112,240,43,88,.489,36,63,.571,7,25,.280,25,31,.806,118
21424,2010-11-11,LAL,@,DEN,L 112-118,240,40,98,.408,31,69,.449,9,29,.310,23,30,.767,112
21425,2010-11-11,BOS,@,MIA,W 112-107,240,43,79,.544,34,63,.540,9,16,.563,17,25,.680,112
21426,2010-11-11,MIA,,BOS,L 107-112,240,36,72,.500,33,56,.589,3,16,.188,32,41,.780,107
21427,2010-11-10,ATL,,MIL,L 91-108,240,36,73,.493,31,60,.517,5,13,.385,14,21,.667,91
21428,2010-11-10,MIL,@,ATL,W 108-91,240,45,87,.517,37,72,.514,8,15,.533,10,14,.714,108
21429,2010-11-10,CLE,,NJN,L 87-95,240,34,77,.442,31,65,.477,3,12,.250,16,22,.727,87
21430,2010-11-10,BRK,@,CLE,W 95-87,240,34,82,.415,26,65,.400,8,17,.471,19,35,.543,95
21431,2010-11-10,DAL,@,MEM,W 106-91,240,46,85,.541,37,60,.617,9,25,.360,5,11,.455,106
21432,2010-11-10,MEM,,DAL,L 91-106,240,38,84,.452,34,70,.486,4,14,.286,11,19,.579,91
21433,2010-11-10,GSW,@,NYK,W 122-117,240,47,89,.528,42,79,.532,5,10,.500,23,32,.719,122
21434,2010-11-10,NYK,,GSW,L 117-122,240,36,77,.468,29,46,.630,7,31,.226,38,43,.884,117
21435,2010-11-10,OKC,,PHI,W 109-103,240,36,73,.493,34,59,.576,2,14,.143,35,37,.946,109
21436,2010-11-10,PHI,@,OKC,L 103-109,240,39,81,.481,34,66,.515,5,15,.333,20,27,.741,103
21437,2010-11-10,ORL,,UTA,L 94-104,240,34,79,.430,22,47,.468,12,32,.375,14,25,.560,94
21438,2010-11-10,UTA,@,ORL,W 104-94,240,37,74,.500,32,60,.533,5,14,.357,25,28,.893,104
21439,2010-11-10,MIN,@,SAC,W 98-89,240,41,87,.471,37,76,.487,4,11,.364,12,20,.600,98
21440,2010-11-10,SAC,,MIN,L 89-98,240,32,72,.444,27,52,.519,5,20,.250,20,32,.625,89
21441,2010-11-10,LAC,@,SAS,L 95-107,240,40,86,.465,33,76,.434,7,10,.700,8,14,.571,95
21442,2010-11-10,SAS,,LAC,W 107-95,240,35,71,.493,24,53,.453,11,18,.611,26,30,.867,107
21443,2010-11-10,CHA,@,TOR,W 101-96,240,34,69,.493,28,55,.509,6,14,.429,27,33,.818,101
21444,2010-11-10,TOR,,CHA,L 96-101,240,37,81,.457,34,71,.479,3,10,.300,19,25,.760,96
21445,2010-11-10,HOU,@,WAS,L 91-98,240,34,87,.391,28,67,.418,6,20,.300,17,19,.895,91
21446,2010-11-10,WAS,,HOU,W 98-91,240,39,88,.443,33,75,.440,6,13,.462,14,22,.636,98
21447,2010-11-09,DEN,@,IND,L 113-144,240,39,90,.433,31,73,.425,8,17,.471,27,30,.900,113
21448,2010-11-09,IND,,DEN,W 144-113,240,56,87,.644,40,57,.702,16,30,.533,16,21,.762,144
21449,2010-11-09,LAL,,MIN,W 99-94,240,40,89,.449,33,68,.485,7,21,.333,12,16,.750,99
21450,2010-11-09,MIN,@,LAL,L 94-99,240,35,92,.380,27,71,.380,8,21,.381,16,19,.842,94
21451,2010-11-09,MIA,,UTA,L 114-116 (OT),265,36,82,.439,30,67,.448,6,15,.400,36,47,.766,114
21452,2010-11-09,UTA,@,MIA,W 116-114 (OT),265,45,93,.484,37,74,.500,8,19,.421,18,21,.857,116
21453,2010-11-09,MIL,,NYK,W 107-80,240,40,78,.513,35,62,.565,5,16,.313,22,28,.786,107
21454,2010-11-09,NYK,@,MIL,L 80-107,240,28,74,.378,23,55,.418,5,19,.263,19,21,.905,80
21455,2010-11-09,CLE,@,NJN,W 93-91,240,36,82,.439,27,65,.415,9,17,.529,12,22,.545,93
21456,2010-11-09,BRK,,CLE,L 91-93,240,33,81,.407,27,61,.443,6,20,.300,19,21,.905,91
21457,2010-11-09,LAC,@,NOH,L 82-101,240,31,67,.463,26,51,.510,5,16,.313,15,18,.833,82
21458,2010-11-09,NOP,,LAC,W 101-82,240,39,77,.506,31,61,.508,8,16,.500,15,21,.714,101
21459,2010-11-09,DET,@,POR,L 78-100,240,31,73,.425,25,56,.446,6,17,.353,10,18,.556,78
21460,2010-11-09,POR,,DET,W 100-78,240,40,80,.500,34,66,.515,6,14,.429,14,16,.875,100
21461,2010-11-08,CHA,,SAS,L 91-95,240,33,83,.398,27,64,.422,6,19,.316,19,24,.792,91
21462,2010-11-08,SAS,@,CHA,W 95-91,240,36,85,.424,24,59,.407,12,26,.462,11,17,.647,95
21463,2010-11-08,CHI,,DEN,W 94-92,240,34,82,.415,29,69,.420,5,13,.385,21,33,.636,94
21464,2010-11-08,DEN,@,CHI,L 92-94,240,34,78,.436,27,60,.450,7,18,.389,17,24,.708,92
21465,2010-11-08,BOS,@,DAL,L 87-89,240,38,91,.418,34,83,.410,4,8,.500,7,7,1.000,87
21466,2010-11-08,DAL,,BOS,W 89-87,240,33,66,.500,27,51,.529,6,15,.400,17,20,.850,89
21467,2010-11-08,MEM,,PHO,W 109-99,240,40,84,.476,35,69,.507,5,15,.333,24,28,.857,109
21468,2010-11-08,PHO,@,MEM,L 99-109,240,38,80,.475,29,49,.592,9,31,.290,14,21,.667,99
21469,2010-11-08,ATL,@,ORL,L 89-93,240,36,76,.474,32,63,.508,4,13,.308,13,16,.813,89
21470,2010-11-08,ORL,,ATL,W 93-89,240,37,86,.430,33,64,.516,4,22,.182,15,24,.625,93
21471,2010-11-08,GSW,@,TOR,W 109-102,240,39,74,.527,34,58,.586,5,16,.313,26,32,.813,109
21472,2010-11-08,TOR,,GSW,L 102-109,240,38,83,.458,34,69,.493,4,14,.286,22,27,.815,102
21473,2010-11-07,ATL,,PHO,L 114-118,240,45,83,.542,38,60,.633,7,23,.304,17,22,.773,114
21474,2010-11-07,PHO,@,ATL,W 118-114,240,45,81,.556,34,58,.586,11,23,.478,17,22,.773,118
21475,2010-11-07,DET,,GSW,W 102-97,240,37,82,.451,28,65,.431,9,17,.529,19,28,.679,102
21476,2010-11-07,GSW,@,DET,L 97-102,240,36,84,.429,30,61,.492,6,23,.261,19,23,.826,97
21477,2010-11-07,HOU,,MIN,W 120-94,240,38,86,.442,33,70,.471,5,16,.313,39,47,.830,120
21478,2010-11-07,MIN,@,HOU,L 94-120,240,34,91,.374,31,78,.397,3,13,.231,23,33,.697,94
21479,2010-11-07,LAL,,POR,W 121-96,240,50,91,.549,42,74,.568,8,17,.471,13,15,.867,121
21480,2010-11-07,POR,@,LAL,L 96-121,240,32,75,.427,26,55,.473,6,20,.300,26,31,.839,96
21481,2010-11-07,NYK,,PHI,L 96-106,240,34,85,.400,31,66,.470,3,19,.158,25,35,.714,96
21482,2010-11-07,PHI,@,NYK,W 106-96,240,37,78,.474,30,60,.500,7,18,.389,25,35,.714,106
21483,2010-11-07,BOS,@,OKC,W 92-83,240,36,76,.474,32,66,.485,4,10,.400,16,20,.800,92
21484,2010-11-07,OKC,,BOS,L 83-92,240,32,75,.427,28,65,.431,4,10,.400,15,17,.882,83
21485,2010-11-06,CHA,,ORL,L 88-91,240,36,75,.480,30,60,.500,6,15,.400,10,11,.909,88
21486,2010-11-06,ORL,@,CHA,W 91-88,240,34,82,.415,24,50,.480,10,32,.313,13,21,.619,91
21487,2010-11-06,DAL,,DEN,L 92-103,240,34,76,.447,30,61,.492,4,15,.267,20,26,.769,92
21488,2010-11-06,DEN,@,DAL,W 103-92,240,37,82,.451,24,61,.393,13,21,.619,16,21,.762,103
21489,2010-11-06,MIA,,NJN,W 101-89,240,36,74,.486,30,59,.508,6,15,.400,23,29,.793,101
21490,2010-11-06,BRK,@,MIA,L 89-101,240,35,85,.412,27,65,.415,8,20,.400,11,17,.647,89
21491,2010-11-06,MIL,,NOH,L 81-87,240,32,83,.386,28,67,.418,4,16,.250,13,20,.650,81
21492,2010-11-06,NOP,@,MIL,W 87-81,240,31,69,.449,24,52,.462,7,17,.412,18,22,.818,87
21493,2010-11-06,POR,,TOR,W 97-84,240,34,75,.453,30,59,.508,4,16,.250,25,28,.893,97
21494,2010-11-06,TOR,@,POR,L 84-97,240,28,76,.368,27,59,.458,1,17,.059,27,34,.794,84
21495,2010-11-06,MEM,@,SAC,W 100-91,240,40,83,.482,37,68,.544,3,15,.200,17,23,.739,100
21496,2010-11-06,SAC,,MEM,L 91-100,240,34,79,.430,29,59,.492,5,20,.250,18,24,.750,91
21497,2010-11-06,HOU,@,SAS,L 121-124 (OT),265,47,99,.475,38,79,.481,9,20,.450,18,21,.857,121
21498,2010-11-06,SAS,,HOU,W 124-121 (OT),265,49,101,.485,40,80,.500,9,21,.429,17,25,.680,124
21499,2010-11-06,LAC,@,UTA,L 107-109 (2OT),290,37,86,.430,32,66,.485,5,20,.250,28,32,.875,107
21500,2010-11-06,UTA,,LAC,W 109-107 (2OT),290,40,97,.412,34,79,.430,6,18,.333,23,31,.742,109
21501,2010-11-06,CLE,@,WAS,W 107-102,240,39,82,.476,31,64,.484,8,18,.444,21,26,.808,107
21502,2010-11-06,WAS,,CLE,L 102-107,240,39,88,.443,31,67,.463,8,21,.381,16,20,.800,102
21503,2010-11-05,BOS,,CHI,W 110-105 (OT),265,42,82,.512,38,71,.535,4,11,.364,22,25,.880,110
21504,2010-11-05,CHI,@,BOS,L 105-110 (OT),265,42,85,.494,38,75,.507,4,10,.400,17,18,.944,105
21505,2010-11-05,DEN,,LAC,W 111-104,240,43,83,.518,38,62,.613,5,21,.238,20,22,.909,111
21506,2010-11-05,LAC,@,DEN,L 104-111,240,43,86,.500,41,71,.577,2,15,.133,16,25,.640,104
21507,2010-11-05,CHA,@,DET,L 90-97,240,37,67,.552,28,47,.596,9,20,.450,7,11,.636,90
21508,2010-11-05,DET,,CHA,W 97-90,240,32,75,.427,25,62,.403,7,13,.538,26,27,.963,97
21509,2010-11-05,GSW,,UTA,W 85-78,240,35,93,.376,33,79,.418,2,14,.143,13,22,.591,85
21510,2010-11-05,UTA,@,GSW,L 78-85,240,30,76,.395,27,62,.435,3,14,.214,15,21,.714,78
21511,2010-11-05,IND,,MIL,L 90-94,240,29,75,.387,23,51,.451,6,24,.250,26,30,.867,90
21512,2010-11-05,MIL,@,IND,W 94-90,240,32,83,.386,24,63,.381,8,20,.400,22,30,.733,94
21513,2010-11-05,LAL,,TOR,W 108-103,240,37,77,.481,30,56,.536,7,21,.333,27,32,.844,108
21514,2010-11-05,TOR,@,LAL,L 103-108,240,41,87,.471,36,74,.486,5,13,.385,16,19,.842,103
21515,2010-11-05,ATL,@,MIN,W 113-103,240,44,81,.543,40,63,.635,4,18,.222,21,26,.808,113
21516,2010-11-05,MIN,,ATL,L 103-113,240,42,99,.424,34,77,.442,8,22,.364,11,12,.917,103
21517,2010-11-05,MIA,@,NOH,L 93-96,240,33,78,.423,28,57,.491,5,21,.238,22,24,.917,93
21518,2010-11-05,NOP,,MIA,W 96-93,240,39,79,.494,35,65,.538,4,14,.286,14,17,.824,96
21519,2010-11-05,NYK,,WAS,W 112-91,240,44,87,.506,32,58,.552,12,29,.414,12,18,.667,112
21520,2010-11-05,WAS,@,NYK,L 91-112,240,34,75,.453,30,59,.508,4,16,.250,19,22,.864,91
21521,2010-11-05,BRK,@,ORL,L 90-105,240,36,84,.429,26,62,.419,10,22,.455,8,9,.889,90
21522,2010-11-05,ORL,,NJN,W 105-90,240,34,71,.479,23,43,.535,11,28,.393,26,32,.813,105
21523,2010-11-05,CLE,@,PHI,W 123-116,240,41,75,.547,38,62,.613,3,13,.231,38,48,.792,123
21524,2010-11-05,PHI,,CLE,L 116-123,240,46,83,.554,40,66,.606,6,17,.353,18,25,.720,116
21525,2010-11-05,MEM,@,PHO,L 118-123 (2OT),290,45,96,.469,39,77,.506,6,19,.316,22,34,.647,118
21526,2010-11-05,PHO,,MEM,W 123-118 (2OT),290,43,101,.426,29,66,.439,14,35,.400,23,32,.719,123
21527,2010-11-04,CHI,,NYK,L 112-120,240,42,81,.519,33,62,.532,9,19,.474,19,27,.704,112
21528,2010-11-04,NYK,@,CHI,W 120-112,240,40,80,.500,24,56,.429,16,24,.667,24,29,.828,120
21529,2010-11-04,OKC,@,POR,W 107-106 (OT),265,40,81,.494,37,66,.561,3,15,.200,24,26,.923,107
21530,2010-11-04,POR,,OKC,L 106-107 (OT),265,43,92,.467,39,76,.513,4,16,.250,16,20,.800,106
21531,2010-11-03,ATL,,DET,W 94-85,240,36,67,.537,33,53,.623,3,14,.214,19,23,.826,94
21532,2010-11-03,DET,@,ATL,L 85-94,240,36,90,.400,33,73,.452,3,17,.176,10,15,.667,85
21533,2010-11-03,BOS,,MIL,W 105-102 (OT),265,37,79,.468,33,67,.493,4,12,.333,27,32,.844,105
21534,2010-11-03,MIL,@,BOS,L 102-105 (OT),265,36,86,.419,31,73,.425,5,13,.385,25,31,.806,102
21535,2010-11-03,DAL,@,DEN,W 102-101,240,39,84,.464,32,69,.464,7,15,.467,17,19,.895,102
21536,2010-11-03,DEN,,DAL,L 101-102,240,41,89,.461,31,61,.508,10,28,.357,9,12,.750,101
21537,2010-11-03,GSW,,MEM,W 115-109,240,38,92,.413,25,62,.403,13,30,.433,26,34,.765,115
21538,2010-11-03,MEM,@,GSW,L 109-115,240,42,82,.512,34,64,.531,8,18,.444,17,25,.680,109
21539,2010-11-03,HOU,,NOH,L 99-107,240,39,93,.419,31,69,.449,8,24,.333,13,18,.722,99
21540,2010-11-03,NOP,@,HOU,W 107-99,240,36,79,.456,31,66,.470,5,13,.385,30,42,.714,107
21541,2010-11-03,LAC,,OKC,W 107-92,240,42,80,.525,34,64,.531,8,16,.500,15,27,.556,107
21542,2010-11-03,OKC,@,LAC,L 92-107,240,34,90,.378,30,64,.469,4,26,.154,20,23,.870,92
21543,2010-11-03,CHA,@,NJN,W 85-83,240,31,72,.431,26,53,.491,5,19,.263,18,23,.783,85
21544,2010-11-03,BRK,,CHA,L 83-85,240,32,75,.427,27,58,.466,5,17,.294,14,15,.933,83
21545,2010-11-03,MIN,@,ORL,L 86-128,240,28,84,.333,22,68,.324,6,16,.375,24,28,.857,86
21546,2010-11-03,ORL,,MIN,W 128-86,240,46,92,.500,31,61,.508,15,31,.484,21,32,.656,128
21547,2010-11-03,IND,@,PHI,L 75-101,240,28,89,.315,21,67,.313,7,22,.318,12,17,.706,75
21548,2010-11-03,PHI,,IND,W 101-75,240,38,81,.469,34,69,.493,4,12,.333,21,25,.840,101
21549,2010-11-03,PHO,,SAS,L 110-112,240,41,92,.446,33,71,.465,8,21,.381,20,23,.870,110
21550,2010-11-03,SAS,@,PHO,W 112-110,240,42,77,.545,36,63,.571,6,14,.429,22,32,.688,112
21551,2010-11-03,LAL,@,SAC,W 112-100,240,39,84,.464,28,63,.444,11,21,.524,23,28,.821,112
21552,2010-11-03,SAC,,LAL,L 100-112,240,40,91,.440,34,69,.493,6,22,.273,14,23,.609,100
21553,2010-11-03,TOR,@,UTA,L 108-125,240,36,79,.456,33,66,.500,3,13,.231,33,42,.786,108
21554,2010-11-03,UTA,,TOR,W 125-108,240,48,85,.565,41,69,.594,7,16,.438,22,25,.880,125
21555,2010-11-02,ATL,@,CLE,W 100-88,240,37,84,.440,32,67,.478,5,17,.294,21,30,.700,100
21556,2010-11-02,CLE,,ATL,L 88-100,240,32,74,.432,27,57,.474,5,17,.294,19,26,.731,88
21557,2010-11-02,BOS,@,DET,W 109-86,240,42,81,.519,35,60,.583,7,21,.333,18,18,1.000,109
21558,2010-11-02,DET,,BOS,L 86-109,240,35,78,.449,33,69,.478,2,9,.222,14,20,.700,86
21559,2010-11-02,LAL,,MEM,W 124-105,240,43,84,.512,29,61,.475,14,23,.609,24,30,.800,124
21560,2010-11-02,MEM,@,LAL,L 105-124,240,38,92,.413,31,78,.397,7,14,.500,22,29,.759,105
21561,2010-11-02,MIA,,MIN,W 129-97,240,46,79,.582,34,58,.586,12,21,.571,25,31,.806,129
21562,2010-11-02,MIN,@,MIA,L 97-129,240,31,84,.369,25,66,.379,6,18,.333,29,38,.763,97
21563,2010-11-02,MIL,,POR,L 76-90,240,27,72,.375,24,57,.421,3,15,.200,19,25,.760,76
21564,2010-11-02,POR,@,MIL,W 90-76,240,38,80,.475,31,56,.554,7,24,.292,7,9,.778,90
21565,2010-11-02,PHI,@,WAS,L 115-116 (OT),265,44,80,.550,40,65,.615,4,15,.267,23,29,.793,115
21566,2010-11-02,WAS,,PHI,W 116-115 (OT),265,37,78,.474,31,66,.470,6,12,.500,36,43,.837,116
21567,2010-11-01,CHI,,POR,W 110-98,240,43,71,.606,38,58,.655,5,13,.385,19,32,.594,110
21568,2010-11-01,POR,@,CHI,L 98-110,240,33,80,.413,33,66,.500,0,14,.000,32,41,.780,98
21569,2010-11-01,LAC,,SAS,L 88-97,240,38,82,.463,34,69,.493,4,13,.308,8,16,.500,88
21570,2010-11-01,SAS,@,LAC,W 97-88,240,38,79,.481,29,58,.500,9,21,.429,12,15,.800,97
21571,2010-11-01,SAC,,TOR,W 111-108,240,42,88,.477,37,76,.487,5,12,.417,22,27,.815,111
21572,2010-11-01,TOR,@,SAC,L 108-111,240,39,85,.459,30,64,.469,9,21,.429,21,29,.724,108
21573,2010-10-31,DAL,@,LAC,W 99-83,240,36,77,.468,29,61,.475,7,16,.438,20,29,.690,99
21574,2010-10-31,LAC,,DAL,L 83-99,240,28,82,.341,24,61,.393,4,21,.190,23,31,.742,83
21575,2010-10-31,GSW,@,LAL,L 83-107,240,36,89,.404,31,69,.449,5,20,.250,6,13,.462,83
21576,2010-10-31,LAL,,GSW,W 107-83,240,39,88,.443,33,69,.478,6,19,.316,23,30,.767,107
21577,2010-10-31,MIA,@,NJN,W 101-78,240,36,67,.537,31,51,.608,5,16,.313,24,34,.706,101
21578,2010-10-31,BRK,,MIA,L 78-101,240,30,85,.353,27,71,.380,3,14,.214,15,23,.652,78
21579,2010-10-31,OKC,,UTA,L 99-120,240,32,80,.400,27,60,.450,5,20,.250,30,34,.882,99
21580,2010-10-31,UTA,@,OKC,W 120-99,240,44,83,.530,37,72,.514,7,11,.636,25,30,.833,120
21581,2010-10-30,ATL,,WAS,W 99-95,240,34,81,.420,29,62,.468,5,19,.263,26,30,.867,99
21582,2010-10-30,WAS,@,ATL,L 95-99,240,38,76,.500,34,64,.531,4,12,.333,15,21,.714,95
21583,2010-10-30,CHI,,DET,W 101-91,240,37,86,.430,32,68,.471,5,18,.278,22,31,.710,101
21584,2010-10-30,DET,@,CHI,L 91-101,240,31,82,.378,26,64,.406,5,18,.278,24,35,.686,91
21585,2010-10-30,CLE,,SAC,L 104-107,240,39,80,.488,33,61,.541,6,19,.316,20,29,.690,104
21586,2010-10-30,SAC,@,CLE,W 107-104,240,40,77,.519,31,62,.500,9,15,.600,18,24,.750,107
21587,2010-10-30,DEN,@,HOU,W 107-94,240,34,90,.378,24,63,.381,10,27,.370,29,33,.879,107
21588,2010-10-30,HOU,,DEN,L 94-107,240,37,81,.457,34,62,.548,3,19,.158,17,21,.810,94
21589,2010-10-30,IND,,PHI,W 99-86,240,37,89,.416,30,65,.462,7,24,.292,18,25,.720,99
21590,2010-10-30,PHI,@,IND,L 86-99,240,36,82,.439,30,71,.423,6,11,.545,8,16,.500,86
21591,2010-10-30,MEM,,MIN,W 109-89,240,43,93,.462,35,73,.479,8,20,.400,15,18,.833,109
21592,2010-10-30,MIN,@,MEM,L 89-109,240,31,89,.348,25,69,.362,6,20,.300,21,32,.656,89
21593,2010-10-30,CHA,@,MIL,L 88-98,240,30,64,.469,21,45,.467,9,19,.474,19,23,.826,88
21594,2010-10-30,MIL,,CHA,W 98-88,240,32,71,.451,21,49,.429,11,22,.500,23,27,.852,98
21595,2010-10-30,NYK,,POR,L 95-100,240,37,88,.420,30,60,.500,7,28,.250,14,25,.560,95
21596,2010-10-30,POR,@,NYK,W 100-95,240,37,76,.487,31,63,.492,6,13,.462,20,30,.667,100
21597,2010-10-30,NOP,@,SAS,W 99-90,240,39,78,.500,32,67,.478,7,11,.636,14,17,.824,99
21598,2010-10-30,SAS,,NOH,L 90-99,240,33,85,.388,27,59,.458,6,26,.231,18,21,.857,90
21599,2010-10-29,BOS,,NYK,W 105-101,240,44,91,.484,39,75,.520,5,16,.313,12,18,.667,105
21600,2010-10-29,NYK,@,BOS,L 101-105,240,37,85,.435,28,58,.483,9,27,.333,18,27,.667,101
21601,2010-10-29,CHA,,IND,L 101-104,240,31,70,.443,27,58,.466,4,12,.333,35,45,.778,101
21602,2010-10-29,IND,@,CHA,W 104-101,240,36,80,.450,24,51,.471,12,29,.414,20,24,.833,104
21603,2010-10-29,DAL,,MEM,L 90-91,240,34,72,.472,28,54,.519,6,18,.333,16,24,.667,90
21604,2010-10-29,MEM,@,DAL,W 91-90,240,31,80,.388,27,65,.415,4,15,.267,25,36,.694,91
21605,2010-10-29,DET,,OKC,L 104-105,240,40,85,.471,32,73,.438,8,12,.667,16,20,.800,104
21606,2010-10-29,OKC,@,DET,W 105-104,240,33,85,.388,31,70,.443,2,15,.133,37,44,.841,105
21607,2010-10-29,GSW,,LAC,W 109-91,240,43,81,.531,29,57,.509,14,24,.583,9,17,.529,109
21608,2010-10-29,LAC,@,GSW,L 91-109,240,32,83,.386,27,65,.415,5,18,.278,22,32,.688,91
21609,2010-10-29,MIA,,ORL,W 96-70,240,33,81,.407,24,63,.381,9,18,.500,21,27,.778,96
21610,2010-10-29,ORL,@,MIA,L 70-96,240,21,69,.304,17,45,.378,4,24,.167,24,34,.706,70
21611,2010-10-29,MIL,@,MIN,L 85-96,240,31,87,.356,28,67,.418,3,20,.150,20,25,.800,85
21612,2010-10-29,MIN,,MIL,W 96-85,240,32,85,.376,26,63,.413,6,22,.273,26,36,.722,96
21613,2010-10-29,BRK,,SAC,W 106-100,240,32,61,.525,26,50,.520,6,11,.545,36,45,.800,106
21614,2010-10-29,SAC,@,NJN,L 100-106,240,39,93,.419,34,73,.466,5,20,.250,17,26,.654,100
21615,2010-10-29,DEN,@,NOH,L 95-101,240,35,72,.486,29,57,.509,6,15,.400,19,25,.760,95
21616,2010-10-29,NOP,,DEN,W 101-95,240,38,77,.494,32,60,.533,6,17,.353,19,24,.792,101
21617,2010-10-29,ATL,@,PHI,W 104-101,240,36,70,.514,30,53,.566,6,17,.353,26,31,.839,104
21618,2010-10-29,PHI,,ATL,L 101-104,240,35,85,.412,30,74,.405,5,11,.455,26,33,.788,101
21619,2010-10-29,LAL,@,PHO,W 114-106,240,46,95,.484,34,68,.500,12,27,.444,10,12,.833,114
21620,2010-10-29,PHO,,LAL,L 106-114,240,44,93,.473,35,69,.507,9,24,.375,9,13,.692,106
21621,2010-10-29,CLE,@,TOR,L 81-101,240,32,84,.381,23,65,.354,9,19,.474,8,10,.800,81
21622,2010-10-29,TOR,,CLE,W 101-81,240,39,82,.476,33,62,.532,6,20,.300,17,18,.944,101
21623,2010-10-28,ORL,,WAS,W 112-83,240,43,77,.558,35,53,.660,8,24,.333,18,32,.563,112
21624,2010-10-28,WAS,@,ORL,L 83-112,240,29,78,.372,25,59,.424,4,19,.211,21,30,.700,83
21625,2010-10-28,PHO,@,UTA,W 110-94,240,37,80,.463,27,54,.500,10,26,.385,26,34,.765,110
21626,2010-10-28,UTA,,PHO,L 94-110,240,36,84,.429,33,71,.465,3,13,.231,19,27,.704,94
21627,2010-10-27,BOS,@,CLE,L 87-95,240,34,72,.472,31,60,.517,3,12,.250,16,21,.762,87
21628,2010-10-27,CLE,,BOS,W 95-87,240,36,81,.444,30,61,.492,6,20,.300,17,21,.810,95
21629,2010-10-27,CHA,@,DAL,L 86-101,240,29,73,.397,24,60,.400,5,13,.385,23,24,.958,86
21630,2010-10-27,DAL,,CHA,W 101-86,240,41,75,.547,37,60,.617,4,15,.267,15,18,.833,101
21631,2010-10-27,DEN,,UTA,W 110-88,240,35,80,.438,29,60,.483,6,20,.300,34,41,.829,110
21632,2010-10-27,UTA,@,DEN,L 88-110,240,27,70,.386,24,57,.421,3,13,.231,31,43,.721,88
21633,2010-10-27,GSW,,HOU,W 132-128,240,51,92,.554,43,72,.597,8,20,.400,22,26,.846,132
21634,2010-10-27,HOU,@,GSW,L 128-132,240,41,87,.471,37,71,.521,4,16,.250,42,52,.808,128
21635,2010-10-27,LAC,,POR,L 88-98,240,32,79,.405,27,61,.443,5,18,.278,19,30,.633,88
21636,2010-10-27,POR,@,LAC,W 98-88,240,36,88,.409,28,68,.412,8,20,.400,18,23,.783,98
21637,2010-10-27,ATL,@,MEM,W 119-104,240,42,80,.525,34,64,.531,8,16,.500,27,31,.871,119
21638,2010-10-27,MEM,,ATL,L 104-119,240,40,86,.465,36,77,.468,4,9,.444,20,25,.800,104
21639,2010-10-27,MIN,,SAC,L 116-117,240,43,91,.473,35,73,.479,8,18,.444,22,28,.786,116
21640,2010-10-27,SAC,@,MIN,W 117-116,240,39,85,.459,35,74,.473,4,11,.364,35,47,.745,117
21641,2010-10-27,DET,@,NJN,L 98-101,240,37,83,.446,29,64,.453,8,19,.421,16,30,.533,98
21642,2010-10-27,BRK,,DET,W 101-98,240,39,80,.488,33,66,.500,6,14,.429,17,24,.708,101
21643,2010-10-27,MIL,@,NOH,L 91-95,240,33,77,.429,25,54,.463,8,23,.348,17,28,.607,91
21644,2010-10-27,NOP,,MIL,W 95-91,240,34,79,.430,30,62,.484,4,17,.235,23,29,.793,95
21645,2010-10-27,CHI,@,OKC,L 95-106,240,40,93,.430,38,79,.481,2,14,.143,13,22,.591,95
21646,2010-10-27,OKC,,CHI,W 106-95,240,32,78,.410,28,60,.467,4,18,.222,38,47,.809,106
21647,2010-10-27,MIA,@,PHI,W 97-87,240,33,69,.478,25,53,.472,8,16,.500,23,31,.742,97
21648,2010-10-27,PHI,,MIA,L 87-97,240,36,83,.434,29,65,.446,7,18,.389,8,11,.727,87
21649,2010-10-27,IND,@,SAS,L 109-122,240,41,77,.532,33,56,.589,8,21,.381,19,28,.679,109
21650,2010-10-27,SAS,,IND,W 122-109,240,42,83,.506,33,63,.524,9,20,.450,29,36,.806,122
21651,2010-10-27,NYK,@,TOR,W 98-93,240,38,88,.432,31,64,.484,7,24,.292,15,17,.882,98
21652,2010-10-27,TOR,,NYK,L 93-98,240,36,94,.383,33,84,.393,3,10,.300,18,24,.750,93
21653,2010-10-26,BOS,,MIA,W 88-80,240,32,69,.464,24,53,.453,8,16,.500,16,25,.640,88
21654,2010-10-26,MIA,@,BOS,L 80-88,240,27,74,.365,19,54,.352,8,20,.400,18,25,.720,80
21655,2010-10-26,HOU,@,LAL,L 110-112,240,38,91,.418,30,71,.423,8,20,.400,26,28,.929,110
21656,2010-10-26,LAL,,HOU,W 112-110,240,40,96,.417,31,75,.413,9,21,.429,23,28,.821,112
21657,2010-10-26,PHO,@,POR,L 92-106,240,36,74,.486,27,55,.491,9,19,.474,11,16,.688,92
21658,2010-10-26,POR,,PHO,W 106-92,240,43,93,.462,33,73,.452,10,20,.500,10,15,.667,106
21659,2010-04-14,ATL,,CLE,W 99-83,240,43,79,.544,41,68,.603,2,11,.182,11,17,.647,99
21660,2010-04-14,CLE,@,ATL,L 83-99,240,31,73,.425,30,59,.508,1,14,.071,20,36,.556,83
21661,2010-04-14,BOS,,MIL,L 95-106,240,36,76,.474,28,54,.519,8,22,.364,15,21,.714,95
21662,2010-04-14,MIL,@,BOS,W 106-95,240,40,79,.506,30,53,.566,10,26,.385,16,24,.667,106
21663,2010-04-14,CHA,,CHI,L 89-98,240,32,80,.400,29,66,.439,3,14,.214,22,26,.846,89
21664,2010-04-14,CHI,@,CHA,W 98-89,240,36,76,.474,30,58,.517,6,18,.333,20,25,.800,98
21665,2010-04-14,DAL,,SAS,W 96-89,240,35,85,.412,29,71,.408,6,14,.429,20,28,.714,96
21666,2010-04-14,SAS,@,DAL,L 89-96,240,37,91,.407,35,69,.507,2,22,.091,13,20,.650,89
21667,2010-04-14,HOU,,NOH,L 115-123,240,47,87,.540,41,68,.603,6,19,.316,15,25,.600,115
21668,2010-04-14,NOP,@,HOU,W 123-115,240,51,80,.638,42,65,.646,9,15,.600,12,16,.750,123
21669,2010-04-14,LAC,,LAL,W 107-91,240,42,83,.506,33,60,.550,9,23,.391,14,19,.737,107
21670,2010-04-14,LAL,@,LAC,L 91-107,240,34,86,.395,30,75,.400,4,11,.364,19,28,.679,91
21671,2010-04-14,MIA,,NJN,W 94-86 (2OT),290,37,93,.398,29,67,.433,8,26,.308,12,16,.750,94
21672,2010-04-14,BRK,@,MIA,L 86-94 (2OT),290,29,80,.363,24,61,.393,5,19,.263,23,32,.719,86
21673,2010-04-14,DET,@,MIN,W 103-98,240,38,79,.481,34,62,.548,4,17,.235,23,30,.767,103
21674,2010-04-14,MIN,,DET,L 98-103,240,38,77,.494,35,65,.538,3,12,.250,19,24,.792,98
21675,2010-04-14,MEM,@,OKC,L 105-114,240,39,85,.459,38,76,.500,1,9,.111,26,33,.788,105
21676,2010-04-14,OKC,,MEM,W 114-105,240,42,79,.532,32,54,.593,10,25,.400,20,25,.800,114
21677,2010-04-14,ORL,,PHI,W 125-111,240,49,82,.598,38,57,.667,11,25,.440,16,20,.800,125
21678,2010-04-14,PHI,@,ORL,L 111-125,240,43,83,.518,37,64,.578,6,19,.316,19,24,.792,111
21679,2010-04-14,GSW,@,POR,W 122-116,240,44,88,.500,32,58,.552,12,30,.400,22,31,.710,122
21680,2010-04-14,POR,,GSW,L 116-122,240,44,87,.506,34,61,.557,10,26,.385,18,24,.750,116
21681,2010-04-14,NYK,@,TOR,L 113-131,240,39,90,.433,24,57,.421,15,33,.455,20,26,.769,113
21682,2010-04-14,TOR,,NYK,W 131-113,240,52,80,.650,45,66,.682,7,14,.500,20,25,.800,131
21683,2010-04-14,PHO,@,UTA,W 100-86,240,35,74,.473,25,47,.532,10,27,.370,20,27,.741,100
21684,2010-04-14,UTA,,PHO,L 86-100,240,30,80,.375,23,61,.377,7,19,.368,19,24,.792,86
21685,2010-04-14,IND,@,WAS,L 97-98,240,33,83,.398,30,61,.492,3,22,.136,28,32,.875,97
21686,2010-04-14,WAS,,IND,W 98-97,240,37,77,.481,33,62,.532,4,15,.267,20,27,.741,98
21687,2010-04-13,BOS,@,CHI,L 93-101,240,35,80,.438,30,65,.462,5,15,.333,18,24,.750,93
21688,2010-04-13,CHI,,BOS,W 101-93,240,40,83,.482,35,72,.486,5,11,.455,16,24,.667,101
21689,2010-04-13,GSW,,UTA,L 94-103,240,32,84,.381,25,61,.410,7,23,.304,23,28,.821,94
21690,2010-04-13,UTA,@,GSW,W 103-94,240,41,85,.482,36,67,.537,5,18,.278,16,20,.800,103
21691,2010-04-13,LAL,,SAC,W 106-100,240,41,83,.494,34,63,.540,7,20,.350,17,21,.810,106
21692,2010-04-13,SAC,@,LAL,L 100-106,240,43,90,.478,38,74,.514,5,16,.313,9,14,.643,100
21693,2010-04-13,DEN,@,PHO,L 101-123,240,41,97,.423,35,76,.461,6,21,.286,13,21,.619,101
21694,2010-04-13,PHO,,DEN,W 123-101,240,43,80,.538,29,56,.518,14,24,.583,23,34,.676,123
21695,2010-04-12,DEN,,MEM,W 123-101,240,40,87,.460,29,55,.527,11,32,.344,32,39,.821,123
21696,2010-04-12,MEM,@,DEN,L 101-123,240,36,92,.391,34,82,.415,2,10,.200,27,36,.750,101
21697,2010-04-12,DET,,TOR,L 97-111,240,37,79,.468,32,62,.516,5,17,.294,18,23,.783,97
21698,2010-04-12,TOR,@,DET,W 111-97,240,45,75,.600,36,60,.600,9,15,.600,12,16,.750,111
21699,2010-04-12,IND,,ORL,L 98-118,240,36,88,.409,26,59,.441,10,29,.345,16,24,.667,98
21700,2010-04-12,ORL,@,IND,W 118-98,240,37,77,.481,25,45,.556,12,32,.375,32,43,.744,118
21701,2010-04-12,DAL,@,LAC,W 117-94,240,45,83,.542,34,56,.607,11,27,.407,16,19,.842,117
21702,2010-04-12,LAC,,DAL,L 94-117,240,38,83,.458,32,66,.485,6,17,.353,12,15,.800,94
21703,2010-04-12,ATL,@,MIL,W 104-96,240,39,74,.527,32,58,.552,7,16,.438,19,27,.704,104
21704,2010-04-12,MIL,,ATL,L 96-104,240,36,93,.387,25,61,.410,11,32,.344,13,17,.765,96
21705,2010-04-12,CHA,@,NJN,W 105-95,240,43,87,.494,40,80,.500,3,7,.429,16,17,.941,105
21706,2010-04-12,BRK,,CHA,L 95-105,240,35,89,.393,31,65,.477,4,24,.167,21,25,.840,95
21707,2010-04-12,NYK,,WAS,W 114-103,240,41,80,.513,30,57,.526,11,23,.478,21,25,.840,114
21708,2010-04-12,WAS,@,NYK,L 103-114,240,41,82,.500,31,65,.477,10,17,.588,11,19,.579,103
21709,2010-04-12,MIA,@,PHI,W 107-105,240,40,72,.556,35,60,.583,5,12,.417,22,28,.786,107
21710,2010-04-12,PHI,,MIA,L 105-107,240,41,75,.547,29,50,.580,12,25,.480,11,19,.579,105
21711,2010-04-12,OKC,@,POR,L 95-103,240,30,64,.469,23,46,.500,7,18,.389,28,36,.778,95
21712,2010-04-12,POR,,OKC,W 103-95,240,40,80,.500,37,65,.569,3,15,.200,20,27,.741,103
21713,2010-04-12,HOU,@,SAC,W 117-107,240,43,83,.518,35,59,.593,8,24,.333,23,23,1.000,117
21714,2010-04-12,SAC,,HOU,L 107-117,240,41,85,.482,36,73,.493,5,12,.417,20,24,.833,107
21715,2010-04-12,MIN,@,SAS,L 111-133,240,39,82,.476,30,66,.455,9,16,.563,24,30,.800,111
21716,2010-04-12,SAS,,MIN,W 133-111,240,47,81,.580,33,55,.600,14,26,.538,25,38,.658,133
21717,2010-04-11,CLE,,ORL,L 92-98,240,34,83,.410,28,65,.431,6,18,.333,18,23,.783,92
21718,2010-04-11,ORL,@,CLE,W 98-92,240,38,79,.481,29,53,.547,9,26,.346,13,19,.684,98
21719,2010-04-11,GSW,,OKC,W 120-117,240,41,81,.506,29,60,.483,12,21,.571,26,33,.788,120
21720,2010-04-11,OKC,@,GSW,L 117-120,240,44,104,.423,35,83,.422,9,21,.429,20,24,.833,117
21721,2010-04-11,LAL,,POR,L 88-91,240,37,87,.425,32,65,.492,5,22,.227,9,14,.643,88
21722,2010-04-11,POR,@,LAL,W 91-88,240,36,80,.450,30,65,.462,6,15,.400,13,15,.867,91
21723,2010-04-11,MIN,@,NOH,L 86-114,240,26,66,.394,23,53,.434,3,13,.231,31,38,.816,86
21724,2010-04-11,NOP,,MIN,W 114-86,240,43,82,.524,39,67,.582,4,15,.267,24,27,.889,114
21725,2010-04-11,MIA,@,NYK,W 111-98,240,44,84,.524,37,66,.561,7,18,.389,16,22,.727,111
21726,2010-04-11,NYK,,MIA,L 98-111,240,33,73,.452,26,49,.531,7,24,.292,25,28,.893,98
21727,2010-04-11,HOU,@,PHO,L 106-116,240,38,85,.447,26,63,.413,12,22,.545,18,23,.783,106
21728,2010-04-11,PHO,,HOU,W 116-106,240,42,86,.488,32,65,.492,10,21,.476,22,29,.759,116
21729,2010-04-11,CHI,@,TOR,W 104-88,240,42,85,.494,39,70,.557,3,15,.200,17,23,.739,104
21730,2010-04-11,TOR,,CHI,L 88-104,240,37,90,.411,32,69,.464,5,21,.238,9,15,.600,88
21731,2010-04-10,CHA,,DET,W 99-95,240,35,65,.538,28,50,.560,7,15,.467,22,26,.846,99
21732,2010-04-10,DET,@,CHA,L 95-99,240,36,79,.456,30,58,.517,6,21,.286,17,26,.654,95
21733,2010-04-10,DEN,,SAS,L 85-104,240,29,74,.392,23,57,.404,6,17,.353,21,31,.677,85
21734,2010-04-10,SAS,@,DEN,W 104-85,240,34,74,.459,28,55,.509,6,19,.316,30,45,.667,104
21735,2010-04-10,IND,,NJN,W 115-102,240,46,86,.535,37,62,.597,9,24,.375,14,18,.778,115
21736,2010-04-10,BRK,@,IND,L 102-115,240,43,82,.524,41,71,.577,2,11,.182,14,17,.824,102
21737,2010-04-10,GSW,@,LAC,L 104-107,240,37,92,.402,23,60,.383,14,32,.438,16,21,.762,104
21738,2010-04-10,LAC,,GSW,W 107-104,240,42,83,.506,37,63,.587,5,20,.250,18,27,.667,107
21739,2010-04-10,MEM,,PHI,L 101-120,240,34,69,.493,31,56,.554,3,13,.231,30,41,.732,101
21740,2010-04-10,PHI,@,MEM,W 120-101,240,49,86,.570,35,60,.583,14,26,.538,8,11,.727,120
21741,2010-04-10,BOS,@,MIL,W 105-90,240,35,75,.467,31,66,.470,4,9,.444,31,35,.886,105
21742,2010-04-10,MIL,,BOS,L 90-105,240,31,78,.397,23,54,.426,8,24,.333,20,24,.833,90
21743,2010-04-10,DAL,@,SAC,W 126-108,240,42,79,.532,29,58,.500,13,21,.619,29,34,.853,126
21744,2010-04-10,SAC,,DAL,L 108-126,240,40,85,.471,36,75,.480,4,10,.400,24,29,.828,108
21745,2010-04-10,ATL,@,WAS,W 105-95,240,40,74,.541,31,56,.554,9,18,.500,16,18,.889,105
21746,2010-04-10,WAS,,ATL,L 95-105,240,40,79,.506,33,67,.493,7,12,.583,8,12,.667,95
21747,2010-04-09,ATL,,TOR,W 107-101,240,36,88,.409,28,63,.444,8,25,.320,27,30,.900,107
21748,2010-04-09,TOR,@,ATL,L 101-107,240,43,90,.478,41,75,.547,2,15,.133,13,20,.650,101
21749,2010-04-09,BOS,,WAS,L 96-106,240,38,90,.422,29,65,.446,9,25,.360,11,19,.579,96
21750,2010-04-09,WAS,@,BOS,W 106-96,240,37,76,.487,32,63,.508,5,13,.385,27,35,.771,106
21751,2010-04-09,CLE,,IND,L 113-116,240,41,89,.461,34,71,.479,7,18,.389,24,28,.857,113
21752,2010-04-09,IND,@,CLE,W 116-113,240,42,83,.506,28,51,.549,14,32,.438,18,24,.750,116
21753,2010-04-09,CHA,@,HOU,L 90-97,240,33,77,.429,29,63,.460,4,14,.286,20,26,.769,90
21754,2010-04-09,HOU,,CHA,W 97-90,240,38,86,.442,30,63,.476,8,23,.348,13,15,.867,97
21755,2010-04-09,DET,@,MIA,W 106-99,240,40,80,.500,29,55,.527,11,25,.440,15,19,.789,106
21756,2010-04-09,MIA,,DET,L 99-106,240,39,70,.557,33,54,.611,6,16,.375,15,18,.833,99
21757,2010-04-09,LAL,@,MIN,W 97-88,240,38,86,.442,31,64,.484,7,22,.318,14,18,.778,97
21758,2010-04-09,MIN,,LAL,L 88-97,240,38,89,.427,31,66,.470,7,23,.304,5,9,.556,88
21759,2010-04-09,CHI,@,NJN,L 116-127 (2OT),290,44,92,.478,35,68,.515,9,24,.375,19,29,.655,116
21760,2010-04-09,BRK,,CHI,W 127-116 (2OT),290,49,105,.467,44,84,.524,5,21,.238,24,32,.750,127
21761,2010-04-09,NOP,,UTA,L 103-114,240,39,79,.494,31,64,.484,8,15,.533,17,24,.708,103
21762,2010-04-09,UTA,@,NOH,W 114-103,240,44,80,.550,36,60,.600,8,20,.400,18,24,.750,114
21763,2010-04-09,OKC,,PHO,W 96-91,240,35,88,.398,31,75,.413,4,13,.308,22,27,.815,96
21764,2010-04-09,PHO,@,OKC,L 91-96,240,34,75,.453,27,56,.482,7,19,.368,16,23,.696,91
21765,2010-04-09,NYK,@,ORL,L 103-118,240,35,74,.473,19,41,.463,16,33,.485,17,22,.773,103
21766,2010-04-09,ORL,,NYK,W 118-103,240,47,84,.560,32,52,.615,15,32,.469,9,18,.500,118
21767,2010-04-09,MIL,@,PHI,W 95-90,240,32,77,.416,22,48,.458,10,29,.345,21,23,.913,95
21768,2010-04-09,PHI,,MIL,L 90-95,240,36,81,.444,27,59,.458,9,22,.409,9,20,.450,90
21769,2010-04-09,DAL,@,POR,W 83-77,240,24,71,.338,19,51,.373,5,20,.250,30,35,.857,83
21770,2010-04-09,POR,,DAL,L 77-83,240,28,77,.364,23,58,.397,5,19,.263,16,23,.696,77
21771,2010-04-09,MEM,@,SAS,W 107-99,240,43,88,.489,39,79,.494,4,9,.444,17,25,.680,107
21772,2010-04-09,SAS,,MEM,L 99-107,240,33,75,.440,24,47,.511,9,28,.321,24,32,.750,99
21773,2010-04-08,CHI,,CLE,W 109-108,240,44,85,.518,39,74,.527,5,11,.455,16,25,.640,109
21774,2010-04-08,CLE,@,CHI,L 108-109,240,41,86,.477,32,61,.525,9,25,.360,17,24,.708,108
21775,2010-04-08,DEN,,LAL,W 98-96,240,34,78,.436,23,53,.434,11,25,.440,19,28,.679,98
21776,2010-04-08,LAL,@,DEN,L 96-98,240,30,82,.366,22,61,.361,8,21,.381,28,33,.848,96
21777,2010-04-08,LAC,@,SAC,L 94-116,240,39,82,.476,32,63,.508,7,19,.368,9,11,.818,94
21778,2010-04-08,SAC,,LAC,W 116-94,240,50,92,.543,46,81,.568,4,11,.364,12,15,.800,116
21779,2010-04-07,DAL,,MEM,W 110-84,240,42,76,.553,34,62,.548,8,14,.571,18,21,.857,110
21780,2010-04-07,MEM,@,DAL,L 84-110,240,33,71,.465,31,61,.508,2,10,.200,16,24,.667,84
21781,2010-04-07,ATL,@,DET,L 88-90,240,36,83,.434,34,66,.515,2,17,.118,14,23,.609,88
21782,2010-04-07,DET,,ATL,W 90-88,240,34,79,.430,28,65,.431,6,14,.429,16,16,1.000,90
21783,2010-04-07,HOU,,UTA,W 113-96,240,41,84,.488,31,65,.477,10,19,.526,21,26,.808,113
21784,2010-04-07,UTA,@,HOU,L 96-113,240,39,79,.494,36,65,.554,3,14,.214,15,21,.714,96
21785,2010-04-07,IND,,NYK,W 113-105,240,43,88,.489,33,60,.550,10,28,.357,17,26,.654,113
21786,2010-04-07,NYK,@,IND,L 105-113,240,40,89,.449,30,64,.469,10,25,.400,15,17,.882,105
21787,2010-04-07,LAC,,POR,L 85-93,240,38,77,.494,33,62,.532,5,15,.333,4,8,.500,85
21788,2010-04-07,POR,@,LAC,W 93-85,240,41,81,.506,39,74,.527,2,7,.286,9,13,.692,93
21789,2010-04-07,MIA,,PHI,W 99-95,240,36,86,.419,30,67,.448,6,19,.316,21,30,.700,99
21790,2010-04-07,PHI,@,MIA,L 95-99,240,38,75,.507,30,57,.526,8,18,.444,11,18,.611,95
21791,2010-04-07,MIL,,NJN,W 108-89,240,43,83,.518,36,61,.590,7,22,.318,15,19,.789,108
21792,2010-04-07,BRK,@,MIL,L 89-108,240,30,76,.395,23,60,.383,7,16,.438,22,26,.846,89
21793,2010-04-07,GSW,@,MIN,W 116-107,240,46,82,.561,38,66,.576,8,16,.500,16,18,.889,116
21794,2010-04-07,MIN,,GSW,L 107-116,240,39,81,.481,29,61,.475,10,20,.500,19,27,.704,107
21795,2010-04-07,CHA,@,NOH,W 104-103,240,36,74,.486,25,50,.500,11,24,.458,21,24,.875,104
21796,2010-04-07,NOP,,CHA,L 103-104,240,39,81,.481,31,61,.508,8,20,.400,17,22,.773,103
21797,2010-04-07,DEN,@,OKC,W 98-94,240,33,82,.402,26,65,.400,7,17,.412,25,29,.862,98
21798,2010-04-07,OKC,,DEN,L 94-98,240,35,80,.438,34,66,.515,1,14,.071,23,31,.742,94
21799,2010-04-07,ORL,,WAS,W 121-94,240,44,76,.579,31,54,.574,13,22,.591,20,24,.833,121
21800,2010-04-07,WAS,@,ORL,L 94-121,240,39,78,.500,35,68,.515,4,10,.400,12,14,.857,94
21801,2010-04-07,PHO,,SAS,W 112-101,240,44,87,.506,36,65,.554,8,22,.364,16,18,.889,112
21802,2010-04-07,SAS,@,PHO,L 101-112,240,39,82,.476,33,57,.579,6,25,.240,17,28,.607,101
21803,2010-04-07,BOS,@,TOR,W 115-104,240,40,71,.563,33,54,.611,7,17,.412,28,33,.848,115
21804,2010-04-07,TOR,,BOS,L 104-115,240,43,90,.478,37,73,.507,6,17,.353,12,12,1.000,104
21805,2010-04-06,ATL,@,CHA,L 100-109,240,40,84,.476,32,65,.492,8,19,.421,12,13,.923,100
21806,2010-04-06,CHA,,ATL,W 109-100,240,37,72,.514,30,60,.500,7,12,.583,28,32,.875,109
21807,2010-04-06,CHI,,MIL,L 74-79,240,32,74,.432,29,63,.460,3,11,.273,7,11,.636,74
21808,2010-04-06,MIL,@,CHI,W 79-74,240,28,77,.364,21,48,.438,7,29,.241,16,22,.727,79
21809,2010-04-06,CLE,,TOR,W 113-101,240,47,84,.560,39,64,.609,8,20,.400,11,14,.786,113
21810,2010-04-06,TOR,@,CLE,L 101-113,240,39,83,.470,32,63,.508,7,20,.350,16,20,.800,101
21811,2010-04-06,HOU,@,MEM,W 113-103,240,38,87,.437,30,60,.500,8,27,.296,29,33,.879,113
21812,2010-04-06,MEM,,HOU,L 103-113,240,45,92,.489,44,87,.506,1,5,.200,12,16,.750,103
21813,2010-04-06,BOS,@,NYK,L 101-104,240,40,73,.548,33,55,.600,7,18,.389,14,22,.636,101
21814,2010-04-06,NYK,,BOS,W 104-101,240,39,88,.443,33,63,.524,6,25,.240,20,25,.800,104
21815,2010-04-06,DET,@,PHI,W 124-103,240,47,75,.627,39,58,.672,8,17,.471,22,29,.759,124
21816,2010-04-06,PHI,,DET,L 103-124,240,39,74,.527,33,54,.611,6,20,.300,19,23,.826,103
21817,2010-04-06,SAC,,SAS,L 86-95,240,36,82,.439,32,71,.451,4,11,.364,10,16,.625,86
21818,2010-04-06,SAS,@,SAC,W 95-86,240,37,79,.468,32,61,.525,5,18,.278,16,18,.889,95
21819,2010-04-06,OKC,@,UTA,L 139-140 (OT),265,45,90,.500,32,60,.533,13,30,.433,36,41,.878,139
21820,2010-04-06,UTA,,OKC,W 140-139 (OT),265,49,94,.521,37,73,.507,12,21,.571,30,37,.811,140
21821,2010-04-06,GSW,@,WAS,L 94-112,240,33,84,.393,26,64,.406,7,20,.350,21,23,.913,94
21822,2010-04-06,WAS,,GSW,W 112-94,240,44,85,.518,36,67,.537,8,18,.444,16,20,.800,112
21823,2010-04-04,BOS,,CLE,W 117-113,240,39,80,.488,31,67,.463,8,13,.615,31,38,.816,117
21824,2010-04-04,CLE,@,BOS,L 113-117,240,40,78,.513,33,61,.541,7,17,.412,26,40,.650,113
21825,2010-04-04,HOU,@,IND,L 102-133,240,39,87,.448,29,60,.483,10,27,.370,14,23,.609,102
21826,2010-04-04,IND,,HOU,W 133-102,240,49,85,.576,35,59,.593,14,26,.538,21,27,.778,133
21827,2010-04-04,LAC,,NYK,L 107-113,240,43,87,.494,36,59,.610,7,28,.250,14,21,.667,107
21828,2010-04-04,NYK,@,LAC,W 113-107,240,42,89,.472,31,59,.525,11,30,.367,18,22,.818,113
21829,2010-04-04,LAL,,SAS,L 81-100,240,33,81,.407,28,60,.467,5,21,.238,10,14,.714,81
21830,2010-04-04,SAS,@,LAL,W 100-81,240,37,76,.487,30,58,.517,7,18,.389,19,24,.792,100
21831,2010-04-04,MIN,@,OKC,L 108-116,240,37,78,.474,31,61,.508,6,17,.353,28,32,.875,108
21832,2010-04-04,OKC,,MIN,W 116-108,240,46,91,.505,41,78,.526,5,13,.385,19,20,.950,116
21833,2010-04-04,MEM,@,ORL,L 92-107,240,30,75,.400,27,66,.409,3,9,.333,29,38,.763,92
21834,2010-04-04,ORL,,MEM,W 107-92,240,38,82,.463,25,53,.472,13,29,.448,18,24,.750,107
21835,2010-04-04,GSW,@,TOR,W 113-112,240,41,86,.477,28,60,.467,13,26,.500,18,25,.720,113
21836,2010-04-04,TOR,,GSW,L 112-113,240,36,92,.391,33,80,.413,3,12,.250,37,45,.822,112
21837,2010-04-04,BRK,@,WAS,L 99-109,240,36,74,.486,32,64,.500,4,10,.400,23,28,.821,99
21838,2010-04-04,WAS,,NJN,W 109-99,240,38,77,.494,34,71,.479,4,6,.667,29,34,.853,109
21839,2010-04-03,ATL,,DET,W 91-85,240,35,73,.479,28,58,.483,7,15,.467,14,21,.667,91
21840,2010-04-03,DET,@,ATL,L 85-91,240,32,85,.376,27,71,.380,5,14,.357,16,20,.800,85
21841,2010-04-03,CHA,@,CHI,L 88-96,240,35,83,.422,29,65,.446,6,18,.333,12,16,.750,88
21842,2010-04-03,CHI,,CHA,W 96-88,240,39,86,.453,37,75,.493,2,11,.182,16,21,.762,96
21843,2010-04-03,DAL,,OKC,L 116-121,240,43,81,.531,38,62,.613,5,19,.263,25,29,.862,116
21844,2010-04-03,OKC,@,DAL,W 121-116,240,42,81,.519,37,67,.552,5,14,.357,32,38,.842,121
21845,2010-04-03,DEN,,LAC,W 98-90,240,39,86,.453,33,63,.524,6,23,.261,14,20,.700,98
21846,2010-04-03,LAC,@,DEN,L 90-98,240,36,76,.474,26,52,.500,10,24,.417,8,12,.667,90
21847,2010-04-03,MIL,,PHO,W 107-98,240,42,78,.538,35,58,.603,7,20,.350,16,24,.667,107
21848,2010-04-03,PHO,@,MIL,L 98-107,240,36,76,.474,30,59,.508,6,17,.353,20,25,.800,98
21849,2010-04-03,MIA,@,MIN,W 97-84,240,38,76,.500,32,62,.516,6,14,.429,15,24,.625,97
21850,2010-04-03,MIN,,MIA,L 84-97,240,34,76,.447,30,58,.517,4,18,.222,12,23,.522,84
21851,2010-04-03,BRK,,NOH,W 115-87,240,46,79,.582,42,70,.600,4,9,.444,19,22,.864,115
21852,2010-04-03,NOP,@,NJN,L 87-115,240,37,93,.398,36,82,.439,1,11,.091,12,18,.667,87
21853,2010-04-03,PHI,,TOR,L 123-128 (OT),265,45,81,.556,38,60,.633,7,21,.333,26,32,.813,123
21854,2010-04-03,TOR,@,PHI,W 128-123 (OT),265,45,80,.563,34,56,.607,11,24,.458,27,34,.794,128
21855,2010-04-03,POR,@,SAC,W 98-87,240,35,73,.479,28,53,.528,7,20,.350,21,24,.875,98
21856,2010-04-03,SAC,,POR,L 87-98,240,35,76,.461,30,59,.508,5,17,.294,12,20,.600,87
21857,2010-04-02,BOS,,HOU,L 114-119 (OT),265,43,83,.518,39,70,.557,4,13,.308,24,37,.649,114
21858,2010-04-02,HOU,@,BOS,W 119-114 (OT),265,41,81,.506,29,63,.460,12,18,.667,25,28,.893,119
21859,2010-04-02,CHA,,MIL,W 87-86 (OT),265,30,80,.375,23,63,.365,7,17,.412,20,27,.741,87
21860,2010-04-02,MIL,@,CHA,L 86-87 (OT),265,35,85,.412,29,64,.453,6,21,.286,10,15,.667,86
21861,2010-04-02,ATL,@,CLE,L 88-93,240,37,90,.411,32,72,.444,5,18,.278,9,15,.600,88
21862,2010-04-02,CLE,,ATL,W 93-88,240,33,80,.413,27,61,.443,6,19,.316,21,28,.750,93
21863,2010-04-02,DET,,PHO,L 94-109,240,36,82,.439,34,71,.479,2,11,.182,20,26,.769,94
21864,2010-04-02,PHO,@,DET,W 109-94,240,41,73,.562,26,44,.591,15,29,.517,12,17,.706,109
21865,2010-04-02,GSW,,NYK,W 128-117,240,54,94,.574,47,73,.644,7,21,.333,13,19,.684,128
21866,2010-04-02,NYK,@,GSW,L 117-128,240,43,89,.483,28,55,.509,15,34,.441,16,19,.842,117
21867,2010-04-02,IND,,MIA,L 96-105 (OT),265,31,82,.378,21,55,.382,10,27,.370,24,29,.828,96
21868,2010-04-02,MIA,@,IND,W 105-96 (OT),265,38,84,.452,31,63,.492,7,21,.333,22,30,.733,105
21869,2010-04-02,LAL,,UTA,W 106-92,240,35,81,.432,28,61,.459,7,20,.350,29,37,.784,106
21870,2010-04-02,UTA,@,LAL,L 92-106,240,38,85,.447,34,70,.486,4,15,.267,12,21,.571,92
21871,2010-04-02,MEM,,NOH,W 107-96,240,40,90,.444,35,77,.455,5,13,.385,22,30,.733,107
21872,2010-04-02,NOP,@,MEM,L 96-107,240,41,93,.441,36,73,.493,5,20,.250,9,13,.692,96
21873,2010-04-02,ORL,@,SAS,L 100-112,240,39,80,.488,29,56,.518,10,24,.417,12,26,.462,100
21874,2010-04-02,SAS,,ORL,W 112-100,240,43,83,.518,37,64,.578,6,19,.316,20,26,.769,112
21875,2010-04-02,CHI,@,WAS,W 95-87,240,37,84,.440,34,70,.486,3,14,.214,18,24,.750,95
21876,2010-04-02,WAS,,CHI,L 87-95,240,32,85,.376,26,71,.366,6,14,.429,17,20,.850,87
21877,2010-04-01,DAL,,ORL,L 82-97,240,31,81,.383,27,67,.403,4,14,.286,16,17,.941,82
21878,2010-04-01,ORL,@,DAL,W 97-82,240,35,72,.486,21,48,.438,14,24,.583,13,21,.619,97
21879,2010-04-01,DEN,,POR,W 109-92,240,41,83,.494,36,61,.590,5,22,.227,22,26,.846,109
21880,2010-04-01,POR,@,DEN,L 92-109,240,33,80,.413,29,71,.408,4,9,.444,22,28,.786,92
21881,2010-03-31,ATL,,LAL,W 109-92,240,45,83,.542,36,61,.590,9,22,.409,10,15,.667,109
21882,2010-03-31,LAL,@,ATL,L 92-109,240,33,72,.458,25,52,.481,8,20,.400,18,26,.692,92
21883,2010-03-31,BOS,,OKC,L 104-109,240,44,74,.595,41,61,.672,3,13,.231,13,17,.765,104
21884,2010-03-31,OKC,@,BOS,W 109-104,240,38,75,.507,33,64,.516,5,11,.455,28,34,.824,109
21885,2010-03-31,CHA,,PHI,W 103-84,240,35,75,.467,29,55,.527,6,20,.300,27,35,.771,103
21886,2010-03-31,PHI,@,CHA,L 84-103,240,37,83,.446,32,62,.516,5,21,.238,5,11,.455,84
21887,2010-03-31,CLE,,MIL,W 101-98,240,34,73,.466,30,57,.526,4,16,.250,29,45,.644,101
21888,2010-03-31,MIL,@,CLE,L 98-101,240,41,90,.456,33,65,.508,8,25,.320,8,9,.889,98
21889,2010-03-31,DET,,MIA,L 81-98,240,32,74,.432,28,60,.467,4,14,.286,13,22,.591,81
21890,2010-03-31,MIA,@,DET,W 98-81,240,36,73,.493,24,52,.462,12,21,.571,14,17,.824,98
21891,2010-03-31,DAL,@,MEM,W 106-102 (OT),265,38,89,.427,27,61,.443,11,28,.393,19,25,.760,106
21892,2010-03-31,MEM,,DAL,L 102-106 (OT),265,38,93,.409,32,74,.432,6,19,.316,20,31,.645,102
21893,2010-03-31,MIN,,SAC,W 108-99,240,46,82,.561,38,67,.567,8,15,.533,8,11,.727,108
21894,2010-03-31,SAC,@,MIN,L 99-108,240,41,89,.461,32,75,.427,9,14,.643,8,15,.533,99
21895,2010-03-31,BRK,,PHO,L 105-116,240,42,86,.488,35,66,.530,7,20,.350,14,16,.875,105
21896,2010-03-31,PHO,@,NJN,W 116-105,240,47,83,.566,36,65,.554,11,18,.611,11,16,.688,116
21897,2010-03-31,NOP,,WAS,L 91-96,240,37,77,.481,34,66,.515,3,11,.273,14,18,.778,91
21898,2010-03-31,WAS,@,NOH,W 96-91,240,38,68,.559,35,62,.565,3,6,.500,17,21,.810,96
21899,2010-03-31,NYK,@,POR,L 90-118,240,32,74,.432,25,54,.463,7,20,.350,19,21,.905,90
21900,2010-03-31,POR,,NYK,W 118-90,240,50,95,.526,44,75,.587,6,20,.300,12,16,.750,118
21901,2010-03-31,HOU,@,SAS,L 102-119,240,38,91,.418,32,72,.444,6,19,.316,20,27,.741,102
21902,2010-03-31,SAS,,HOU,W 119-102,240,46,81,.568,40,67,.597,6,14,.429,21,25,.840,119
21903,2010-03-31,LAC,@,TOR,L 92-114,240,38,88,.432,29,63,.460,9,25,.360,7,15,.467,92
21904,2010-03-31,TOR,,LAC,W 114-92,240,47,77,.610,40,62,.645,7,15,.467,13,18,.722,114
21905,2010-03-31,GSW,@,UTA,L 104-128,240,32,89,.360,28,63,.444,4,26,.154,36,42,.857,104
21906,2010-03-31,UTA,,GSW,W 128-104,240,46,87,.529,38,68,.559,8,19,.421,28,38,.737,128
21907,2010-03-30,CHI,,PHO,L 105-111,240,36,81,.444,28,60,.467,8,21,.381,25,29,.862,105
21908,2010-03-30,PHO,@,CHI,W 111-105,240,38,85,.447,24,57,.421,14,28,.500,21,32,.656,111
21909,2010-03-30,HOU,,WAS,W 98-94,240,38,84,.452,34,65,.523,4,19,.211,18,25,.720,98
21910,2010-03-30,WAS,@,HOU,L 94-98,240,37,85,.435,35,71,.493,2,14,.143,18,25,.720,94
21911,2010-03-30,IND,,SAC,W 102-95,240,39,83,.470,27,57,.474,12,26,.462,12,15,.800,102
21912,2010-03-30,SAC,@,IND,L 95-102,240,39,92,.424,35,80,.438,4,12,.333,13,15,.867,95
21913,2010-03-30,LAC,@,MIL,L 89-107,240,32,87,.368,27,72,.375,5,15,.333,20,25,.800,89
21914,2010-03-30,MIL,,LAC,W 107-89,240,43,92,.467,35,70,.500,8,22,.364,13,16,.813,107
21915,2010-03-30,OKC,@,PHI,W 111-93,240,43,88,.489,37,76,.487,6,12,.500,19,27,.704,111
21916,2010-03-30,PHI,,OKC,L 93-111,240,36,76,.474,33,65,.508,3,11,.273,18,22,.818,93
21917,2010-03-29,CHA,,TOR,L 101-103,240,32,69,.464,20,45,.444,12,24,.500,25,31,.806,101
21918,2010-03-29,TOR,@,CHA,W 103-101,240,40,79,.506,32,61,.525,8,18,.444,15,24,.625,103
21919,2010-03-29,DAL,,DEN,W 109-93,240,38,81,.469,26,59,.441,12,22,.545,21,24,.875,109
21920,2010-03-29,DEN,@,DAL,L 93-109,240,32,78,.410,26,58,.448,6,20,.300,23,30,.767,93
21921,2010-03-29,BRK,,SAS,W 90-84,240,32,85,.376,27,66,.409,5,19,.263,21,24,.875,90
21922,2010-03-29,SAS,@,NJN,L 84-90,240,34,82,.415,29,67,.433,5,15,.333,11,20,.550,84
21923,2010-03-29,LAL,@,NOH,L 100-108,240,38,91,.418,31,62,.500,7,29,.241,17,22,.773,100
21924,2010-03-29,NOP,,LAL,W 108-100,240,36,73,.493,26,50,.520,10,23,.435,26,34,.765,108
21925,2010-03-29,NYK,@,UTA,L 98-103,240,35,77,.455,26,49,.531,9,28,.321,19,25,.760,98
21926,2010-03-29,UTA,,NYK,W 103-98,240,41,80,.513,32,64,.500,9,16,.563,12,18,.667,103
21927,2010-03-28,ATL,,IND,W 94-84,240,39,87,.448,36,71,.507,3,16,.188,13,18,.722,94
21928,2010-03-28,IND,@,ATL,L 84-94,240,33,81,.407,25,55,.455,8,26,.308,10,14,.714,84
21929,2010-03-28,BOS,,SAS,L 73-94,240,27,74,.365,26,60,.433,1,14,.071,18,21,.857,73
21930,2010-03-28,SAS,@,BOS,W 94-73,240,34,78,.436,28,55,.509,6,23,.261,20,24,.833,94
21931,2010-03-28,CLE,,SAC,W 97-90,240,38,75,.507,32,58,.552,6,17,.353,15,19,.789,97
21932,2010-03-28,SAC,@,CLE,L 90-97,240,34,79,.430,28,67,.418,6,12,.500,16,20,.800,90
21933,2010-03-28,CHI,@,DET,W 110-103,240,39,71,.549,34,57,.596,5,14,.357,27,34,.794,110
21934,2010-03-28,DET,,CHI,L 103-110,240,35,79,.443,26,52,.500,9,27,.333,24,26,.923,103
21935,2010-03-28,GSW,@,LAC,W 121-103,240,47,88,.534,39,70,.557,8,18,.444,19,23,.826,121
21936,2010-03-28,LAC,,GSW,L 103-121,240,34,90,.378,26,64,.406,8,26,.308,27,32,.844,103
21937,2010-03-28,MIA,,TOR,W 97-94,240,37,70,.529,33,53,.623,4,17,.235,19,21,.905,97
21938,2010-03-28,TOR,@,MIA,L 94-97,240,35,72,.486,28,57,.491,7,15,.467,17,20,.850,94
21939,2010-03-28,MEM,@,MIL,L 103-108 (OT),265,42,90,.467,39,79,.494,3,11,.273,16,22,.727,103
21940,2010-03-28,MIL,,MEM,W 108-103 (OT),265,38,88,.432,28,59,.475,10,29,.345,22,27,.815,108
21941,2010-03-28,MIN,,PHO,L 105-111,240,37,94,.394,33,78,.423,4,16,.250,27,37,.730,105
21942,2010-03-28,PHO,@,MIN,W 111-105,240,42,86,.488,32,59,.542,10,27,.370,17,22,.773,111
21943,2010-03-28,OKC,,POR,L 87-92,240,32,70,.457,29,55,.527,3,15,.200,20,25,.800,87
21944,2010-03-28,POR,@,OKC,W 92-87,240,37,81,.457,35,73,.479,2,8,.250,16,17,.941,92
21945,2010-03-28,DEN,@,ORL,L 97-103,240,42,80,.525,37,64,.578,5,16,.313,8,11,.727,97
21946,2010-03-28,ORL,,DEN,W 103-97,240,39,79,.494,28,50,.560,11,29,.379,14,22,.636,103
21947,2010-03-27,CHI,,NJN,W 106-83,240,37,84,.440,30,71,.423,7,13,.538,25,29,.862,106
21948,2010-03-27,BRK,@,CHI,L 83-106,240,29,81,.358,19,59,.322,10,22,.455,15,21,.714,83
21949,2010-03-27,DAL,@,GSW,W 111-90,240,44,91,.484,28,61,.459,16,30,.533,7,10,.700,111
21950,2010-03-27,GSW,,DAL,L 90-111,240,34,102,.333,26,73,.356,8,29,.276,14,15,.933,90
21951,2010-03-27,HOU,,LAL,L 101-109,240,38,88,.432,30,62,.484,8,26,.308,17,21,.810,101
21952,2010-03-27,LAL,@,HOU,W 109-101,240,42,73,.575,34,59,.576,8,14,.571,17,24,.708,109
21953,2010-03-27,NOP,,POR,L 101-112,240,41,70,.586,34,58,.586,7,12,.583,12,17,.706,101
21954,2010-03-27,POR,@,NOH,W 112-101,240,43,75,.573,37,57,.649,6,18,.333,20,23,.870,112
21955,2010-03-27,UTA,@,WAS,W 103-87,240,39,66,.591,34,54,.630,5,12,.417,20,26,.769,103
21956,2010-03-27,WAS,,UTA,L 87-103,240,33,86,.384,27,68,.397,6,18,.333,15,22,.682,87
21957,2010-03-26,BOS,,SAC,W 94-86,240,36,90,.400,33,73,.452,3,17,.176,19,28,.679,94
21958,2010-03-26,SAC,@,BOS,L 86-94,240,31,73,.425,30,61,.492,1,12,.083,23,31,.742,86
21959,2010-03-26,CHA,,WAS,W 107-96,240,41,74,.554,35,59,.593,6,15,.400,19,27,.704,107
21960,2010-03-26,WAS,@,CHA,L 96-107,240,34,71,.479,22,51,.431,12,20,.600,16,19,.842,96
21961,2010-03-26,IND,,UTA,W 122-106,240,43,85,.506,26,49,.531,17,36,.472,19,29,.655,122
21962,2010-03-26,UTA,@,IND,L 106-122,240,37,86,.430,27,68,.397,10,18,.556,22,26,.846,106
21963,2010-03-26,MIA,@,MIL,W 87-74,240,30,61,.492,28,47,.596,2,14,.143,25,28,.893,87
21964,2010-03-26,MIL,,MIA,L 74-87,240,28,89,.315,25,69,.362,3,20,.150,15,21,.714,74
21965,2010-03-26,DET,@,NJN,L 110-118,240,43,88,.489,36,72,.500,7,16,.438,17,19,.895,110
21966,2010-03-26,BRK,,DET,W 118-110,240,40,70,.571,32,50,.640,8,20,.400,30,36,.833,118
21967,2010-03-26,LAL,@,OKC,L 75-91,240,29,74,.392,27,59,.458,2,15,.133,15,24,.625,75
21968,2010-03-26,OKC,,LAL,W 91-75,240,37,77,.481,35,59,.593,2,18,.111,15,18,.833,91
21969,2010-03-26,MIN,@,ORL,L 97-106,240,39,88,.443,34,72,.472,5,16,.313,14,19,.737,97
21970,2010-03-26,ORL,,MIN,W 106-97,240,36,79,.456,23,43,.535,13,36,.361,21,26,.808,106
21971,2010-03-26,ATL,@,PHI,L 98-105,240,37,78,.474,30,60,.500,7,18,.389,17,21,.810,98
21972,2010-03-26,PHI,,ATL,W 105-98,240,41,83,.494,35,67,.522,6,16,.375,17,25,.680,105
21973,2010-03-26,NYK,@,PHO,L 96-132,240,36,94,.383,24,64,.375,12,30,.400,12,16,.750,96
21974,2010-03-26,PHO,,NYK,W 132-96,240,50,90,.556,42,69,.609,8,21,.381,24,32,.750,132
21975,2010-03-26,CLE,@,SAS,L 97-102,240,38,80,.475,32,60,.533,6,20,.300,15,23,.652,97
21976,2010-03-26,SAS,,CLE,W 102-97,240,37,78,.474,31,61,.508,6,17,.353,22,27,.815,102
21977,2010-03-26,DEN,@,TOR,W 97-96,240,35,85,.412,29,62,.468,6,23,.261,21,31,.677,97
21978,2010-03-26,TOR,,DEN,L 96-97,240,40,85,.471,36,70,.514,4,15,.267,12,16,.750,96
21979,2010-03-25,CHI,,MIA,L 74-103,240,27,82,.329,23,67,.343,4,15,.267,16,23,.696,74
21980,2010-03-25,MIA,@,CHI,W 103-74,240,41,79,.519,38,68,.559,3,11,.273,18,26,.692,103
21981,2010-03-25,HOU,,LAC,L 93-99,240,35,88,.398,29,65,.446,6,23,.261,17,27,.630,93
21982,2010-03-25,LAC,@,HOU,W 99-93,240,36,85,.424,27,57,.474,9,28,.321,18,26,.692,99
21983,2010-03-25,DAL,@,POR,L 89-101,240,36,81,.444,27,59,.458,9,22,.409,8,9,.889,89
21984,2010-03-25,POR,,DAL,W 101-89,240,40,80,.500,37,69,.536,3,11,.273,18,26,.692,101
21985,2010-03-24,ATL,,ORL,W 86-84,240,31,76,.408,24,63,.381,7,13,.538,17,20,.850,86
21986,2010-03-24,ORL,@,ATL,L 84-86,240,27,72,.375,21,51,.412,6,21,.286,24,31,.774,84
21987,2010-03-24,BOS,,DEN,W 113-99,240,44,90,.489,40,72,.556,4,18,.222,21,26,.808,113
21988,2010-03-24,DEN,@,BOS,L 99-113,240,34,70,.486,28,57,.491,6,13,.462,25,37,.676,99
21989,2010-03-24,CHA,,MIN,W 108-95,240,45,84,.536,38,69,.551,7,15,.467,11,16,.688,108
21990,2010-03-24,MIN,@,CHA,L 95-108,240,37,82,.451,33,69,.478,4,13,.308,17,23,.739,95
21991,2010-03-24,GSW,,MEM,W 128-110,240,48,88,.545,38,64,.594,10,24,.417,22,27,.815,128
21992,2010-03-24,MEM,@,GSW,L 110-128,240,41,90,.456,38,77,.494,3,13,.231,25,33,.758,110
21993,2010-03-24,IND,,WAS,W 99-82,240,37,83,.446,31,55,.564,6,28,.214,19,29,.655,99
21994,2010-03-24,WAS,@,IND,L 82-99,240,35,96,.365,31,84,.369,4,12,.333,8,13,.615,82
21995,2010-03-24,MIL,,PHI,L 86-101,240,32,80,.400,27,52,.519,5,28,.179,17,23,.739,86
21996,2010-03-24,PHI,@,MIL,W 101-86,240,41,78,.526,35,59,.593,6,19,.316,13,17,.765,101
21997,2010-03-24,BRK,,SAC,W 93-79,240,32,82,.390,26,68,.382,6,14,.429,23,28,.821,93
21998,2010-03-24,SAC,@,NJN,L 79-93,240,29,81,.358,24,66,.364,5,15,.333,16,22,.727,79
21999,2010-03-24,CLE,@,NOH,W 105-92,240,44,77,.571,38,57,.667,6,20,.300,11,16,.688,105
22000,2010-03-24,NOP,,CLE,L 92-105,240,37,84,.440,31,63,.492,6,21,.286,12,15,.800,92
22001,2010-03-24,HOU,@,OKC,L 104-122,240,38,93,.409,29,74,.392,9,19,.474,19,26,.731,104
22002,2010-03-24,OKC,,HOU,W 122-104,240,47,80,.588,39,64,.609,8,16,.500,20,22,.909,122
22003,2010-03-24,LAL,@,SAS,W 92-83,240,36,79,.456,26,59,.441,10,20,.500,10,17,.588,92
22004,2010-03-24,SAS,,LAL,L 83-92,240,30,80,.375,22,53,.415,8,27,.296,15,19,.789,83
22005,2010-03-24,TOR,,UTA,L 87-113,240,33,82,.402,28,61,.459,5,21,.238,16,25,.640,87
22006,2010-03-24,UTA,@,TOR,W 113-87,240,43,87,.494,35,67,.522,8,20,.400,19,27,.704,113
22007,2010-03-23,DAL,,LAC,W 106-96,240,42,91,.462,34,71,.479,8,20,.400,14,19,.737,106
22008,2010-03-23,LAC,@,DAL,L 96-106,240,33,87,.379,26,62,.419,7,25,.280,23,30,.767,96
22009,2010-03-23,DET,,IND,L 83-98,240,31,84,.369,24,61,.393,7,23,.304,14,17,.824,83
22010,2010-03-23,IND,@,DET,W 98-83,240,33,76,.434,21,45,.467,12,31,.387,20,33,.606,98
22011,2010-03-23,DEN,@,NYK,L 104-109,240,35,77,.455,29,56,.518,6,21,.286,28,31,.903,104
22012,2010-03-23,NYK,,DEN,W 109-104,240,36,78,.462,26,49,.531,10,29,.345,27,35,.771,109
22013,2010-03-23,CHA,@,WAS,W 95-86 (OT),265,36,91,.396,35,82,.427,1,9,.111,22,34,.647,95
22014,2010-03-23,WAS,,CHA,L 86-95 (OT),265,33,83,.398,27,66,.409,6,17,.353,14,17,.824,86
22015,2010-03-22,CHI,,HOU,W 98-88,240,37,78,.474,30,64,.469,7,14,.500,17,26,.654,98
22016,2010-03-22,HOU,@,CHI,L 88-98,240,30,89,.337,23,64,.359,7,25,.280,21,24,.875,88
22017,2010-03-22,GSW,,PHO,L 131-133,240,46,92,.500,37,65,.569,9,27,.333,30,37,.811,131
22018,2010-03-22,PHO,@,GSW,W 133-131,240,45,84,.536,32,61,.525,13,23,.565,30,39,.769,133
22019,2010-03-22,ATL,@,MIL,L 95-98,240,41,78,.526,34,61,.557,7,17,.412,6,13,.462,95
22020,2010-03-22,MIL,,ATL,W 98-95,240,37,83,.446,27,56,.482,10,27,.370,14,17,.824,98
22021,2010-03-22,MIN,,TOR,L 100-106,240,37,80,.463,31,64,.484,6,16,.375,20,22,.909,100
22022,2010-03-22,TOR,@,MIN,W 106-100,240,41,83,.494,35,63,.556,6,20,.300,18,24,.750,106
22023,2010-03-22,MIA,@,NJN,W 99-89,240,41,74,.554,38,62,.613,3,12,.250,14,22,.636,99
22024,2010-03-22,BRK,,MIA,L 89-99,240,27,72,.375,22,63,.349,5,9,.556,30,38,.789,89
22025,2010-03-22,DAL,@,NOH,L 99-115,240,42,81,.519,34,65,.523,8,16,.500,7,13,.538,99
22026,2010-03-22,NOP,,DAL,W 115-99,240,45,83,.542,33,59,.559,12,24,.500,13,17,.765,115
22027,2010-03-22,OKC,,SAS,L 96-99,240,33,73,.452,31,60,.517,2,13,.154,28,32,.875,96
22028,2010-03-22,SAS,@,OKC,W 99-96,240,37,85,.435,29,60,.483,8,25,.320,17,24,.708,99
22029,2010-03-22,ORL,@,PHI,W 109-93,240,36,69,.522,20,38,.526,16,31,.516,21,30,.700,109
22030,2010-03-22,PHI,,ORL,L 93-109,240,36,84,.429,30,70,.429,6,14,.429,15,22,.682,93
22031,2010-03-22,MEM,@,SAC,W 102-85,240,38,84,.452,32,72,.444,6,12,.500,20,32,.625,102
22032,2010-03-22,SAC,,MEM,L 85-102,240,36,88,.409,33,72,.458,3,16,.188,10,14,.714,85
22033,2010-03-22,BOS,@,UTA,L 97-110,240,33,74,.446,27,55,.491,6,19,.316,25,33,.758,97
22034,2010-03-22,UTA,,BOS,W 110-97,240,38,74,.514,31,53,.585,7,21,.333,27,31,.871,110
22035,2010-03-21,ATL,,SAS,W 119-114 (OT),265,46,98,.469,42,81,.519,4,17,.235,23,28,.821,119
22036,2010-03-21,SAS,@,ATL,L 114-119 (OT),265,41,81,.506,33,57,.579,8,24,.333,24,29,.828,114
22037,2010-03-21,CLE,,DET,W 104-79,240,37,76,.487,30,57,.526,7,19,.368,23,29,.793,104
22038,2010-03-21,DET,@,CLE,L 79-104,240,32,78,.410,28,67,.418,4,11,.364,11,17,.647,79
22039,2010-03-21,IND,,OKC,W 121-101,240,45,87,.517,35,58,.603,10,29,.345,21,25,.840,121
22040,2010-03-21,OKC,@,IND,L 101-121,240,38,88,.432,34,72,.472,4,16,.250,21,23,.913,101
22041,2010-03-21,LAC,,SAC,L 89-102,240,34,74,.459,32,62,.516,2,12,.167,19,27,.704,89
22042,2010-03-21,SAC,@,LAC,W 102-89,240,42,84,.500,36,68,.529,6,16,.375,12,19,.632,102
22043,2010-03-21,LAL,,WAS,W 99-92,240,36,68,.529,27,51,.529,9,17,.529,18,22,.818,99
22044,2010-03-21,WAS,@,LAL,L 92-99,240,37,76,.487,31,62,.500,6,14,.429,12,17,.706,92
22045,2010-03-21,HOU,@,NYK,W 116-112,240,41,81,.506,33,61,.541,8,20,.400,26,30,.867,116
22046,2010-03-21,NYK,,HOU,L 112-116,240,42,82,.512,32,53,.604,10,29,.345,18,23,.783,112
22047,2010-03-21,PHO,,POR,W 93-87,240,31,80,.388,24,57,.421,7,23,.304,24,26,.923,93
22048,2010-03-21,POR,@,PHO,L 87-93,240,32,88,.364,30,71,.423,2,17,.118,21,29,.724,87
22049,2010-03-20,BOS,@,DAL,W 102-93,240,39,75,.520,34,58,.586,5,17,.294,19,22,.864,102
22050,2010-03-20,DAL,,BOS,L 93-102,240,37,80,.463,32,65,.492,5,15,.333,14,17,.824,93
22051,2010-03-20,DEN,,MIL,L 97-102,240,32,87,.368,29,73,.397,3,14,.214,30,38,.789,97
22052,2010-03-20,MIL,@,DEN,W 102-97,240,35,76,.461,26,55,.473,9,21,.429,23,28,.821,102
22053,2010-03-20,GSW,@,MEM,L 107-123,240,45,93,.484,39,72,.542,6,21,.286,11,13,.846,107
22054,2010-03-20,MEM,,GSW,W 123-107,240,49,98,.500,39,80,.488,10,18,.556,15,18,.833,123
22055,2010-03-20,CHA,@,MIA,L 71-77,240,21,72,.292,19,59,.322,2,13,.154,27,34,.794,71
22056,2010-03-20,MIA,,CHA,W 77-71,240,28,78,.359,21,50,.420,7,28,.250,14,20,.700,77
22057,2010-03-20,BRK,,TOR,L 90-100,240,33,83,.398,29,66,.439,4,17,.235,20,28,.714,90
22058,2010-03-20,TOR,@,NJN,W 100-90,240,42,83,.506,38,71,.535,4,12,.333,12,14,.857,100
22059,2010-03-20,CHI,@,PHI,W 98-84,240,36,80,.450,29,62,.468,7,18,.389,19,27,.704,98
22060,2010-03-20,PHI,,CHI,L 84-98,240,33,82,.402,32,65,.492,1,17,.059,17,26,.654,84
22061,2010-03-20,NOP,@,UTA,L 86-106,240,34,79,.430,31,66,.470,3,13,.231,15,24,.625,86
22062,2010-03-20,UTA,,NOH,W 106-86,240,43,77,.558,40,64,.625,3,13,.231,17,26,.654,106
22063,2010-03-19,ATL,,CHA,W 93-92 (OT),265,36,86,.419,32,73,.438,4,13,.308,17,22,.773,93
22064,2010-03-19,CHA,@,ATL,L 92-93 (OT),265,39,86,.453,34,71,.479,5,15,.333,9,15,.600,92
22065,2010-03-19,CHI,,CLE,L 85-92,240,33,84,.393,29,62,.468,4,22,.182,15,22,.682,85
22066,2010-03-19,CLE,@,CHI,W 92-85,240,31,75,.413,25,56,.446,6,19,.316,24,28,.857,92
22067,2010-03-19,BOS,@,HOU,W 94-87,240,37,81,.457,27,58,.466,10,23,.435,10,16,.625,94
22068,2010-03-19,HOU,,BOS,L 87-94,240,30,76,.395,25,59,.424,5,17,.294,22,29,.759,87
22069,2010-03-19,DET,@,IND,L 102-106,240,33,76,.434,25,60,.417,8,16,.500,28,34,.824,102
22070,2010-03-19,IND,,DET,W 106-102,240,36,67,.537,24,45,.533,12,22,.545,22,28,.786,106
22071,2010-03-19,LAL,,MIN,W 104-96,240,34,82,.415,27,57,.474,7,25,.280,29,35,.829,104
22072,2010-03-19,MIN,@,LAL,L 96-104,240,42,91,.462,38,73,.521,4,18,.222,8,11,.727,96
22073,2010-03-19,NYK,,PHI,W 92-88,240,28,76,.368,18,44,.409,10,32,.313,26,30,.867,92
22074,2010-03-19,PHI,@,NYK,L 88-92,240,33,78,.423,27,60,.450,6,18,.333,16,22,.727,88
22075,2010-03-19,PHO,,UTA,W 110-100,240,39,74,.527,33,57,.579,6,17,.353,26,33,.788,110
22076,2010-03-19,UTA,@,PHO,L 100-110,240,34,88,.386,34,79,.430,0,9,.000,32,39,.821,100
22077,2010-03-19,POR,,WAS,W 76-74,240,25,78,.321,23,66,.348,2,12,.167,24,31,.774,76
22078,2010-03-19,WAS,@,POR,L 74-76,240,30,77,.390,27,69,.391,3,8,.375,11,18,.611,74
22079,2010-03-19,MIL,@,SAC,W 114-108 (2OT),290,43,98,.439,29,68,.426,14,30,.467,14,23,.609,114
22080,2010-03-19,SAC,,MIL,L 108-114 (2OT),290,40,90,.444,35,73,.479,5,17,.294,23,30,.767,108
22081,2010-03-19,GSW,@,SAS,L 116-147,240,44,91,.484,32,59,.542,12,32,.375,16,21,.762,116
22082,2010-03-19,SAS,,GSW,W 147-116,240,62,96,.646,56,78,.718,6,18,.333,17,32,.531,147
22083,2010-03-19,OKC,@,TOR,W 115-89,240,39,94,.415,31,72,.431,8,22,.364,29,33,.879,115
22084,2010-03-19,TOR,,OKC,L 89-115,240,32,73,.438,29,64,.453,3,9,.333,22,26,.846,89
22085,2010-03-18,DEN,,NOH,W 93-80,240,38,95,.400,36,81,.444,2,14,.143,15,21,.714,93
22086,2010-03-18,NOP,@,DEN,L 80-93,240,33,77,.429,31,69,.449,2,8,.250,12,15,.800,80
22087,2010-03-18,MIA,,ORL,L 102-108 (OT),265,37,90,.411,29,65,.446,8,25,.320,20,24,.833,102
22088,2010-03-18,ORL,@,MIA,W 108-102 (OT),265,40,88,.455,29,57,.509,11,31,.355,17,25,.680,108
22089,2010-03-17,BOS,,NYK,W 109-97,240,42,83,.506,35,63,.556,7,20,.350,18,20,.900,109
22090,2010-03-17,NYK,@,BOS,L 97-109,240,36,87,.414,28,61,.459,8,26,.308,17,21,.810,97
22091,2010-03-17,CHA,,OKC,W 100-92,240,37,77,.481,32,70,.457,5,7,.714,21,32,.656,100
22092,2010-03-17,OKC,@,CHA,L 92-100,240,37,82,.451,35,69,.507,2,13,.154,16,18,.889,92
22093,2010-03-17,CLE,,IND,W 99-94,240,40,83,.482,35,67,.522,5,16,.313,14,20,.700,99
22094,2010-03-17,IND,@,CLE,L 94-99,240,37,78,.474,27,54,.500,10,24,.417,10,13,.769,94
22095,2010-03-17,CHI,@,DAL,L 106-113,240,43,82,.524,40,67,.597,3,15,.200,17,23,.739,106
22096,2010-03-17,DAL,,CHI,W 113-106,240,41,78,.526,35,60,.583,6,18,.333,25,33,.758,113
22097,2010-03-17,GSW,,NOH,W 131-121,240,47,87,.540,34,60,.567,13,27,.481,24,26,.923,131
22098,2010-03-17,NOP,@,GSW,L 121-131,240,44,86,.512,37,65,.569,7,21,.333,26,34,.765,121
22099,2010-03-17,HOU,,MEM,W 107-94,240,39,73,.534,29,54,.537,10,19,.526,19,25,.760,107
22100,2010-03-17,MEM,@,HOU,L 94-107,240,39,91,.429,38,84,.452,1,7,.143,15,26,.577,94
22101,2010-03-17,LAC,,MIL,W 101-93,240,34,64,.531,28,52,.538,6,12,.500,27,34,.794,101
22102,2010-03-17,MIL,@,LAC,L 93-101,240,37,83,.446,29,60,.483,8,23,.348,11,14,.786,93
22103,2010-03-17,ORL,,SAS,W 110-84,240,37,71,.521,27,48,.563,10,23,.435,26,33,.788,110
22104,2010-03-17,SAS,@,ORL,L 84-110,240,34,80,.425,29,66,.439,5,14,.357,11,14,.786,84
22105,2010-03-17,BRK,@,PHI,L 97-108,240,34,83,.410,28,67,.418,6,16,.375,23,24,.958,97
22106,2010-03-17,PHI,,NJN,W 108-97,240,42,75,.560,38,65,.585,4,10,.400,20,30,.667,108
22107,2010-03-17,ATL,@,TOR,L 105-106,240,41,85,.482,30,67,.448,11,18,.611,12,18,.667,105
22108,2010-03-17,TOR,,ATL,W 106-105,240,41,90,.456,37,78,.474,4,12,.333,20,30,.667,106
22109,2010-03-17,MIN,@,UTA,L 100-122,240,34,78,.436,27,63,.429,7,15,.467,25,30,.833,100
22110,2010-03-17,UTA,,MIN,W 122-100,240,49,91,.538,44,71,.620,5,20,.250,19,20,.950,122
22111,2010-03-16,DEN,,WAS,W 97-87,240,37,73,.507,34,55,.618,3,18,.167,20,26,.769,97
22112,2010-03-16,WAS,@,DEN,L 87-97,240,34,78,.436,30,67,.448,4,11,.364,15,26,.577,87
22113,2010-03-16,CLE,@,DET,W 113-101,240,41,83,.494,32,61,.525,9,22,.409,22,33,.667,113
22114,2010-03-16,DET,,CLE,L 101-113,240,36,78,.462,27,64,.422,9,14,.643,20,25,.800,101
22115,2010-03-16,CHA,@,IND,L 94-99,240,33,71,.465,30,58,.517,3,13,.231,25,36,.694,94
22116,2010-03-16,IND,,CHA,W 99-94,240,34,83,.410,26,60,.433,8,23,.348,23,28,.821,99
22117,2010-03-16,CHI,@,MEM,L 97-104,240,34,78,.436,27,51,.529,7,27,.259,22,27,.815,97
22118,2010-03-16,MEM,,CHI,W 104-97,240,36,76,.474,28,61,.459,8,15,.533,24,34,.706,104
22119,2010-03-16,MIA,,SAS,L 76-88,240,30,78,.385,27,62,.435,3,16,.188,13,19,.684,76
22120,2010-03-16,SAS,@,MIA,W 88-76,240,34,76,.447,26,59,.441,8,17,.471,12,13,.923,88
22121,2010-03-16,ATL,@,NJN,W 108-84,240,42,85,.494,34,70,.486,8,15,.533,16,24,.667,108
22122,2010-03-16,BRK,,ATL,L 84-108,240,30,78,.385,26,64,.406,4,14,.286,20,28,.714,84
22123,2010-03-16,MIN,@,PHO,L 114-152,240,42,91,.462,35,77,.455,7,14,.500,23,31,.742,114
22124,2010-03-16,PHO,,MIN,W 152-114,240,55,98,.561,40,67,.597,15,31,.484,27,29,.931,152
22125,2010-03-16,LAL,@,SAC,W 106-99,240,42,87,.483,38,73,.521,4,14,.286,18,28,.643,106
22126,2010-03-16,SAC,,LAL,L 99-106,240,36,84,.429,29,62,.468,7,22,.318,20,28,.714,99
22127,2010-03-15,BOS,,DET,W 119-93,240,46,74,.622,39,58,.672,7,16,.438,20,28,.714,119
22128,2010-03-15,DET,@,BOS,L 93-119,240,33,68,.485,28,52,.538,5,16,.313,22,31,.710,93
22129,2010-03-15,GSW,,LAL,L 121-124,240,48,100,.480,35,70,.500,13,30,.433,12,13,.923,121
22130,2010-03-15,LAL,@,GSW,W 124-121,240,42,75,.560,36,55,.655,6,20,.300,34,42,.810,124
22131,2010-03-15,DEN,@,HOU,L 123-125,240,49,99,.495,40,77,.519,9,22,.409,16,20,.800,123
22132,2010-03-15,HOU,,DEN,W 125-123,240,45,79,.570,38,63,.603,7,16,.438,28,35,.800,125
22133,2010-03-15,LAC,,NOH,L 100-108,240,40,93,.430,35,68,.515,5,25,.200,15,19,.789,100
22134,2010-03-15,NOP,@,LAC,W 108-100,240,48,85,.565,39,67,.582,9,18,.500,3,5,.600,108
22135,2010-03-15,NYK,@,PHI,W 94-84,240,36,77,.468,25,52,.481,11,25,.440,11,15,.733,94
22136,2010-03-15,PHI,,NYK,L 84-94,240,33,86,.384,27,61,.443,6,25,.240,12,21,.571,84
22137,2010-03-15,UTA,,WAS,W 112-89,240,43,82,.524,38,69,.551,5,13,.385,21,35,.600,112
22138,2010-03-15,WAS,@,UTA,L 89-112,240,31,84,.369,28,75,.373,3,9,.333,24,30,.800,89
22139,2010-03-14,BOS,@,CLE,L 93-104,240,32,80,.400,26,63,.413,6,17,.353,23,30,.767,93
22140,2010-03-14,CLE,,BOS,W 104-93,240,33,80,.413,26,58,.448,7,22,.318,31,48,.646,104
22141,2010-03-14,MIA,,PHI,W 104-91,240,39,79,.494,32,57,.561,7,22,.318,19,26,.731,104
22142,2010-03-14,PHI,@,MIA,L 91-104,240,32,86,.372,21,62,.339,11,24,.458,16,19,.842,91
22143,2010-03-14,IND,@,MIL,L 94-98,240,27,72,.375,20,51,.392,7,21,.333,33,36,.917,94
22144,2010-03-14,MIL,,IND,W 98-94,240,36,84,.429,28,68,.412,8,16,.500,18,24,.750,98
22145,2010-03-14,OKC,,UTA,W 119-111,240,44,73,.603,41,61,.672,3,12,.250,28,35,.800,119
22146,2010-03-14,UTA,@,OKC,L 111-119,240,39,77,.506,28,58,.483,11,19,.579,22,34,.647,111
22147,2010-03-14,CHA,@,ORL,W 96-89,240,35,75,.467,30,65,.462,5,10,.500,21,26,.808,96
22148,2010-03-14,ORL,,CHA,L 89-96,240,33,72,.458,22,40,.550,11,32,.344,12,21,.571,89
22149,2010-03-14,NOP,@,PHO,L 106-120,240,42,90,.467,35,75,.467,7,15,.467,15,20,.750,106
22150,2010-03-14,PHO,,NOH,W 120-106,240,42,73,.575,34,57,.596,8,16,.500,28,35,.800,120
22151,2010-03-14,POR,,TOR,W 109-98,240,38,83,.458,26,63,.413,12,20,.600,21,23,.913,109
22152,2010-03-14,TOR,@,POR,L 98-109,240,39,71,.549,34,56,.607,5,15,.333,15,19,.789,98
22153,2010-03-14,MIN,@,SAC,L 100-114,240,38,91,.418,29,76,.382,9,15,.600,15,24,.625,100
22154,2010-03-14,SAC,,MIN,W 114-100,240,46,99,.465,40,75,.533,6,24,.250,16,21,.762,114
22155,2010-03-13,ATL,,DET,W 112-99,240,46,73,.630,39,59,.661,7,14,.500,13,18,.722,112
22156,2010-03-13,DET,@,ATL,L 99-112,240,37,75,.493,32,61,.525,5,14,.357,20,29,.690,99
22157,2010-03-13,DAL,,NYK,L 94-128,240,34,80,.425,27,59,.458,7,21,.333,19,26,.731,94
22158,2010-03-13,NYK,@,DAL,W 128-94,240,50,89,.562,34,59,.576,16,30,.533,12,17,.706,128
22159,2010-03-13,GSW,,TOR,W 124-112,240,45,95,.474,29,68,.426,16,27,.593,18,22,.818,124
22160,2010-03-13,TOR,@,GSW,L 112-124,240,43,76,.566,35,60,.583,8,16,.500,18,23,.783,112
22161,2010-03-13,HOU,,NJN,W 116-108,240,46,88,.523,41,71,.577,5,17,.294,19,23,.826,116
22162,2010-03-13,BRK,@,HOU,L 108-116,240,41,76,.539,32,61,.525,9,15,.600,17,26,.654,108
22163,2010-03-13,DEN,@,MEM,W 125-108,240,50,85,.588,41,63,.651,9,22,.409,16,20,.800,125
22164,2010-03-13,MEM,,DEN,L 108-125,240,39,78,.500,34,61,.557,5,17,.294,25,32,.781,108
22165,2010-03-13,LAC,@,SAS,L 88-118,240,37,82,.451,31,68,.456,6,14,.429,8,12,.667,88
22166,2010-03-13,SAS,,LAC,W 118-88,240,51,87,.586,42,73,.575,9,14,.643,7,9,.778,118
22167,2010-03-13,ORL,@,WAS,W 109-95,240,41,79,.519,33,65,.508,8,14,.571,19,23,.826,109
22168,2010-03-13,WAS,,ORL,L 95-109,240,40,82,.488,38,73,.521,2,9,.222,13,17,.765,95
22169,2010-03-12,BOS,,IND,W 122-103,240,45,77,.584,37,61,.607,8,16,.500,24,29,.828,122
22170,2010-03-12,IND,@,BOS,L 103-122,240,36,74,.486,28,56,.500,8,18,.444,23,33,.697,103
22171,2010-03-12,CHA,,LAC,W 106-98,240,45,83,.542,42,72,.583,3,11,.273,13,17,.765,106
22172,2010-03-12,LAC,@,CHA,L 98-106,240,42,73,.575,33,54,.611,9,19,.474,5,9,.556,98
22173,2010-03-12,DET,,WAS,W 101-87,240,42,82,.512,36,62,.581,6,20,.300,11,20,.550,101
22174,2010-03-12,WAS,@,DET,L 87-101,240,33,74,.446,29,63,.460,4,11,.364,17,22,.773,87
22175,2010-03-12,MEM,,NYK,W 119-112,240,42,87,.483,37,69,.536,5,18,.278,30,33,.909,119
22176,2010-03-12,NYK,@,MEM,L 112-119,240,40,88,.455,33,64,.516,7,24,.292,25,29,.862,112
22177,2010-03-12,CHI,@,MIA,L 95-108,240,38,78,.487,31,55,.564,7,23,.304,12,17,.706,95
22178,2010-03-12,MIA,,CHI,W 108-95,240,36,73,.493,24,52,.462,12,21,.571,24,32,.750,108
22179,2010-03-12,MIL,,UTA,W 95-87,240,32,79,.405,25,57,.439,7,22,.318,24,28,.857,95
22180,2010-03-12,UTA,@,MIL,L 87-95,240,35,84,.417,35,74,.473,0,10,.000,17,23,.739,87
22181,2010-03-12,MIN,,SAS,L 85-103,240,30,77,.390,26,66,.394,4,11,.364,21,25,.840,85
22182,2010-03-12,SAS,@,MIN,W 103-85,240,42,85,.494,37,63,.587,5,22,.227,14,18,.778,103
22183,2010-03-12,DEN,@,NOH,W 102-95,240,37,79,.468,34,57,.596,3,22,.136,25,28,.893,102
22184,2010-03-12,NOP,,DEN,L 95-102,240,37,89,.416,33,72,.458,4,17,.235,17,21,.810,95
22185,2010-03-12,BRK,@,OKC,L 102-104,240,40,87,.460,34,68,.500,6,19,.316,16,19,.842,102
22186,2010-03-12,OKC,,NJN,W 104-102,240,40,77,.519,35,66,.530,5,11,.455,19,23,.826,104
22187,2010-03-12,CLE,@,PHI,W 100-95,240,38,75,.507,28,44,.636,10,31,.323,14,23,.609,100
22188,2010-03-12,PHI,,CLE,L 95-100,240,42,88,.477,40,73,.548,2,15,.133,9,16,.563,95
22189,2010-03-12,LAL,@,PHO,W 102-96,240,40,81,.494,31,56,.554,9,25,.360,13,22,.591,102
22190,2010-03-12,PHO,,LAL,L 96-102,240,34,80,.425,28,59,.475,6,21,.286,22,27,.815,96
22191,2010-03-12,POR,@,SAC,W 110-94,240,38,74,.514,33,65,.508,5,9,.556,29,32,.906,110
22192,2010-03-12,SAC,,POR,L 94-110,240,39,77,.506,35,67,.522,4,10,.400,12,19,.632,94
22193,2010-03-11,GSW,,POR,L 105-110,240,38,80,.475,28,54,.519,10,26,.385,19,21,.905,105
22194,2010-03-11,POR,@,GSW,W 110-105,240,36,86,.419,29,71,.408,7,15,.467,31,37,.838,110
22195,2010-03-11,CHI,@,ORL,L 82-111,240,33,83,.398,29,67,.433,4,16,.250,12,19,.632,82
22196,2010-03-11,ORL,,CHI,W 111-82,240,38,69,.551,29,45,.644,9,24,.375,26,33,.788,111
22197,2010-03-11,ATL,@,WAS,W 105-99,240,41,79,.519,33,62,.532,8,17,.471,15,25,.600,105
22198,2010-03-11,WAS,,ATL,L 99-105,240,39,79,.494,38,66,.576,1,13,.077,20,22,.909,99
22199,2010-03-10,BOS,,MEM,L 91-111,240,35,80,.438,29,59,.492,6,21,.286,15,24,.625,91
22200,2010-03-10,MEM,@,BOS,W 111-91,240,44,80,.550,35,64,.547,9,16,.563,14,19,.737,111
22201,2010-03-10,DAL,,NJN,W 96-87,240,33,75,.440,27,62,.435,6,13,.462,24,29,.828,96
22202,2010-03-10,BRK,@,DAL,L 87-96,240,34,83,.410,28,63,.444,6,20,.300,13,18,.722,87
22203,2010-03-10,DET,,UTA,L 104-115,240,37,85,.435,32,66,.485,5,19,.263,25,27,.926,104
22204,2010-03-10,UTA,@,DET,W 115-104,240,45,80,.563,39,63,.619,6,17,.353,19,25,.760,115
22205,2010-03-10,LAC,@,MIA,L 97-108,240,38,89,.427,27,62,.435,11,27,.407,10,13,.769,97
22206,2010-03-10,MIA,,LAC,W 108-97,240,35,77,.455,26,60,.433,9,17,.529,29,35,.829,108
22207,2010-03-10,DEN,@,MIN,W 110-102,240,40,86,.465,34,61,.557,6,25,.240,24,28,.857,110
22208,2010-03-10,MIN,,DEN,L 102-110,240,35,90,.389,30,72,.417,5,18,.278,27,33,.818,102
22209,2010-03-10,NOP,@,OKC,L 83-98,240,34,79,.430,31,65,.477,3,14,.214,12,19,.632,83
22210,2010-03-10,OKC,,NOH,W 98-83,240,39,83,.470,37,74,.500,2,9,.222,18,23,.783,98
22211,2010-03-10,CHA,@,PHI,W 102-87,240,33,66,.500,28,53,.528,5,13,.385,31,41,.756,102
22212,2010-03-10,PHI,,CHA,L 87-102,240,34,82,.415,29,58,.500,5,24,.208,14,21,.667,87
22213,2010-03-10,SAC,,TOR,W 113-90,240,47,93,.505,43,82,.524,4,11,.364,15,20,.750,113
22214,2010-03-10,TOR,@,SAC,L 90-113,240,36,82,.439,32,69,.464,4,13,.308,14,17,.824,90
22215,2010-03-10,NYK,@,SAS,L 87-97,240,31,77,.403,29,60,.483,2,17,.118,23,27,.852,87
22216,2010-03-10,SAS,,NYK,W 97-87,240,36,80,.450,28,60,.467,8,20,.400,17,22,.773,97
22217,2010-03-09,CHA,,MIA,W 83-78,240,28,72,.389,23,57,.404,5,15,.333,22,30,.733,83
22218,2010-03-09,MIA,@,CHA,L 78-83,240,31,77,.403,28,59,.475,3,18,.167,13,16,.813,78
22219,2010-03-09,CHI,,UTA,L 108-132,240,41,76,.539,33,61,.541,8,15,.533,18,27,.667,108
22220,2010-03-09,UTA,@,CHI,W 132-108,240,45,83,.542,33,63,.524,12,20,.600,30,39,.769,132
22221,2010-03-09,IND,,PHI,W 107-96,240,42,94,.447,34,75,.453,8,19,.421,15,19,.789,107
22222,2010-03-09,PHI,@,IND,L 96-107,240,39,85,.459,34,69,.493,5,16,.313,13,15,.867,96
22223,2010-03-09,LAL,,TOR,W 109-107,240,35,78,.449,32,63,.508,3,15,.200,36,44,.818,109
22224,2010-03-09,TOR,@,LAL,L 107-109,240,36,81,.444,27,59,.458,9,22,.409,26,30,.867,107
22225,2010-03-09,BOS,@,MIL,L 84-86,240,30,68,.441,25,56,.446,5,12,.417,19,22,.864,84
22226,2010-03-09,MIL,,BOS,W 86-84,240,34,73,.466,26,56,.464,8,17,.471,10,11,.909,86
22227,2010-03-09,LAC,@,ORL,L 87-113,240,37,86,.430,29,65,.446,8,21,.381,5,6,.833,87
22228,2010-03-09,ORL,,LAC,W 113-87,240,45,92,.489,34,65,.523,11,27,.407,12,12,1.000,113
22229,2010-03-09,POR,,SAC,W 88-81,240,35,77,.455,32,69,.464,3,8,.375,15,22,.682,88
22230,2010-03-09,SAC,@,POR,L 81-88,240,34,79,.430,31,66,.470,3,13,.231,10,16,.625,81
22231,2010-03-09,HOU,@,WAS,W 96-88,240,33,86,.384,27,58,.466,6,28,.214,24,28,.857,96
22232,2010-03-09,WAS,,HOU,L 88-96,240,35,83,.422,32,71,.451,3,12,.250,15,16,.938,88
22233,2010-03-08,CLE,,SAS,W 97-95,240,36,76,.474,30,62,.484,6,14,.429,19,24,.792,97
22234,2010-03-08,SAS,@,CLE,L 95-97,240,35,84,.417,25,55,.455,10,29,.345,15,22,.682,95
22235,2010-03-08,MEM,,NJN,W 107-101,240,41,87,.471,37,75,.493,4,12,.333,21,28,.750,107
22236,2010-03-08,BRK,@,MEM,L 101-107,240,39,85,.459,32,62,.516,7,23,.304,16,24,.667,101
22237,2010-03-08,DAL,@,MIN,W 125-112,240,48,96,.500,41,75,.547,7,21,.333,22,26,.846,125
22238,2010-03-08,MIN,,DAL,L 112-125,240,42,89,.472,38,67,.567,4,22,.182,24,33,.727,112
22239,2010-03-08,GSW,@,NOH,L 131-135,240,50,85,.588,37,60,.617,13,25,.520,18,21,.857,131
22240,2010-03-08,NOP,,GSW,W 135-131,240,54,92,.587,44,70,.629,10,22,.455,17,24,.708,135
22241,2010-03-08,ATL,@,NYK,L 98-99,240,37,87,.425,34,70,.486,3,17,.176,21,27,.778,98
22242,2010-03-08,NYK,,ATL,W 99-98,240,39,77,.506,29,62,.468,10,15,.667,11,13,.846,99
22243,2010-03-07,BOS,,WAS,W 86-83,240,30,73,.411,25,61,.410,5,12,.417,21,26,.808,86
22244,2010-03-07,WAS,@,BOS,L 83-86,240,31,68,.456,30,57,.526,1,11,.091,20,24,.833,83
22245,2010-03-07,DEN,,POR,W 118-106,240,43,73,.589,34,51,.667,9,22,.409,23,34,.676,118
22246,2010-03-07,POR,@,DEN,L 106-118,240,35,82,.427,26,66,.394,9,16,.563,27,36,.750,106
22247,2010-03-07,DET,,HOU,W 110-107 (OT),265,43,91,.473,37,78,.474,6,13,.462,18,25,.720,110
22248,2010-03-07,HOU,@,DET,L 107-110 (OT),265,40,87,.460,33,59,.559,7,28,.250,20,23,.870,107
22249,2010-03-07,LAL,@,ORL,L 94-96,240,33,88,.375,28,71,.394,5,17,.294,23,26,.885,94
22250,2010-03-07,ORL,,LAL,W 96-94,240,30,73,.411,22,49,.449,8,24,.333,28,39,.718,96
22251,2010-03-07,OKC,@,SAC,W 108-102,240,41,86,.477,37,72,.514,4,14,.286,22,25,.880,108
22252,2010-03-07,SAC,,OKC,L 102-108,240,41,81,.506,36,72,.500,5,9,.556,15,24,.625,102
22253,2010-03-07,PHI,@,TOR,W 114-101,240,45,81,.556,36,69,.522,9,12,.750,15,19,.789,114
22254,2010-03-07,TOR,,PHI,L 101-114,240,43,84,.512,36,66,.545,7,18,.389,8,12,.667,101
22255,2010-03-06,CHA,,GSW,W 101-90,240,40,87,.460,35,67,.522,5,20,.250,16,22,.727,101
22256,2010-03-06,GSW,@,CHA,L 90-101,240,34,89,.382,24,66,.364,10,23,.435,12,19,.632,90
22257,2010-03-06,CHI,,DAL,L 116-122,240,47,90,.522,40,74,.541,7,16,.438,15,19,.789,116
22258,2010-03-06,DAL,@,CHI,W 122-116,240,49,87,.563,38,60,.633,11,27,.407,13,15,.867,122
22259,2010-03-06,MEM,,SAS,L 92-102,240,36,83,.434,33,73,.452,3,10,.300,17,25,.680,92
22260,2010-03-06,SAS,@,MEM,W 102-92,240,39,80,.488,30,59,.508,9,21,.429,15,21,.714,102
22261,2010-03-06,ATL,@,MIA,L 94-100,240,31,78,.397,22,54,.407,9,24,.375,23,25,.920,94
22262,2010-03-06,MIA,,ATL,W 100-94,240,34,80,.425,23,51,.451,11,29,.379,21,29,.724,100
22263,2010-03-06,CLE,@,MIL,L 85-92,240,34,77,.442,27,55,.491,7,22,.318,10,16,.625,85
22264,2010-03-06,MIL,,CLE,W 92-85,240,32,79,.405,21,50,.420,11,29,.379,17,21,.810,92
22265,2010-03-06,HOU,@,MIN,W 112-98,240,46,97,.474,35,71,.493,11,26,.423,9,9,1.000,112
22266,2010-03-06,MIN,,HOU,L 98-112,240,37,82,.451,34,69,.493,3,13,.231,21,27,.778,98
22267,2010-03-06,BRK,@,NYK,W 113-93,240,43,86,.500,29,62,.468,14,24,.583,13,18,.722,113
22268,2010-03-06,NYK,,NJN,L 93-113,240,40,85,.471,40,67,.597,0,18,.000,13,18,.722,93
22269,2010-03-06,IND,@,PHO,L 105-113,240,35,93,.376,26,67,.388,9,26,.346,26,32,.813,105
22270,2010-03-06,PHO,,IND,W 113-105,240,36,82,.439,29,67,.433,7,15,.467,34,40,.850,113
22271,2010-03-06,LAC,@,UTA,L 85-107,240,35,86,.407,27,65,.415,8,21,.381,7,11,.636,85
22272,2010-03-06,UTA,,LAC,W 107-85,240,42,93,.452,35,79,.443,7,14,.500,16,21,.762,107
22273,2010-03-05,ATL,,GSW,W 127-122,240,44,83,.530,35,65,.538,9,18,.500,30,40,.750,127
22274,2010-03-05,GSW,@,ATL,L 122-127,240,43,86,.500,32,60,.533,11,26,.423,25,31,.806,122
22275,2010-03-05,CHA,,LAL,W 98-83,240,36,70,.514,30,58,.517,6,12,.500,20,27,.741,98
22276,2010-03-05,LAL,@,CHA,L 83-98,240,29,80,.363,26,62,.419,3,18,.167,22,30,.733,83
22277,2010-03-05,CLE,,DET,W 99-92,240,40,79,.506,34,59,.576,6,20,.300,13,23,.565,99
22278,2010-03-05,DET,@,CLE,L 92-99,240,37,75,.493,33,63,.524,4,12,.333,14,20,.700,92
22279,2010-03-05,DAL,,SAC,W 108-100,240,42,86,.488,35,69,.507,7,17,.412,17,18,.944,108
22280,2010-03-05,SAC,@,DAL,L 100-108,240,38,81,.469,29,62,.468,9,19,.474,15,21,.714,100
22281,2010-03-05,DEN,,IND,W 122-114,240,42,88,.477,36,63,.571,6,25,.240,32,38,.842,122
22282,2010-03-05,IND,@,DEN,L 114-122,240,36,82,.439,27,60,.450,9,22,.409,33,40,.825,114
22283,2010-03-05,LAC,,OKC,L 87-104,240,32,86,.372,26,65,.400,6,21,.286,17,26,.654,87
22284,2010-03-05,OKC,@,LAC,W 104-87,240,36,79,.456,31,65,.477,5,14,.357,27,36,.750,104
22285,2010-03-05,BRK,,ORL,L 87-97,240,32,80,.400,28,69,.406,4,11,.364,19,20,.950,87
22286,2010-03-05,ORL,@,NJN,W 97-87,240,34,77,.442,21,46,.457,13,31,.419,16,24,.667,97
22287,2010-03-05,BOS,@,PHI,W 96-86,240,35,69,.507,31,57,.544,4,12,.333,22,27,.815,96
22288,2010-03-05,PHI,,BOS,L 86-96,240,37,77,.481,33,61,.541,4,16,.250,8,12,.667,86
22289,2010-03-05,NOP,@,SAS,L 91-102,240,41,83,.494,37,73,.507,4,10,.400,5,9,.556,91
22290,2010-03-05,SAS,,NOH,W 102-91,240,38,71,.535,26,51,.510,12,20,.600,14,21,.667,102
22291,2010-03-05,NYK,@,TOR,L 96-102,240,39,80,.488,36,64,.563,3,16,.188,15,19,.789,96
22292,2010-03-05,TOR,,NYK,W 102-96,240,46,91,.505,42,79,.532,4,12,.333,6,11,.545,102
22293,2010-03-05,MIL,@,WAS,W 102-74,240,38,83,.458,32,64,.500,6,19,.316,20,25,.800,102
22294,2010-03-05,WAS,,MIL,L 74-102,240,31,82,.378,31,77,.403,0,5,.000,12,21,.571,74
22295,2010-03-04,CHI,,MEM,L 96-105,240,37,83,.446,34,69,.493,3,14,.214,19,21,.905,96
22296,2010-03-04,MEM,@,CHI,W 105-96,240,40,76,.526,38,66,.576,2,10,.200,23,30,.767,105
22297,2010-03-04,LAL,@,MIA,L 111-114 (OT),265,45,88,.511,39,65,.600,6,23,.261,15,25,.600,111
22298,2010-03-04,MIA,,LAL,W 114-111 (OT),265,42,80,.525,33,61,.541,9,19,.474,21,25,.840,114
22299,2010-03-04,PHO,,UTA,L 108-116,240,42,73,.575,37,54,.685,5,19,.263,19,28,.679,108
22300,2010-03-04,UTA,@,PHO,W 116-108,240,38,83,.458,26,59,.441,12,24,.500,28,38,.737,116
22301,2010-03-03,ATL,,PHI,W 112-93,240,42,84,.500,34,64,.531,8,20,.400,20,27,.741,112
22302,2010-03-03,PHI,@,ATL,L 93-112,240,35,75,.467,31,64,.484,4,11,.364,19,25,.760,93
22303,2010-03-03,BOS,,CHA,W 104-80,240,38,71,.535,28,55,.509,10,16,.625,18,28,.643,104
22304,2010-03-03,CHA,@,BOS,L 80-104,240,27,75,.360,27,66,.409,0,9,.000,26,30,.867,80
22305,2010-03-03,DAL,,MIN,W 112-109,240,43,86,.500,34,69,.493,9,17,.529,17,18,.944,112
22306,2010-03-03,MIN,@,DAL,L 109-112,240,42,79,.532,35,58,.603,7,21,.333,18,23,.783,109
22307,2010-03-03,DEN,,OKC,W 119-90,240,44,87,.506,38,68,.559,6,19,.316,25,29,.862,119
22308,2010-03-03,OKC,@,DEN,L 90-119,240,27,83,.325,19,66,.288,8,17,.471,28,35,.800,90
22309,2010-03-03,HOU,,SAC,L 81-84,240,30,77,.390,25,55,.455,5,22,.227,16,26,.615,81
22310,2010-03-03,SAC,@,HOU,W 84-81,240,32,100,.320,28,87,.322,4,13,.308,16,20,.800,84
22311,2010-03-03,LAC,,PHO,L 101-127,240,39,85,.459,29,57,.509,10,28,.357,13,17,.765,101
22312,2010-03-03,PHO,@,LAC,W 127-101,240,45,81,.556,33,58,.569,12,23,.522,25,31,.806,127
22313,2010-03-03,MIL,,WAS,W 100-87,240,38,80,.475,30,61,.492,8,19,.421,16,19,.842,100
22314,2010-03-03,WAS,@,MIL,L 87-100,240,35,77,.455,31,64,.484,4,13,.308,13,18,.722,87
22315,2010-03-03,CLE,@,NJN,W 111-92,240,44,85,.518,37,65,.569,7,20,.350,16,21,.762,111
22316,2010-03-03,BRK,,CLE,L 92-111,240,33,84,.393,27,66,.409,6,18,.333,20,28,.714,92
22317,2010-03-03,MEM,@,NOH,W 104-100,240,39,79,.494,37,68,.544,2,11,.182,24,38,.632,104
22318,2010-03-03,NOP,,MEM,L 100-104,240,41,82,.500,36,65,.554,5,17,.294,13,13,1.000,100
22319,2010-03-03,DET,@,NYK,L 104-128,240,41,89,.461,34,75,.453,7,14,.500,15,20,.750,104
22320,2010-03-03,NYK,,DET,W 128-104,240,47,85,.553,35,62,.565,12,23,.522,22,26,.846,128
22321,2010-03-03,GSW,@,ORL,L 90-117,240,35,82,.427,25,59,.424,10,23,.435,10,15,.667,90
22322,2010-03-03,ORL,,GSW,W 117-90,240,47,90,.522,42,69,.609,5,21,.238,18,24,.750,117
22323,2010-03-03,IND,@,POR,L 79-102,240,33,76,.434,27,53,.509,6,23,.261,7,11,.636,79
22324,2010-03-03,POR,,IND,W 102-79,240,35,81,.432,28,62,.452,7,19,.368,25,30,.833,102
22325,2010-03-02,BOS,@,DET,W 105-100,240,35,76,.461,26,58,.448,9,18,.500,26,31,.839,105
22326,2010-03-02,DET,,BOS,L 100-105,240,37,79,.468,34,59,.576,3,20,.150,23,30,.767,100
22327,2010-03-02,IND,@,LAL,L 99-122,240,41,87,.471,34,70,.486,7,17,.412,10,15,.667,99
22328,2010-03-02,LAL,,IND,W 122-99,240,45,87,.517,35,64,.547,10,23,.435,22,24,.917,122
22329,2010-03-02,GSW,@,MIA,L 106-110,240,44,86,.512,35,55,.636,9,31,.290,9,17,.529,106
22330,2010-03-02,MIA,,GSW,W 110-106,240,42,85,.494,37,71,.521,5,14,.357,21,31,.677,110
22331,2010-03-02,OKC,,SAC,W 113-107,240,40,80,.500,35,68,.515,5,12,.417,28,32,.875,113
22332,2010-03-02,SAC,@,OKC,L 107-113,240,41,76,.539,36,60,.600,5,16,.313,20,24,.833,107
22333,2010-03-01,CHA,,DAL,L 84-89,240,29,73,.397,24,55,.436,5,18,.278,21,28,.750,84
22334,2010-03-01,DAL,@,CHA,W 89-84,240,37,80,.463,34,64,.531,3,16,.188,12,15,.800,89
22335,2010-03-01,ATL,@,CHI,W 116-92,240,43,96,.448,37,78,.474,6,18,.333,24,30,.800,116
22336,2010-03-01,CHI,,ATL,L 92-116,240,39,89,.438,37,72,.514,2,17,.118,12,15,.800,92
22337,2010-03-01,CLE,,NYK,W 124-93,240,51,90,.567,45,71,.634,6,19,.316,16,27,.593,124
22338,2010-03-01,NYK,@,CLE,L 93-124,240,36,88,.409,27,58,.466,9,30,.300,12,17,.706,93
22339,2010-03-01,HOU,,TOR,W 116-92,240,41,80,.513,28,55,.509,13,25,.520,21,23,.913,116
22340,2010-03-01,TOR,@,HOU,L 92-116,240,34,77,.442,29,63,.460,5,14,.357,19,25,.760,92
22341,2010-03-01,LAC,,UTA,W 108-104,240,36,75,.480,26,53,.491,10,22,.455,26,29,.897,108
22342,2010-03-01,UTA,@,LAC,L 104-108,240,38,89,.427,34,74,.459,4,15,.267,24,31,.774,104
22343,2010-03-01,MEM,,POR,L 93-103,240,35,77,.455,31,61,.508,4,16,.250,19,25,.760,93
22344,2010-03-01,POR,@,MEM,W 103-93,240,38,85,.447,30,64,.469,8,21,.381,19,19,1.000,103
22345,2010-03-01,NOP,,SAS,L 92-106,240,37,82,.451,29,64,.453,8,18,.444,10,13,.769,92
22346,2010-03-01,SAS,@,NOH,W 106-92,240,42,83,.506,34,60,.567,8,23,.348,14,17,.824,106
22347,2010-03-01,ORL,@,PHI,W 126-105,240,45,77,.584,30,54,.556,15,23,.652,21,25,.840,126
22348,2010-03-01,PHI,,ORL,L 105-126,240,42,86,.488,34,69,.493,8,17,.471,13,14,.929,105
22349,2010-03-01,DEN,@,PHO,L 85-101,240,33,78,.423,24,54,.444,9,24,.375,10,16,.625,85
22350,2010-03-01,PHO,,DEN,W 101-85,240,34,76,.447,27,58,.466,7,18,.389,26,33,.788,101
22351,2010-02-28,ATL,,MIL,W 106-102 (OT),265,39,90,.433,36,77,.468,3,13,.231,25,30,.833,106
22352,2010-02-28,MIL,@,ATL,L 102-106 (OT),265,37,81,.457,32,66,.485,5,15,.333,23,25,.920,102
22353,2010-02-28,DAL,,NOH,W 108-100,240,45,87,.517,41,72,.569,4,15,.267,14,17,.824,108
22354,2010-02-28,NOP,@,DAL,L 100-108,240,37,83,.446,31,62,.500,6,21,.286,20,23,.870,100
22355,2010-02-28,DEN,@,LAL,L 89-95,240,28,78,.359,21,53,.396,7,25,.280,26,33,.788,89
22356,2010-02-28,LAL,,DEN,W 95-89,240,36,79,.456,28,63,.444,8,16,.500,15,21,.714,95
22357,2010-02-28,BRK,,WAS,L 85-89,240,32,91,.352,29,77,.377,3,14,.214,18,24,.750,85
22358,2010-02-28,WAS,@,NJN,W 89-85,240,35,83,.422,32,74,.432,3,9,.333,16,20,.800,89
22359,2010-02-28,OKC,,TOR,W 119-99,240,43,83,.518,37,71,.521,6,12,.500,27,33,.818,119
22360,2010-02-28,TOR,@,OKC,L 99-119,240,38,87,.437,32,72,.444,6,15,.400,17,24,.708,99
22361,2010-02-28,MIA,@,ORL,L 80-96,240,30,77,.390,24,61,.393,6,16,.375,14,18,.778,80
22362,2010-02-28,ORL,,MIA,W 96-80,240,32,70,.457,25,46,.543,7,24,.292,25,30,.833,96
22363,2010-02-28,LAC,@,SAC,L 92-97,240,31,83,.373,26,63,.413,5,20,.250,25,31,.806,92
22364,2010-02-28,SAC,,LAC,W 97-92,240,38,88,.432,33,74,.446,5,14,.357,16,24,.667,97
22365,2010-02-28,PHO,@,SAS,L 110-113,240,43,84,.512,35,69,.507,8,15,.533,16,23,.696,110
22366,2010-02-28,SAS,,PHO,W 113-110,240,43,85,.506,39,71,.549,4,14,.286,23,28,.821,113
22367,2010-02-27,BOS,,NJN,L 96-104,240,42,84,.500,39,65,.600,3,19,.158,9,11,.818,96
22368,2010-02-27,BRK,@,BOS,W 104-96,240,32,72,.444,26,59,.441,6,13,.462,34,41,.829,104
22369,2010-02-27,DET,@,GSW,L 88-95,240,37,86,.430,34,78,.436,3,8,.375,11,26,.423,88
22370,2010-02-27,GSW,,DET,W 95-88,240,35,85,.412,25,54,.463,10,31,.323,15,25,.600,95
22371,2010-02-27,CHI,@,IND,L 90-100,240,31,74,.419,28,61,.459,3,13,.231,25,33,.758,90
22372,2010-02-27,IND,,CHI,W 100-90,240,35,74,.473,30,57,.526,5,17,.294,25,28,.893,100
22373,2010-02-27,MIA,,MIL,L 71-94,240,28,78,.359,25,65,.385,3,13,.231,12,18,.667,71
22374,2010-02-27,MIL,@,MIA,W 94-71,240,38,79,.481,28,53,.528,10,26,.385,8,10,.800,94
22375,2010-02-27,MIN,,POR,L 91-110,240,36,79,.456,30,63,.476,6,16,.375,13,17,.765,91
22376,2010-02-27,POR,@,MIN,W 110-91,240,37,81,.457,29,61,.475,8,20,.400,28,35,.800,110
22377,2010-02-27,MEM,@,NYK,W 120-109,240,45,87,.517,39,74,.527,6,13,.462,24,35,.686,120
22378,2010-02-27,NYK,,MEM,L 109-120,240,41,81,.506,29,50,.580,12,31,.387,15,20,.750,109
22379,2010-02-27,HOU,@,UTA,L 110-133,240,35,79,.443,29,58,.500,6,21,.286,34,42,.810,110
22380,2010-02-27,UTA,,HOU,W 133-110,240,52,77,.675,38,52,.731,14,25,.560,15,26,.577,133
22381,2010-02-26,ATL,,DAL,L 103-111 (OT),265,38,95,.400,29,69,.420,9,26,.346,18,21,.857,103
22382,2010-02-26,DAL,@,ATL,W 111-103 (OT),265,48,92,.522,41,71,.577,7,21,.333,8,11,.727,111
22383,2010-02-26,CHI,,POR,W 115-111 (OT),265,46,80,.575,45,74,.608,1,6,.167,22,28,.786,115
22384,2010-02-26,POR,@,CHI,L 111-115 (OT),265,43,84,.512,38,69,.551,5,15,.333,20,25,.800,111
22385,2010-02-26,DEN,,DET,W 107-102,240,35,77,.455,27,59,.458,8,18,.444,29,37,.784,107
22386,2010-02-26,DET,@,DEN,L 102-107,240,41,92,.446,35,76,.461,6,16,.375,14,20,.700,102
22387,2010-02-26,HOU,,SAS,W 109-104,240,36,79,.456,33,63,.524,3,16,.188,34,38,.895,109
22388,2010-02-26,SAS,@,HOU,L 104-109,240,38,85,.447,32,64,.500,6,21,.286,22,30,.733,104
22389,2010-02-26,LAL,,PHI,W 99-90,240,41,91,.451,36,77,.468,5,14,.357,12,14,.857,99
22390,2010-02-26,PHI,@,LAL,L 90-99,240,40,91,.440,37,75,.493,3,16,.188,7,11,.636,90
22391,2010-02-26,CHA,@,MEM,W 93-89,240,38,79,.481,32,62,.516,6,17,.353,11,19,.579,93
22392,2010-02-26,MEM,,CHA,L 89-93,240,34,70,.486,25,50,.500,9,20,.450,12,18,.667,89
22393,2010-02-26,NOP,,ORL,W 100-93,240,39,81,.481,36,73,.493,3,8,.375,19,25,.760,100
22394,2010-02-26,ORL,@,NOH,L 93-100,240,38,77,.494,31,50,.620,7,27,.259,10,16,.625,93
22395,2010-02-26,MIN,@,OKC,L 92-109,240,37,91,.407,34,75,.453,3,16,.188,15,17,.882,92
22396,2010-02-26,OKC,,MIN,W 109-92,240,44,81,.543,42,70,.600,2,11,.182,19,25,.760,109
22397,2010-02-26,LAC,@,PHO,L 112-125,240,43,89,.483,31,64,.484,12,25,.480,14,19,.737,112
22398,2010-02-26,PHO,,LAC,W 125-112,240,48,84,.571,39,65,.600,9,19,.474,20,26,.769,125
22399,2010-02-26,SAC,,UTA,W 103-99,240,42,77,.545,39,68,.574,3,9,.333,16,28,.571,103
22400,2010-02-26,UTA,@,SAC,L 99-103,240,36,88,.409,31,67,.463,5,21,.238,22,28,.786,99
22401,2010-02-26,CLE,@,TOR,W 126-118 (OT),265,42,82,.512,31,53,.585,11,29,.379,31,36,.861,126
22402,2010-02-26,TOR,,CLE,L 118-126 (OT),265,45,93,.484,37,68,.544,8,25,.320,20,25,.800,118
22403,2010-02-26,NYK,@,WAS,W 118-116 (OT),265,44,91,.484,38,74,.514,6,17,.353,24,33,.727,118
22404,2010-02-26,WAS,,NYK,L 116-118 (OT),265,47,89,.528,37,71,.521,10,18,.556,12,21,.571,116
22405,2010-02-25,BOS,,CLE,L 88-108,240,33,81,.407,27,63,.429,6,18,.333,16,23,.696,88
22406,2010-02-25,CLE,@,BOS,W 108-88,240,41,78,.526,31,57,.544,10,21,.476,16,21,.762,108
22407,2010-02-25,DEN,@,GSW,W 127-112,240,47,92,.511,31,65,.477,16,27,.593,17,28,.607,127
22408,2010-02-25,GSW,,DEN,L 112-127,240,40,96,.417,30,72,.417,10,24,.417,22,25,.880,112
22409,2010-02-25,IND,,MIL,L 110-112,240,34,74,.459,27,58,.466,7,16,.438,35,44,.795,110
22410,2010-02-25,MIL,@,IND,W 112-110,240,42,86,.488,34,68,.500,8,18,.444,20,25,.800,112
22411,2010-02-24,ATL,,MIN,W 98-92,240,33,81,.407,29,67,.433,4,14,.286,28,32,.875,98
22412,2010-02-24,MIN,@,ATL,L 92-98,240,36,79,.456,30,63,.476,6,16,.375,14,21,.667,92
22413,2010-02-24,CHI,,IND,W 120-110,240,44,87,.506,39,76,.513,5,11,.455,27,35,.771,120
22414,2010-02-24,IND,@,CHI,L 110-120,240,36,88,.409,23,59,.390,13,29,.448,25,27,.926,110
22415,2010-02-24,DAL,,LAL,W 101-96,240,35,80,.438,27,59,.458,8,21,.381,23,26,.885,101
22416,2010-02-24,LAL,@,DAL,L 96-101,240,38,78,.487,33,61,.541,5,17,.294,15,16,.938,96
22417,2010-02-24,HOU,,ORL,L 92-110,240,33,77,.429,21,53,.396,12,24,.500,14,19,.737,92
22418,2010-02-24,ORL,@,HOU,W 110-92,240,43,87,.494,34,56,.607,9,31,.290,15,22,.682,110
22419,2010-02-24,DET,@,LAC,L 91-97,240,38,86,.442,33,68,.485,5,18,.278,10,22,.455,91
22420,2010-02-24,LAC,,DET,W 97-91,240,34,84,.405,27,63,.429,7,21,.333,22,24,.917,97
22421,2010-02-24,MIL,,NOH,W 115-95,240,48,93,.516,42,75,.560,6,18,.333,13,17,.765,115
22422,2010-02-24,NOP,@,MIL,L 95-115,240,35,82,.427,30,67,.448,5,15,.333,20,24,.833,95
22423,2010-02-24,PHI,@,PHO,L 95-106,240,37,85,.435,32,67,.478,5,18,.278,16,22,.727,95
22424,2010-02-24,PHO,,PHI,W 106-95,240,44,86,.512,36,65,.554,8,21,.381,10,13,.769,106
22425,2010-02-24,OKC,@,SAS,L 87-95,240,33,83,.398,28,66,.424,5,17,.294,16,24,.667,87
22426,2010-02-24,SAS,,OKC,W 95-87,240,33,78,.423,27,61,.443,6,17,.353,23,30,.767,95
22427,2010-02-24,POR,@,TOR,W 101-87,240,42,85,.494,36,70,.514,6,15,.400,11,15,.733,101
22428,2010-02-24,TOR,,POR,L 87-101,240,34,76,.447,27,56,.482,7,20,.350,12,17,.706,87
22429,2010-02-24,CHA,@,UTA,L 93-102,240,28,68,.412,21,47,.447,7,21,.333,30,34,.882,93
22430,2010-02-24,UTA,,CHA,W 102-93,240,39,82,.476,30,61,.492,9,21,.429,15,23,.652,102
22431,2010-02-24,MEM,@,WAS,W 99-94,240,42,87,.483,39,77,.506,3,10,.300,12,18,.667,99
22432,2010-02-24,WAS,,MEM,L 94-99,240,37,77,.481,36,70,.514,1,7,.143,19,26,.731,94
22433,2010-02-23,BOS,,NYK,W 110-106,240,44,79,.557,39,63,.619,5,16,.313,17,22,.773,110
22434,2010-02-23,NYK,@,BOS,L 106-110,240,42,80,.525,32,52,.615,10,28,.357,12,17,.706,106
22435,2010-02-23,CLE,,NOH,W 105-95,240,40,82,.488,32,57,.561,8,25,.320,17,24,.708,105
22436,2010-02-23,NOP,@,CLE,L 95-105,240,39,78,.500,35,61,.574,4,17,.235,13,13,1.000,95
22437,2010-02-23,GSW,,PHI,L 102-110,240,36,95,.379,23,62,.371,13,33,.394,17,21,.810,102
22438,2010-02-23,PHI,@,GSW,W 110-102,240,41,85,.482,32,65,.492,9,20,.450,19,23,.826,110
22439,2010-02-23,LAL,@,MEM,W 99-98,240,37,76,.487,31,59,.525,6,17,.353,19,26,.731,99
22440,2010-02-23,MEM,,LAL,L 98-99,240,39,83,.470,34,69,.493,5,14,.357,15,20,.750,98
22441,2010-02-23,MIA,,MIN,L 88-91,240,33,80,.413,25,58,.431,8,22,.364,14,16,.875,88
22442,2010-02-23,MIN,@,MIA,W 91-88,240,34,78,.436,26,64,.406,8,14,.571,15,19,.789,91
22443,2010-02-23,BRK,,POR,L 93-102,240,34,69,.493,28,58,.483,6,11,.545,19,21,.905,93
22444,2010-02-23,POR,@,NJN,W 102-93,240,40,74,.541,36,62,.581,4,12,.333,18,22,.818,102
22445,2010-02-23,OKC,,PHO,L 102-104,240,38,86,.442,34,70,.486,4,16,.250,22,24,.917,102
22446,2010-02-23,PHO,@,OKC,W 104-102,240,40,78,.513,33,65,.508,7,13,.538,17,27,.630,104
22447,2010-02-23,DET,@,SAC,W 101-89,240,45,77,.584,41,66,.621,4,11,.364,7,14,.500,101
22448,2010-02-23,SAC,,DET,L 89-101,240,32,72,.444,28,59,.475,4,13,.308,21,29,.724,89
22449,2010-02-22,DAL,,IND,W 91-82,240,32,83,.386,28,69,.406,4,14,.286,23,31,.742,91
22450,2010-02-22,IND,@,DAL,L 82-91,240,31,84,.369,28,61,.459,3,23,.130,17,23,.739,82
22451,2010-02-22,CHA,@,LAC,L 94-98,240,34,78,.436,29,56,.518,5,22,.227,21,28,.750,94
22452,2010-02-22,LAC,,CHA,W 98-94,240,36,76,.474,27,53,.509,9,23,.391,17,25,.680,98
22453,2010-02-22,MIL,@,NYK,W 83-67,240,37,86,.430,33,68,.485,4,18,.222,5,8,.625,83
22454,2010-02-22,NYK,,MIL,L 67-83,240,26,77,.338,21,53,.396,5,24,.208,10,14,.714,67
22455,2010-02-22,ATL,@,UTA,W 105-100,240,39,72,.542,31,56,.554,8,16,.500,19,25,.760,105
22456,2010-02-22,UTA,,ATL,L 100-105,240,41,85,.482,37,68,.544,4,17,.235,14,21,.667,100
22457,2010-02-22,CHI,@,WAS,L 95-101,240,36,78,.462,31,66,.470,5,12,.417,18,25,.720,95
22458,2010-02-22,WAS,,CHI,W 101-95,240,41,81,.506,38,69,.551,3,12,.250,16,19,.842,101
22459,2010-02-21,BOS,@,DEN,L 105-114,240,45,85,.529,43,72,.597,2,13,.154,13,24,.542,105
22460,2010-02-21,DEN,,BOS,W 114-105,240,40,78,.513,31,57,.544,9,21,.429,25,40,.625,114
22461,2010-02-21,DET,,SAS,W 109-101 (OT),265,37,82,.451,31,65,.477,6,17,.353,29,40,.725,109
22462,2010-02-21,SAS,@,DET,L 101-109 (OT),265,34,81,.420,28,60,.467,6,21,.286,27,33,.818,101
22463,2010-02-21,ATL,@,GSW,L 104-108,240,40,88,.455,35,73,.479,5,15,.333,19,28,.679,104
22464,2010-02-21,GSW,,ATL,W 108-104,240,45,84,.536,42,72,.583,3,12,.250,15,21,.714,108
22465,2010-02-21,MIN,,OKC,L 107-109,240,43,94,.457,37,77,.481,6,17,.353,15,21,.714,107
22466,2010-02-21,OKC,@,MIN,W 109-107,240,41,87,.471,36,75,.480,5,12,.417,22,23,.957,109
22467,2010-02-21,MEM,@,NJN,W 104-94,240,41,90,.456,36,81,.444,5,9,.556,17,20,.850,104
22468,2010-02-21,BRK,,MEM,L 94-104,240,39,87,.448,35,66,.530,4,21,.190,12,19,.632,94
22469,2010-02-21,HOU,@,NOH,L 94-102,240,40,92,.435,33,67,.493,7,25,.280,7,14,.500,94
22470,2010-02-21,NOP,,HOU,W 102-94,240,37,85,.435,31,65,.477,6,20,.300,22,27,.815,102
22471,2010-02-21,CLE,@,ORL,L 95-101,240,38,82,.463,35,66,.530,3,16,.188,16,25,.640,95
22472,2010-02-21,ORL,,CLE,W 101-95,240,37,73,.507,29,53,.547,8,20,.400,19,27,.704,101
22473,2010-02-21,PHO,,SAC,W 104-88,240,41,89,.461,35,78,.449,6,11,.545,16,22,.727,104
22474,2010-02-21,SAC,@,PHO,L 88-104,240,35,74,.473,31,64,.484,4,10,.400,14,21,.667,88
22475,2010-02-21,POR,,UTA,L 89-93 (OT),265,31,88,.352,25,68,.368,6,20,.300,21,29,.724,89
22476,2010-02-21,UTA,@,POR,W 93-89 (OT),265,33,83,.398,29,68,.426,4,15,.267,23,34,.676,93
22477,2010-02-20,CHI,,PHI,W 122-90,240,44,95,.463,36,80,.450,8,15,.533,26,32,.813,122
22478,2010-02-20,PHI,@,CHI,L 90-122,240,33,86,.384,27,67,.403,6,19,.316,18,25,.720,90
22479,2010-02-20,DAL,,MIA,W 97-91,240,33,73,.452,30,57,.526,3,16,.188,28,33,.848,97
22480,2010-02-20,MIA,@,DAL,L 91-97,240,37,80,.463,30,61,.492,7,19,.368,10,10,1.000,91
22481,2010-02-20,HOU,,IND,L 115-125,240,42,90,.467,30,65,.462,12,25,.480,19,29,.655,115
22482,2010-02-20,IND,@,HOU,W 125-115,240,46,93,.495,35,73,.479,11,20,.550,22,31,.710,125
22483,2010-02-20,LAC,,SAC,W 99-89,240,35,79,.443,24,57,.421,11,22,.500,18,21,.857,99
22484,2010-02-20,SAC,@,LAC,L 89-99,240,35,77,.455,31,63,.492,4,14,.286,15,25,.600,89
22485,2010-02-20,CHA,@,MIL,L 88-93,240,33,75,.440,27,63,.429,6,12,.500,16,19,.842,88
22486,2010-02-20,MIL,,CHA,W 93-88,240,32,79,.405,23,55,.418,9,24,.375,20,26,.769,93
22487,2010-02-20,NYK,,OKC,L 118-121 (OT),265,46,94,.489,38,65,.585,8,29,.276,18,23,.783,118
22488,2010-02-20,OKC,@,NYK,W 121-118 (OT),265,43,89,.483,38,76,.500,5,13,.385,30,41,.732,121
22489,2010-02-20,TOR,,WAS,W 109-104,240,38,73,.521,31,60,.517,7,13,.538,26,32,.813,109
22490,2010-02-20,WAS,@,TOR,L 104-109,240,43,91,.473,37,77,.481,6,14,.429,12,18,.667,104
22491,2010-02-19,CHA,,CLE,W 110-93,240,41,75,.547,32,56,.571,9,19,.474,19,25,.760,110
22492,2010-02-19,CLE,@,CHA,L 93-110,240,32,82,.390,20,53,.377,12,29,.414,17,25,.680,93
22493,2010-02-19,DET,,MIL,L 85-91,240,33,68,.485,32,62,.516,1,6,.167,18,20,.900,85
22494,2010-02-19,MIL,@,DET,W 91-85,240,31,81,.383,22,57,.386,9,24,.375,20,26,.769,91
22495,2010-02-19,GSW,,UTA,L 89-100,240,29,78,.372,21,57,.368,8,21,.381,23,25,.920,89
22496,2010-02-19,UTA,@,GSW,W 100-89,240,38,89,.427,30,68,.441,8,21,.381,16,24,.667,100
22497,2010-02-19,MEM,,MIA,L 87-100 (2OT),290,34,89,.382,29,69,.420,5,20,.250,14,18,.778,87
22498,2010-02-19,MIA,@,MEM,W 100-87 (2OT),290,38,90,.422,30,70,.429,8,20,.400,16,23,.696,100
22499,2010-02-19,CHI,@,MIN,W 100-94,240,38,88,.432,36,73,.493,2,15,.133,22,31,.710,100
22500,2010-02-19,MIN,,CHI,L 94-100,240,38,85,.447,31,68,.456,7,17,.412,11,20,.550,94
22501,2010-02-19,BRK,,TOR,L 89-106,240,33,79,.418,25,60,.417,8,19,.421,15,23,.652,89
22502,2010-02-19,TOR,@,NJN,W 106-89,240,43,72,.597,37,60,.617,6,12,.500,14,25,.560,106
22503,2010-02-19,IND,@,NOH,L 101-107,240,39,90,.433,29,63,.460,10,27,.370,13,15,.867,101
22504,2010-02-19,NOP,,IND,W 107-101,240,39,84,.464,32,66,.485,7,18,.389,22,32,.688,107
22505,2010-02-19,DAL,@,ORL,W 95-85,240,38,84,.452,33,69,.478,5,15,.333,14,18,.778,95
22506,2010-02-19,ORL,,DAL,L 85-95,240,36,87,.414,32,62,.516,4,25,.160,9,12,.750,85
22507,2010-02-19,PHI,,SAS,W 106-94,240,42,83,.506,40,75,.533,2,8,.250,20,23,.870,106
22508,2010-02-19,SAS,@,PHI,L 94-106,240,36,86,.419,31,65,.477,5,21,.238,17,19,.895,94
22509,2010-02-19,ATL,@,PHO,L 80-88,240,30,76,.395,27,62,.435,3,14,.214,17,25,.680,80
22510,2010-02-19,PHO,,ATL,W 88-80,240,37,82,.451,35,64,.547,2,18,.111,12,17,.706,88
22511,2010-02-19,BOS,@,POR,W 96-76,240,39,73,.534,33,57,.579,6,16,.375,12,23,.522,96
22512,2010-02-19,POR,,BOS,L 76-96,240,22,65,.338,20,53,.377,2,12,.167,30,40,.750,76
22513,2010-02-19,DEN,@,WAS,L 97-107,240,32,72,.444,28,59,.475,4,13,.308,29,37,.784,97
22514,2010-02-19,WAS,,DEN,W 107-97,240,40,87,.460,35,73,.479,5,14,.357,22,25,.880,107
22515,2010-02-18,CLE,,DEN,L 116-118 (OT),265,43,86,.500,36,63,.571,7,23,.304,23,40,.575,116
22516,2010-02-18,DEN,@,CLE,W 118-116 (OT),265,46,100,.460,41,84,.488,5,16,.313,21,26,.808,118
22517,2010-02-18,BOS,@,LAL,W 87-86,240,37,84,.440,32,69,.464,5,15,.333,8,13,.615,87
22518,2010-02-18,LAL,,BOS,L 86-87,240,33,82,.402,29,66,.439,4,16,.250,16,25,.640,86
22519,2010-02-17,DAL,,PHO,W 107-97,240,41,87,.471,36,72,.500,5,15,.333,20,27,.741,107
22520,2010-02-17,PHO,@,DAL,L 97-107,240,37,80,.463,32,58,.552,5,22,.227,18,25,.720,97
22521,2010-02-17,GSW,,SAC,W 130-98,240,50,97,.515,38,73,.521,12,24,.500,18,21,.857,130
22522,2010-02-17,SAC,@,GSW,L 98-130,240,38,90,.422,33,72,.458,5,18,.278,17,24,.708,98
22523,2010-02-17,IND,,SAS,L 87-90,240,35,83,.422,30,64,.469,5,19,.263,12,15,.800,87
22524,2010-02-17,SAS,@,IND,W 90-87,240,35,99,.354,28,75,.373,7,24,.292,13,17,.765,90
22525,2010-02-17,ATL,@,LAC,W 110-92,240,43,79,.544,43,72,.597,0,7,.000,24,33,.727,110
22526,2010-02-17,LAC,,ATL,L 92-110,240,37,73,.507,29,52,.558,8,21,.381,10,17,.588,92
22527,2010-02-17,HOU,@,MIL,W 127-99,240,42,72,.583,26,49,.531,16,23,.696,27,37,.730,127
22528,2010-02-17,MIL,,HOU,L 99-127,240,38,94,.404,33,76,.434,5,18,.278,18,25,.720,99
22529,2010-02-17,MIA,@,NJN,W 87-84,240,29,74,.392,24,60,.400,5,14,.357,24,34,.706,87
22530,2010-02-17,BRK,,MIA,L 84-87,240,30,84,.357,29,69,.420,1,15,.067,23,28,.821,84
22531,2010-02-17,NOP,,UTA,L 90-98,240,34,88,.386,25,67,.373,9,21,.429,13,18,.722,90
22532,2010-02-17,UTA,@,NOH,W 98-90,240,38,70,.543,35,61,.574,3,9,.333,19,22,.864,98
22533,2010-02-17,CHI,@,NYK,W 115-109,240,43,90,.478,40,80,.500,3,10,.300,26,33,.788,115
22534,2010-02-17,NYK,,CHI,L 109-115,240,42,92,.457,30,60,.500,12,32,.375,13,16,.813,109
22535,2010-02-17,DET,@,ORL,L 91-116,240,34,80,.425,31,71,.437,3,9,.333,20,27,.741,91
22536,2010-02-17,ORL,,DET,W 116-91,240,42,82,.512,32,53,.604,10,29,.345,22,26,.846,116
22537,2010-02-17,MEM,@,TOR,W 109-102 (OT),265,40,83,.482,34,72,.472,6,11,.545,23,33,.697,109
22538,2010-02-17,TOR,,MEM,L 102-109 (OT),265,40,89,.449,37,72,.514,3,17,.176,19,23,.826,102
22539,2010-02-17,MIN,@,WAS,L 99-108,240,38,79,.481,33,68,.485,5,11,.455,18,23,.783,99
22540,2010-02-17,WAS,,MIN,W 108-99,240,42,88,.477,35,72,.486,7,16,.438,17,28,.607,108
22541,2010-02-16,CHA,,NJN,L 94-103,240,34,81,.420,29,62,.468,5,19,.263,21,26,.808,94
22542,2010-02-16,BRK,@,CHA,W 103-94,240,42,81,.519,37,67,.552,5,14,.357,14,20,.700,103
22543,2010-02-16,CHI,,NYK,W 118-85,240,52,86,.605,47,73,.644,5,13,.385,9,13,.692,118
22544,2010-02-16,NYK,@,CHI,L 85-118,240,28,81,.346,21,56,.375,7,25,.280,22,28,.786,85
22545,2010-02-16,DET,,MIN,W 108-85,240,46,86,.535,42,68,.618,4,18,.222,12,21,.571,108
22546,2010-02-16,MIN,@,DET,L 85-108,240,31,70,.443,28,57,.491,3,13,.231,20,33,.606,85
22547,2010-02-16,HOU,,UTA,L 95-104,240,32,79,.405,21,53,.396,11,26,.423,20,22,.909,95
22548,2010-02-16,UTA,@,HOU,W 104-95,240,41,79,.519,39,69,.565,2,10,.200,20,24,.833,104
22549,2010-02-16,GSW,@,LAL,L 94-104,240,35,84,.417,25,57,.439,10,27,.370,14,19,.737,94
22550,2010-02-16,LAL,,GSW,W 104-94,240,38,85,.447,32,63,.508,6,22,.273,22,31,.710,104
22551,2010-02-16,MEM,,PHO,L 95-109,240,32,90,.356,24,71,.338,8,19,.421,23,37,.622,95
22552,2010-02-16,PHO,@,MEM,W 109-95,240,41,82,.500,35,69,.507,6,13,.462,21,29,.724,109
22553,2010-02-16,DAL,@,OKC,L 86-99,240,30,93,.323,23,72,.319,7,21,.333,19,23,.826,86
22554,2010-02-16,OKC,,DAL,W 99-86,240,35,82,.427,28,65,.431,7,17,.412,22,30,.733,99
22555,2010-02-16,MIA,@,PHI,W 105-78,240,42,82,.512,37,70,.529,5,12,.417,16,20,.800,105
22556,2010-02-16,PHI,,MIA,L 78-105,240,33,87,.379,32,75,.427,1,12,.083,11,17,.647,78
22557,2010-02-16,LAC,@,POR,L 87-109,240,36,75,.480,29,55,.527,7,20,.350,8,15,.533,87
22558,2010-02-16,POR,,LAC,W 109-87,240,37,75,.493,27,57,.474,10,18,.556,25,32,.781,109
22559,2010-02-16,BOS,@,SAC,W 95-92,240,30,80,.375,21,57,.368,9,23,.391,26,31,.839,95
22560,2010-02-16,SAC,,BOS,L 92-95,240,32,84,.381,23,64,.359,9,20,.450,19,30,.633,92
22561,2010-02-11,CLE,,ORL,W 115-106,240,44,84,.524,35,64,.547,9,20,.450,18,25,.720,115
22562,2010-02-11,ORL,@,CLE,L 106-115,240,36,75,.480,26,49,.531,10,26,.385,24,31,.774,106
22563,2010-02-11,DEN,,SAS,L 92-111,240,31,79,.392,28,60,.467,3,19,.158,27,36,.750,92
22564,2010-02-11,SAS,@,DEN,W 111-92,240,41,77,.532,32,58,.552,9,19,.474,20,30,.667,111
22565,2010-02-10,ATL,,MIA,L 76-94,240,27,72,.375,23,53,.434,4,19,.211,18,25,.720,76
22566,2010-02-10,MIA,@,ATL,W 94-76,240,41,81,.506,36,65,.554,5,16,.313,7,11,.636,94
22567,2010-02-10,CHI,,ORL,L 87-107,240,32,87,.368,28,68,.412,4,19,.211,19,23,.826,87
22568,2010-02-10,ORL,@,CHI,W 107-87,240,37,79,.468,25,47,.532,12,32,.375,21,25,.840,107
22569,2010-02-10,DET,,SAC,L 97-103,240,35,86,.407,32,75,.427,3,11,.273,24,27,.889,97
22570,2010-02-10,SAC,@,DET,W 103-97,240,39,76,.513,32,61,.525,7,15,.467,18,23,.783,103
22571,2010-02-10,GSW,,LAC,W 132-102,240,49,79,.620,36,57,.632,13,22,.591,21,28,.750,132
22572,2010-02-10,LAC,@,GSW,L 102-132,240,37,88,.420,30,73,.411,7,15,.467,21,26,.808,102
22573,2010-02-10,CHA,@,MIN,W 93-92,240,36,75,.480,27,53,.509,9,22,.409,12,18,.667,93
22574,2010-02-10,MIN,,CHA,L 92-93,240,39,85,.459,30,64,.469,9,21,.429,5,9,.556,92
22575,2010-02-10,MIL,@,NJN,W 97-77,240,43,86,.500,37,72,.514,6,14,.429,5,12,.417,97
22576,2010-02-10,BRK,,MIL,L 77-97,240,29,74,.392,25,67,.373,4,7,.571,15,22,.682,77
22577,2010-02-10,BOS,@,NOH,L 85-93,240,34,72,.472,33,64,.516,1,8,.125,16,27,.593,85
22578,2010-02-10,NOP,,BOS,W 93-85,240,34,75,.453,26,57,.456,8,18,.444,17,21,.810,93
22579,2010-02-10,PHO,,POR,L 101-108,240,39,83,.470,31,61,.508,8,22,.364,15,19,.789,101
22580,2010-02-10,POR,@,PHO,W 108-101,240,45,77,.584,42,68,.618,3,9,.333,15,19,.789,108
22581,2010-02-10,PHI,@,TOR,L 93-104,240,35,81,.432,31,59,.525,4,22,.182,19,22,.864,93
22582,2010-02-10,TOR,,PHI,W 104-93,240,40,85,.471,37,74,.500,3,11,.273,21,31,.677,104
22583,2010-02-10,LAL,@,UTA,W 96-81,240,36,77,.468,31,64,.484,5,13,.385,19,24,.792,96
22584,2010-02-10,UTA,,LAL,L 81-96,240,33,75,.440,31,62,.500,2,13,.154,13,25,.520,81
22585,2010-02-09,CHA,,WAS,W 94-92,240,35,74,.473,31,58,.534,4,16,.250,20,27,.741,94
22586,2010-02-09,WAS,@,CHA,L 92-94,240,35,81,.432,29,63,.460,6,18,.333,16,20,.800,92
22587,2010-02-09,CLE,,NJN,W 104-97,240,39,74,.527,32,56,.571,7,18,.389,19,29,.655,104
22588,2010-02-09,BRK,@,CLE,L 97-104,240,38,74,.514,33,63,.524,5,11,.455,16,20,.800,97
22589,2010-02-09,DAL,@,DEN,L 91-127,240,29,76,.382,22,55,.400,7,21,.333,26,28,.929,91
22590,2010-02-09,DEN,,DAL,W 127-91,240,48,79,.608,37,61,.607,11,18,.611,20,23,.870,127
22591,2010-02-09,CHI,@,IND,W 109-101,240,41,81,.506,37,68,.544,4,13,.308,23,33,.697,109
22592,2010-02-09,IND,,CHI,L 101-109,240,40,92,.435,33,73,.452,7,19,.368,14,19,.737,101
22593,2010-02-09,LAC,,UTA,L 99-109,240,33,72,.458,28,52,.538,5,20,.250,28,38,.737,99
22594,2010-02-09,UTA,@,LAC,W 109-99,240,42,83,.506,38,68,.559,4,15,.267,21,28,.750,109
22595,2010-02-09,ATL,@,MEM,W 108-94,240,41,74,.554,34,58,.586,7,16,.438,19,25,.760,108
22596,2010-02-09,MEM,,ATL,L 94-108,240,40,80,.500,36,66,.545,4,14,.286,10,12,.833,94
22597,2010-02-09,HOU,@,MIA,L 66-99,240,26,86,.302,22,68,.324,4,18,.222,10,15,.667,66
22598,2010-02-09,MIA,,HOU,W 99-66,240,41,79,.519,34,64,.531,7,15,.467,10,13,.769,99
22599,2010-02-09,DET,@,MIL,W 93-81,240,37,84,.440,32,72,.444,5,12,.417,14,17,.824,93
22600,2010-02-09,MIL,,DET,L 81-93,240,30,82,.366,24,63,.381,6,19,.316,15,19,.789,81
22601,2010-02-09,NYK,,SAC,L 114-118 (OT),265,42,94,.447,35,65,.538,7,29,.241,23,33,.697,114
22602,2010-02-09,SAC,@,NYK,W 118-114 (OT),265,45,96,.469,38,77,.494,7,19,.368,21,28,.750,118
22603,2010-02-09,MIN,@,PHI,L 97-119,240,36,76,.474,30,61,.492,6,15,.400,19,26,.731,97
22604,2010-02-09,PHI,,MIN,W 119-97,240,46,80,.575,41,66,.621,5,14,.357,22,25,.880,119
22605,2010-02-09,OKC,@,POR,W 89-77,240,31,73,.425,26,57,.456,5,16,.313,22,28,.786,89
22606,2010-02-09,POR,,OKC,L 77-89,240,31,77,.403,28,57,.491,3,20,.150,12,14,.857,77
22607,2010-02-08,DAL,@,GSW,W 127-117,240,37,71,.521,25,49,.510,12,22,.545,41,46,.891,127
22608,2010-02-08,GSW,,DAL,L 117-127,240,42,85,.494,34,65,.523,8,20,.400,25,29,.862,117
22609,2010-02-08,LAL,,SAS,W 101-89,240,38,87,.437,32,73,.438,6,14,.429,19,26,.731,101
22610,2010-02-08,SAS,@,LAL,L 89-101,240,35,82,.427,31,70,.443,4,12,.333,15,18,.833,89
22611,2010-02-08,NOP,@,ORL,L 117-123,240,46,89,.517,37,71,.521,9,18,.500,16,19,.842,117
22612,2010-02-08,ORL,,NOH,W 123-117,240,45,83,.542,33,57,.579,12,26,.462,21,28,.750,123
22613,2010-02-07,BOS,,ORL,L 89-96,240,35,83,.422,30,67,.448,5,16,.313,14,19,.737,89
22614,2010-02-07,ORL,@,BOS,W 96-89,240,31,67,.463,20,45,.444,11,22,.500,23,29,.793,96
22615,2010-02-07,SAC,@,TOR,L 104-115,240,37,85,.435,32,71,.451,5,14,.357,25,36,.694,104
22616,2010-02-07,TOR,,SAC,W 115-104,240,46,82,.561,40,65,.615,6,17,.353,17,23,.739,115
22617,2010-02-06,CHA,,NOH,L 99-104,240,37,77,.481,30,59,.508,7,18,.389,18,27,.667,99
22618,2010-02-06,NOP,@,CHA,W 104-99,240,39,77,.506,30,55,.545,9,22,.409,17,21,.810,104
22619,2010-02-06,CHI,,MIA,W 95-91,240,33,82,.402,32,74,.432,1,8,.125,28,35,.800,95
22620,2010-02-06,MIA,@,CHI,L 91-95,240,34,82,.415,27,61,.443,7,21,.333,16,19,.842,91
22621,2010-02-06,CLE,,NYK,W 113-106,240,44,80,.550,33,58,.569,11,22,.500,14,17,.824,113
22622,2010-02-06,NYK,@,CLE,L 106-113,240,41,78,.526,29,51,.569,12,27,.444,12,12,1.000,106
22623,2010-02-06,DET,,NJN,W 99-92,240,38,73,.521,30,61,.492,8,12,.667,15,21,.714,99
22624,2010-02-06,BRK,@,DET,L 92-99,240,34,74,.459,26,59,.441,8,15,.533,16,21,.762,92
22625,2010-02-06,GSW,,OKC,L 95-104,240,37,88,.420,29,65,.446,8,23,.348,13,21,.619,95
22626,2010-02-06,OKC,@,GSW,W 104-95,240,38,90,.422,32,76,.421,6,14,.429,22,24,.917,104
22627,2010-02-06,HOU,,PHI,L 95-102,240,34,83,.410,25,58,.431,9,25,.360,18,24,.750,95
22628,2010-02-06,PHI,@,HOU,W 102-95,240,35,72,.486,25,48,.521,10,24,.417,22,23,.957,102
22629,2010-02-06,LAC,,SAS,L 81-98,240,31,75,.413,30,66,.455,1,9,.111,18,20,.900,81
22630,2010-02-06,SAS,@,LAC,W 98-81,240,37,86,.430,26,58,.448,11,28,.393,13,17,.765,98
22631,2010-02-06,IND,@,MIL,L 81-93,240,32,69,.464,26,51,.510,6,18,.333,11,13,.846,81
22632,2010-02-06,MIL,,IND,W 93-81,240,34,79,.430,25,53,.472,9,26,.346,16,21,.762,93
22633,2010-02-06,MEM,@,MIN,L 102-109,240,45,87,.517,39,73,.534,6,14,.429,6,8,.750,102
22634,2010-02-06,MIN,,MEM,W 109-102,240,45,81,.556,38,67,.567,7,14,.500,12,19,.632,109
22635,2010-02-06,LAL,@,POR,W 99-82,240,41,84,.488,33,65,.508,8,19,.421,9,15,.600,99
22636,2010-02-06,POR,,LAL,L 82-99,240,31,71,.437,26,53,.491,5,18,.278,15,19,.789,82
22637,2010-02-06,DEN,@,UTA,L 106-116,240,37,83,.446,33,67,.493,4,16,.250,28,34,.824,106
22638,2010-02-06,UTA,,DEN,W 116-106,240,40,81,.494,35,64,.547,5,17,.294,31,40,.775,116
22639,2010-02-05,ATL,,CHI,W 91-81,240,39,88,.443,31,70,.443,8,18,.444,5,11,.455,91
22640,2010-02-05,CHI,@,ATL,L 81-91,240,33,76,.434,33,66,.500,0,10,.000,15,20,.750,81
22641,2010-02-05,BOS,,NJN,W 96-87,240,36,72,.500,31,57,.544,5,15,.333,19,25,.760,96
22642,2010-02-05,BRK,@,BOS,L 87-96,240,30,68,.441,25,52,.481,5,16,.313,22,27,.815,87
22643,2010-02-05,DAL,,MIN,L 108-117,240,35,82,.427,26,63,.413,9,19,.474,29,35,.829,108
22644,2010-02-05,MIN,@,DAL,W 117-108,240,44,83,.530,32,61,.525,12,22,.545,17,20,.850,117
22645,2010-02-05,DET,@,IND,L 83-107,240,34,87,.391,30,74,.405,4,13,.308,11,14,.786,83
22646,2010-02-05,IND,,DET,W 107-83,240,41,79,.519,31,52,.596,10,27,.370,15,19,.789,107
22647,2010-02-05,DEN,@,LAL,W 126-113,240,48,84,.571,33,62,.532,15,22,.682,15,21,.714,126
22648,2010-02-05,LAL,,DEN,L 113-126,240,44,98,.449,36,72,.500,8,26,.308,17,20,.850,113
22649,2010-02-05,HOU,@,MEM,W 101-83,240,39,89,.438,32,64,.500,7,25,.280,16,21,.762,101
22650,2010-02-05,MEM,,HOU,L 83-101,240,34,84,.405,33,75,.440,1,9,.111,14,20,.700,83
22651,2010-02-05,NOP,,PHI,L 94-101,240,37,79,.468,26,58,.448,11,21,.524,9,14,.643,94
22652,2010-02-05,PHI,@,NOH,W 101-94,240,38,79,.481,32,66,.485,6,13,.462,19,25,.760,101
22653,2010-02-05,MIL,@,NYK,W 114-107,240,44,92,.478,34,68,.500,10,24,.417,16,20,.800,114
22654,2010-02-05,NYK,,MIL,L 107-114,240,39,87,.448,32,67,.478,7,20,.350,22,29,.759,107
22655,2010-02-05,ORL,,WAS,L 91-92,240,32,83,.386,25,61,.410,7,22,.318,20,25,.800,91
22656,2010-02-05,WAS,@,ORL,W 92-91,240,34,79,.430,30,65,.462,4,14,.286,20,22,.909,92
22657,2010-02-05,PHO,@,SAC,W 114-102,240,38,78,.487,31,56,.554,7,22,.318,31,39,.795,114
22658,2010-02-05,SAC,,PHO,L 102-114,240,36,81,.444,33,68,.485,3,13,.231,27,40,.675,102
22659,2010-02-04,CLE,,MIA,W 102-86,240,34,70,.486,29,50,.580,5,20,.250,29,36,.806,102
22660,2010-02-04,MIA,@,CLE,L 86-102,240,36,87,.414,32,70,.457,4,17,.235,10,14,.714,86
22661,2010-02-04,POR,,SAS,W 96-93,240,39,76,.513,33,63,.524,6,13,.462,12,18,.667,96
22662,2010-02-04,SAS,@,POR,L 93-96,240,37,84,.440,33,67,.493,4,17,.235,15,22,.682,93
22663,2010-02-03,ATL,,LAC,W 103-97,240,36,79,.456,30,65,.462,6,14,.429,25,28,.893,103
22664,2010-02-03,LAC,@,ATL,L 97-103,240,39,89,.438,32,71,.451,7,18,.389,12,18,.667,97
22665,2010-02-03,BOS,,MIA,W 107-102,240,37,76,.487,31,60,.517,6,16,.375,27,39,.692,107
22666,2010-02-03,MIA,@,BOS,L 102-107,240,38,73,.521,29,50,.580,9,23,.391,17,22,.773,102
22667,2010-02-03,DAL,,GSW,W 110-101,240,43,79,.544,38,62,.613,5,17,.294,19,21,.905,110
22668,2010-02-03,GSW,@,DAL,L 101-110,240,38,77,.494,32,61,.525,6,16,.375,19,27,.704,101
22669,2010-02-03,DEN,,PHO,L 97-109,240,35,79,.443,31,65,.477,4,14,.286,23,33,.697,97
22670,2010-02-03,PHO,@,DEN,W 109-97,240,43,87,.494,34,69,.493,9,18,.500,14,15,.933,109
22671,2010-02-03,CHA,@,LAL,L 97-99,240,37,82,.451,31,62,.500,6,20,.300,17,22,.773,97
22672,2010-02-03,LAL,,CHA,W 99-97,240,39,84,.464,33,67,.493,6,17,.353,15,20,.750,99
22673,2010-02-03,NOP,,OKC,L 99-103,240,41,91,.451,33,68,.485,8,23,.348,9,11,.818,99
22674,2010-02-03,OKC,@,NOH,W 103-99,240,42,73,.575,37,61,.607,5,12,.417,14,17,.824,103
22675,2010-02-03,NYK,,WAS,W 107-85,240,46,88,.523,37,70,.529,9,18,.500,6,8,.750,107
22676,2010-02-03,WAS,@,NYK,L 85-107,240,37,77,.481,32,57,.561,5,20,.250,6,7,.857,85
22677,2010-02-03,CHI,@,PHI,L 103-106 (OT),265,38,86,.442,30,64,.469,8,22,.364,19,25,.760,103
22678,2010-02-03,PHI,,CHI,W 106-103 (OT),265,45,86,.523,40,71,.563,5,15,.333,11,19,.579,106
22679,2010-02-03,SAC,,SAS,L 113-115,240,45,86,.523,36,64,.563,9,22,.409,14,19,.737,113
22680,2010-02-03,SAS,@,SAC,W 115-113,240,44,84,.524,40,71,.563,4,13,.308,23,28,.821,115
22681,2010-02-03,BRK,@,TOR,L 99-108,240,39,89,.438,32,72,.444,7,17,.412,14,17,.824,99
22682,2010-02-03,TOR,,NJN,W 108-99,240,37,78,.474,27,59,.458,10,19,.526,24,29,.828,108
22683,2010-02-03,POR,@,UTA,L 105-118,240,37,87,.425,29,68,.426,8,19,.421,23,28,.821,105
22684,2010-02-03,UTA,,POR,W 118-105,240,42,67,.627,37,54,.685,5,13,.385,29,32,.906,118
22685,2010-02-02,CHI,,LAC,L 82-90,240,30,79,.380,25,64,.391,5,15,.333,17,21,.810,82
22686,2010-02-02,LAC,@,CHI,W 90-82,240,37,82,.451,31,68,.456,6,14,.429,10,17,.588,90
22687,2010-02-02,CLE,,MEM,W 105-89,240,40,81,.494,35,63,.556,5,18,.278,20,24,.833,105
22688,2010-02-02,MEM,@,CLE,L 89-105,240,35,92,.380,33,78,.423,2,14,.143,17,23,.739,89
22689,2010-02-02,GSW,@,HOU,L 97-119,240,41,98,.418,35,74,.473,6,24,.250,9,15,.600,97
22690,2010-02-02,HOU,,GSW,W 119-97,240,43,86,.500,36,64,.563,7,22,.318,26,31,.839,119
22691,2010-02-02,IND,,TOR,W 130-115,240,44,84,.524,35,60,.583,9,24,.375,33,35,.943,130
22692,2010-02-02,TOR,@,IND,L 115-130,240,41,92,.446,33,72,.458,8,20,.400,25,34,.735,115
22693,2010-02-02,DET,@,NJN,W 97-93,240,38,82,.463,35,74,.473,3,8,.375,18,24,.750,97
22694,2010-02-02,BRK,,DET,L 93-97,240,33,73,.452,29,58,.500,4,15,.267,23,28,.821,93
22695,2010-02-02,ATL,@,OKC,L 99-106,240,36,75,.480,30,61,.492,6,14,.429,21,25,.840,99
22696,2010-02-02,OKC,,ATL,W 106-99,240,37,81,.457,32,66,.485,5,15,.333,27,32,.844,106
22697,2010-02-02,MIL,@,ORL,L 82-99,240,33,91,.363,26,69,.377,7,22,.318,9,19,.474,82
22698,2010-02-02,ORL,,MIL,W 99-82,240,33,71,.465,24,55,.436,9,16,.563,24,34,.706,99
22699,2010-02-01,DEN,,SAC,W 112-109 (OT),265,41,89,.461,37,68,.544,4,21,.190,26,38,.684,112
22700,2010-02-01,SAC,@,DEN,L 109-112 (OT),265,40,82,.488,33,63,.524,7,19,.368,22,24,.917,109
22701,2010-02-01,LAL,@,MEM,L 93-95,240,34,73,.466,26,53,.491,8,20,.400,17,27,.630,93
22702,2010-02-01,MEM,,LAL,W 95-93,240,34,82,.415,29,65,.446,5,17,.294,22,32,.688,95
22703,2010-02-01,MIA,,MIL,L 81-97,240,28,77,.364,22,55,.400,6,22,.273,19,28,.679,81
22704,2010-02-01,MIL,@,MIA,W 97-81,240,37,73,.507,32,57,.561,5,16,.313,18,22,.818,97
22705,2010-02-01,NOP,,PHO,L 100-109,240,41,90,.456,35,72,.486,6,18,.333,12,16,.750,100
22706,2010-02-01,PHO,@,NOH,W 109-100,240,43,83,.518,37,62,.597,6,21,.286,17,23,.739,109
22707,2010-02-01,CHA,@,POR,L 79-98,240,26,64,.406,20,41,.488,6,23,.261,21,24,.875,79
22708,2010-02-01,POR,,CHA,W 98-79,240,40,75,.533,33,55,.600,7,20,.350,11,13,.846,98
22709,2010-02-01,DAL,@,UTA,L 92-104,240,36,78,.462,32,67,.478,4,11,.364,16,18,.889,92
22710,2010-02-01,UTA,,DAL,W 104-92,240,39,79,.494,35,65,.538,4,14,.286,22,25,.880,104
22711,2010-02-01,BOS,@,WAS,W 99-88,240,34,62,.548,31,54,.574,3,8,.375,28,36,.778,99
22712,2010-02-01,WAS,,BOS,L 88-99,240,28,72,.389,27,62,.435,1,10,.100,31,36,.861,88
22713,2010-01-31,BOS,,LAL,L 89-90,240,34,73,.466,28,53,.528,6,20,.300,15,19,.789,89
22714,2010-01-31,LAL,@,BOS,W 90-89,240,35,73,.479,31,59,.525,4,14,.286,16,22,.727,90
22715,2010-01-31,CLE,,LAC,W 114-89,240,40,79,.506,24,52,.462,16,27,.593,18,24,.750,114
22716,2010-01-31,LAC,@,CLE,L 89-114,240,35,83,.422,28,64,.438,7,19,.368,12,19,.632,89
22717,2010-01-31,DET,,ORL,L 86-91,240,31,79,.392,26,63,.413,5,16,.313,19,25,.760,86
22718,2010-01-31,ORL,@,DET,W 91-86,240,30,64,.469,20,42,.476,10,22,.455,21,32,.656,91
22719,2010-01-31,HOU,,PHO,L 111-115 (OT),265,40,106,.377,29,72,.403,11,34,.324,20,29,.690,111
22720,2010-01-31,PHO,@,HOU,W 115-111 (OT),265,40,83,.482,37,69,.536,3,14,.214,32,35,.914,115
22721,2010-01-31,MIN,,NYK,W 112-91,240,42,84,.500,34,65,.523,8,19,.421,20,25,.800,112
22722,2010-01-31,NYK,@,MIN,L 91-112,240,35,88,.398,26,60,.433,9,28,.321,12,16,.750,91
22723,2010-01-31,BRK,,PHI,L 79-83,240,32,81,.395,25,59,.424,7,22,.318,8,10,.800,79
22724,2010-01-31,PHI,@,NJN,W 83-79,240,31,85,.365,28,75,.373,3,10,.300,18,29,.621,83
22725,2010-01-31,GSW,@,OKC,L 104-112,240,37,79,.468,31,66,.470,6,13,.462,24,29,.828,104
22726,2010-01-31,OKC,,GSW,W 112-104,240,39,76,.513,35,66,.530,4,10,.400,30,41,.732,112
22727,2010-01-31,DEN,@,SAS,W 103-89,240,37,69,.536,28,57,.491,9,12,.750,20,25,.800,103
22728,2010-01-31,SAS,,DEN,L 89-103,240,34,79,.430,31,62,.500,3,17,.176,18,21,.857,89
22729,2010-01-31,IND,@,TOR,L 102-117,240,39,82,.476,29,55,.527,10,27,.370,14,20,.700,102
22730,2010-01-31,TOR,,IND,W 117-102,240,50,83,.602,43,67,.642,7,16,.438,10,16,.625,117
22731,2010-01-30,DAL,,POR,L 112-114 (OT),265,42,89,.472,35,75,.467,7,14,.500,21,22,.955,112
22732,2010-01-30,POR,@,DAL,W 114-112 (OT),265,46,86,.535,43,76,.566,3,10,.300,19,25,.760,114
22733,2010-01-30,MEM,,NOH,L 102-109 (OT),265,43,99,.434,40,78,.513,3,21,.143,13,18,.722,102
22734,2010-01-30,NOP,@,MEM,W 109-102 (OT),265,40,84,.476,36,70,.514,4,14,.286,25,31,.806,109
22735,2010-01-30,MIA,@,MIL,L 84-95,240,29,78,.372,23,56,.411,6,22,.273,20,28,.714,84
22736,2010-01-30,MIL,,MIA,W 95-84,240,34,75,.453,27,59,.458,7,16,.438,20,25,.800,95
22737,2010-01-30,ATL,@,ORL,L 86-104,240,32,81,.395,25,60,.417,7,21,.333,15,20,.750,86
22738,2010-01-30,ORL,,ATL,W 104-86,240,39,72,.542,32,49,.653,7,23,.304,19,27,.704,104
22739,2010-01-30,CHA,@,SAC,W 103-96,240,39,81,.481,34,65,.523,5,16,.313,20,29,.690,103
22740,2010-01-30,SAC,,CHA,L 96-103,240,39,86,.453,29,64,.453,10,22,.455,8,13,.615,96
22741,2010-01-30,NYK,@,WAS,L 96-106,240,38,85,.447,32,64,.500,6,21,.286,14,22,.636,96
22742,2010-01-30,WAS,,NYK,W 106-96,240,44,98,.449,33,77,.429,11,21,.524,7,10,.700,106
22743,2010-01-29,ATL,,BOS,W 100-91,240,37,78,.474,31,63,.492,6,15,.400,20,27,.741,100
22744,2010-01-29,BOS,@,ATL,L 91-100,240,31,74,.419,28,62,.452,3,12,.250,26,30,.867,91
22745,2010-01-29,DET,,MIA,L 65-92,240,26,66,.394,25,62,.403,1,4,.250,12,19,.632,65
22746,2010-01-29,MIA,@,DET,W 92-65,240,35,73,.479,25,58,.431,10,15,.667,12,17,.706,92
22747,2010-01-29,CHA,@,GSW,W 121-110,240,41,81,.506,31,63,.492,10,18,.556,29,39,.744,121
22748,2010-01-29,GSW,,CHA,L 110-121,240,45,85,.529,42,66,.636,3,19,.158,17,29,.586,110
22749,2010-01-29,HOU,,POR,W 104-100,240,35,75,.467,30,57,.526,5,18,.278,29,43,.674,104
22750,2010-01-29,POR,@,HOU,L 100-104,240,37,81,.457,29,60,.483,8,21,.381,18,21,.857,100
22751,2010-01-29,CLE,@,IND,W 94-73,240,32,69,.464,25,47,.532,7,22,.318,23,44,.523,94
22752,2010-01-29,IND,,CLE,L 73-94,240,31,92,.337,25,67,.373,6,25,.240,5,5,1.000,73
22753,2010-01-29,LAC,@,MIN,L 97-111,240,39,94,.415,34,71,.479,5,23,.217,14,27,.519,97
22754,2010-01-29,MIN,,LAC,W 111-97,240,43,82,.524,35,64,.547,8,18,.444,17,22,.773,111
22755,2010-01-29,BRK,,WAS,L 79-81,240,30,66,.455,28,61,.459,2,5,.400,17,25,.680,79
22756,2010-01-29,WAS,@,NJN,W 81-79,240,32,76,.421,29,59,.492,3,17,.176,14,17,.824,81
22757,2010-01-29,CHI,@,NOH,W 108-106 (OT),265,41,91,.451,36,78,.462,5,13,.385,21,27,.778,108
22758,2010-01-29,NOP,,CHI,L 106-108 (OT),265,39,99,.394,27,77,.351,12,22,.545,16,19,.842,106
22759,2010-01-29,DEN,@,OKC,L 84-101,240,27,67,.403,17,46,.370,10,21,.476,20,22,.909,84
22760,2010-01-29,OKC,,DEN,W 101-84,240,42,81,.519,37,72,.514,5,9,.556,12,18,.667,101
22761,2010-01-29,LAL,@,PHI,W 99-91,240,37,81,.457,34,66,.515,3,15,.200,22,27,.815,99
22762,2010-01-29,PHI,,LAL,L 91-99,240,36,80,.450,32,69,.464,4,11,.364,15,20,.750,91
22763,2010-01-29,MEM,@,SAS,L 97-104,240,37,73,.507,33,64,.516,4,9,.444,19,23,.826,97
22764,2010-01-29,SAS,,MEM,W 104-97,240,42,87,.483,34,68,.500,8,19,.421,12,18,.667,104
22765,2010-01-29,SAC,@,UTA,L 94-101,240,33,76,.434,28,56,.500,5,20,.250,23,26,.885,94
22766,2010-01-29,UTA,,SAC,W 101-94,240,35,72,.486,31,60,.517,4,12,.333,27,40,.675,101
22767,2010-01-28,NYK,,TOR,L 104-106,240,38,87,.437,31,64,.484,7,23,.304,21,24,.875,104
22768,2010-01-28,TOR,@,NYK,W 106-104,240,40,81,.494,33,60,.550,7,21,.333,19,26,.731,106
22769,2010-01-28,BOS,@,ORL,L 94-96,240,35,74,.473,23,48,.479,12,26,.462,12,18,.667,94
22770,2010-01-28,ORL,,BOS,W 96-94,240,32,73,.438,26,53,.491,6,20,.300,26,40,.650,96
22771,2010-01-28,DAL,@,PHO,L 106-112,240,41,82,.500,36,66,.545,5,16,.313,19,23,.826,106
22772,2010-01-28,PHO,,DAL,W 112-106,240,40,73,.548,31,58,.534,9,15,.600,23,31,.742,112
22773,2010-01-27,CLE,,MIN,W 109-95,240,40,73,.548,35,57,.614,5,16,.313,24,28,.857,109
22774,2010-01-27,MIN,@,CLE,L 95-109,240,37,95,.389,33,82,.402,4,13,.308,17,23,.739,95
22775,2010-01-27,DET,,MEM,L 93-99,240,40,85,.471,38,75,.507,2,10,.200,11,19,.579,93
22776,2010-01-27,MEM,@,DET,W 99-93,240,34,77,.442,29,69,.420,5,8,.625,26,28,.929,99
22777,2010-01-27,GSW,,NOH,L 110-123,240,45,89,.506,38,69,.551,7,20,.350,13,18,.722,110
22778,2010-01-27,NOP,@,GSW,W 123-110,240,45,86,.523,39,69,.565,6,17,.353,27,29,.931,123
22779,2010-01-27,DEN,@,HOU,W 97-92,240,32,72,.444,28,55,.509,4,17,.235,29,39,.744,97
22780,2010-01-27,HOU,,DEN,L 92-97,240,36,83,.434,29,64,.453,7,19,.368,13,19,.684,92
22781,2010-01-27,IND,,LAL,L 96-118,240,39,93,.419,32,65,.492,7,28,.250,11,14,.786,96
22782,2010-01-27,LAL,@,IND,W 118-96,240,44,97,.454,39,75,.520,5,22,.227,25,30,.833,118
22783,2010-01-27,MIL,,PHI,W 91-88,240,37,85,.435,32,72,.444,5,13,.385,12,21,.571,91
22784,2010-01-27,PHI,@,MIL,L 88-91,240,36,78,.462,34,64,.531,2,14,.143,14,21,.667,88
22785,2010-01-27,LAC,@,NJN,L 87-103,240,32,76,.421,27,57,.474,5,19,.263,18,28,.643,87
22786,2010-01-27,BRK,,LAC,W 103-87,240,41,77,.532,36,64,.563,5,13,.385,16,18,.889,103
22787,2010-01-27,CHI,@,OKC,W 96-86,240,41,90,.456,35,73,.479,6,17,.353,8,8,1.000,96
22788,2010-01-27,OKC,,CHI,L 86-96,240,31,84,.369,24,65,.369,7,19,.368,17,23,.739,86
22789,2010-01-27,POR,,UTA,L 95-106,240,33,92,.359,28,68,.412,5,24,.208,24,28,.857,95
22790,2010-01-27,UTA,@,POR,W 106-95,240,38,63,.603,32,48,.667,6,15,.400,24,35,.686,106
22791,2010-01-27,ATL,@,SAS,L 90-105,240,35,88,.398,30,68,.441,5,20,.250,15,24,.625,90
22792,2010-01-27,SAS,,ATL,W 105-90,240,40,92,.435,36,76,.474,4,16,.250,21,28,.750,105
22793,2010-01-27,MIA,@,TOR,L 103-111,240,40,90,.444,35,68,.515,5,22,.227,18,21,.857,103
22794,2010-01-27,TOR,,MIA,W 111-103,240,46,81,.568,42,71,.592,4,10,.400,15,22,.682,111
22795,2010-01-26,DAL,,MIL,W 108-107,240,41,80,.513,31,62,.500,10,18,.556,16,17,.941,108
22796,2010-01-26,MIL,@,DAL,L 107-108,240,40,75,.533,31,57,.544,9,18,.500,18,22,.818,107
22797,2010-01-26,MIN,@,NYK,L 105-132,240,40,85,.471,31,68,.456,9,17,.529,16,23,.696,105
22798,2010-01-26,NYK,,MIN,W 132-105,240,47,93,.505,30,53,.566,17,40,.425,21,25,.840,132
22799,2010-01-26,CHA,@,PHO,W 114-109 (OT),265,41,92,.446,34,71,.479,7,21,.333,25,30,.833,114
22800,2010-01-26,PHO,,CHA,L 109-114 (OT),265,39,87,.448,24,53,.453,15,34,.441,16,17,.941,109
22801,2010-01-26,GSW,@,SAC,L 96-99,240,30,94,.319,26,71,.366,4,23,.174,32,42,.762,96
22802,2010-01-26,SAC,,GSW,W 99-96,240,35,92,.380,31,77,.403,4,15,.267,25,33,.758,99
22803,2010-01-26,LAL,@,WAS,W 115-103,240,44,75,.587,35,53,.660,9,22,.409,18,22,.818,115
22804,2010-01-26,WAS,,LAL,L 103-115,240,43,87,.494,36,67,.537,7,20,.350,10,14,.714,103
22805,2010-01-25,BOS,,LAC,W 95-89,240,34,72,.472,30,58,.517,4,14,.286,23,34,.676,95
22806,2010-01-25,LAC,@,BOS,L 89-95,240,31,80,.388,26,68,.382,5,12,.417,22,28,.786,89
22807,2010-01-25,CHA,@,DEN,L 93-104,240,34,72,.472,29,59,.492,5,13,.385,20,28,.714,93
22808,2010-01-25,DEN,,CHA,W 104-93,240,36,79,.456,26,56,.464,10,23,.435,22,26,.846,104
22809,2010-01-25,ATL,@,HOU,W 102-95,240,39,82,.476,30,58,.517,9,24,.375,15,19,.789,102
22810,2010-01-25,HOU,,ATL,L 95-102,240,33,83,.398,28,62,.452,5,21,.238,24,30,.800,95
22811,2010-01-25,MEM,,ORL,W 99-94,240,38,82,.463,32,70,.457,6,12,.500,17,26,.654,99
22812,2010-01-25,ORL,@,MEM,L 94-99,240,33,78,.423,20,43,.465,13,35,.371,15,18,.833,94
22813,2010-01-25,CLE,@,MIA,W 92-91,240,33,73,.452,26,51,.510,7,22,.318,19,28,.679,92
22814,2010-01-25,MIA,,CLE,L 91-92,240,34,78,.436,28,63,.444,6,15,.400,17,29,.586,91
22815,2010-01-25,IND,@,PHI,W 109-98,240,43,83,.518,35,61,.574,8,22,.364,15,22,.682,109
22816,2010-01-25,PHI,,IND,L 98-109,240,36,82,.439,28,64,.438,8,18,.444,18,26,.692,98
22817,2010-01-25,NOP,@,POR,W 98-97,240,35,68,.515,26,49,.531,9,19,.474,19,22,.864,98
22818,2010-01-25,POR,,NOH,L 97-98,240,40,84,.476,32,67,.478,8,17,.471,9,13,.692,97
22819,2010-01-25,CHI,@,SAS,W 98-93,240,42,78,.538,37,67,.552,5,11,.455,9,12,.750,98
22820,2010-01-25,SAS,,CHI,L 93-98,240,39,93,.419,36,79,.456,3,14,.214,12,20,.600,93
22821,2010-01-25,PHO,@,UTA,L 115-124,240,41,84,.488,24,54,.444,17,30,.567,16,23,.696,115
22822,2010-01-25,UTA,,PHO,W 124-115,240,44,84,.524,37,64,.578,7,20,.350,29,37,.784,124
22823,2010-01-24,DAL,@,NYK,W 128-78,240,50,86,.581,38,64,.594,12,22,.545,16,17,.941,128
22824,2010-01-24,NYK,,DAL,L 78-128,240,29,86,.337,25,61,.410,4,25,.160,16,21,.762,78
22825,2010-01-24,LAL,@,TOR,L 105-106,240,45,98,.459,39,79,.494,6,19,.316,9,9,1.000,105
22826,2010-01-24,TOR,,LAL,W 106-105,240,39,82,.476,32,64,.500,7,18,.389,21,26,.808,106
22827,2010-01-24,LAC,@,WAS,W 92-78,240,37,86,.430,34,70,.486,3,16,.188,15,20,.750,92
22828,2010-01-24,WAS,,LAC,L 78-92,240,32,81,.395,27,63,.429,5,18,.278,9,17,.529,78
22829,2010-01-23,CHA,,ORL,L 95-106 (OT),265,35,88,.398,26,61,.426,9,27,.333,16,22,.727,95
22830,2010-01-23,ORL,@,CHA,W 106-95 (OT),265,38,87,.437,24,48,.500,14,39,.359,16,22,.727,106
22831,2010-01-23,CLE,,OKC,W 100-99,240,34,69,.493,22,41,.537,12,28,.429,20,40,.500,100
22832,2010-01-23,OKC,@,CLE,L 99-100,240,33,86,.384,28,75,.373,5,11,.455,28,33,.848,99
22833,2010-01-23,DEN,,NOH,W 116-110 (OT),265,40,90,.444,30,63,.476,10,27,.370,26,36,.722,116
22834,2010-01-23,NOP,@,DEN,L 110-116 (OT),265,42,92,.457,35,66,.530,7,26,.269,19,22,.864,110
22835,2010-01-23,DET,,POR,L 93-97,240,32,75,.427,28,54,.519,4,21,.190,25,34,.735,93
22836,2010-01-23,POR,@,DET,W 97-93,240,34,71,.479,26,49,.531,8,22,.364,21,26,.808,97
22837,2010-01-23,CHI,@,HOU,W 104-97,240,39,73,.534,32,61,.525,7,12,.583,19,26,.731,104
22838,2010-01-23,HOU,,CHI,L 97-104,240,34,85,.400,26,63,.413,8,22,.364,21,23,.913,97
22839,2010-01-23,IND,,PHI,L 97-107,240,34,76,.447,24,49,.490,10,27,.370,19,22,.864,97
22840,2010-01-23,PHI,@,IND,W 107-97,240,40,97,.412,33,86,.384,7,11,.636,20,23,.870,107
22841,2010-01-23,MIA,,SAC,W 115-84,240,44,78,.564,38,63,.603,6,15,.400,21,32,.656,115
22842,2010-01-23,SAC,@,MIA,L 84-115,240,32,73,.438,30,62,.484,2,11,.182,18,32,.563,84
22843,2010-01-23,MIL,,MIN,W 127-94,240,49,86,.570,38,63,.603,11,23,.478,18,21,.857,127
22844,2010-01-23,MIN,@,MIL,L 94-127,240,33,86,.384,31,73,.425,2,13,.154,26,37,.703,94
22845,2010-01-23,GSW,@,PHO,L 103-112,240,41,94,.436,33,71,.465,8,23,.348,13,15,.867,103
22846,2010-01-23,PHO,,GSW,W 112-103,240,37,85,.435,28,58,.483,9,27,.333,29,33,.879,112
22847,2010-01-23,BRK,@,UTA,L 83-116,240,31,73,.425,24,54,.444,7,19,.368,14,23,.609,83
22848,2010-01-23,UTA,,NJN,W 116-83,240,44,72,.611,42,65,.646,2,7,.286,26,34,.765,116
22849,2010-01-22,ATL,,CHA,W 103-89,240,42,82,.512,37,65,.569,5,17,.294,14,14,1.000,103
22850,2010-01-22,CHA,@,ATL,L 89-103,240,32,69,.464,29,56,.518,3,13,.231,22,30,.733,89
22851,2010-01-22,BOS,,POR,W 98-95 (OT),265,38,78,.487,32,58,.552,6,20,.300,16,18,.889,98
22852,2010-01-22,POR,@,BOS,L 95-98 (OT),265,34,89,.382,29,64,.453,5,25,.200,22,27,.815,95
22853,2010-01-22,DET,,IND,L 93-105,240,35,85,.412,34,76,.447,1,9,.111,22,31,.710,93
22854,2010-01-22,IND,@,DET,W 105-93,240,36,76,.474,27,51,.529,9,25,.360,24,26,.923,105
22855,2010-01-22,GSW,,NJN,W 111-79,240,40,77,.519,34,59,.576,6,18,.333,25,31,.806,111
22856,2010-01-22,BRK,@,GSW,L 79-111,240,26,73,.356,23,62,.371,3,11,.273,24,32,.750,79
22857,2010-01-22,MEM,,OKC,W 86-84,240,29,74,.392,25,59,.424,4,15,.267,24,34,.706,86
22858,2010-01-22,OKC,@,MEM,L 84-86,240,31,77,.403,27,63,.429,4,14,.286,18,23,.783,84
22859,2010-01-22,MIN,,NOH,L 94-96,240,38,80,.475,34,68,.500,4,12,.333,14,16,.875,94
22860,2010-01-22,NOP,@,MIN,W 96-94,240,32,73,.438,28,53,.528,4,20,.200,28,34,.824,96
22861,2010-01-22,LAL,@,NYK,W 115-105,240,39,78,.500,27,55,.491,12,23,.522,25,31,.806,115
22862,2010-01-22,NYK,,LAL,L 105-115,240,41,91,.451,35,69,.507,6,22,.273,17,21,.810,105
22863,2010-01-22,ORL,,SAC,W 100-84,240,32,74,.432,25,49,.510,7,25,.280,29,33,.879,100
22864,2010-01-22,SAC,@,ORL,L 84-100,240,31,93,.333,27,81,.333,4,12,.333,18,27,.667,84
22865,2010-01-22,DAL,@,PHI,L 81-92,240,32,81,.395,29,66,.439,3,15,.200,14,17,.824,81
22866,2010-01-22,PHI,,DAL,W 92-81,240,37,86,.430,34,71,.479,3,15,.200,15,18,.833,92
22867,2010-01-22,CHI,@,PHO,W 115-104,240,43,85,.506,37,71,.521,6,14,.429,23,28,.821,115
22868,2010-01-22,PHO,,CHI,L 104-115,240,37,96,.385,26,70,.371,11,26,.423,19,24,.792,104
22869,2010-01-22,HOU,@,SAS,W 116-109,240,43,78,.551,35,62,.565,8,16,.500,22,27,.815,116
22870,2010-01-22,SAS,,HOU,L 109-116,240,38,91,.418,30,69,.435,8,22,.364,25,33,.758,109
22871,2010-01-22,MIL,@,TOR,L 96-101,240,35,79,.443,30,53,.566,5,26,.192,21,24,.875,96
22872,2010-01-22,TOR,,MIL,W 101-96,240,32,75,.427,26,55,.473,6,20,.300,31,42,.738,101
22873,2010-01-22,MIA,@,WAS,W 112-88,240,45,79,.570,32,57,.561,13,22,.591,9,12,.750,112
22874,2010-01-22,WAS,,MIA,L 88-112,240,32,81,.395,24,61,.393,8,20,.400,16,21,.762,88
22875,2010-01-21,CLE,,LAL,W 93-87,240,34,71,.479,28,53,.528,6,18,.333,19,25,.760,93
22876,2010-01-21,LAL,@,CLE,L 87-93,240,32,83,.386,24,60,.400,8,23,.348,15,24,.625,87
22877,2010-01-21,DEN,,LAC,W 105-85,240,34,71,.479,23,49,.469,11,22,.500,26,37,.703,105
22878,2010-01-21,LAC,@,DEN,L 85-105,240,34,90,.378,33,73,.452,1,17,.059,16,19,.842,85
22879,2010-01-20,ATL,,SAC,W 108-97,240,40,78,.513,35,64,.547,5,14,.357,23,28,.821,108
22880,2010-01-20,SAC,@,ATL,L 97-108,240,41,87,.471,38,72,.528,3,15,.200,12,15,.800,97
22881,2010-01-20,CHA,,MIA,W 104-65,240,35,72,.486,30,60,.500,5,12,.417,29,37,.784,104
22882,2010-01-20,MIA,@,CHA,L 65-104,240,22,76,.289,20,53,.377,2,23,.087,19,31,.613,65
22883,2010-01-20,BOS,@,DET,L 86-92,240,30,70,.429,25,51,.490,5,19,.263,21,28,.750,86
22884,2010-01-20,DET,,BOS,W 92-86,240,36,85,.424,32,71,.451,4,14,.286,16,21,.762,92
22885,2010-01-20,DEN,@,GSW,W 123-118 (OT),265,42,88,.477,33,69,.478,9,19,.474,30,43,.698,123
22886,2010-01-20,GSW,,DEN,L 118-123 (OT),265,41,95,.432,32,66,.485,9,29,.310,27,32,.844,118
22887,2010-01-20,CHI,@,LAC,L 97-104,240,39,91,.429,37,80,.463,2,11,.182,17,26,.654,97
22888,2010-01-20,LAC,,CHI,W 104-97,240,38,82,.463,33,71,.465,5,11,.455,23,39,.590,104
22889,2010-01-20,MIL,,TOR,W 113-107,240,43,92,.467,33,69,.478,10,23,.435,17,20,.850,113
22890,2010-01-20,TOR,@,MIL,L 107-113,240,38,85,.447,33,69,.478,5,16,.313,26,27,.963,107
22891,2010-01-20,MIN,,OKC,L 92-94,240,40,85,.471,37,74,.500,3,11,.273,9,10,.900,92
22892,2010-01-20,OKC,@,MIN,W 94-92,240,34,74,.459,26,57,.456,8,17,.471,18,21,.857,94
22893,2010-01-20,MEM,@,NOH,L 111-113,240,45,85,.529,41,72,.569,4,13,.308,17,20,.850,111
22894,2010-01-20,NOP,,MEM,W 113-111,240,48,87,.552,44,68,.647,4,19,.211,13,17,.765,113
22895,2010-01-20,IND,@,ORL,L 98-109,240,34,76,.447,28,52,.538,6,24,.250,24,33,.727,98
22896,2010-01-20,ORL,,IND,W 109-98,240,37,75,.493,27,49,.551,10,26,.385,25,37,.676,109
22897,2010-01-20,PHI,,POR,L 90-98,240,34,78,.436,30,64,.469,4,14,.286,18,21,.857,90
22898,2010-01-20,POR,@,PHI,W 98-90,240,36,76,.474,32,65,.492,4,11,.364,22,25,.880,98
22899,2010-01-20,BRK,@,PHO,L 94-118,240,38,87,.437,35,73,.479,3,14,.214,15,20,.750,94
22900,2010-01-20,PHO,,NJN,W 118-94,240,45,84,.536,41,71,.577,4,13,.308,24,29,.828,118
22901,2010-01-20,SAS,,UTA,L 98-105,240,35,89,.393,29,68,.426,6,21,.286,22,26,.846,98
22902,2010-01-20,UTA,@,SAS,W 105-98,240,37,79,.468,34,68,.500,3,11,.273,28,32,.875,105
22903,2010-01-20,DAL,@,WAS,W 94-93,240,39,85,.459,35,65,.538,4,20,.200,12,14,.857,94
22904,2010-01-20,WAS,,DAL,L 93-94,240,36,81,.444,31,68,.456,5,13,.385,16,20,.800,93
22905,2010-01-19,CLE,,TOR,W 108-100,240,38,72,.528,31,50,.620,7,22,.318,25,30,.833,108
22906,2010-01-19,TOR,@,CLE,L 100-108,240,40,83,.482,33,64,.516,7,19,.368,13,21,.619,100
22907,2010-01-19,IND,@,MIA,L 83-113,240,31,85,.365,24,59,.407,7,26,.269,14,20,.700,83
22908,2010-01-19,MIA,,IND,W 113-83,240,45,80,.563,35,63,.556,10,17,.588,13,19,.684,113
22909,2010-01-18,ATL,,OKC,L 91-94,240,36,90,.400,32,74,.432,4,16,.250,15,21,.714,91
22910,2010-01-18,OKC,@,ATL,W 94-91,240,34,76,.447,30,67,.448,4,9,.444,22,26,.846,94
22911,2010-01-18,BOS,,DAL,L 90-99,240,39,77,.506,35,64,.547,4,13,.308,8,16,.500,90
22912,2010-01-18,DAL,@,BOS,W 99-90,240,39,68,.574,35,61,.574,4,7,.571,17,24,.708,99
22913,2010-01-18,CHA,,SAC,W 105-103,240,39,83,.470,34,67,.507,5,16,.313,22,33,.667,105
22914,2010-01-18,SAC,@,CHA,L 103-105,240,41,84,.488,34,57,.596,7,27,.259,14,21,.667,103
22915,2010-01-18,CHI,@,GSW,L 97-114,240,35,96,.365,30,86,.349,5,10,.500,22,33,.667,97
22916,2010-01-18,GSW,,CHI,W 114-97,240,42,95,.442,33,73,.452,9,22,.409,21,32,.656,114
22917,2010-01-18,HOU,,MIL,W 101-98 (OT),265,36,86,.419,30,62,.484,6,24,.250,23,28,.821,101
22918,2010-01-18,MIL,@,HOU,L 98-101 (OT),265,41,92,.446,32,67,.478,9,25,.360,7,11,.636,98
22919,2010-01-18,LAC,,NJN,W 106-95,240,40,72,.556,37,60,.617,3,12,.250,23,29,.793,106
22920,2010-01-18,BRK,@,LAC,L 95-106,240,38,83,.458,35,70,.500,3,13,.231,16,20,.800,95
22921,2010-01-18,LAL,,ORL,W 98-92,240,38,89,.427,32,71,.451,6,18,.333,16,22,.727,98
22922,2010-01-18,ORL,@,LAL,L 92-98,240,36,82,.439,25,49,.510,11,33,.333,9,15,.600,92
22923,2010-01-18,MEM,,PHO,W 125-118,240,45,89,.506,36,70,.514,9,19,.474,26,32,.813,125
22924,2010-01-18,PHO,@,MEM,L 118-125,240,47,96,.490,37,67,.552,10,29,.345,14,19,.737,118
22925,2010-01-18,MIN,,PHI,W 108-103 (OT),265,41,88,.466,34,76,.447,7,12,.583,19,22,.864,108
22926,2010-01-18,PHI,@,MIN,L 103-108 (OT),265,40,83,.482,34,64,.531,6,19,.316,17,24,.708,103
22927,2010-01-18,NOP,,SAS,L 90-97,240,38,83,.458,34,70,.486,4,13,.308,10,12,.833,90
22928,2010-01-18,SAS,@,NOH,W 97-90,240,33,78,.423,26,60,.433,7,18,.389,24,38,.632,97
22929,2010-01-18,DET,@,NYK,L 91-99,240,39,96,.406,39,84,.464,0,12,.000,13,19,.684,91
22930,2010-01-18,NYK,,DET,W 99-91,240,36,73,.493,26,51,.510,10,22,.455,17,22,.773,99
22931,2010-01-18,POR,@,WAS,L 92-97,240,37,82,.451,34,65,.523,3,17,.176,15,16,.938,92
22932,2010-01-18,WAS,,POR,W 97-92,240,35,68,.515,33,60,.550,2,8,.250,25,28,.893,97
22933,2010-01-17,DEN,,UTA,W 119-112,240,36,74,.486,30,53,.566,6,21,.286,41,49,.837,119
22934,2010-01-17,UTA,@,DEN,L 112-119,240,42,81,.519,34,63,.540,8,18,.444,20,27,.741,112
22935,2010-01-17,DAL,@,TOR,L 88-110,240,36,80,.450,31,65,.477,5,15,.333,11,16,.688,88
22936,2010-01-17,TOR,,DAL,W 110-88,240,44,90,.489,37,74,.500,7,16,.438,15,22,.682,110
22937,2010-01-16,CHA,,PHO,W 125-99,240,46,91,.505,36,76,.474,10,15,.667,23,27,.852,125
22938,2010-01-16,PHO,@,CHA,L 99-125,240,35,84,.417,27,61,.443,8,23,.348,21,25,.840,99
22939,2010-01-16,DET,,NYK,W 94-90,240,32,82,.390,28,69,.406,4,13,.308,26,36,.722,94
22940,2010-01-16,NYK,@,DET,L 90-94,240,32,81,.395,25,64,.391,7,17,.412,19,21,.905,90
22941,2010-01-16,IND,,NOH,L 96-101,240,38,88,.432,32,59,.542,6,29,.207,14,18,.778,96
22942,2010-01-16,NOP,@,IND,W 101-96,240,39,91,.429,35,76,.461,4,15,.267,19,23,.826,101
22943,2010-01-16,CLE,@,LAC,W 102-101,240,38,79,.481,31,56,.554,7,23,.304,19,24,.792,102
22944,2010-01-16,LAC,,CLE,L 101-102,240,37,62,.597,27,43,.628,10,19,.526,17,24,.708,101
22945,2010-01-16,MEM,,SAS,W 92-86,240,36,83,.434,33,74,.446,3,9,.333,17,27,.630,92
22946,2010-01-16,SAS,@,MEM,L 86-92,240,36,87,.414,29,66,.439,7,21,.333,7,12,.583,86
22947,2010-01-16,MIA,@,OKC,L 80-98,240,34,82,.415,33,74,.446,1,8,.125,11,20,.550,80
22948,2010-01-16,OKC,,MIA,W 98-80,240,38,75,.507,32,63,.508,6,12,.500,16,20,.800,98
22949,2010-01-16,MIL,@,UTA,L 95-112,240,35,81,.432,24,57,.421,11,24,.458,14,21,.667,95
22950,2010-01-16,UTA,,MIL,W 112-95,240,44,78,.564,36,62,.581,8,16,.500,16,26,.615,112
22951,2010-01-16,SAC,@,WAS,L 86-96,240,31,83,.373,24,60,.400,7,23,.304,17,19,.895,86
22952,2010-01-16,WAS,,SAC,W 96-86,240,38,80,.475,35,67,.522,3,13,.231,17,23,.739,96
22953,2010-01-15,ATL,,PHO,W 102-101,240,37,90,.411,32,67,.478,5,23,.217,23,28,.821,102
22954,2010-01-15,PHO,@,ATL,L 101-102,240,38,86,.442,36,73,.493,2,13,.154,23,32,.719,101
22955,2010-01-15,CHA,,SAS,W 92-76,240,35,76,.461,29,62,.468,6,14,.429,16,21,.762,92
22956,2010-01-15,SAS,@,CHA,L 76-92,240,31,80,.388,26,55,.473,5,25,.200,9,13,.692,76
22957,2010-01-15,CHI,,WAS,W 121-119 (2OT),290,44,97,.454,40,87,.460,4,10,.400,29,35,.829,121
22958,2010-01-15,WAS,@,CHI,L 119-121 (2OT),290,46,102,.451,39,80,.488,7,22,.318,20,30,.667,119
22959,2010-01-15,DAL,,OKC,W 99-98,240,31,70,.443,27,56,.482,4,14,.286,33,39,.846,99
22960,2010-01-15,OKC,@,DAL,L 98-99,240,34,81,.420,28,64,.438,6,17,.353,24,29,.828,98
22961,2010-01-15,DET,,NOH,W 110-104 (OT),265,36,80,.450,29,63,.460,7,17,.412,31,40,.775,110
22962,2010-01-15,NOP,@,DET,L 104-110 (OT),265,38,79,.481,31,57,.544,7,22,.318,21,25,.840,104
22963,2010-01-15,GSW,,MIL,L 104-113,240,40,85,.471,35,67,.522,5,18,.278,19,27,.704,104
22964,2010-01-15,MIL,@,GSW,W 113-104,240,38,83,.458,32,62,.516,6,21,.286,31,39,.795,113
22965,2010-01-15,HOU,,MIA,L 106-115,240,37,76,.487,26,55,.473,11,21,.524,21,25,.840,106
22966,2010-01-15,MIA,@,HOU,W 115-106,240,45,84,.536,39,70,.557,6,14,.429,19,23,.826,115
22967,2010-01-15,LAC,@,LAL,L 86-126,240,31,77,.403,26,57,.456,5,20,.250,19,25,.760,86
22968,2010-01-15,LAL,,LAC,W 126-86,240,41,82,.500,31,60,.517,10,22,.455,34,41,.829,126
22969,2010-01-15,MEM,,MIN,W 135-110,240,55,94,.585,44,71,.620,11,23,.478,14,16,.875,135
22970,2010-01-15,MIN,@,MEM,L 110-135,240,43,90,.478,38,78,.487,5,12,.417,19,24,.792,110
22971,2010-01-15,IND,@,NJN,W 121-105,240,43,81,.531,30,58,.517,13,23,.565,22,26,.846,121
22972,2010-01-15,BRK,,IND,L 105-121,240,34,81,.420,29,67,.433,5,14,.357,32,39,.821,105
22973,2010-01-15,NYK,,TOR,L 104-112,240,38,86,.442,27,57,.474,11,29,.379,17,20,.850,104
22974,2010-01-15,TOR,@,NYK,W 112-104,240,39,73,.534,27,51,.529,12,22,.545,22,31,.710,112
22975,2010-01-15,PHI,,SAC,W 98-86,240,37,82,.451,33,70,.471,4,12,.333,20,26,.769,98
22976,2010-01-15,SAC,@,PHI,L 86-98,240,26,70,.371,20,55,.364,6,15,.400,28,33,.848,86
22977,2010-01-15,ORL,@,POR,L 87-102,240,35,73,.479,28,43,.651,7,30,.233,10,20,.500,87
22978,2010-01-15,POR,,ORL,W 102-87,240,41,87,.471,30,66,.455,11,21,.524,9,10,.900,102
22979,2010-01-14,BOS,,CHI,L 83-96,240,32,71,.451,28,54,.519,4,17,.235,15,28,.536,83
22980,2010-01-14,CHI,@,BOS,W 96-83,240,38,84,.452,36,78,.462,2,6,.333,18,25,.720,96
22981,2010-01-14,CLE,@,UTA,L 96-97,240,31,68,.456,22,49,.449,9,19,.474,25,35,.714,96
22982,2010-01-14,UTA,,CLE,W 97-96,240,32,79,.405,26,60,.433,6,19,.316,27,38,.711,97
22983,2010-01-13,ATL,,WAS,W 94-82,240,37,85,.435,31,64,.484,6,21,.286,14,20,.700,94
22984,2010-01-13,WAS,@,ATL,L 82-94,240,29,81,.358,23,69,.333,6,12,.500,18,21,.857,82
22985,2010-01-13,DAL,,LAL,L 95-100,240,36,85,.424,28,61,.459,8,24,.333,15,21,.714,95
22986,2010-01-13,LAL,@,DAL,W 100-95,240,39,80,.488,36,66,.545,3,14,.214,19,22,.864,100
22987,2010-01-13,DEN,,ORL,W 115-97,240,43,77,.558,33,56,.589,10,21,.476,19,26,.731,115
22988,2010-01-13,ORL,@,DEN,L 97-115,240,34,78,.436,22,47,.468,12,31,.387,17,23,.739,97
22989,2010-01-13,GSW,,MIA,L 102-115,240,33,77,.429,22,53,.415,11,24,.458,25,32,.781,102
22990,2010-01-13,MIA,@,GSW,W 115-102,240,42,75,.560,34,59,.576,8,16,.500,23,26,.885,115
22991,2010-01-13,HOU,,MIN,W 120-114 (3OT),315,45,106,.425,37,82,.451,8,24,.333,22,34,.647,120
22992,2010-01-13,MIN,@,HOU,L 114-120 (3OT),315,43,111,.387,36,92,.391,7,19,.368,21,26,.808,114
22993,2010-01-13,IND,,PHO,W 122-114,240,37,86,.430,25,57,.439,12,29,.414,36,42,.857,122
22994,2010-01-13,PHO,@,IND,L 114-122,240,41,96,.427,34,79,.430,7,17,.412,25,31,.806,114
22995,2010-01-13,BOS,@,NJN,W 111-87,240,43,81,.531,37,64,.578,6,17,.353,19,30,.633,111
22996,2010-01-13,BRK,,BOS,L 87-111,240,26,69,.377,24,60,.400,2,9,.222,33,43,.767,87
22997,2010-01-13,LAC,@,NOH,L 94-108,240,35,86,.407,34,72,.472,1,14,.071,23,32,.719,94
22998,2010-01-13,NOP,,LAC,W 108-94,240,45,87,.517,36,60,.600,9,27,.333,9,12,.750,108
22999,2010-01-13,OKC,,SAS,L 108-109 (OT),265,41,89,.461,39,84,.464,2,5,.400,24,27,.889,108
23000,2010-01-13,SAS,@,OKC,W 109-108 (OT),265,43,95,.453,36,73,.493,7,22,.318,16,24,.667,109
23001,2010-01-13,NYK,@,PHI,W 93-92,240,36,80,.450,31,61,.508,5,19,.263,16,23,.696,93
23002,2010-01-13,PHI,,NYK,L 92-93,240,37,86,.430,31,68,.456,6,18,.333,12,16,.750,92
23003,2010-01-13,MIL,@,POR,L 108-120,240,39,86,.453,27,57,.474,12,29,.414,18,25,.720,108
23004,2010-01-13,POR,,MIL,W 120-108,240,44,73,.603,36,54,.667,8,19,.421,24,31,.774,120
23005,2010-01-12,CHA,,HOU,W 102-94,240,39,77,.506,34,62,.548,5,15,.333,19,26,.731,102
23006,2010-01-12,HOU,@,CHA,L 94-102,240,35,84,.417,25,54,.463,10,30,.333,14,18,.778,94
23007,2010-01-12,LAC,@,MEM,L 102-104,240,42,78,.538,38,59,.644,4,19,.211,14,21,.667,102
23008,2010-01-12,MEM,,LAC,W 104-102,240,38,81,.469,34,72,.472,4,9,.444,24,31,.774,104
23009,2010-01-12,ORL,@,SAC,W 109-88,240,39,77,.506,31,50,.620,8,27,.296,23,28,.821,109
23010,2010-01-12,SAC,,ORL,L 88-109,240,30,86,.349,22,59,.373,8,27,.296,20,25,.800,88
23011,2010-01-12,LAL,@,SAS,L 85-105,240,34,78,.436,32,71,.451,2,7,.286,15,16,.938,85
23012,2010-01-12,SAS,,LAL,W 105-85,240,47,82,.573,40,66,.606,7,16,.438,4,11,.364,105
23013,2010-01-12,DET,@,WAS,W 99-90,240,38,82,.463,28,66,.424,10,16,.625,13,17,.765,99
23014,2010-01-12,WAS,,DET,L 90-99,240,34,77,.442,25,59,.424,9,18,.500,13,19,.684,90
23015,2010-01-11,ATL,@,BOS,W 102-96,240,35,77,.455,26,61,.426,9,16,.563,23,33,.697,102
23016,2010-01-11,BOS,,ATL,L 96-102,240,36,65,.554,26,45,.578,10,20,.500,14,18,.778,96
23017,2010-01-11,CHI,,DET,W 120-87,240,48,84,.571,40,65,.615,8,19,.421,16,21,.762,120
23018,2010-01-11,DET,@,CHI,L 87-120,240,33,80,.413,31,69,.449,2,11,.182,19,27,.704,87
23019,2010-01-11,DEN,,MIN,W 105-94,240,38,82,.463,28,54,.519,10,28,.357,19,28,.679,105
23020,2010-01-11,MIN,@,DEN,L 94-105,240,34,92,.370,31,74,.419,3,18,.167,23,28,.821,94
23021,2010-01-11,CLE,@,GSW,W 117-114,240,43,81,.531,36,63,.571,7,18,.389,24,32,.750,117
23022,2010-01-11,GSW,,CLE,L 114-117,240,36,85,.424,26,70,.371,10,15,.667,32,38,.842,114
23023,2010-01-11,IND,,TOR,W 105-101,240,37,87,.425,26,56,.464,11,31,.355,20,27,.741,105
23024,2010-01-11,TOR,@,IND,L 101-105,240,32,81,.395,26,61,.426,6,20,.300,31,43,.721,101
23025,2010-01-11,NYK,@,OKC,L 88-106,240,34,89,.382,28,61,.459,6,28,.214,14,19,.737,88
23026,2010-01-11,OKC,,NYK,W 106-88,240,41,88,.466,37,71,.521,4,17,.235,20,24,.833,106
23027,2010-01-11,NOP,@,PHI,L 92-96,240,37,91,.407,29,73,.397,8,18,.444,10,12,.833,92
23028,2010-01-11,PHI,,NOH,W 96-92,240,33,79,.418,25,64,.391,8,15,.533,22,27,.815,96
23029,2010-01-11,MIL,@,PHO,L 101-105,240,39,101,.386,29,71,.408,10,30,.333,13,17,.765,101
23030,2010-01-11,PHO,,MIL,W 105-101,240,43,87,.494,37,71,.521,6,16,.375,13,15,.867,105
23031,2010-01-11,MIA,@,UTA,L 89-118,240,33,81,.407,23,56,.411,10,25,.400,13,16,.813,89
23032,2010-01-11,UTA,,MIA,W 118-89,240,44,77,.571,35,62,.565,9,15,.600,21,24,.875,118
23033,2010-01-10,LAC,,MIA,W 94-84,240,31,74,.419,26,60,.433,5,14,.357,27,33,.818,94
23034,2010-01-10,MIA,@,LAC,L 84-94,240,33,84,.393,30,70,.429,3,14,.214,15,18,.833,84
23035,2010-01-10,LAL,,MIL,W 95-77,240,32,80,.400,26,66,.394,6,14,.429,25,30,.833,95
23036,2010-01-10,MIL,@,LAL,L 77-95,240,31,91,.341,25,72,.347,6,19,.316,9,13,.692,77
23037,2010-01-10,CLE,@,POR,W 106-94,240,37,74,.500,30,54,.556,7,20,.350,25,30,.833,106
23038,2010-01-10,POR,,CLE,L 94-106,240,38,74,.514,33,54,.611,5,20,.250,13,20,.650,94
23039,2010-01-10,BRK,@,SAS,L 85-97,240,32,81,.395,29,67,.433,3,14,.214,18,21,.857,85
23040,2010-01-10,SAS,,NJN,W 97-85,240,36,79,.456,32,67,.478,4,12,.333,21,25,.840,97
23041,2010-01-10,BOS,@,TOR,W 114-107,240,40,79,.506,29,53,.547,11,26,.423,23,34,.676,114
23042,2010-01-10,TOR,,BOS,L 107-114,240,39,81,.481,31,62,.500,8,19,.421,21,27,.778,107
23043,2010-01-10,NOP,@,WAS,W 115-110,240,42,80,.525,29,57,.509,13,23,.565,18,28,.643,115
23044,2010-01-10,WAS,,NOH,L 110-115,240,44,75,.587,38,59,.644,6,16,.375,16,21,.762,110
23045,2010-01-09,CHA,,MEM,W 89-87,240,33,78,.423,28,60,.467,5,18,.278,18,25,.720,89
23046,2010-01-09,MEM,@,CHA,L 87-89,240,35,86,.407,31,73,.425,4,13,.308,13,18,.722,87
23047,2010-01-09,CHI,,MIN,W 110-96,240,43,83,.518,36,69,.522,7,14,.500,17,22,.773,110
23048,2010-01-09,MIN,@,CHI,L 96-110,240,37,86,.430,31,69,.449,6,17,.353,16,24,.667,96
23049,2010-01-09,DAL,,UTA,L 93-111,240,33,80,.413,25,59,.424,8,21,.381,19,23,.826,93
23050,2010-01-09,UTA,@,DAL,W 111-93,240,42,79,.532,34,62,.548,8,17,.471,19,25,.760,111
23051,2010-01-09,DET,,PHI,L 94-104,240,36,87,.414,31,70,.443,5,17,.294,17,20,.850,94
23052,2010-01-09,PHI,@,DET,W 104-94,240,39,68,.574,33,59,.559,6,9,.667,20,28,.714,104
23053,2010-01-09,HOU,,NYK,W 105-96,240,42,85,.494,37,66,.561,5,19,.263,16,19,.842,105
23054,2010-01-09,NYK,@,HOU,L 96-105,240,39,75,.520,32,55,.582,7,20,.350,11,15,.733,96
23055,2010-01-09,IND,@,OKC,L 102-108,240,36,91,.396,26,65,.400,10,26,.385,20,25,.800,102
23056,2010-01-09,OKC,,IND,W 108-102,240,38,74,.514,32,61,.525,6,13,.462,26,37,.703,108
23057,2010-01-09,ATL,@,ORL,L 81-113,240,31,78,.397,27,61,.443,4,17,.235,15,25,.600,81
23058,2010-01-09,ORL,,ATL,W 113-81,240,43,82,.524,31,54,.574,12,28,.429,15,20,.750,113
23059,2010-01-09,DEN,@,SAC,L 100-102,240,37,83,.446,29,61,.475,8,22,.364,18,23,.783,100
23060,2010-01-09,SAC,,DEN,W 102-100,240,38,78,.487,30,62,.484,8,16,.500,18,24,.750,102
23061,2010-01-08,ATL,,BOS,W 93-85,240,38,77,.494,30,61,.492,8,16,.500,9,13,.692,93
23062,2010-01-08,BOS,@,ATL,L 85-93,240,31,76,.408,22,52,.423,9,24,.375,14,20,.700,85
23063,2010-01-08,CLE,@,DEN,L 97-99,240,35,75,.467,26,53,.491,9,22,.409,18,29,.621,97
23064,2010-01-08,DEN,,CLE,W 99-97,240,35,78,.449,28,61,.459,7,17,.412,22,30,.733,99
23065,2010-01-08,GSW,,SAC,W 108-101,240,38,79,.481,35,68,.515,3,11,.273,29,33,.879,108
23066,2010-01-08,SAC,@,GSW,L 101-108,240,37,84,.440,31,61,.508,6,23,.261,21,25,.840,101
23067,2010-01-08,MEM,,UTA,W 91-89,240,30,70,.429,27,56,.482,3,14,.214,28,36,.778,91
23068,2010-01-08,UTA,@,MEM,L 89-91,240,33,83,.398,28,72,.389,5,11,.455,18,25,.720,89
23069,2010-01-08,CHI,@,MIL,L 93-96,240,33,81,.407,27,69,.391,6,12,.500,21,31,.677,93
23070,2010-01-08,MIL,,CHI,W 96-93,240,34,85,.400,26,64,.406,8,21,.381,20,26,.769,96
23071,2010-01-08,IND,@,MIN,L 109-116,240,40,92,.435,24,60,.400,16,32,.500,13,17,.765,109
23072,2010-01-08,MIN,,IND,W 116-109,240,39,78,.500,34,67,.507,5,11,.455,33,45,.733,116
23073,2010-01-08,BRK,@,NOH,L 99-103,240,37,83,.446,28,66,.424,9,17,.529,16,17,.941,99
23074,2010-01-08,NOP,,NJN,W 103-99,240,39,84,.464,34,63,.540,5,21,.238,20,26,.769,103
23075,2010-01-08,PHI,,TOR,L 106-108,240,38,83,.458,32,65,.492,6,18,.333,24,25,.960,106
23076,2010-01-08,TOR,@,PHI,W 108-106,240,40,78,.513,35,63,.556,5,15,.333,23,28,.821,108
23077,2010-01-08,MIA,@,PHO,W 109-105,240,39,93,.419,33,73,.452,6,20,.300,25,28,.893,109
23078,2010-01-08,PHO,,MIA,L 105-109,240,36,83,.434,27,58,.466,9,25,.360,24,28,.857,105
23079,2010-01-08,LAL,@,POR,L 98-107,240,41,95,.432,30,67,.448,11,28,.393,5,10,.500,98
23080,2010-01-08,POR,,LAL,W 107-98,240,35,69,.507,30,54,.556,5,15,.333,32,39,.821,107
23081,2010-01-08,DAL,@,SAS,W 112-103,240,44,89,.494,37,74,.500,7,15,.467,17,20,.850,112
23082,2010-01-08,SAS,,DAL,L 103-112,240,40,76,.526,33,61,.541,7,15,.467,16,21,.762,103
23083,2010-01-08,ORL,@,WAS,L 97-104,240,36,84,.429,29,57,.509,7,27,.259,18,30,.600,97
23084,2010-01-08,WAS,,ORL,W 104-97,240,34,80,.425,28,65,.431,6,15,.400,30,34,.882,104
23085,2010-01-07,CHA,@,NYK,L 93-97,240,37,89,.416,25,63,.397,12,26,.462,7,10,.700,93
23086,2010-01-07,NYK,,CHA,W 97-93,240,39,73,.534,27,49,.551,12,24,.500,7,8,.875,97
23087,2010-01-06,ATL,,NJN,W 119-89,240,43,75,.573,30,53,.566,13,22,.591,20,21,.952,119
23088,2010-01-06,BRK,@,ATL,L 89-119,240,33,79,.418,30,66,.455,3,13,.231,20,25,.800,89
23089,2010-01-06,CLE,,WAS,W 121-98,240,43,75,.573,32,53,.604,11,22,.500,24,30,.800,121
23090,2010-01-06,WAS,@,CLE,L 98-121,240,37,84,.440,29,68,.426,8,16,.500,16,20,.800,98
23091,2010-01-06,LAC,,LAL,W 102-91,240,40,87,.460,36,72,.500,4,15,.267,18,23,.783,102
23092,2010-01-06,LAL,@,LAC,L 91-102,240,33,86,.384,26,64,.406,7,22,.318,18,23,.783,91
23093,2010-01-06,BOS,@,MIA,W 112-106 (OT),265,36,67,.537,29,50,.580,7,17,.412,33,41,.805,112
23094,2010-01-06,MIA,,BOS,L 106-112 (OT),265,40,98,.408,34,79,.430,6,19,.316,20,27,.741,106
23095,2010-01-06,GSW,@,MIN,W 107-101,240,40,87,.460,37,74,.500,3,13,.231,24,29,.828,107
23096,2010-01-06,MIN,,GSW,L 101-107,240,37,84,.440,36,75,.480,1,9,.111,26,33,.788,101
23097,2010-01-06,NOP,@,OKC,W 97-92,240,37,75,.493,30,53,.566,7,22,.318,16,17,.941,97
23098,2010-01-06,OKC,,NOH,L 92-97,240,35,79,.443,31,64,.484,4,15,.267,18,23,.783,92
23099,2010-01-06,ORL,,TOR,L 103-108,240,31,74,.419,22,43,.512,9,31,.290,32,38,.842,103
23100,2010-01-06,TOR,@,ORL,W 108-103,240,39,71,.549,30,51,.588,9,20,.450,21,24,.875,108
23101,2010-01-06,HOU,@,PHO,L 110-118,240,43,96,.448,32,63,.508,11,33,.333,13,15,.867,110
23102,2010-01-06,PHO,,HOU,W 118-110,240,43,79,.544,30,54,.556,13,25,.520,19,23,.826,118
23103,2010-01-06,DET,@,SAS,L 92-112,240,38,85,.447,36,72,.500,2,13,.154,14,25,.560,92
23104,2010-01-06,SAS,,DET,W 112-92,240,43,74,.581,35,60,.583,8,14,.571,18,24,.750,112
23105,2010-01-06,MEM,@,UTA,L 94-117,240,32,79,.405,28,68,.412,4,11,.364,26,37,.703,94
23106,2010-01-06,UTA,,MEM,W 117-94,240,46,81,.568,37,62,.597,9,19,.474,16,22,.727,117
23107,2010-01-05,CHA,,CHI,W 113-108,240,39,76,.513,31,60,.517,8,16,.500,27,33,.818,113
23108,2010-01-05,CHI,@,CHA,L 108-113,240,43,84,.512,36,68,.529,7,16,.438,15,22,.682,108
23109,2010-01-05,DAL,,DET,W 98-93,240,38,86,.442,33,69,.478,5,17,.294,17,18,.944,98
23110,2010-01-05,DET,@,DAL,L 93-98,240,38,80,.475,33,63,.524,5,17,.294,12,20,.600,93
23111,2010-01-05,DEN,,GSW,W 123-122,240,46,90,.511,40,76,.526,6,14,.429,25,31,.806,123
23112,2010-01-05,GSW,@,DEN,L 122-123,240,47,85,.553,39,68,.574,8,17,.471,20,23,.870,122
23113,2010-01-05,IND,,ORL,W 97-90,240,36,84,.429,31,68,.456,5,16,.313,20,29,.690,97
23114,2010-01-05,ORL,@,IND,L 90-97,240,33,86,.384,24,64,.375,9,22,.409,15,24,.625,90
23115,2010-01-05,HOU,@,LAL,L 79-88,240,31,77,.403,27,54,.500,4,23,.174,13,20,.650,79
23116,2010-01-05,LAL,,HOU,W 88-79,240,36,79,.456,34,69,.493,2,10,.200,14,18,.778,88
23117,2010-01-05,MIL,@,NJN,W 98-76,240,36,79,.456,33,65,.508,3,14,.214,23,27,.852,98
23118,2010-01-05,BRK,,MIL,L 76-98,240,25,66,.379,23,56,.411,2,10,.200,24,28,.857,76
23119,2010-01-05,PHI,,WAS,L 97-104,240,38,78,.487,31,61,.508,7,17,.412,14,24,.583,97
23120,2010-01-05,WAS,@,PHI,W 104-97,240,41,79,.519,37,67,.552,4,12,.333,18,22,.818,104
23121,2010-01-05,MEM,@,POR,W 109-105,240,41,79,.519,35,67,.522,6,12,.500,21,34,.618,109
23122,2010-01-05,POR,,MEM,L 105-109,240,41,78,.526,35,61,.574,6,17,.353,17,22,.773,105
23123,2010-01-05,PHO,@,SAC,W 113-109,240,37,82,.451,30,61,.492,7,21,.333,32,36,.889,113
23124,2010-01-05,SAC,,PHO,L 109-113,240,42,94,.447,38,76,.500,4,18,.222,21,27,.778,109
23125,2010-01-04,CHI,,OKC,L 85-98,240,35,99,.354,32,90,.356,3,9,.333,12,16,.750,85
23126,2010-01-04,OKC,@,CHI,W 98-85,240,40,82,.488,32,67,.478,8,15,.533,10,12,.833,98
23127,2010-01-04,LAC,,POR,W 105-95,240,41,71,.577,33,58,.569,8,13,.615,15,19,.789,105
23128,2010-01-04,POR,@,LAC,L 95-105,240,39,77,.506,33,61,.541,6,16,.375,11,16,.688,95
23129,2010-01-04,ATL,@,MIA,L 75-92,240,25,71,.352,22,57,.386,3,14,.214,22,29,.759,75
23130,2010-01-04,MIA,,ATL,W 92-75,240,37,79,.468,34,67,.507,3,12,.250,15,20,.750,92
23131,2010-01-04,NOP,@,UTA,W 91-87,240,34,78,.436,25,51,.490,9,27,.333,14,19,.737,91
23132,2010-01-04,UTA,,NOH,L 87-91,240,33,87,.379,26,73,.356,7,14,.500,14,16,.875,87
23133,2010-01-03,CHA,@,CLE,W 91-88,240,34,69,.493,27,53,.509,7,16,.438,16,19,.842,91
23134,2010-01-03,CLE,,CHA,L 88-91,240,35,73,.479,26,52,.500,9,21,.429,9,13,.692,88
23135,2010-01-03,DEN,,PHI,L 105-108,240,42,79,.532,38,65,.585,4,14,.286,17,29,.586,105
23136,2010-01-03,PHI,@,DEN,W 108-105,240,40,80,.500,35,61,.574,5,19,.263,23,29,.793,108
23137,2010-01-03,DAL,@,LAL,L 96-131,240,34,90,.378,29,69,.420,5,21,.238,23,28,.821,96
23138,2010-01-03,LAL,,DAL,W 131-96,240,52,82,.634,38,58,.655,14,24,.583,13,16,.813,131
23139,2010-01-03,IND,@,NYK,L 89-132,240,37,91,.407,31,61,.508,6,30,.200,9,9,1.000,89
23140,2010-01-03,NYK,,IND,W 132-89,240,50,96,.521,38,66,.576,12,30,.400,20,23,.870,132
23141,2010-01-03,SAS,@,TOR,L 86-91,240,33,80,.413,29,67,.433,4,13,.308,16,27,.593,86
23142,2010-01-03,TOR,,SAS,W 91-86,240,33,77,.429,32,69,.464,1,8,.125,24,27,.889,91
23143,2010-01-02,BOS,,TOR,W 103-96,240,36,70,.514,30,54,.556,6,16,.375,25,31,.806,103
23144,2010-01-02,TOR,@,BOS,L 96-103,240,35,71,.493,27,56,.482,8,15,.533,18,25,.720,96
23145,2010-01-02,CHI,,ORL,W 101-93,240,37,87,.425,34,82,.415,3,5,.600,24,27,.889,101
23146,2010-01-02,ORL,@,CHI,L 93-101,240,33,92,.359,19,55,.345,14,37,.378,13,20,.650,93
23147,2010-01-02,IND,,MIN,W 122-111,240,48,98,.490,38,73,.521,10,25,.400,16,17,.941,122
23148,2010-01-02,MIN,@,IND,L 111-122,240,40,89,.449,35,72,.486,5,17,.294,26,31,.839,111
23149,2010-01-02,CHA,@,MIA,W 107-97,240,35,67,.522,26,50,.520,9,17,.529,28,31,.903,107
23150,2010-01-02,MIA,,CHA,L 97-107,240,36,78,.462,25,54,.463,11,24,.458,14,16,.875,97
23151,2010-01-02,MIL,,OKC,W 103-97 (OT),265,42,106,.396,38,89,.427,4,17,.235,15,19,.789,103
23152,2010-01-02,OKC,@,MIL,L 97-103 (OT),265,36,84,.429,34,70,.486,2,14,.143,23,31,.742,97
23153,2010-01-02,CLE,@,NJN,W 94-86,240,32,81,.395,28,67,.418,4,14,.286,26,33,.788,94
23154,2010-01-02,BRK,,CLE,L 86-94,240,29,75,.387,26,65,.400,3,10,.300,25,32,.781,86
23155,2010-01-02,HOU,@,NOH,L 95-99,240,35,72,.486,27,52,.519,8,20,.400,17,21,.810,95
23156,2010-01-02,NOP,,HOU,W 99-95,240,38,85,.447,35,71,.493,3,14,.214,20,24,.833,99
23157,2010-01-02,MEM,@,PHO,W 128-103,240,51,96,.531,43,81,.531,8,15,.533,18,25,.720,128
23158,2010-01-02,PHO,,MEM,L 103-128,240,40,88,.455,35,70,.500,5,18,.278,18,24,.750,103
23159,2010-01-02,GSW,@,POR,L 89-105,240,34,79,.430,31,67,.463,3,12,.250,18,24,.750,89
23160,2010-01-02,POR,,GSW,W 105-89,240,36,74,.486,31,59,.525,5,15,.333,28,34,.824,105
23161,2010-01-02,DAL,@,SAC,W 99-91,240,36,74,.486,33,65,.508,3,9,.333,24,28,.857,99
23162,2010-01-02,SAC,,DAL,L 91-99,240,37,92,.402,31,74,.419,6,18,.333,11,13,.846,91
23163,2010-01-02,DEN,@,UTA,W 105-95,240,42,82,.512,37,67,.552,5,15,.333,16,23,.696,105
23164,2010-01-02,UTA,,DEN,L 95-105,240,36,71,.507,33,59,.559,3,12,.250,20,27,.741,95
23165,2010-01-02,SAS,@,WAS,W 97-86,240,37,73,.507,29,61,.475,8,12,.667,15,20,.750,97
23166,2010-01-02,WAS,,SAS,L 86-97,240,35,80,.438,31,70,.443,4,10,.400,12,17,.706,86
23167,2010-01-01,ATL,,NYK,L 108-112 (OT),265,46,100,.460,39,73,.534,7,27,.259,9,14,.643,108
23168,2010-01-01,NYK,@,ATL,W 112-108 (OT),265,45,88,.511,34,64,.531,11,24,.458,11,17,.647,112
23169,2010-01-01,LAL,,SAC,W 109-108,240,39,86,.453,31,66,.470,8,20,.400,23,29,.793,109
23170,2010-01-01,SAC,@,LAL,L 108-109,240,43,79,.544,33,60,.550,10,19,.526,12,16,.750,108
23171,2010-01-01,MIN,,ORL,L 94-106,240,37,86,.430,29,68,.426,8,18,.444,12,16,.750,94
23172,2010-01-01,ORL,@,MIN,W 106-94,240,36,80,.450,21,43,.488,15,37,.405,19,23,.826,106
23173,2009-12-31,CHI,@,DET,W 98-87,240,33,69,.478,31,62,.500,2,7,.286,30,35,.857,98
23174,2009-12-31,DET,,CHI,L 87-98,240,34,88,.386,29,70,.414,5,18,.278,14,18,.778,87
23175,2009-12-31,DAL,@,HOU,L 94-97,240,37,82,.451,35,70,.500,2,12,.167,18,22,.818,94
23176,2009-12-31,HOU,,DAL,W 97-94,240,40,90,.444,30,62,.484,10,28,.357,7,11,.636,97
23177,2009-12-31,LAC,,PHI,W 104-88,240,41,75,.547,31,59,.525,10,16,.625,12,19,.632,104
23178,2009-12-31,PHI,@,LAC,L 88-104,240,32,85,.376,28,69,.406,4,16,.250,20,22,.909,88
23179,2009-12-31,OKC,,UTA,W 87-86,240,35,74,.473,32,63,.508,3,11,.273,14,28,.500,87
23180,2009-12-31,UTA,@,OKC,L 86-87,240,37,90,.411,37,81,.457,0,9,.000,12,17,.706,86
23181,2009-12-31,MIA,@,SAS,L 78-108,240,33,75,.440,30,63,.476,3,12,.250,9,16,.563,78
23182,2009-12-31,SAS,,MIA,W 108-78,240,42,79,.532,38,66,.576,4,13,.308,20,22,.909,108
23183,2009-12-30,ATL,@,CLE,L 101-106,240,40,83,.482,33,67,.493,7,16,.438,14,15,.933,101
23184,2009-12-30,CLE,,ATL,W 106-101,240,36,76,.474,30,58,.517,6,18,.333,28,38,.737,106
23185,2009-12-30,IND,,MEM,L 110-121,240,43,89,.483,36,65,.554,7,24,.292,17,22,.773,110
23186,2009-12-30,MEM,@,IND,W 121-110,240,43,85,.506,37,74,.500,6,11,.545,29,35,.829,121
23187,2009-12-30,MIN,,UTA,L 103-107,240,41,78,.526,36,65,.554,5,13,.385,16,26,.615,103
23188,2009-12-30,UTA,@,MIN,W 107-103,240,42,92,.457,35,76,.461,7,16,.438,16,22,.727,107
23189,2009-12-30,BRK,,NYK,W 104-95,240,43,84,.512,41,77,.532,2,7,.286,16,27,.593,104
23190,2009-12-30,NYK,@,NJN,L 95-104,240,37,83,.446,29,59,.492,8,24,.333,13,16,.813,95
23191,2009-12-30,MIA,@,NOH,L 91-95,240,32,78,.410,25,59,.424,7,19,.368,20,25,.800,91
23192,2009-12-30,NOP,,MIA,W 95-91,240,34,78,.436,27,61,.443,7,17,.412,20,22,.909,95
23193,2009-12-30,MIL,@,ORL,L 92-117,240,38,97,.392,29,75,.387,9,22,.409,7,9,.778,92
23194,2009-12-30,ORL,,MIL,W 117-92,240,43,77,.558,33,56,.589,10,21,.476,21,26,.808,117
23195,2009-12-30,BOS,@,PHO,L 98-116,240,35,83,.422,29,62,.468,6,21,.286,22,30,.733,98
23196,2009-12-30,PHO,,BOS,W 116-98,240,40,79,.506,31,54,.574,9,25,.360,27,32,.844,116
23197,2009-12-30,LAC,@,POR,L 99-103,240,37,75,.493,30,55,.545,7,20,.350,18,29,.621,99
23198,2009-12-30,POR,,LAC,W 103-99,240,43,85,.506,38,69,.551,5,16,.313,12,19,.632,103
23199,2009-12-30,PHI,@,SAC,W 116-106,240,42,80,.525,33,64,.516,9,16,.563,23,30,.767,116
23200,2009-12-30,SAC,,PHI,L 106-116,240,42,89,.472,36,72,.500,6,17,.353,16,21,.762,106
23201,2009-12-30,CHA,@,TOR,L 103-107,240,39,72,.542,34,50,.680,5,22,.227,20,22,.909,103
23202,2009-12-30,TOR,,CHA,W 107-103,240,37,84,.440,32,65,.492,5,19,.263,28,31,.903,107
23203,2009-12-29,ATL,,CLE,L 84-95,240,31,70,.443,25,55,.455,6,15,.400,16,26,.615,84
23204,2009-12-29,CLE,@,ATL,W 95-84,240,38,77,.494,33,60,.550,5,17,.294,14,19,.737,95
23205,2009-12-29,CHI,,IND,W 104-95,240,38,72,.528,32,62,.516,6,10,.600,22,24,.917,104
23206,2009-12-29,IND,@,CHI,L 95-104,240,37,90,.411,28,66,.424,9,24,.375,12,18,.667,95
23207,2009-12-29,DET,,NYK,L 87-104,240,33,79,.418,28,63,.444,5,16,.313,16,20,.800,87
23208,2009-12-29,NYK,@,DET,W 104-87,240,39,76,.513,31,50,.620,8,26,.308,18,24,.750,104
23209,2009-12-29,HOU,,NOH,W 108-100,240,37,76,.487,25,53,.472,12,23,.522,22,28,.786,108
23210,2009-12-29,NOP,@,HOU,L 100-108,240,42,84,.500,37,70,.529,5,14,.357,11,16,.688,100
23211,2009-12-29,GSW,@,LAL,L 118-124,240,46,83,.554,40,68,.588,6,15,.400,20,28,.714,118
23212,2009-12-29,LAL,,GSW,W 124-118,240,42,87,.483,34,65,.523,8,22,.364,32,36,.889,124
23213,2009-12-29,MIN,@,SAS,L 99-117,240,36,91,.396,32,79,.405,4,12,.333,23,25,.920,99
23214,2009-12-29,SAS,,MIN,W 117-99,240,41,86,.477,29,62,.468,12,24,.500,23,31,.742,117
23215,2009-12-29,OKC,@,WAS,W 110-98,240,43,79,.544,33,61,.541,10,18,.556,14,19,.737,110
23216,2009-12-29,WAS,,OKC,L 98-110,240,37,92,.402,29,74,.392,8,18,.444,16,20,.800,98
23217,2009-12-28,CHA,,MIL,W 94-84,240,34,81,.420,30,63,.476,4,18,.222,22,28,.786,94
23218,2009-12-28,MIL,@,CHA,L 84-94,240,30,78,.385,24,53,.453,6,25,.240,18,24,.750,84
23219,2009-12-28,BOS,@,GSW,L 99-103,240,40,80,.500,35,61,.574,5,19,.263,14,21,.667,99
23220,2009-12-28,GSW,,BOS,W 103-99,240,40,87,.460,36,74,.486,4,13,.308,19,29,.655,103
23221,2009-12-28,MEM,,WAS,W 116-111 (OT),265,44,94,.468,40,78,.513,4,16,.250,24,28,.857,116
23222,2009-12-28,WAS,@,MEM,L 111-116 (OT),265,41,94,.436,30,71,.423,11,23,.478,18,25,.720,111
23223,2009-12-28,BRK,,OKC,L 89-105,240,34,75,.453,33,66,.500,1,9,.111,20,25,.800,89
23224,2009-12-28,OKC,@,NJN,W 105-89,240,36,76,.474,36,64,.563,0,12,.000,33,40,.825,105
23225,2009-12-28,LAL,@,PHO,L 103-118,240,40,92,.435,34,75,.453,6,17,.353,17,22,.773,103
23226,2009-12-28,PHO,,LAL,W 118-103,240,43,88,.489,31,55,.564,12,33,.364,20,27,.741,118
23227,2009-12-28,PHI,@,POR,W 104-93,240,45,78,.577,42,68,.618,3,10,.300,11,16,.688,104
23228,2009-12-28,POR,,PHI,L 93-104,240,35,83,.422,30,68,.441,5,15,.333,18,26,.692,93
23229,2009-12-28,DEN,@,SAC,L 101-106,240,39,94,.415,36,82,.439,3,12,.250,20,35,.571,101
23230,2009-12-28,SAC,,DEN,W 106-101,240,37,80,.463,30,66,.455,7,14,.500,25,33,.758,106
23231,2009-12-27,CLE,,HOU,W 108-83,240,44,93,.473,37,76,.487,7,17,.412,13,16,.813,108
23232,2009-12-27,HOU,@,CLE,L 83-108,240,25,76,.329,17,51,.333,8,25,.320,25,34,.735,83
23233,2009-12-27,DAL,@,DEN,W 104-96,240,41,82,.500,37,69,.536,4,13,.308,18,26,.692,104
23234,2009-12-27,DEN,,DAL,L 96-104,240,34,89,.382,29,72,.403,5,17,.294,23,29,.793,96
23235,2009-12-27,BOS,@,LAC,L 90-92,240,39,83,.470,38,71,.535,1,12,.083,11,15,.733,90
23236,2009-12-27,LAC,,BOS,W 92-90,240,35,69,.507,31,59,.525,4,10,.400,18,23,.783,92
23237,2009-12-27,IND,@,MIA,L 80-114,240,23,75,.307,17,53,.321,6,22,.273,28,44,.636,80
23238,2009-12-27,MIA,,IND,W 114-80,240,46,93,.495,45,82,.549,1,11,.091,21,29,.724,114
23239,2009-12-27,NYK,,SAS,L 88-95,240,34,77,.442,32,61,.525,2,16,.125,18,25,.720,88
23240,2009-12-27,SAS,@,NYK,W 95-88,240,41,81,.506,37,67,.552,4,14,.286,9,12,.750,95
23241,2009-12-27,DET,@,TOR,L 95-102,240,34,85,.400,30,70,.429,4,15,.267,23,33,.697,95
23242,2009-12-27,TOR,,DET,W 102-95,240,33,63,.524,29,50,.580,4,13,.308,32,44,.727,102
23243,2009-12-26,CHI,,NOH,W 96-85,240,42,91,.462,38,82,.463,4,9,.444,8,11,.727,96
23244,2009-12-26,NOP,@,CHI,L 85-96,240,33,79,.418,24,60,.400,9,19,.474,10,14,.714,85
23245,2009-12-26,DAL,,MEM,W 106-101,240,43,82,.524,37,65,.569,6,17,.353,14,20,.700,106
23246,2009-12-26,MEM,@,DAL,L 101-106,240,39,88,.443,37,80,.463,2,8,.250,21,29,.724,101
23247,2009-12-26,GSW,,PHO,W 132-127,240,48,84,.571,44,73,.603,4,11,.364,32,37,.865,132
23248,2009-12-26,PHO,@,GSW,L 127-132,240,47,88,.534,33,57,.579,14,31,.452,19,27,.704,127
23249,2009-12-26,ATL,@,IND,W 110-98,240,40,79,.506,34,61,.557,6,18,.333,24,31,.774,110
23250,2009-12-26,IND,,ATL,L 98-110,240,40,90,.444,34,76,.447,6,14,.429,12,16,.750,98
23251,2009-12-26,MIL,,SAS,L 97-112,240,35,82,.427,26,65,.400,9,17,.529,18,25,.720,97
23252,2009-12-26,SAS,@,MIL,W 112-97,240,46,77,.597,41,64,.641,5,13,.385,15,20,.750,112
23253,2009-12-26,MIN,,WAS,W 101-89,240,34,91,.374,29,80,.363,5,11,.455,28,39,.718,101
23254,2009-12-26,WAS,@,MIN,L 89-101,240,32,81,.395,27,62,.435,5,19,.263,20,24,.833,89
23255,2009-12-26,HOU,@,NJN,W 98-93,240,34,82,.415,26,63,.413,8,19,.421,22,32,.688,98
23256,2009-12-26,BRK,,HOU,L 93-98,240,38,81,.469,34,65,.523,4,16,.250,13,17,.765,93
23257,2009-12-26,CHA,@,OKC,L 91-98,240,35,81,.432,30,64,.469,5,17,.294,16,24,.667,91
23258,2009-12-26,OKC,,CHA,W 98-91,240,39,83,.470,34,70,.486,5,13,.385,15,21,.714,98
23259,2009-12-26,LAL,@,SAC,W 112-103 (2OT),290,43,98,.439,35,79,.443,8,19,.421,18,25,.720,112
23260,2009-12-26,SAC,,LAL,L 103-112 (2OT),290,42,105,.400,36,80,.450,6,25,.240,13,20,.650,103
23261,2009-12-26,PHI,@,UTA,L 76-97,240,27,80,.338,21,62,.339,6,18,.333,16,23,.696,76
23262,2009-12-26,UTA,,PHI,W 97-76,240,36,69,.522,30,58,.517,6,11,.545,19,30,.633,97
23263,2009-12-25,CLE,@,LAL,W 102-87,240,38,71,.535,31,53,.585,7,18,.389,19,30,.633,102
23264,2009-12-25,LAL,,CLE,L 87-102,240,31,85,.365,26,67,.388,5,18,.278,20,27,.741,87
23265,2009-12-25,MIA,@,NYK,W 93-87,240,32,75,.427,30,63,.476,2,12,.167,27,32,.844,93
23266,2009-12-25,NYK,,MIA,L 87-93,240,32,78,.410,27,50,.540,5,28,.179,18,23,.783,87
23267,2009-12-25,BOS,@,ORL,W 86-77,240,31,73,.425,27,58,.466,4,15,.267,20,28,.714,86
23268,2009-12-25,ORL,,BOS,L 77-86,240,26,78,.333,21,52,.404,5,26,.192,20,24,.833,77
23269,2009-12-25,LAC,@,PHO,L 93-124,240,37,92,.402,33,73,.452,4,19,.211,15,17,.882,93
23270,2009-12-25,PHO,,LAC,W 124-93,240,44,82,.537,32,58,.552,12,24,.500,24,27,.889,124
23271,2009-12-25,DEN,@,POR,L 96-107,240,37,82,.451,32,67,.478,5,15,.333,17,21,.810,96
23272,2009-12-25,POR,,DEN,W 107-96,240,40,76,.526,29,55,.527,11,21,.524,16,20,.800,107
23273,2009-12-23,ATL,@,DEN,L 104-124,240,38,79,.481,30,56,.536,8,23,.348,20,24,.833,104
23274,2009-12-23,DEN,,ATL,W 124-104,240,49,90,.544,36,64,.563,13,26,.500,13,22,.591,124
23275,2009-12-23,DET,,TOR,L 64-94,240,24,86,.279,23,77,.299,1,9,.111,15,24,.625,64
23276,2009-12-23,TOR,@,DET,W 94-64,240,35,65,.538,27,50,.540,8,15,.533,16,22,.727,94
23277,2009-12-23,MIA,,UTA,W 80-70,240,31,86,.360,27,71,.380,4,15,.267,14,18,.778,80
23278,2009-12-23,UTA,@,MIA,L 70-80,240,27,72,.375,25,61,.410,2,11,.182,14,21,.667,70
23279,2009-12-23,MIL,,WAS,L 97-109,240,32,90,.356,27,65,.415,5,25,.200,28,33,.848,97
23280,2009-12-23,WAS,@,MIL,W 109-97,240,36,69,.522,30,59,.508,6,10,.600,31,35,.886,109
23281,2009-12-23,MIN,@,NJN,W 103-99,240,44,92,.478,42,80,.525,2,12,.167,13,16,.813,103
23282,2009-12-23,BRK,,MIN,L 99-103,240,34,77,.442,25,60,.417,9,17,.529,22,29,.759,99
23283,2009-12-23,GSW,@,NOH,L 102-108,240,40,84,.476,35,66,.530,5,18,.278,17,22,.773,102
23284,2009-12-23,NOP,,GSW,W 108-102,240,40,96,.417,32,79,.405,8,17,.471,20,24,.833,108
23285,2009-12-23,HOU,@,ORL,L 87-102,240,32,82,.390,26,62,.419,6,20,.300,17,19,.895,87
23286,2009-12-23,ORL,,HOU,W 102-87,240,39,85,.459,28,56,.500,11,29,.379,13,17,.765,102
23287,2009-12-23,OKC,@,PHO,W 117-113,240,44,92,.478,39,79,.494,5,13,.385,24,31,.774,117
23288,2009-12-23,PHO,,OKC,L 113-117,240,40,80,.500,33,57,.579,7,23,.304,26,35,.743,113
23289,2009-12-23,CLE,@,SAC,W 117-104 (OT),265,47,92,.511,39,76,.513,8,16,.500,15,17,.882,117
23290,2009-12-23,SAC,,CLE,L 104-117 (OT),265,41,92,.446,34,71,.479,7,21,.333,15,22,.682,104
23291,2009-12-23,POR,@,SAS,W 98-94,240,35,77,.455,30,66,.455,5,11,.455,23,26,.885,98
23292,2009-12-23,SAS,,POR,L 94-98,240,36,70,.514,30,49,.612,6,21,.286,16,17,.941,94
23293,2009-12-22,BOS,,IND,W 103-94,240,30,79,.380,24,59,.407,6,20,.300,37,40,.925,103
23294,2009-12-22,IND,@,BOS,L 94-103,240,33,74,.446,23,53,.434,10,21,.476,18,24,.750,94
23295,2009-12-22,CHA,,DET,W 88-76,240,34,70,.486,25,52,.481,9,18,.500,11,17,.647,88
23296,2009-12-22,DET,@,CHA,L 76-88,240,31,82,.378,29,70,.414,2,12,.167,12,21,.571,76
23297,2009-12-22,DAL,,POR,L 81-85,240,31,80,.388,24,61,.393,7,19,.368,12,22,.545,81
23298,2009-12-22,POR,@,DAL,W 85-81,240,32,79,.405,27,65,.415,5,14,.357,16,19,.842,85
23299,2009-12-22,HOU,,LAC,W 108-99,240,38,79,.481,33,61,.541,5,18,.278,27,38,.711,108
23300,2009-12-22,LAC,@,HOU,L 99-108,240,40,79,.506,37,70,.529,3,9,.333,16,21,.762,99
23301,2009-12-22,LAL,,OKC,W 111-108,240,36,81,.444,29,63,.460,7,18,.389,32,39,.821,111
23302,2009-12-22,OKC,@,LAL,L 108-111,240,41,91,.451,35,77,.455,6,14,.429,20,24,.833,108
23303,2009-12-22,GSW,@,MEM,L 108-121,240,41,82,.500,36,65,.554,5,17,.294,21,29,.724,108
23304,2009-12-22,MEM,,GSW,W 121-108,240,50,92,.543,49,86,.570,1,6,.167,20,30,.667,121
23305,2009-12-22,ATL,@,MIN,W 112-87,240,43,88,.489,34,68,.500,9,20,.450,17,25,.680,112
23306,2009-12-22,MIN,,ATL,L 87-112,240,30,73,.411,28,66,.424,2,7,.286,25,36,.694,87
23307,2009-12-22,CHI,@,NYK,L 81-88,240,34,84,.405,31,76,.408,3,8,.375,10,12,.833,81
23308,2009-12-22,NYK,,CHI,W 88-81,240,34,85,.400,29,58,.500,5,27,.185,15,20,.750,88
23309,2009-12-22,PHI,@,WAS,L 98-105,240,38,75,.507,34,62,.548,4,13,.308,18,25,.720,98
23310,2009-12-22,WAS,,PHI,W 105-98,240,39,83,.470,32,68,.471,7,15,.467,20,26,.769,105
23311,2009-12-21,CHI,,SAC,L 98-102,240,38,80,.475,34,70,.486,4,10,.400,18,24,.750,98
23312,2009-12-21,SAC,@,CHI,W 102-98,240,36,82,.439,25,59,.424,11,23,.478,19,26,.731,102
23313,2009-12-21,IND,,MIL,L 81-84,240,31,87,.356,28,70,.400,3,17,.176,16,22,.727,81
23314,2009-12-21,MIL,@,IND,W 84-81,240,35,83,.422,30,67,.448,5,16,.313,9,20,.450,84
23315,2009-12-21,ORL,,UTA,W 104-99,240,32,66,.485,23,45,.511,9,21,.429,31,41,.756,104
23316,2009-12-21,UTA,@,ORL,L 99-104,240,36,89,.404,29,71,.408,7,18,.389,20,27,.741,99
23317,2009-12-21,CLE,@,PHO,W 109-91,240,41,78,.526,36,66,.545,5,12,.417,22,26,.846,109
23318,2009-12-21,PHO,,CLE,L 91-109,240,36,76,.474,32,57,.561,4,19,.211,15,20,.750,91
23319,2009-12-21,LAC,@,SAS,L 87-103,240,36,82,.439,31,68,.456,5,14,.357,10,15,.667,87
23320,2009-12-21,SAS,,LAC,W 103-87,240,39,77,.506,34,67,.507,5,10,.500,20,26,.769,103
23321,2009-12-20,BOS,,MIN,W 122-104,240,42,81,.519,33,63,.524,9,18,.500,29,35,.829,122
23322,2009-12-20,MIN,@,BOS,L 104-122,240,38,90,.422,34,78,.436,4,12,.333,24,29,.828,104
23323,2009-12-20,CLE,@,DAL,L 95-102,240,35,77,.455,30,63,.476,5,14,.357,20,26,.769,95
23324,2009-12-20,DAL,,CLE,W 102-95,240,38,80,.475,31,61,.508,7,19,.368,19,20,.950,102
23325,2009-12-20,DET,,LAL,L 81-93,240,33,79,.418,31,67,.463,2,12,.167,13,19,.684,81
23326,2009-12-20,LAL,@,DET,W 93-81,240,34,83,.410,29,65,.446,5,18,.278,20,27,.741,93
23327,2009-12-20,DEN,@,MEM,L 96-102,240,34,84,.405,28,63,.444,6,21,.286,22,26,.846,96
23328,2009-12-20,MEM,,DEN,W 102-96,240,43,90,.478,41,79,.519,2,11,.182,14,20,.700,102
23329,2009-12-20,MIA,,POR,L 95-102,240,39,79,.494,31,63,.492,8,16,.500,9,11,.818,95
23330,2009-12-20,POR,@,MIA,W 102-95,240,38,74,.514,27,55,.491,11,19,.579,15,18,.833,102
23331,2009-12-20,CHA,@,NYK,L 94-98,240,38,84,.452,33,66,.500,5,18,.278,13,16,.813,94
23332,2009-12-20,NYK,,CHA,W 98-94,240,32,71,.451,21,46,.457,11,25,.440,23,30,.767,98
23333,2009-12-20,NOP,@,TOR,L 92-98,240,37,95,.389,34,74,.459,3,21,.143,15,20,.750,92
23334,2009-12-20,TOR,,NOH,W 98-92,240,41,87,.471,38,72,.528,3,15,.200,13,19,.684,98
23335,2009-12-19,CHA,,UTA,L 102-110,240,35,71,.493,28,58,.483,7,13,.538,25,33,.758,102
23336,2009-12-19,UTA,@,CHA,W 110-102,240,41,77,.532,37,60,.617,4,17,.235,24,30,.800,110
23337,2009-12-19,ATL,@,CHI,L 98-101 (OT),265,36,87,.414,28,68,.412,8,19,.421,18,20,.900,98
23338,2009-12-19,CHI,,ATL,W 101-98 (OT),265,39,81,.481,36,73,.493,3,8,.375,20,27,.741,101
23339,2009-12-19,HOU,,OKC,W 95-90,240,38,90,.422,30,67,.448,8,23,.348,11,21,.524,95
23340,2009-12-19,OKC,@,HOU,L 90-95,240,35,78,.449,33,66,.500,2,12,.167,18,21,.857,90
23341,2009-12-19,MIL,,SAC,L 95-96,240,38,89,.427,32,73,.438,6,16,.375,13,20,.650,95
23342,2009-12-19,SAC,@,MIL,W 96-95,240,35,77,.455,31,67,.463,4,10,.400,22,29,.759,96
23343,2009-12-19,LAL,@,NJN,W 103-84,240,43,87,.494,36,65,.554,7,22,.318,10,13,.769,103
23344,2009-12-19,BRK,,LAL,L 84-103,240,31,82,.378,28,70,.400,3,12,.250,19,27,.704,84
23345,2009-12-19,ORL,,POR,W 92-83,240,32,76,.421,23,49,.469,9,27,.333,19,26,.731,92
23346,2009-12-19,POR,@,ORL,L 83-92,240,29,78,.372,26,60,.433,3,18,.167,22,29,.759,83
23347,2009-12-19,LAC,@,PHI,W 112-107 (OT),265,46,87,.529,40,71,.563,6,16,.375,14,18,.778,112
23348,2009-12-19,PHI,,LAC,L 107-112 (OT),265,43,94,.457,40,80,.500,3,14,.214,18,24,.750,107
23349,2009-12-19,PHO,,WAS,W 121-95,240,48,93,.516,41,73,.562,7,20,.350,18,25,.720,121
23350,2009-12-19,WAS,@,PHO,L 95-121,240,32,88,.364,24,67,.358,8,21,.381,23,29,.793,95
23351,2009-12-19,IND,@,SAS,L 99-100,240,39,81,.481,33,64,.516,6,17,.353,15,18,.833,99
23352,2009-12-19,SAS,,IND,W 100-99,240,36,85,.424,31,70,.443,5,15,.333,23,38,.605,100
23353,2009-12-18,ATL,,UTA,W 96-83,240,37,83,.446,31,63,.492,6,20,.300,16,25,.640,96
23354,2009-12-18,UTA,@,ATL,L 83-96,240,30,70,.429,28,60,.467,2,10,.200,21,33,.636,83
23355,2009-12-18,BOS,,PHI,L 97-98,240,36,80,.450,31,65,.477,5,15,.333,20,27,.741,97
23356,2009-12-18,PHI,@,BOS,W 98-97,240,35,87,.402,31,72,.431,4,15,.267,24,30,.800,98
23357,2009-12-18,CLE,,MIL,W 85-82,240,28,66,.424,23,52,.442,5,14,.357,24,31,.774,85
23358,2009-12-18,MIL,@,CLE,L 82-85,240,32,88,.364,25,62,.403,7,26,.269,11,14,.786,82
23359,2009-12-18,DAL,,HOU,L 108-116 (OT),265,40,95,.421,32,75,.427,8,20,.400,20,27,.741,108
23360,2009-12-18,HOU,@,DAL,W 116-108 (OT),265,44,95,.463,36,75,.480,8,20,.400,20,26,.769,116
23361,2009-12-18,GSW,,WAS,L 109-118,240,39,83,.470,33,66,.500,6,17,.353,25,31,.806,109
23362,2009-12-18,WAS,@,GSW,W 118-109,240,46,91,.505,41,70,.586,5,21,.238,21,30,.700,118
23363,2009-12-18,IND,@,MEM,L 94-107,240,35,86,.407,32,65,.492,3,21,.143,21,27,.778,94
23364,2009-12-18,MEM,,IND,W 107-94,240,42,89,.472,34,75,.453,8,14,.571,15,21,.714,107
23365,2009-12-18,MIN,,SAC,W 112-96,240,47,86,.547,45,79,.570,2,7,.286,16,21,.762,112
23366,2009-12-18,SAC,@,MIN,L 96-112,240,39,91,.429,35,64,.547,4,27,.148,14,22,.636,96
23367,2009-12-18,DEN,@,NOH,L 92-98,240,36,77,.468,33,61,.541,3,16,.188,17,23,.739,92
23368,2009-12-18,NOP,,DEN,W 98-92,240,40,83,.482,32,64,.500,8,19,.421,10,15,.667,98
23369,2009-12-18,LAC,@,NYK,L 91-95,240,33,72,.458,28,51,.549,5,21,.238,20,24,.833,91
23370,2009-12-18,NYK,,LAC,W 95-91,240,38,81,.469,31,58,.534,7,23,.304,12,13,.923,95
23371,2009-12-18,DET,@,OKC,L 98-109,240,39,84,.464,34,70,.486,5,14,.357,15,16,.938,98
23372,2009-12-18,OKC,,DET,W 109-98,240,37,74,.500,29,59,.492,8,15,.533,27,36,.750,109
23373,2009-12-18,BRK,@,TOR,L 95-118,240,35,76,.461,30,59,.508,5,17,.294,20,22,.909,95
23374,2009-12-18,TOR,,NJN,W 118-95,240,49,83,.590,43,74,.581,6,9,.667,14,21,.667,118
23375,2009-12-17,CHI,,NYK,W 98-89,240,35,78,.449,32,69,.464,3,9,.333,25,28,.893,98
23376,2009-12-17,NYK,@,CHI,L 89-98,240,31,86,.360,15,39,.385,16,47,.340,11,16,.688,89
23377,2009-12-17,MIA,,ORL,W 104-86,240,42,81,.519,35,67,.522,7,14,.500,13,19,.684,104
23378,2009-12-17,ORL,@,MIA,L 86-104,240,34,78,.436,25,50,.500,9,28,.321,9,17,.529,86
23379,2009-12-17,PHO,@,POR,L 102-105,240,38,79,.481,28,58,.483,10,21,.476,16,22,.727,102
23380,2009-12-17,POR,,PHO,W 105-102,240,35,78,.449,25,58,.431,10,20,.500,25,35,.714,105
23381,2009-12-16,ATL,,MEM,W 110-97,240,45,93,.484,39,77,.506,6,16,.375,14,18,.778,110
23382,2009-12-16,MEM,@,ATL,L 97-110,240,38,76,.500,35,69,.507,3,7,.429,18,22,.818,97
23383,2009-12-16,DEN,,HOU,W 111-101,240,39,83,.470,32,71,.451,7,12,.583,26,32,.813,111
23384,2009-12-16,HOU,@,DEN,L 101-111,240,36,81,.444,25,53,.472,11,28,.393,18,20,.900,101
23385,2009-12-16,GSW,,SAS,L 91-103,240,37,87,.425,36,77,.468,1,10,.100,16,22,.727,91
23386,2009-12-16,SAS,@,GSW,W 103-91,240,39,81,.481,34,63,.540,5,18,.278,20,23,.870,103
23387,2009-12-16,CHA,@,IND,L 98-101,240,32,75,.427,28,58,.483,4,17,.235,30,40,.750,98
23388,2009-12-16,IND,,CHA,W 101-98,240,35,73,.479,23,49,.469,12,24,.500,19,26,.731,101
23389,2009-12-16,LAL,@,MIL,W 107-106 (OT),265,37,78,.474,33,62,.532,4,16,.250,29,33,.879,107
23390,2009-12-16,MIL,,LAL,L 106-107 (OT),265,42,99,.424,32,70,.457,10,29,.345,12,17,.706,106
23391,2009-12-16,LAC,@,MIN,W 120-95,240,47,90,.522,37,67,.552,10,23,.435,16,26,.615,120
23392,2009-12-16,MIN,,LAC,L 95-120,240,35,91,.385,34,80,.425,1,11,.091,24,30,.800,95
23393,2009-12-16,BRK,,UTA,L 92-108,240,35,81,.432,33,68,.485,2,13,.154,20,29,.690,92
23394,2009-12-16,UTA,@,NJN,W 108-92,240,40,71,.563,37,64,.578,3,7,.429,25,32,.781,108
23395,2009-12-16,DET,@,NOH,L 87-95,240,35,77,.455,30,63,.476,5,14,.357,12,16,.750,87
23396,2009-12-16,NOP,,DET,W 95-87,240,35,71,.493,29,50,.580,6,21,.286,19,23,.826,95
23397,2009-12-16,DAL,@,OKC,W 100-86,240,36,73,.493,29,60,.483,7,13,.538,21,26,.808,100
23398,2009-12-16,OKC,,DAL,L 86-100,240,34,81,.420,30,64,.469,4,17,.235,14,23,.609,86
23399,2009-12-16,ORL,,TOR,W 118-99,240,43,75,.573,29,45,.644,14,30,.467,18,23,.783,118
23400,2009-12-16,TOR,@,ORL,L 99-118,240,39,89,.438,34,77,.442,5,12,.417,16,20,.800,99
23401,2009-12-16,CLE,@,PHI,W 108-101,240,34,73,.466,25,58,.431,9,15,.600,31,40,.775,108
23402,2009-12-16,PHI,,CLE,L 101-108,240,36,81,.444,31,64,.484,5,17,.294,24,25,.960,101
23403,2009-12-16,SAC,,WAS,W 112-109,240,40,86,.465,35,63,.556,5,23,.217,27,33,.818,112
23404,2009-12-16,WAS,@,SAC,L 109-112,240,41,95,.432,37,76,.487,4,19,.211,23,26,.885,109
23405,2009-12-15,CHA,,NYK,W 94-87,240,36,77,.468,33,62,.532,3,15,.200,19,22,.864,94
23406,2009-12-15,NYK,@,CHA,L 87-94,240,34,75,.453,27,50,.540,7,25,.280,12,20,.600,87
23407,2009-12-15,CHI,,LAL,L 87-96,240,37,96,.385,35,85,.412,2,11,.182,11,16,.688,87
23408,2009-12-15,LAL,@,CHI,W 96-87,240,36,79,.456,32,59,.542,4,20,.200,20,25,.800,96
23409,2009-12-15,CLE,,NJN,W 99-89,240,39,67,.582,35,54,.648,4,13,.308,17,27,.630,99
23410,2009-12-15,BRK,@,CLE,L 89-99,240,30,77,.390,25,59,.424,5,18,.278,24,29,.828,89
23411,2009-12-15,DET,@,HOU,L 96-107,240,42,96,.438,38,75,.507,4,21,.190,8,13,.615,96
23412,2009-12-15,HOU,,DET,W 107-96,240,41,75,.547,39,59,.661,2,16,.125,23,32,.719,107
23413,2009-12-15,MIA,,TOR,W 115-95,240,46,89,.517,43,78,.551,3,11,.273,20,22,.909,115
23414,2009-12-15,TOR,@,MIA,L 95-115,240,33,73,.452,31,62,.500,2,11,.182,27,34,.794,95
23415,2009-12-15,PHO,,SAS,W 116-104,240,49,95,.516,38,77,.494,11,18,.611,7,13,.538,116
23416,2009-12-15,SAS,@,PHO,L 104-116,240,40,86,.465,33,70,.471,7,16,.438,17,20,.850,104
23417,2009-12-15,POR,,SAC,W 95-88,240,36,76,.474,32,63,.508,4,13,.308,19,26,.731,95
23418,2009-12-15,SAC,@,POR,L 88-95,240,34,76,.447,29,61,.475,5,15,.333,15,22,.682,88
23419,2009-12-14,DAL,,NOH,W 94-90,240,38,69,.551,32,54,.593,6,15,.400,12,13,.923,94
23420,2009-12-14,NOP,@,DAL,L 90-94,240,39,89,.438,32,66,.485,7,23,.304,5,11,.455,90
23421,2009-12-14,DEN,,OKC,W 102-93,240,32,80,.400,28,66,.424,4,14,.286,34,40,.850,102
23422,2009-12-14,OKC,@,DEN,L 93-102,240,31,79,.392,26,66,.394,5,13,.385,26,31,.839,93
23423,2009-12-14,LAC,,WAS,W 97-95,240,35,82,.427,29,66,.439,6,16,.375,21,31,.677,97
23424,2009-12-14,WAS,@,LAC,L 95-97,240,33,85,.388,28,69,.406,5,16,.313,24,28,.857,95
23425,2009-12-14,BOS,@,MEM,W 110-105,240,42,80,.525,32,60,.533,10,20,.500,16,21,.762,110
23426,2009-12-14,MEM,,BOS,L 105-110,240,42,82,.512,41,69,.594,1,13,.077,20,22,.909,105
23427,2009-12-14,IND,@,ORL,L 98-106,240,42,88,.477,35,66,.530,7,22,.318,7,10,.700,98
23428,2009-12-14,ORL,,IND,W 106-98,240,36,86,.419,27,57,.474,9,29,.310,25,35,.714,106
23429,2009-12-14,GSW,@,PHI,L 101-117,240,30,68,.441,21,50,.420,9,18,.500,32,40,.800,101
23430,2009-12-14,PHI,,GSW,W 117-101,240,48,97,.495,44,79,.557,4,18,.222,17,20,.850,117
23431,2009-12-14,MIN,@,UTA,W 110-108,240,40,83,.482,33,68,.485,7,15,.467,23,34,.676,110
23432,2009-12-14,UTA,,MIN,L 108-110,240,41,81,.506,36,66,.545,5,15,.333,21,37,.568,108
23433,2009-12-13,ATL,,NJN,W 130-107,240,49,92,.533,38,75,.507,11,17,.647,21,29,.724,130
23434,2009-12-13,BRK,@,ATL,L 107-130,240,44,87,.506,39,77,.506,5,10,.500,14,19,.737,107
23435,2009-12-13,LAC,,SAS,L 90-115,240,38,86,.442,34,73,.466,4,13,.308,10,15,.667,90
23436,2009-12-13,SAS,@,LAC,W 115-90,240,43,75,.573,32,55,.582,11,20,.550,18,26,.692,115
23437,2009-12-13,MEM,@,MIA,W 118-90,240,47,89,.528,43,80,.538,4,9,.444,20,27,.741,118
23438,2009-12-13,MIA,,MEM,L 90-118,240,35,80,.438,31,66,.470,4,14,.286,16,20,.800,90
23439,2009-12-13,CLE,@,OKC,W 102-89,240,40,84,.476,29,62,.468,11,22,.500,11,15,.733,102
23440,2009-12-13,OKC,,CLE,L 89-102,240,30,69,.435,26,53,.491,4,16,.250,25,29,.862,89
23441,2009-12-13,HOU,@,TOR,L 88-101,240,32,87,.368,29,63,.460,3,24,.125,21,25,.840,88
23442,2009-12-13,TOR,,HOU,W 101-88,240,40,80,.500,35,68,.515,5,12,.417,16,21,.762,101
23443,2009-12-12,BOS,@,CHI,W 106-80,240,38,88,.432,30,62,.484,8,26,.308,22,30,.733,106
23444,2009-12-12,CHI,,BOS,L 80-106,240,30,92,.326,29,83,.349,1,9,.111,19,27,.704,80
23445,2009-12-12,CHA,@,DAL,L 97-98 (OT),265,34,81,.420,27,58,.466,7,23,.304,22,27,.815,97
23446,2009-12-12,DAL,,CHA,W 98-97 (OT),265,37,93,.398,34,75,.453,3,18,.167,21,26,.808,98
23447,2009-12-12,DEN,,PHO,W 105-99,240,32,78,.410,25,61,.410,7,17,.412,34,43,.791,105
23448,2009-12-12,PHO,@,DEN,L 99-105,240,36,66,.545,31,54,.574,5,12,.417,22,28,.786,99
23449,2009-12-12,DET,,GSW,W 104-95,240,39,72,.542,37,61,.607,2,11,.182,24,30,.800,104
23450,2009-12-12,GSW,@,DET,L 95-104,240,34,72,.472,29,53,.547,5,19,.263,22,25,.880,95
23451,2009-12-12,MIL,,POR,W 108-101 (2OT),290,45,91,.495,37,72,.514,8,19,.421,10,17,.588,108
23452,2009-12-12,POR,@,MIL,L 101-108 (2OT),290,37,92,.402,31,74,.419,6,18,.333,21,29,.724,101
23453,2009-12-12,MIN,@,SAC,L 100-120,240,40,93,.430,37,85,.435,3,8,.375,17,28,.607,100
23454,2009-12-12,SAC,,MIN,W 120-100,240,50,95,.526,44,74,.595,6,21,.286,14,22,.636,120
23455,2009-12-12,LAL,@,UTA,L 94-102,240,37,80,.463,34,59,.576,3,21,.143,17,24,.708,94
23456,2009-12-12,UTA,,LAL,W 102-94,240,40,77,.519,33,59,.559,7,18,.389,15,18,.833,102
23457,2009-12-12,IND,@,WAS,W 114-113,240,38,90,.422,28,68,.412,10,22,.455,28,30,.933,114
23458,2009-12-12,WAS,,IND,L 113-114,240,45,82,.549,37,63,.587,8,19,.421,15,23,.652,113
23459,2009-12-11,CHI,,GSW,W 96-91 (OT),265,43,103,.417,42,90,.467,1,13,.077,9,11,.818,96
23460,2009-12-11,GSW,@,CHI,L 91-96 (OT),265,37,97,.381,29,69,.420,8,28,.286,9,12,.750,91
23461,2009-12-11,CLE,,POR,W 104-99,240,43,79,.544,40,67,.597,3,12,.250,15,19,.789,104
23462,2009-12-11,POR,@,CLE,L 99-104,240,37,80,.463,29,57,.509,8,23,.348,17,18,.944,99
23463,2009-12-11,IND,,NJN,W 107-91,240,42,90,.467,36,77,.468,6,13,.462,17,19,.895,107
23464,2009-12-11,BRK,@,IND,L 91-107,240,33,91,.363,30,78,.385,3,13,.231,22,29,.759,91
23465,2009-12-11,LAL,,MIN,W 104-92,240,43,95,.453,35,70,.500,8,25,.320,10,13,.769,104
23466,2009-12-11,MIN,@,LAL,L 92-104,240,38,88,.432,34,78,.436,4,10,.400,12,16,.750,92
23467,2009-12-11,MEM,,OKC,L 94-102,240,38,92,.413,34,74,.459,4,18,.222,14,24,.583,94
23468,2009-12-11,OKC,@,MEM,W 102-94,240,39,84,.464,35,65,.538,4,19,.211,20,24,.833,102
23469,2009-12-11,DAL,@,MIA,W 106-93,240,39,80,.488,29,55,.527,10,25,.400,18,23,.783,106
23470,2009-12-11,MIA,,DAL,L 93-106,240,33,82,.402,31,70,.443,2,12,.167,25,32,.781,93
23471,2009-12-11,NOP,,NYK,L 96-113,240,34,85,.400,28,58,.483,6,27,.222,22,25,.880,96
23472,2009-12-11,NYK,@,NOH,W 113-96,240,43,78,.551,30,53,.566,13,25,.520,14,15,.933,113
23473,2009-12-11,HOU,@,PHI,W 96-91,240,33,74,.446,25,53,.472,8,21,.381,22,33,.667,96
23474,2009-12-11,PHI,,HOU,L 91-96,240,34,82,.415,33,76,.434,1,6,.167,22,30,.733,91
23475,2009-12-11,ORL,@,PHO,L 103-106,240,32,76,.421,19,38,.500,13,38,.342,26,38,.684,103
23476,2009-12-11,PHO,,ORL,W 106-103,240,41,86,.477,31,58,.534,10,28,.357,14,24,.583,106
23477,2009-12-11,CHA,@,SAS,L 85-104,240,32,75,.427,29,63,.460,3,12,.250,18,29,.621,85
23478,2009-12-11,SAS,,CHA,W 104-85,240,39,66,.591,29,49,.592,10,17,.588,16,24,.667,104
23479,2009-12-11,ATL,@,TOR,W 111-89,240,43,83,.518,34,65,.523,9,18,.500,16,19,.842,111
23480,2009-12-11,TOR,,ATL,L 89-111,240,36,74,.486,34,64,.531,2,10,.200,15,23,.652,89
23481,2009-12-10,DEN,@,DET,L 99-101,240,34,76,.447,28,61,.459,6,15,.400,25,31,.806,99
23482,2009-12-10,DET,,DEN,W 101-99,240,33,76,.434,28,62,.452,5,14,.357,30,41,.732,101
23483,2009-12-10,ORL,@,UTA,L 111-120,240,35,76,.461,21,41,.512,14,35,.400,27,32,.844,111
23484,2009-12-10,UTA,,ORL,W 120-111,240,42,84,.500,36,62,.581,6,22,.273,30,46,.652,120
23485,2009-12-10,BOS,@,WAS,W 104-102,240,37,75,.493,33,63,.524,4,12,.333,26,37,.703,104
23486,2009-12-10,WAS,,BOS,L 102-104,240,41,85,.482,35,67,.522,6,18,.333,14,22,.636,102
23487,2009-12-09,ATL,,CHI,W 118-83,240,44,88,.500,35,64,.547,9,24,.375,21,28,.750,118
23488,2009-12-09,CHI,@,ATL,L 83-118,240,28,77,.364,24,65,.369,4,12,.333,23,27,.852,83
23489,2009-12-09,CLE,@,HOU,L 85-95,240,30,75,.400,25,60,.417,5,15,.333,20,28,.714,85
23490,2009-12-09,HOU,,CLE,W 95-85,240,32,79,.405,23,58,.397,9,21,.429,22,31,.710,95
23491,2009-12-09,IND,,POR,L 91-102,240,38,92,.413,35,75,.467,3,17,.176,12,17,.706,91
23492,2009-12-09,POR,@,IND,W 102-91,240,39,79,.494,33,63,.524,6,16,.375,18,27,.667,102
23493,2009-12-09,LAL,,UTA,W 101-77,240,36,78,.462,31,62,.500,5,16,.313,24,31,.774,101
23494,2009-12-09,UTA,@,LAL,L 77-101,240,29,86,.337,25,69,.362,4,17,.235,15,19,.789,77
23495,2009-12-09,MIL,,TOR,W 117-95,240,42,80,.525,33,59,.559,9,21,.429,24,28,.857,117
23496,2009-12-09,TOR,@,MIL,L 95-117,240,33,68,.485,29,54,.537,4,14,.286,25,33,.758,95
23497,2009-12-09,MIN,,NOH,L 96-97,240,41,78,.526,38,69,.551,3,9,.333,11,20,.550,96
23498,2009-12-09,NOP,@,MIN,W 97-96,240,39,83,.470,26,58,.448,13,25,.520,6,10,.600,97
23499,2009-12-09,GSW,@,NJN,W 105-89,240,43,87,.494,39,75,.520,4,12,.333,15,21,.714,105
23500,2009-12-09,BRK,,GSW,L 89-105,240,34,79,.430,33,69,.478,1,10,.100,20,29,.690,89
23501,2009-12-09,DET,@,PHI,W 90-86,240,34,74,.459,33,66,.500,1,8,.125,21,24,.875,90
23502,2009-12-09,PHI,,DET,L 86-90,240,33,75,.440,27,57,.474,6,18,.333,14,19,.737,86
23503,2009-12-09,SAC,@,SAS,L 106-118,240,46,88,.523,40,75,.533,6,13,.462,8,15,.533,106
23504,2009-12-09,SAS,,SAC,W 118-106,240,47,85,.553,39,76,.513,8,9,.889,16,22,.727,118
23505,2009-12-08,BOS,,MIL,W 98-89,240,35,67,.522,29,49,.592,6,18,.333,22,31,.710,98
23506,2009-12-08,MIL,@,BOS,L 89-98,240,34,79,.430,30,64,.469,4,15,.267,17,19,.895,89
23507,2009-12-08,CHA,,DEN,W 107-95,240,35,76,.461,29,62,.468,6,14,.429,31,37,.838,107
23508,2009-12-08,DEN,@,CHA,L 95-107,240,34,75,.453,32,59,.542,2,16,.125,25,30,.833,95
23509,2009-12-08,CHI,,NJN,L 101-103,240,41,88,.466,37,76,.487,4,12,.333,15,23,.652,101
23510,2009-12-08,BRK,@,CHI,W 103-101,240,38,84,.452,35,64,.547,3,20,.150,24,28,.857,103
23511,2009-12-08,DAL,,PHO,W 102-101,240,38,85,.447,32,62,.516,6,23,.261,20,23,.870,102
23512,2009-12-08,PHO,@,DAL,L 101-102,240,35,79,.443,28,60,.467,7,19,.368,24,25,.960,101
23513,2009-12-08,LAC,,ORL,L 86-97,240,34,85,.400,28,68,.412,6,17,.353,12,19,.632,86
23514,2009-12-08,ORL,@,LAC,W 97-86,240,32,71,.451,18,37,.486,14,34,.412,19,25,.760,97
23515,2009-12-08,CLE,@,MEM,L 109-111 (OT),265,40,90,.444,30,66,.455,10,24,.417,19,24,.792,109
23516,2009-12-08,MEM,,CLE,W 111-109 (OT),265,40,91,.440,34,77,.442,6,14,.429,25,32,.781,111
23517,2009-12-08,NOP,,SAC,W 96-94,240,37,74,.500,29,56,.518,8,18,.444,14,23,.609,96
23518,2009-12-08,SAC,@,NOH,L 94-96,240,41,81,.506,38,68,.559,3,13,.231,9,19,.474,94
23519,2009-12-08,MIN,@,TOR,L 88-94,240,33,89,.371,30,73,.411,3,16,.188,19,23,.826,88
23520,2009-12-08,TOR,,MIN,W 94-88,240,26,80,.325,24,59,.407,2,21,.095,40,48,.833,94
23521,2009-12-07,NYK,,POR,W 93-84,240,32,78,.410,19,52,.365,13,26,.500,16,24,.667,93
23522,2009-12-07,POR,@,NYK,L 84-93,240,31,66,.470,30,58,.517,1,8,.125,21,25,.840,84
23523,2009-12-07,GSW,@,OKC,L 88-104,240,33,76,.434,29,63,.460,4,13,.308,18,22,.818,88
23524,2009-12-07,OKC,,GSW,W 104-88,240,35,83,.422,30,67,.448,5,16,.313,29,35,.829,104
23525,2009-12-07,DEN,@,PHI,W 93-83,240,29,74,.392,18,56,.321,11,18,.611,24,26,.923,93
23526,2009-12-07,PHI,,DEN,L 83-93,240,35,87,.402,30,68,.441,5,19,.263,8,9,.889,83
23527,2009-12-07,SAS,@,UTA,L 101-104,240,34,70,.486,25,48,.521,9,22,.409,24,31,.774,101
23528,2009-12-07,UTA,,SAS,W 104-101,240,42,79,.532,35,68,.515,7,11,.636,13,15,.867,104
23529,2009-12-06,DET,,WAS,W 98-94,240,35,82,.427,31,62,.500,4,20,.200,24,36,.667,98
23530,2009-12-06,WAS,@,DET,L 94-98,240,34,78,.436,28,57,.491,6,21,.286,20,23,.870,94
23531,2009-12-06,LAL,,PHO,W 108-88,240,38,81,.469,28,60,.467,10,21,.476,22,26,.846,108
23532,2009-12-06,PHO,@,LAL,L 88-108,240,37,83,.446,33,70,.471,4,13,.308,10,11,.909,88
23533,2009-12-06,CLE,@,MIL,W 101-86,240,35,74,.473,29,64,.453,6,10,.600,25,27,.926,101
23534,2009-12-06,MIL,,CLE,L 86-101,240,35,93,.376,31,73,.425,4,20,.200,12,16,.750,86
23535,2009-12-06,BRK,@,NYK,L 97-106,240,40,81,.494,35,65,.538,5,16,.313,12,15,.800,97
23536,2009-12-06,NYK,,NJN,W 106-97,240,36,77,.468,30,62,.484,6,15,.400,28,34,.824,106
23537,2009-12-06,MIA,@,SAC,W 115-102,240,41,70,.586,34,51,.667,7,19,.368,26,31,.839,115
23538,2009-12-06,SAC,,MIA,L 102-115,240,37,79,.468,29,57,.509,8,22,.364,20,32,.625,102
23539,2009-12-05,CHA,,PHI,W 106-105,240,38,78,.487,29,61,.475,9,17,.529,21,26,.808,106
23540,2009-12-05,PHI,@,CHA,L 105-106,240,39,91,.429,31,72,.431,8,19,.421,19,26,.731,105
23541,2009-12-05,CHI,,TOR,L 78-110,240,30,77,.390,26,57,.456,4,20,.200,14,24,.583,78
23542,2009-12-05,TOR,@,CHI,W 110-78,240,40,83,.482,33,62,.532,7,21,.333,23,26,.885,110
23543,2009-12-05,ATL,@,DAL,W 80-75,240,32,89,.360,30,76,.395,2,13,.154,14,22,.636,80
23544,2009-12-05,DAL,,ATL,L 75-80,240,25,67,.373,17,43,.395,8,24,.333,17,24,.708,75
23545,2009-12-05,GSW,,ORL,L 118-126,240,42,89,.472,38,74,.514,4,15,.267,30,36,.833,118
23546,2009-12-05,ORL,@,GSW,W 126-118,240,39,74,.527,27,48,.563,12,26,.462,36,41,.878,126
23547,2009-12-05,IND,@,LAC,L 72-88,240,27,72,.375,22,51,.431,5,21,.238,13,19,.684,72
23548,2009-12-05,LAC,,IND,W 88-72,240,29,83,.349,25,67,.373,4,16,.250,26,31,.839,88
23549,2009-12-05,MIN,,UTA,W 108-101,240,44,77,.571,40,68,.588,4,9,.444,16,24,.667,108
23550,2009-12-05,UTA,@,MIN,L 101-108,240,43,86,.500,41,70,.586,2,16,.125,13,17,.765,101
23551,2009-12-05,PHO,,SAC,W 115-107,240,38,88,.432,27,64,.422,11,24,.458,28,34,.824,115
23552,2009-12-05,SAC,@,PHO,L 107-115,240,39,90,.433,30,67,.448,9,23,.391,20,29,.690,107
23553,2009-12-05,HOU,@,POR,L 89-90,240,34,77,.442,30,60,.500,4,17,.235,17,23,.739,89
23554,2009-12-05,POR,,HOU,W 90-89,240,32,67,.478,28,55,.509,4,12,.333,22,26,.846,90
23555,2009-12-05,DEN,@,SAS,W 106-99,240,38,79,.481,34,70,.486,4,9,.444,26,33,.788,106
23556,2009-12-05,SAS,,DEN,L 99-106,240,33,70,.471,26,49,.531,7,21,.333,26,31,.839,99
23557,2009-12-04,ATL,,NYK,L 107-114,240,41,90,.456,37,67,.552,4,23,.174,21,29,.724,107
23558,2009-12-04,NYK,@,ATL,W 114-107,240,45,78,.577,34,53,.642,11,25,.440,13,20,.650,114
23559,2009-12-04,CHI,@,CLE,L 87-101,240,33,78,.423,28,69,.406,5,9,.556,16,20,.800,87
23560,2009-12-04,CLE,,CHI,W 101-87,240,39,76,.513,33,58,.569,6,18,.333,17,31,.548,101
23561,2009-12-04,DET,,MIL,W 105-96,240,39,68,.574,35,54,.648,4,14,.286,23,33,.697,105
23562,2009-12-04,MIL,@,DET,L 96-105,240,36,83,.434,26,53,.491,10,30,.333,14,19,.737,96
23563,2009-12-04,LAL,,MIA,W 108-107,240,40,93,.430,35,76,.461,5,17,.294,23,28,.821,108
23564,2009-12-04,MIA,@,LAL,L 107-108,240,37,76,.487,31,63,.492,6,13,.462,27,42,.643,107
23565,2009-12-04,DAL,@,MEM,L 82-98,240,32,91,.352,24,62,.387,8,29,.276,10,10,1.000,82
23566,2009-12-04,MEM,,DAL,W 98-82,240,39,85,.459,30,68,.441,9,17,.529,11,15,.733,98
23567,2009-12-04,CHA,@,NJN,L 91-97,240,33,73,.452,26,57,.456,7,16,.438,18,30,.600,91
23568,2009-12-04,BRK,,CHA,W 97-91,240,34,87,.391,29,72,.403,5,15,.333,24,29,.828,97
23569,2009-12-04,MIN,@,NOH,L 89-98,240,36,85,.424,29,71,.408,7,14,.500,10,16,.625,89
23570,2009-12-04,NOP,,MIN,W 98-89,240,39,78,.500,31,57,.544,8,21,.381,12,21,.571,98
23571,2009-12-04,BOS,@,OKC,W 105-87,240,39,69,.565,30,52,.577,9,17,.529,18,24,.750,105
23572,2009-12-04,OKC,,BOS,L 87-105,240,32,68,.471,29,51,.569,3,17,.176,20,26,.769,87
23573,2009-12-04,IND,@,UTA,L 87-96,240,27,68,.397,19,41,.463,8,27,.296,25,34,.735,87
23574,2009-12-04,UTA,,IND,W 96-87,240,37,85,.435,32,69,.464,5,16,.313,17,27,.630,96
23575,2009-12-04,TOR,@,WAS,W 109-107 (OT),265,41,91,.451,32,66,.485,9,25,.360,18,23,.783,109
23576,2009-12-04,WAS,,TOR,L 107-109 (OT),265,35,95,.368,25,66,.379,10,29,.345,27,34,.794,107
23577,2009-12-03,DEN,,MIA,W 114-96,240,36,76,.474,27,59,.458,9,17,.529,33,43,.767,114
23578,2009-12-03,MIA,@,DEN,L 96-114,240,35,82,.427,29,64,.453,6,18,.333,20,31,.645,96
23579,2009-12-03,GSW,,HOU,L 109-111,240,41,91,.451,30,68,.441,11,23,.478,16,20,.800,109
23580,2009-12-03,HOU,@,GSW,W 111-109,240,40,82,.488,32,59,.542,8,23,.348,23,29,.793,111
23581,2009-12-03,BOS,@,SAS,W 90-83,240,36,78,.462,32,60,.533,4,18,.222,14,19,.737,90
23582,2009-12-03,SAS,,BOS,L 83-90,240,37,88,.420,35,72,.486,2,16,.125,7,17,.412,83
23583,2009-12-02,ATL,,TOR,W 146-115,240,52,88,.591,41,67,.612,11,21,.524,31,39,.795,146
23584,2009-12-02,TOR,@,ATL,L 115-146,240,42,82,.512,32,66,.485,10,16,.625,21,34,.618,115
23585,2009-12-02,CHI,,DET,W 92-85,240,33,69,.478,29,60,.483,4,9,.444,22,30,.733,92
23586,2009-12-02,DET,@,CHI,L 85-92,240,30,78,.385,26,62,.419,4,16,.250,21,31,.677,85
23587,2009-12-02,CLE,,PHO,W 107-90,240,45,93,.484,39,71,.549,6,22,.273,11,16,.688,107
23588,2009-12-02,PHO,@,CLE,L 90-107,240,32,80,.400,22,57,.386,10,23,.435,16,21,.762,90
23589,2009-12-02,HOU,@,LAC,W 102-85,240,38,75,.507,26,52,.500,12,23,.522,14,17,.824,102
23590,2009-12-02,LAC,,HOU,L 85-102,240,34,75,.453,33,61,.541,1,14,.071,16,19,.842,85
23591,2009-12-02,MEM,@,MIN,W 97-95,240,34,75,.453,28,58,.483,6,17,.353,23,32,.719,97
23592,2009-12-02,MIN,,MEM,L 95-97,240,37,74,.500,33,64,.516,4,10,.400,17,25,.680,95
23593,2009-12-02,DAL,@,NJN,W 117-101,240,44,75,.587,36,57,.632,8,18,.444,21,25,.840,117
23594,2009-12-02,BRK,,DAL,L 101-117,240,34,77,.442,28,59,.475,6,18,.333,27,32,.844,101
23595,2009-12-02,OKC,,PHI,W 117-106,240,43,85,.506,31,61,.508,12,24,.500,19,23,.826,117
23596,2009-12-02,PHI,@,OKC,L 106-117,240,37,74,.500,23,51,.451,14,23,.609,18,19,.947,106
23597,2009-12-02,NYK,@,ORL,L 104-118,240,39,84,.464,29,60,.483,10,24,.417,16,21,.762,104
23598,2009-12-02,ORL,,NYK,W 118-104,240,43,78,.551,33,48,.688,10,30,.333,22,30,.733,118
23599,2009-12-02,IND,@,SAC,L 105-110,240,40,92,.435,33,70,.471,7,22,.318,18,25,.720,105
23600,2009-12-02,SAC,,IND,W 110-105,240,41,81,.506,32,63,.508,9,18,.500,19,25,.760,110
23601,2009-12-02,MIL,@,WAS,L 102-104,240,42,95,.442,33,68,.485,9,27,.333,9,12,.750,102
23602,2009-12-02,WAS,,MIL,W 104-102,240,38,70,.543,35,60,.583,3,10,.300,25,34,.735,104
23603,2009-12-01,BOS,@,CHA,W 108-90,240,36,66,.545,26,49,.531,10,17,.588,26,29,.897,108
23604,2009-12-01,CHA,,BOS,L 90-108,240,32,79,.405,30,68,.441,2,11,.182,24,35,.686,90
23605,2009-12-01,DEN,,GSW,W 135-107,240,52,95,.547,49,81,.605,3,14,.214,28,32,.875,135
23606,2009-12-01,GSW,@,DEN,L 107-135,240,41,94,.436,35,68,.515,6,26,.231,19,24,.792,107
23607,2009-12-01,LAL,,NOH,W 110-99,240,38,73,.521,32,51,.627,6,22,.273,28,33,.848,110
23608,2009-12-01,NOP,@,LAL,L 99-110,240,41,86,.477,37,65,.569,4,21,.190,13,15,.867,99
23609,2009-12-01,NYK,,PHO,W 126-99,240,47,95,.495,33,64,.516,14,31,.452,18,27,.667,126
23610,2009-12-01,PHO,@,NYK,L 99-126,240,35,77,.455,31,60,.517,4,17,.235,25,32,.781,99
23611,2009-12-01,MIA,@,POR,W 107-100,240,40,75,.533,33,58,.569,7,17,.412,20,27,.741,107
23612,2009-12-01,POR,,MIA,L 100-107,240,34,87,.391,26,67,.388,8,20,.400,24,32,.750,100
23613,2009-12-01,TOR,,WAS,L 102-106,240,36,84,.429,28,63,.444,8,21,.381,22,27,.815,102
23614,2009-12-01,WAS,@,TOR,W 106-102,240,40,84,.476,34,66,.515,6,18,.333,20,32,.625,106
23615,2009-11-30,DAL,,PHI,W 104-102,240,40,87,.460,30,66,.455,10,21,.476,14,17,.824,104
23616,2009-11-30,PHI,@,DAL,L 102-104,240,37,91,.407,33,75,.440,4,16,.250,24,27,.889,102
23617,2009-11-30,GSW,,IND,W 126-107,240,45,80,.563,37,61,.607,8,19,.421,28,34,.824,126
23618,2009-11-30,IND,@,GSW,L 107-126,240,38,86,.442,35,65,.538,3,21,.143,28,34,.824,107
23619,2009-11-30,CHI,@,MIL,L 97-99,240,34,80,.425,32,72,.444,2,8,.250,27,33,.818,97
23620,2009-11-30,MIL,,CHI,W 99-97,240,39,92,.424,29,66,.439,10,26,.385,11,21,.524,99
23621,2009-11-30,MEM,@,UTA,L 93-120,240,36,76,.474,34,67,.507,2,9,.222,19,32,.594,93
23622,2009-11-30,UTA,,MEM,W 120-93,240,45,77,.584,38,63,.603,7,14,.500,23,25,.920,120
23623,2009-11-29,DEN,,MIN,L 100-106,240,35,84,.417,29,60,.483,6,24,.250,24,30,.800,100
23624,2009-11-29,MIN,@,DEN,W 106-100,240,43,84,.512,40,68,.588,3,16,.188,17,21,.810,106
23625,2009-11-29,ATL,@,DET,L 88-94,240,37,74,.500,30,53,.566,7,21,.333,7,8,.875,88
23626,2009-11-29,DET,,ATL,W 94-88,240,40,91,.440,39,85,.459,1,6,.167,13,16,.813,94
23627,2009-11-29,LAC,,MEM,W 98-88,240,39,78,.500,37,67,.552,2,11,.182,18,27,.667,98
23628,2009-11-29,MEM,@,LAC,L 88-98,240,37,76,.487,34,61,.557,3,15,.200,11,18,.611,88
23629,2009-11-29,LAL,,NJN,W 106-87,240,40,80,.500,27,55,.491,13,25,.520,13,21,.619,106
23630,2009-11-29,BRK,@,LAL,L 87-106,240,34,79,.430,29,67,.433,5,12,.417,14,20,.700,87
23631,2009-11-29,BOS,@,MIA,W 92-85,240,36,69,.522,31,48,.646,5,21,.238,15,23,.652,92
23632,2009-11-29,MIA,,BOS,L 85-92,240,33,79,.418,31,64,.484,2,15,.133,17,28,.607,85
23633,2009-11-29,NYK,,ORL,L 102-114,240,42,83,.506,33,60,.550,9,23,.391,9,13,.692,102
23634,2009-11-29,ORL,@,NYK,W 114-102,240,42,83,.506,29,45,.644,13,38,.342,17,31,.548,114
23635,2009-11-29,HOU,@,OKC,W 100-91,240,38,94,.404,31,71,.437,7,23,.304,17,18,.944,100
23636,2009-11-29,OKC,,HOU,L 91-100,240,36,75,.480,35,60,.583,1,15,.067,18,20,.900,91
23637,2009-11-29,NOP,@,SAC,L 96-112,240,37,80,.463,32,61,.525,5,19,.263,17,20,.850,96
23638,2009-11-29,SAC,,NOH,W 112-96,240,44,83,.530,35,65,.538,9,18,.500,15,19,.789,112
23639,2009-11-29,PHI,@,SAS,L 89-97,240,35,89,.393,30,70,.429,5,19,.263,14,17,.824,89
23640,2009-11-29,SAS,,PHI,W 97-89,240,37,76,.487,27,58,.466,10,18,.556,13,16,.813,97
23641,2009-11-29,PHO,@,TOR,W 113-94,240,43,84,.512,30,54,.556,13,30,.433,14,17,.824,113
23642,2009-11-29,TOR,,PHO,L 94-113,240,36,92,.391,35,72,.486,1,20,.050,21,26,.808,94
23643,2009-11-28,CLE,,DAL,W 111-95,240,45,78,.577,36,65,.554,9,13,.692,12,17,.706,111
23644,2009-11-28,DAL,@,CLE,L 95-111,240,34,72,.472,26,53,.491,8,19,.421,19,24,.792,95
23645,2009-11-28,GSW,,LAL,L 97-130,240,36,92,.391,32,75,.427,4,17,.235,21,24,.875,97
23646,2009-11-28,LAL,@,GSW,W 130-97,240,51,94,.543,40,72,.556,11,22,.500,17,24,.708,130
23647,2009-11-28,MIL,,ORL,L 98-100,240,37,90,.411,26,71,.366,11,19,.579,13,17,.765,98
23648,2009-11-28,ORL,@,MIL,W 100-98,240,39,77,.506,31,55,.564,8,22,.364,14,25,.560,100
23649,2009-11-28,POR,@,UTA,L 92-108,240,34,75,.453,31,57,.544,3,18,.167,21,29,.724,92
23650,2009-11-28,UTA,,POR,W 108-92,240,43,71,.606,36,59,.610,7,12,.583,15,27,.556,108
23651,2009-11-28,CHA,@,WAS,W 92-76,240,35,76,.461,31,66,.470,4,10,.400,18,25,.720,92
23652,2009-11-28,WAS,,CHA,L 76-92,240,30,77,.390,26,61,.426,4,16,.250,12,13,.923,76
23653,2009-11-27,BOS,,TOR,W 116-103,240,48,77,.623,41,60,.683,7,17,.412,13,15,.867,116
23654,2009-11-27,TOR,@,BOS,L 103-116,240,39,70,.557,32,56,.571,7,14,.500,18,23,.783,103
23655,2009-11-27,CHA,,CLE,W 94-87,240,35,74,.473,29,60,.483,6,14,.429,18,30,.600,94
23656,2009-11-27,CLE,@,CHA,L 87-94,240,36,79,.456,30,51,.588,6,28,.214,9,17,.529,87
23657,2009-11-27,DEN,,NYK,W 128-125,240,45,84,.536,35,65,.538,10,19,.526,28,35,.800,128
23658,2009-11-27,NYK,@,DEN,L 125-128,240,45,92,.489,32,61,.525,13,31,.419,22,31,.710,125
23659,2009-11-27,DET,,LAC,L 96-104,240,36,91,.396,28,74,.378,8,17,.471,16,22,.727,96
23660,2009-11-27,LAC,@,DET,W 104-96,240,37,63,.587,35,53,.660,2,10,.200,28,35,.800,104
23661,2009-11-27,HOU,,SAS,L 84-92,240,33,92,.359,25,74,.338,8,18,.444,10,14,.714,84
23662,2009-11-27,SAS,@,HOU,W 92-84,240,32,71,.451,30,66,.455,2,5,.400,26,34,.765,92
23663,2009-11-27,DAL,@,IND,W 113-92,240,41,92,.446,32,71,.451,9,21,.429,22,28,.786,113
23664,2009-11-27,IND,,DAL,L 92-113,240,33,76,.434,26,54,.481,7,22,.318,19,28,.679,92
23665,2009-11-27,MIA,,WAS,L 84-94,240,34,82,.415,28,56,.500,6,26,.231,10,14,.714,84
23666,2009-11-27,WAS,@,MIA,W 94-84,240,42,86,.488,40,72,.556,2,14,.143,8,15,.533,94
23667,2009-11-27,MIN,,PHO,L 95-120,240,35,86,.407,33,72,.458,2,14,.143,23,32,.719,95
23668,2009-11-27,PHO,@,MIN,W 120-95,240,51,86,.593,41,62,.661,10,24,.417,8,10,.800,120
23669,2009-11-27,MIL,@,OKC,L 90-108,240,31,82,.378,23,62,.371,8,20,.400,20,22,.909,90
23670,2009-11-27,OKC,,MIL,W 108-90,240,38,80,.475,32,66,.485,6,14,.429,26,35,.743,108
23671,2009-11-27,ATL,@,PHI,W 100-86,240,38,74,.514,29,56,.518,9,18,.500,15,20,.750,100
23672,2009-11-27,PHI,,ATL,L 86-100,240,35,78,.449,27,60,.450,8,18,.444,8,11,.727,86
23673,2009-11-27,MEM,@,POR,W 106-96,240,43,80,.538,39,72,.542,4,8,.500,16,19,.842,106
23674,2009-11-27,POR,,MEM,L 96-106,240,33,81,.407,23,57,.404,10,24,.417,20,26,.769,96
23675,2009-11-27,BRK,@,SAC,L 96-109,240,36,94,.383,34,85,.400,2,9,.222,22,27,.815,96
23676,2009-11-27,SAC,,NJN,W 109-96,240,39,71,.549,33,59,.559,6,12,.500,25,34,.735,109
23677,2009-11-26,ATL,,ORL,L 76-93,240,33,85,.388,26,66,.394,7,19,.368,3,7,.429,76
23678,2009-11-26,ORL,@,ATL,W 93-76,240,35,80,.438,25,49,.510,10,31,.323,13,20,.650,93
23679,2009-11-26,CHI,@,UTA,L 86-105,240,34,81,.420,31,73,.425,3,8,.375,15,19,.789,86
23680,2009-11-26,UTA,,CHI,W 105-86,240,45,74,.608,43,69,.623,2,5,.400,13,23,.565,105
23681,2009-11-25,BOS,,PHI,W 113-110,240,38,78,.487,31,51,.608,7,27,.259,30,39,.769,113
23682,2009-11-25,PHI,@,BOS,L 110-113,240,39,82,.476,26,62,.419,13,20,.650,19,26,.731,110
23683,2009-11-25,CHA,,TOR,W 116-81,240,42,93,.452,37,75,.493,5,18,.278,27,32,.844,116
23684,2009-11-25,TOR,@,CHA,L 81-116,240,30,87,.345,26,68,.382,4,19,.211,17,23,.739,81
23685,2009-11-25,CLE,@,DET,W 98-88,240,34,68,.500,25,51,.490,9,17,.529,21,28,.750,98
23686,2009-11-25,DET,,CLE,L 88-98,240,31,79,.392,26,65,.400,5,14,.357,21,31,.677,88
23687,2009-11-25,DAL,@,HOU,W 130-99,240,55,84,.655,46,67,.687,9,17,.529,11,14,.786,130
23688,2009-11-25,HOU,,DAL,L 99-130,240,38,83,.458,33,63,.524,5,20,.250,18,29,.621,99
23689,2009-11-25,IND,,LAC,W 86-73,240,32,85,.376,26,68,.382,6,17,.353,16,20,.800,86
23690,2009-11-25,LAC,@,IND,L 73-86,240,29,90,.322,25,80,.313,4,10,.400,11,14,.786,73
23691,2009-11-25,DEN,@,MIN,W 124-111,240,42,80,.525,32,62,.516,10,18,.556,30,33,.909,124
23692,2009-11-25,MIN,,DEN,L 111-124,240,44,99,.444,40,80,.500,4,19,.211,19,28,.679,111
23693,2009-11-25,MIL,@,NOH,L 99-102 (OT),265,38,96,.396,31,71,.437,7,25,.280,16,22,.727,99
23694,2009-11-25,NOP,,MIL,W 102-99 (OT),265,34,93,.366,28,69,.406,6,24,.250,28,31,.903,102
23695,2009-11-25,MIA,@,ORL,W 99-98,240,33,85,.388,27,65,.415,6,20,.300,27,32,.844,99
23696,2009-11-25,ORL,,MIA,L 98-99,240,32,77,.416,18,46,.391,14,31,.452,20,33,.606,98
23697,2009-11-25,MEM,@,PHO,L 111-126,240,45,94,.479,44,86,.512,1,8,.125,20,25,.800,111
23698,2009-11-25,PHO,,MEM,W 126-111,240,52,84,.619,43,67,.642,9,17,.529,13,18,.722,126
23699,2009-11-25,BRK,@,POR,L 83-93,240,36,81,.444,35,75,.467,1,6,.167,10,14,.714,83
23700,2009-11-25,POR,,NJN,W 93-83,240,35,70,.500,26,53,.491,9,17,.529,14,24,.583,93
23701,2009-11-25,NYK,@,SAC,L 97-111,240,35,91,.385,25,52,.481,10,39,.256,17,18,.944,97
23702,2009-11-25,SAC,,NYK,W 111-97,240,43,89,.483,31,62,.500,12,27,.444,13,18,.722,111
23703,2009-11-25,GSW,@,SAS,L 104-118,240,40,86,.465,37,75,.493,3,11,.273,21,26,.808,104
23704,2009-11-25,SAS,,GSW,W 118-104,240,44,85,.518,39,67,.582,5,18,.278,25,32,.781,118
23705,2009-11-24,DAL,,GSW,L 103-111,240,38,82,.463,34,67,.507,4,15,.267,23,25,.920,103
23706,2009-11-24,GSW,@,DAL,W 111-103,240,42,88,.477,32,67,.478,10,21,.476,17,21,.810,111
23707,2009-11-24,DEN,,NJN,W 101-87,240,38,79,.481,36,68,.529,2,11,.182,23,33,.697,101
23708,2009-11-24,BRK,@,DEN,L 87-101,240,28,72,.389,23,52,.442,5,20,.250,26,36,.722,87
23709,2009-11-24,LAL,,NYK,W 100-90,240,40,86,.465,35,65,.538,5,21,.238,15,18,.833,100
23710,2009-11-24,NYK,@,LAL,L 90-100,240,35,90,.389,24,57,.421,11,33,.333,9,12,.750,90
23711,2009-11-24,IND,@,TOR,L 112-123,240,39,86,.453,27,59,.458,12,27,.444,22,26,.846,112
23712,2009-11-24,TOR,,IND,W 123-112,240,43,77,.558,34,59,.576,9,18,.500,28,37,.757,123
23713,2009-11-24,OKC,@,UTA,W 104-94,240,37,76,.487,29,58,.500,8,18,.444,22,25,.880,104
23714,2009-11-24,UTA,,OKC,L 94-104,240,38,77,.494,35,67,.522,3,10,.300,15,18,.833,94
23715,2009-11-24,PHI,@,WAS,L 107-108,240,38,94,.404,28,67,.418,10,27,.370,21,23,.913,107
23716,2009-11-24,WAS,,PHI,W 108-107,240,44,93,.473,38,76,.500,6,17,.353,14,18,.778,108
23717,2009-11-23,LAC,,MIN,W 91-87,240,35,83,.422,33,69,.478,2,14,.143,19,22,.864,91
23718,2009-11-23,MIN,@,LAC,L 87-91,240,33,76,.434,26,60,.433,7,16,.438,14,18,.778,87
23719,2009-11-23,MEM,,SAC,W 116-105,240,41,76,.539,38,67,.567,3,9,.333,31,42,.738,116
23720,2009-11-23,SAC,@,MEM,L 105-116,240,41,83,.494,35,67,.522,6,16,.375,17,23,.739,105
23721,2009-11-23,CHI,@,POR,L 98-122,240,37,80,.463,31,67,.463,6,13,.462,18,22,.818,98
23722,2009-11-23,POR,,CHI,W 122-98,240,42,73,.575,36,58,.621,6,15,.400,32,40,.800,122
23723,2009-11-23,MIL,@,SAS,L 98-112,240,41,83,.494,34,67,.507,7,16,.438,9,14,.643,98
23724,2009-11-23,SAS,,MIL,W 112-98,240,40,78,.513,30,57,.526,10,21,.476,22,26,.846,112
23725,2009-11-22,CHA,,IND,W 104-88,240,41,82,.500,40,72,.556,1,10,.100,21,28,.750,104
23726,2009-11-22,IND,@,CHA,L 88-104,240,32,78,.410,27,56,.482,5,22,.227,19,24,.792,88
23727,2009-11-22,LAL,,OKC,W 101-85,240,40,99,.404,38,85,.447,2,14,.143,19,21,.905,101
23728,2009-11-22,OKC,@,LAL,L 85-101,240,32,86,.372,29,63,.460,3,23,.130,18,23,.783,85
23729,2009-11-22,MIA,,NOH,W 102-101,240,37,71,.521,30,58,.517,7,13,.538,21,28,.750,102
23730,2009-11-22,NOP,@,MIA,L 101-102,240,36,91,.396,24,63,.381,12,28,.429,17,19,.895,101
23731,2009-11-22,BOS,@,NYK,W 107-105 (OT),265,35,85,.412,25,60,.417,10,25,.400,27,35,.771,107
23732,2009-11-22,NYK,,BOS,L 105-107 (OT),265,38,88,.432,28,58,.483,10,30,.333,19,24,.792,105
23733,2009-11-22,DET,@,PHO,L 91-117,240,38,89,.427,31,71,.437,7,18,.389,8,12,.667,91
23734,2009-11-22,PHO,,DET,W 117-91,240,42,73,.575,31,55,.564,11,18,.611,22,25,.880,117
23735,2009-11-22,ORL,@,TOR,W 104-96,240,34,83,.410,25,51,.490,9,32,.281,27,35,.771,104
23736,2009-11-22,TOR,,ORL,L 96-104,240,34,77,.442,28,61,.459,6,16,.375,22,28,.786,96
23737,2009-11-21,CLE,,PHI,W 97-91,240,36,75,.480,28,55,.509,8,20,.400,17,21,.810,97
23738,2009-11-21,PHI,@,CLE,L 91-97,240,37,88,.420,32,69,.464,5,19,.263,12,16,.750,91
23739,2009-11-21,CHI,@,DEN,L 93-112,240,36,81,.444,34,70,.486,2,11,.182,19,24,.792,93
23740,2009-11-21,DEN,,CHI,W 112-93,240,42,86,.488,35,61,.574,7,25,.280,21,26,.808,112
23741,2009-11-21,HOU,,SAC,W 113-106,240,43,90,.478,40,72,.556,3,18,.167,24,26,.923,113
23742,2009-11-21,SAC,@,HOU,L 106-113,240,43,85,.506,36,69,.522,7,16,.438,13,17,.765,106
23743,2009-11-21,MEM,,MIL,L 98-103,240,37,80,.463,34,66,.515,3,14,.214,21,29,.724,98
23744,2009-11-21,MIL,@,MEM,W 103-98,240,38,83,.458,29,58,.500,9,25,.360,18,24,.750,103
23745,2009-11-21,BRK,,NYK,L 91-98,240,37,90,.411,33,72,.458,4,18,.222,13,19,.684,91
23746,2009-11-21,NYK,@,NJN,W 98-91,240,34,80,.425,26,57,.456,8,23,.348,22,28,.786,98
23747,2009-11-21,ATL,@,NOH,L 88-96,240,35,94,.372,31,72,.431,4,22,.182,14,17,.824,88
23748,2009-11-21,NOP,,ATL,W 96-88,240,37,85,.435,25,68,.368,12,17,.706,10,17,.588,96
23749,2009-11-21,MIN,@,POR,L 78-106,240,29,77,.377,27,68,.397,2,9,.222,18,18,1.000,78
23750,2009-11-21,POR,,MIN,W 106-78,240,39,78,.500,29,54,.537,10,24,.417,18,28,.643,106
23751,2009-11-21,SAS,,WAS,W 106-84,240,40,86,.465,30,65,.462,10,21,.476,16,21,.762,106
23752,2009-11-21,WAS,@,SAS,L 84-106,240,28,84,.333,24,65,.369,4,19,.211,24,34,.706,84
23753,2009-11-21,DET,@,UTA,L 97-100 (OT),265,36,80,.450,32,65,.492,4,15,.267,21,25,.840,97
23754,2009-11-21,UTA,,DET,W 100-97 (OT),265,32,73,.438,29,62,.468,3,11,.273,33,44,.750,100
23755,2009-11-20,ATL,,HOU,W 105-103,240,39,78,.500,31,58,.534,8,20,.400,19,26,.731,105
23756,2009-11-20,HOU,@,ATL,L 103-105,240,39,92,.424,32,70,.457,7,22,.318,18,21,.857,103
23757,2009-11-20,BOS,,ORL,L 78-83,240,30,87,.345,28,68,.412,2,19,.105,16,18,.889,78
23758,2009-11-20,ORL,@,BOS,W 83-78,240,29,70,.414,19,48,.396,10,22,.455,15,26,.577,83
23759,2009-11-20,DAL,,SAC,W 104-102,240,42,93,.452,37,74,.500,5,19,.263,15,21,.714,104
23760,2009-11-20,SAC,@,DAL,L 102-104,240,43,81,.531,37,65,.569,6,16,.375,10,14,.714,102
23761,2009-11-20,GSW,,POR,W 108-94,240,40,84,.476,33,71,.465,7,13,.538,21,27,.778,108
23762,2009-11-20,POR,@,GSW,L 94-108,240,33,79,.418,29,60,.483,4,19,.211,24,30,.800,94
23763,2009-11-20,CLE,@,IND,W 105-95,240,36,78,.462,30,65,.462,6,13,.462,27,34,.794,105
23764,2009-11-20,IND,,CLE,L 95-105,240,38,81,.469,34,63,.540,4,18,.222,15,21,.714,95
23765,2009-11-20,DEN,@,LAC,L 99-106,240,34,70,.486,30,53,.566,4,17,.235,27,33,.818,99
23766,2009-11-20,LAC,,DEN,W 106-99,240,36,73,.493,29,56,.518,7,17,.412,27,33,.818,106
23767,2009-11-20,CHA,@,MIL,L 88-95,240,30,59,.508,28,45,.622,2,14,.143,26,43,.605,88
23768,2009-11-20,MIL,,CHA,W 95-88,240,34,82,.415,24,54,.444,10,28,.357,17,21,.810,95
23769,2009-11-20,OKC,,WAS,W 127-108,240,44,82,.537,33,61,.541,11,21,.524,28,33,.848,127
23770,2009-11-20,WAS,@,OKC,L 108-127,240,41,87,.471,34,72,.472,7,15,.467,19,27,.704,108
23771,2009-11-20,MEM,@,PHI,W 102-97,240,41,79,.519,38,68,.559,3,11,.273,17,25,.680,102
23772,2009-11-20,PHI,,MEM,L 97-102,240,37,81,.457,28,60,.467,9,21,.429,14,19,.737,97
23773,2009-11-20,MIA,@,TOR,L 113-120,240,39,89,.438,32,66,.485,7,23,.304,28,34,.824,113
23774,2009-11-20,TOR,,MIA,W 120-113,240,41,71,.577,32,56,.571,9,15,.600,29,36,.806,120
23775,2009-11-19,CHI,@,LAL,L 93-108,240,38,84,.452,33,69,.478,5,15,.333,12,17,.706,93
23776,2009-11-19,LAL,,CHI,W 108-93,240,42,92,.457,36,73,.493,6,19,.316,18,22,.818,108
23777,2009-11-19,NOP,,PHO,W 110-103,240,39,97,.402,26,72,.361,13,25,.520,19,23,.826,110
23778,2009-11-19,PHO,@,NOH,L 103-110,240,38,83,.458,27,55,.491,11,28,.393,16,22,.727,103
23779,2009-11-19,SAS,,UTA,L 83-90,240,32,75,.427,28,55,.509,4,20,.200,15,23,.652,83
23780,2009-11-19,UTA,@,SAS,W 90-83,240,36,78,.462,32,69,.464,4,9,.444,14,20,.700,90
23781,2009-11-18,ATL,,MIA,W 105-90,240,38,89,.427,30,69,.435,8,20,.400,21,28,.750,105
23782,2009-11-18,MIA,@,ATL,L 90-105,240,35,79,.443,26,58,.448,9,21,.429,11,16,.688,90
23783,2009-11-18,BOS,,GSW,W 109-95,240,42,80,.525,34,61,.557,8,19,.421,17,27,.630,109
23784,2009-11-18,GSW,@,BOS,L 95-109,240,37,80,.463,31,63,.492,6,17,.353,15,19,.789,95
23785,2009-11-18,DAL,,SAS,W 99-94 (OT),265,40,100,.400,37,83,.446,3,17,.176,16,21,.762,99
23786,2009-11-18,SAS,@,DAL,L 94-99 (OT),265,34,78,.436,27,63,.429,7,15,.467,19,24,.792,94
23787,2009-11-18,IND,,NYK,L 103-110,240,34,77,.442,26,51,.510,8,26,.308,27,39,.692,103
23788,2009-11-18,NYK,@,IND,W 110-103,240,35,73,.479,25,48,.521,10,25,.400,30,41,.732,110
23789,2009-11-18,LAC,@,MEM,L 91-106,240,39,82,.476,37,72,.514,2,10,.200,11,18,.611,91
23790,2009-11-18,MEM,,LAC,W 106-91,240,44,81,.543,42,71,.592,2,10,.200,16,19,.842,106
23791,2009-11-18,MIL,,NJN,W 99-85,240,39,82,.476,29,59,.492,10,23,.435,11,13,.846,99
23792,2009-11-18,BRK,@,MIL,L 85-99,240,30,78,.385,27,65,.415,3,13,.231,22,25,.880,85
23793,2009-11-18,HOU,@,MIN,W 97-84,240,39,90,.433,27,62,.435,12,28,.429,7,10,.700,97
23794,2009-11-18,MIN,,HOU,L 84-97,240,36,79,.456,32,64,.500,4,15,.267,8,10,.800,84
23795,2009-11-18,OKC,@,ORL,L 94-108,240,34,83,.410,26,62,.419,8,21,.381,18,23,.783,94
23796,2009-11-18,ORL,,OKC,W 108-94,240,39,81,.481,26,50,.520,13,31,.419,17,26,.654,108
23797,2009-11-18,CHA,@,PHI,L 84-86,240,30,71,.423,23,47,.489,7,24,.292,17,24,.708,84
23798,2009-11-18,PHI,,CHA,W 86-84,240,34,79,.430,28,63,.444,6,16,.375,12,15,.800,86
23799,2009-11-18,DET,@,POR,L 81-87,240,31,80,.388,27,65,.415,4,15,.267,15,18,.833,81
23800,2009-11-18,POR,,DET,W 87-81,240,33,70,.471,28,54,.519,5,16,.313,16,23,.696,87
23801,2009-11-18,TOR,@,UTA,L 91-104,240,34,91,.374,28,66,.424,6,25,.240,17,22,.773,91
23802,2009-11-18,UTA,,TOR,W 104-91,240,41,84,.488,38,73,.521,3,11,.273,19,29,.655,104
23803,2009-11-18,CLE,@,WAS,L 91-108,240,35,78,.449,28,56,.500,7,22,.318,14,15,.933,91
23804,2009-11-18,WAS,,CLE,W 108-91,240,36,84,.429,31,61,.508,5,23,.217,31,35,.886,108
23805,2009-11-17,CLE,,GSW,W 114-108,240,46,79,.582,37,59,.627,9,20,.450,13,17,.765,114
23806,2009-11-17,GSW,@,CLE,L 108-114,240,41,88,.466,32,64,.500,9,24,.375,17,22,.773,108
23807,2009-11-17,DEN,,TOR,W 130-112,240,48,78,.615,41,61,.672,7,17,.412,27,35,.771,130
23808,2009-11-17,TOR,@,DEN,L 112-130,240,42,91,.462,35,75,.467,7,16,.438,21,28,.750,112
23809,2009-11-17,HOU,,PHO,L 105-111,240,43,97,.443,34,71,.479,9,26,.346,10,13,.769,105
23810,2009-11-17,PHO,@,HOU,W 111-105,240,41,79,.519,35,58,.603,6,21,.286,23,32,.719,111
23811,2009-11-17,DET,@,LAL,L 93-106,240,34,72,.472,31,60,.517,3,12,.250,22,27,.815,93
23812,2009-11-17,LAL,,DET,W 106-93,240,42,89,.472,38,69,.551,4,20,.200,18,22,.818,106
23813,2009-11-17,MIA,,OKC,L 87-100,240,31,72,.431,26,54,.481,5,18,.278,20,30,.667,87
23814,2009-11-17,OKC,@,MIA,W 100-87,240,37,77,.481,32,63,.508,5,14,.357,21,22,.955,100
23815,2009-11-17,IND,@,NJN,W 91-83,240,31,79,.392,27,66,.409,4,13,.308,25,31,.806,91
23816,2009-11-17,BRK,,IND,L 83-91,240,29,80,.363,28,69,.406,1,11,.091,24,27,.889,83
23817,2009-11-17,LAC,@,NOH,L 102-110,240,39,82,.476,32,62,.516,7,20,.350,17,21,.810,102
23818,2009-11-17,NOP,,LAC,W 110-102,240,37,81,.457,29,53,.547,8,28,.286,28,33,.848,110
23819,2009-11-17,CHI,@,SAC,W 101-87,240,39,83,.470,32,71,.451,7,12,.583,16,21,.762,101
23820,2009-11-17,SAC,,CHI,L 87-101,240,35,81,.432,31,60,.517,4,21,.190,13,18,.722,87
23821,2009-11-16,ATL,,POR,W 99-95 (OT),265,39,91,.429,34,73,.466,5,18,.278,16,20,.800,99
23822,2009-11-16,POR,@,ATL,L 95-99 (OT),265,37,80,.463,30,63,.476,7,17,.412,14,17,.824,95
23823,2009-11-16,DAL,@,MIL,W 115-113 (OT),265,44,86,.512,34,66,.515,10,20,.500,17,22,.773,115
23824,2009-11-16,MIL,,DAL,L 113-115 (OT),265,44,99,.444,30,72,.417,14,27,.519,11,17,.647,113
23825,2009-11-16,CHA,@,ORL,L 91-97,240,36,71,.507,32,57,.561,4,14,.286,15,26,.577,91
23826,2009-11-16,ORL,,CHA,W 97-91,240,33,77,.429,22,45,.489,11,32,.344,20,31,.645,97
23827,2009-11-15,DAL,@,DET,W 95-90,240,36,82,.439,29,66,.439,7,16,.438,16,21,.762,95
23828,2009-11-15,DET,,DAL,L 90-95,240,38,83,.458,36,70,.514,2,13,.154,12,17,.706,90
23829,2009-11-15,HOU,@,LAL,W 101-91,240,38,91,.418,29,59,.492,9,32,.281,16,19,.842,101
23830,2009-11-15,LAL,,HOU,L 91-101,240,32,84,.381,25,61,.410,7,23,.304,20,27,.741,91
23831,2009-11-15,LAC,@,OKC,W 101-93,240,38,79,.481,33,62,.532,5,17,.294,20,28,.714,101
23832,2009-11-15,OKC,,LAC,L 93-101,240,33,85,.388,30,65,.462,3,20,.150,24,29,.828,93
23833,2009-11-15,PHO,,TOR,W 101-100,240,35,78,.449,27,54,.500,8,24,.333,23,27,.852,101
23834,2009-11-15,TOR,@,PHO,L 100-101,240,40,88,.455,31,64,.484,9,24,.375,11,14,.786,100
23835,2009-11-14,ATL,,NOH,W 121-98,240,48,88,.545,41,68,.603,7,20,.350,18,29,.621,121
23836,2009-11-14,NOP,@,ATL,L 98-121,240,40,91,.440,33,64,.516,7,27,.259,11,18,.611,98
23837,2009-11-14,CHA,,POR,L 74-80,240,30,82,.366,24,63,.381,6,19,.316,8,14,.571,74
23838,2009-11-14,POR,@,CHA,W 80-74,240,27,64,.422,22,44,.500,5,20,.250,21,25,.840,80
23839,2009-11-14,CHI,,PHI,W 94-88,240,35,78,.449,32,70,.457,3,8,.375,21,28,.750,94
23840,2009-11-14,PHI,@,CHI,L 88-94,240,34,81,.420,27,61,.443,7,20,.350,13,21,.619,88
23841,2009-11-14,CLE,,UTA,W 107-103,240,39,76,.513,30,54,.556,9,22,.409,20,27,.741,107
23842,2009-11-14,UTA,@,CLE,L 103-107,240,39,74,.527,36,62,.581,3,12,.250,22,26,.846,103
23843,2009-11-14,BOS,@,IND,L 104-113,240,39,82,.476,36,70,.514,3,12,.250,23,31,.742,104
23844,2009-11-14,IND,,BOS,W 113-104,240,40,76,.526,31,58,.534,9,18,.500,24,31,.774,113
23845,2009-11-14,MEM,,MIN,W 97-87,240,39,80,.488,37,66,.561,2,14,.143,17,20,.850,97
23846,2009-11-14,MIN,@,MEM,L 87-97,240,40,83,.482,39,68,.574,1,15,.067,6,9,.667,87
23847,2009-11-14,MIA,,NJN,W 81-80,240,33,84,.393,29,66,.439,4,18,.222,11,15,.733,81
23848,2009-11-14,BRK,@,MIA,L 80-81,240,30,70,.429,26,61,.426,4,9,.444,16,21,.762,80
23849,2009-11-14,GSW,@,MIL,L 125-129,240,46,82,.561,38,62,.613,8,20,.400,25,28,.893,125
23850,2009-11-14,MIL,,GSW,W 129-125,240,48,91,.527,34,67,.507,14,24,.583,19,30,.633,129
23851,2009-11-14,OKC,@,SAS,W 101-98,240,36,77,.468,34,65,.523,2,12,.167,27,34,.794,101
23852,2009-11-14,SAS,,OKC,L 98-101,240,37,79,.468,34,61,.557,3,18,.167,21,25,.840,98
23853,2009-11-14,DET,@,WAS,W 106-103,240,37,81,.457,28,62,.452,9,19,.474,23,32,.719,106
23854,2009-11-14,WAS,,DET,L 103-106,240,36,79,.456,27,62,.435,9,17,.529,22,25,.880,103
23855,2009-11-13,ATL,@,BOS,W 97-86,240,38,84,.452,34,69,.493,4,15,.267,17,23,.739,97
23856,2009-11-13,BOS,,ATL,L 86-97,240,36,73,.493,35,58,.603,1,15,.067,13,19,.684,86
23857,2009-11-13,DEN,,LAL,W 105-79,240,37,85,.435,31,69,.449,6,16,.375,25,29,.862,105
23858,2009-11-13,LAL,@,DEN,L 79-105,240,31,89,.348,24,64,.375,7,25,.280,10,16,.625,79
23859,2009-11-13,LAC,,TOR,L 89-104,240,33,70,.471,29,52,.558,4,18,.222,19,27,.704,89
23860,2009-11-13,TOR,@,LAC,W 104-89,240,41,80,.513,32,60,.533,9,20,.450,13,15,.867,104
23861,2009-11-13,DAL,@,MIN,W 89-77,240,34,85,.400,30,63,.476,4,22,.182,17,22,.773,89
23862,2009-11-13,MIN,,DAL,L 77-89,240,29,89,.326,26,72,.361,3,17,.176,16,27,.593,77
23863,2009-11-13,NOP,,POR,L 78-86,240,29,79,.367,26,65,.400,3,14,.214,17,22,.773,78
23864,2009-11-13,POR,@,NOH,W 86-78,240,33,87,.379,31,74,.419,2,13,.154,18,26,.692,86
23865,2009-11-13,GSW,@,NYK,W 121-107,240,49,84,.583,43,66,.652,6,18,.333,17,23,.739,121
23866,2009-11-13,NYK,,GSW,L 107-121,240,42,86,.488,34,64,.531,8,22,.364,15,19,.789,107
23867,2009-11-13,BRK,@,ORL,L 72-88,240,28,85,.329,23,68,.338,5,17,.294,11,13,.846,72
23868,2009-11-13,ORL,,NJN,W 88-72,240,33,74,.446,25,47,.532,8,27,.296,14,25,.560,88
23869,2009-11-13,PHI,,UTA,L 90-112,240,34,71,.479,29,53,.547,5,18,.278,17,23,.739,90
23870,2009-11-13,UTA,@,PHI,W 112-90,240,42,82,.512,36,71,.507,6,11,.545,22,24,.917,112
23871,2009-11-13,HOU,@,SAC,L 100-109,240,37,89,.416,29,62,.468,8,27,.296,18,19,.947,100
23872,2009-11-13,SAC,,HOU,W 109-100,240,39,81,.481,31,66,.470,8,15,.533,23,29,.793,109
23873,2009-11-12,LAL,,PHO,W 121-102,240,53,92,.576,45,76,.592,8,16,.500,7,18,.389,121
23874,2009-11-12,PHO,@,LAL,L 102-121,240,38,104,.365,30,81,.370,8,23,.348,18,29,.621,102
23875,2009-11-12,CLE,@,MIA,W 111-104,240,36,75,.480,27,56,.482,9,19,.474,30,40,.750,111
23876,2009-11-12,MIA,,CLE,L 104-111,240,35,76,.461,28,54,.519,7,22,.318,27,37,.730,104
23877,2009-11-11,BOS,,UTA,W 105-86,240,41,77,.532,34,58,.586,7,19,.368,16,18,.889,105
23878,2009-11-11,UTA,@,BOS,L 86-105,240,37,79,.468,37,69,.536,0,10,.000,12,18,.667,86
23879,2009-11-11,CHA,@,DET,L 75-98,240,28,64,.438,24,49,.490,4,15,.267,15,26,.577,75
23880,2009-11-11,DET,,CHA,W 98-75,240,40,72,.556,35,58,.603,5,14,.357,13,17,.765,98
23881,2009-11-11,HOU,,MEM,W 104-79,240,44,88,.500,38,65,.585,6,23,.261,10,16,.625,104
23882,2009-11-11,MEM,@,HOU,L 79-104,240,32,81,.395,30,74,.405,2,7,.286,13,21,.619,79
23883,2009-11-11,GSW,@,IND,L 94-108,240,37,92,.402,33,77,.429,4,15,.267,16,24,.667,94
23884,2009-11-11,IND,,GSW,W 108-94,240,38,85,.447,31,71,.437,7,14,.500,25,34,.735,108
23885,2009-11-11,LAC,,OKC,L 79-83,240,28,78,.359,21,58,.362,7,20,.350,16,22,.727,79
23886,2009-11-11,OKC,@,LAC,W 83-79,240,35,83,.422,32,70,.457,3,13,.231,10,15,.667,83
23887,2009-11-11,DEN,@,MIL,L 102-108,240,35,88,.398,30,70,.429,5,18,.278,27,31,.871,102
23888,2009-11-11,MIL,,DEN,W 108-102,240,40,82,.488,34,67,.507,6,15,.400,22,25,.880,108
23889,2009-11-11,MIN,,POR,L 84-107,240,34,77,.442,28,65,.431,6,12,.500,10,12,.833,84
23890,2009-11-11,POR,@,MIN,W 107-84,240,42,76,.553,32,51,.627,10,25,.400,13,15,.867,107
23891,2009-11-11,BRK,,PHI,L 79-82,240,30,75,.400,27,61,.443,3,14,.214,16,20,.800,79
23892,2009-11-11,PHI,@,NJN,W 82-79,240,32,82,.390,27,62,.435,5,20,.250,13,20,.650,82
23893,2009-11-11,ATL,@,NYK,W 114-101,240,44,81,.543,38,68,.559,6,13,.462,20,24,.833,114
23894,2009-11-11,NYK,,ATL,L 101-114,240,40,85,.471,35,61,.574,5,24,.208,16,18,.889,101
23895,2009-11-11,CLE,@,ORL,W 102-93,240,37,77,.481,27,63,.429,10,14,.714,18,23,.783,102
23896,2009-11-11,ORL,,CLE,L 93-102,240,37,82,.451,33,64,.516,4,18,.222,15,25,.600,93
23897,2009-11-11,NOP,@,PHO,L 104-124,240,38,85,.447,30,66,.455,8,19,.421,20,25,.800,104
23898,2009-11-11,PHO,,NOH,W 124-104,240,46,83,.554,33,57,.579,13,26,.500,19,24,.792,124
23899,2009-11-11,DAL,@,SAS,L 83-92,240,28,79,.354,23,64,.359,5,15,.333,22,27,.815,83
23900,2009-11-11,SAS,,DAL,W 92-83,240,34,80,.425,20,46,.435,14,34,.412,10,19,.526,92
23901,2009-11-11,CHI,@,TOR,L 89-99,240,35,88,.398,33,80,.413,2,8,.250,17,21,.810,89
23902,2009-11-11,TOR,,CHI,W 99-89,240,36,88,.409,31,68,.456,5,20,.250,22,23,.957,99
23903,2009-11-10,CHA,,ORL,L 81-93,240,34,77,.442,32,60,.533,2,17,.118,11,14,.786,81
23904,2009-11-10,ORL,@,CHA,W 93-81,240,38,81,.469,29,56,.518,9,25,.360,8,14,.571,93
23905,2009-11-10,CHI,,DEN,L 89-90,240,38,87,.437,34,69,.493,4,18,.222,9,13,.692,89
23906,2009-11-10,DEN,@,CHI,W 90-89,240,35,84,.417,30,68,.441,5,16,.313,15,19,.789,90
23907,2009-11-10,DAL,,HOU,W 121-103,240,46,83,.554,39,71,.549,7,12,.583,22,23,.957,121
23908,2009-11-10,HOU,@,DAL,L 103-121,240,35,82,.427,29,59,.492,6,23,.261,27,34,.794,103
23909,2009-11-10,MEM,,POR,L 79-93,240,29,78,.372,28,68,.412,1,10,.100,20,28,.714,79
23910,2009-11-10,POR,@,MEM,W 93-79,240,32,70,.457,23,52,.442,9,18,.500,20,23,.870,93
23911,2009-11-10,MIA,,WAS,W 90-76,240,33,74,.446,29,62,.468,4,12,.333,20,26,.769,90
23912,2009-11-10,WAS,@,MIA,L 76-90,240,29,72,.403,25,58,.431,4,14,.286,14,21,.667,76
23913,2009-11-10,OKC,@,SAC,L 98-101,240,31,78,.397,25,61,.410,6,17,.353,30,35,.857,98
23914,2009-11-10,SAC,,OKC,W 101-98,240,34,76,.447,32,62,.516,2,14,.143,31,36,.861,101
23915,2009-11-09,GSW,,MIN,W 146-105,240,52,91,.571,40,68,.588,12,23,.522,30,38,.789,146
23916,2009-11-09,MIN,@,GSW,L 105-146,240,42,94,.447,37,74,.500,5,20,.250,16,20,.800,105
23917,2009-11-09,LAC,,NOH,L 84-112,240,34,79,.430,29,61,.475,5,18,.278,11,20,.550,84
23918,2009-11-09,NOP,@,LAC,W 112-84,240,43,86,.500,33,59,.559,10,27,.370,16,20,.800,112
23919,2009-11-09,NYK,,UTA,L 93-95,240,35,81,.432,27,52,.519,8,29,.276,15,23,.652,93
23920,2009-11-09,UTA,@,NYK,W 95-93,240,37,81,.457,29,60,.483,8,21,.381,13,20,.650,95
23921,2009-11-09,PHI,,PHO,L 115-119,240,44,82,.537,39,69,.565,5,13,.385,22,27,.815,115
23922,2009-11-09,PHO,@,PHI,W 119-115,240,41,77,.532,26,47,.553,15,30,.500,22,29,.759,119
23923,2009-11-09,SAS,,TOR,W 131-124,240,42,87,.483,28,59,.475,14,28,.500,33,44,.750,131
23924,2009-11-09,TOR,@,SAS,L 124-131,240,45,76,.592,34,59,.576,11,17,.647,23,29,.793,124
23925,2009-11-08,DET,,PHI,W 88-81,240,36,81,.444,33,65,.508,3,16,.188,13,21,.619,88
23926,2009-11-08,PHI,@,DET,L 81-88,240,34,78,.436,31,60,.517,3,18,.167,10,16,.625,81
23927,2009-11-08,LAL,,NOH,W 104-88,240,38,81,.469,26,54,.481,12,27,.444,16,18,.889,104
23928,2009-11-08,NOP,@,LAL,L 88-104,240,31,85,.365,24,63,.381,7,22,.318,19,23,.826,88
23929,2009-11-08,OKC,,ORL,W 102-74,240,40,70,.571,31,54,.574,9,16,.563,13,15,.867,102
23930,2009-11-08,ORL,@,OKC,L 74-102,240,25,68,.368,22,52,.423,3,16,.188,21,34,.618,74
23931,2009-11-08,MIN,@,POR,L 93-116,240,37,83,.446,30,64,.469,7,19,.368,12,21,.571,93
23932,2009-11-08,POR,,MIN,W 116-93,240,41,82,.500,34,67,.507,7,15,.467,27,30,.900,116
23933,2009-11-08,GSW,@,SAC,L 107-120,240,42,83,.506,36,65,.554,6,18,.333,17,28,.607,107
23934,2009-11-08,SAC,,GSW,W 120-107,240,43,87,.494,38,69,.551,5,18,.278,29,38,.763,120
23935,2009-11-08,PHO,@,WAS,W 102-90,240,42,88,.477,30,61,.492,12,27,.444,6,14,.429,102
23936,2009-11-08,WAS,,PHO,L 90-102,240,34,87,.391,30,71,.423,4,16,.250,18,27,.667,90
23937,2009-11-07,ATL,,DEN,W 125-100,240,45,87,.517,37,68,.544,8,19,.421,27,30,.900,125
23938,2009-11-07,DEN,@,ATL,L 100-125,240,32,78,.410,30,68,.441,2,10,.200,34,41,.829,100
23939,2009-11-07,CHA,@,CHI,L 90-93,240,34,86,.395,22,57,.386,12,29,.414,10,14,.714,90
23940,2009-11-07,CHI,,CHA,W 93-90,240,38,76,.500,34,67,.507,4,9,.444,13,22,.591,93
23941,2009-11-07,DAL,,TOR,W 129-101,240,53,85,.624,43,65,.662,10,20,.500,13,21,.619,129
23942,2009-11-07,TOR,@,DAL,L 101-129,240,36,82,.439,28,60,.467,8,22,.364,21,27,.778,101
23943,2009-11-07,LAC,,MEM,W 113-110,240,42,84,.500,36,63,.571,6,21,.286,23,33,.697,113
23944,2009-11-07,MEM,@,LAC,L 110-113,240,41,89,.461,39,79,.494,2,10,.200,26,32,.813,110
23945,2009-11-07,MIL,,NYK,W 102-87,240,41,88,.466,33,64,.516,8,24,.333,12,16,.750,102
23946,2009-11-07,NYK,@,MIL,L 87-102,240,33,80,.413,25,65,.385,8,15,.533,13,17,.765,87
23947,2009-11-07,BOS,@,NJN,W 86-76,240,31,69,.449,30,59,.508,1,10,.100,23,29,.793,86
23948,2009-11-07,BRK,,BOS,L 76-86,240,31,72,.431,26,61,.426,5,11,.455,9,14,.643,76
23949,2009-11-07,SAC,@,UTA,W 104-99,240,33,67,.493,22,48,.458,11,19,.579,27,32,.844,104
23950,2009-11-07,UTA,,SAC,L 99-104,240,37,76,.487,32,61,.525,5,15,.333,20,26,.769,99
23951,2009-11-06,BOS,,PHO,L 103-110,240,45,87,.517,41,69,.594,4,18,.222,9,18,.500,103
23952,2009-11-06,PHO,@,BOS,W 110-103,240,37,74,.500,24,50,.480,13,24,.542,23,30,.767,110
23953,2009-11-06,ATL,@,CHA,L 83-103,240,33,83,.398,31,67,.463,2,16,.125,15,23,.652,83
23954,2009-11-06,CHA,,ATL,W 103-83,240,39,83,.470,28,65,.431,11,18,.611,14,18,.778,103
23955,2009-11-06,GSW,,LAC,L 90-118,240,29,84,.345,22,62,.355,7,22,.318,25,33,.758,90
23956,2009-11-06,LAC,@,GSW,W 118-90,240,44,76,.579,38,63,.603,6,13,.462,24,32,.750,118
23957,2009-11-06,HOU,,OKC,W 105-94,240,42,78,.538,36,62,.581,6,16,.375,15,19,.789,105
23958,2009-11-06,OKC,@,HOU,L 94-105,240,40,92,.435,38,84,.452,2,8,.250,12,17,.706,94
23959,2009-11-06,IND,,WAS,W 102-86,240,34,85,.400,27,62,.435,7,23,.304,27,36,.750,102
23960,2009-11-06,WAS,@,IND,L 86-102,240,33,84,.393,28,68,.412,5,16,.313,15,26,.577,86
23961,2009-11-06,LAL,,MEM,W 114-98,240,48,95,.505,39,78,.500,9,17,.529,9,11,.818,114
23962,2009-11-06,MEM,@,LAL,L 98-114,240,36,79,.456,32,72,.444,4,7,.571,22,29,.759,98
23963,2009-11-06,DEN,@,MIA,L 88-96,240,34,72,.472,32,59,.542,2,13,.154,18,24,.750,88
23964,2009-11-06,MIA,,DEN,W 96-88,240,37,75,.493,31,58,.534,6,17,.353,16,24,.667,96
23965,2009-11-06,MIL,@,MIN,W 87-72,240,34,82,.415,27,62,.435,7,20,.350,12,18,.667,87
23966,2009-11-06,MIN,,MIL,L 72-87,240,29,74,.392,25,60,.417,4,14,.286,10,17,.588,72
23967,2009-11-06,NOP,,TOR,L 90-107,240,36,75,.480,30,55,.545,6,20,.300,12,19,.632,90
23968,2009-11-06,TOR,@,NOH,W 107-90,240,39,77,.506,25,48,.521,14,29,.483,15,23,.652,107
23969,2009-11-06,CLE,@,NYK,W 100-91,240,38,71,.535,31,54,.574,7,17,.412,17,26,.654,100
23970,2009-11-06,NYK,,CLE,L 91-100,240,36,81,.444,28,53,.528,8,28,.286,11,12,.917,91
23971,2009-11-06,DET,@,ORL,L 103-110,240,38,74,.514,34,63,.540,4,11,.364,23,37,.622,103
23972,2009-11-06,ORL,,DET,W 110-103,240,36,76,.474,28,48,.583,8,28,.286,30,35,.857,110
23973,2009-11-06,BRK,@,PHI,L 94-97,240,39,83,.470,35,69,.507,4,14,.286,12,19,.632,94
23974,2009-11-06,PHI,,NJN,W 97-94,240,36,72,.500,28,56,.500,8,16,.500,17,25,.680,97
23975,2009-11-06,POR,,SAS,W 96-84,240,32,74,.432,27,57,.474,5,17,.294,27,30,.900,96
23976,2009-11-06,SAS,@,POR,L 84-96,240,30,79,.380,26,58,.448,4,21,.190,20,26,.769,84
23977,2009-11-05,CHI,@,CLE,W 86-85,240,36,88,.409,33,78,.423,3,10,.300,11,14,.786,86
23978,2009-11-05,CLE,,CHI,L 85-86,240,33,81,.407,26,63,.413,7,18,.389,12,20,.600,85
23979,2009-11-05,SAS,@,UTA,L 99-113,240,35,81,.432,29,65,.446,6,16,.375,23,31,.742,99
23980,2009-11-05,UTA,,SAS,W 113-99,240,44,83,.530,43,76,.566,1,7,.143,24,30,.800,113
23981,2009-11-04,GSW,,MEM,W 113-105,240,47,87,.540,40,75,.533,7,12,.583,12,17,.706,113
23982,2009-11-04,MEM,@,GSW,L 105-113,240,39,80,.488,36,71,.507,3,9,.333,24,36,.667,105
23983,2009-11-04,HOU,,LAL,L 102-103 (OT),265,39,86,.453,32,62,.516,7,24,.292,17,24,.708,102
23984,2009-11-04,LAL,@,HOU,W 103-102 (OT),265,39,93,.419,34,78,.436,5,15,.333,20,28,.714,103
23985,2009-11-04,BOS,@,MIN,W 92-90,240,37,83,.446,32,64,.500,5,19,.263,13,19,.684,92
23986,2009-11-04,MIN,,BOS,L 90-92,240,39,75,.520,37,64,.578,2,11,.182,10,12,.833,90
23987,2009-11-04,DEN,@,NJN,W 122-94,240,44,83,.530,34,65,.523,10,18,.556,24,31,.774,122
23988,2009-11-04,BRK,,DEN,L 94-122,240,35,92,.380,33,77,.429,2,15,.133,22,28,.786,94
23989,2009-11-04,DAL,@,NOH,L 107-114 (OT),265,39,85,.459,28,59,.475,11,26,.423,18,24,.750,107
23990,2009-11-04,NOP,,DAL,W 114-107 (OT),265,46,92,.500,38,72,.528,8,20,.400,14,17,.824,114
23991,2009-11-04,IND,@,NYK,W 101-89,240,38,82,.463,33,61,.541,5,21,.238,20,28,.714,101
23992,2009-11-04,NYK,,IND,L 89-101,240,34,86,.395,27,60,.450,7,26,.269,14,18,.778,89
23993,2009-11-04,ORL,,PHO,W 122-100,240,46,88,.523,34,65,.523,12,23,.522,18,24,.750,122
23994,2009-11-04,PHO,@,ORL,L 100-122,240,40,88,.455,33,66,.500,7,22,.318,13,20,.650,100
23995,2009-11-04,ATL,@,SAC,W 113-105,240,46,85,.541,40,69,.580,6,16,.375,15,19,.789,113
23996,2009-11-04,SAC,,ATL,L 105-113,240,40,96,.417,35,81,.432,5,15,.333,20,27,.741,105
23997,2009-11-04,DET,@,TOR,L 99-110,240,37,83,.446,29,66,.439,8,17,.471,17,25,.680,99
23998,2009-11-04,TOR,,DET,W 110-99,240,33,76,.434,25,52,.481,8,24,.333,36,47,.766,110
23999,2009-11-04,MIA,@,WAS,W 93-89,240,35,72,.486,27,58,.466,8,14,.571,15,19,.789,93
24000,2009-11-04,WAS,,MIA,L 89-93,240,31,82,.378,26,66,.394,5,16,.313,22,28,.786,89
24001,2009-11-03,CHI,,MIL,W 83-81,240,29,74,.392,24,63,.381,5,11,.455,20,31,.645,83
24002,2009-11-03,MIL,@,CHI,L 81-83,240,36,91,.396,32,71,.451,4,20,.200,5,10,.500,81
24003,2009-11-03,CLE,,WAS,W 102-90,240,36,86,.419,25,60,.417,11,26,.423,19,27,.704,102
24004,2009-11-03,WAS,@,CLE,L 90-102,240,27,69,.391,23,55,.418,4,14,.286,32,41,.780,90
24005,2009-11-03,DAL,,UTA,W 96-85,240,34,86,.395,27,68,.397,7,18,.389,21,23,.913,96
24006,2009-11-03,UTA,@,DAL,L 85-96,240,34,82,.415,30,71,.423,4,11,.364,13,20,.650,85
24007,2009-11-03,DET,,ORL,W 85-80,240,27,72,.375,27,66,.409,0,6,.000,31,38,.816,85
24008,2009-11-03,ORL,@,DET,L 80-85,240,29,79,.367,19,44,.432,10,35,.286,12,16,.750,80
24009,2009-11-03,DEN,@,IND,W 111-93,240,35,82,.427,27,67,.403,8,15,.533,33,41,.805,111
24010,2009-11-03,IND,,DEN,L 93-111,240,36,91,.396,33,69,.478,3,22,.136,18,24,.750,93
24011,2009-11-03,MIA,,PHO,L 96-104,240,36,90,.400,27,66,.409,9,24,.375,15,17,.882,96
24012,2009-11-03,PHO,@,MIA,W 104-96,240,39,77,.506,30,54,.556,9,23,.391,17,27,.630,104
24013,2009-11-03,LAL,@,OKC,W 101-98 (OT),265,38,73,.521,33,62,.532,5,11,.455,20,28,.714,101
24014,2009-11-03,OKC,,LAL,L 98-101 (OT),265,38,88,.432,32,65,.492,6,23,.261,16,19,.842,98
24015,2009-11-03,BOS,@,PHI,W 105-74,240,41,72,.569,27,52,.519,14,20,.700,9,14,.643,105
24016,2009-11-03,PHI,,BOS,L 74-105,240,29,80,.363,28,64,.438,1,16,.063,15,22,.682,74
24017,2009-11-03,ATL,@,POR,W 97-91,240,37,80,.463,32,65,.492,5,15,.333,18,22,.818,97
24018,2009-11-03,POR,,ATL,L 91-97,240,36,85,.424,30,64,.469,6,21,.286,13,16,.813,91
24019,2009-11-02,CHA,,NJN,W 79-68,240,24,74,.324,23,59,.390,1,15,.067,30,35,.857,79
24020,2009-11-02,BRK,@,CHA,L 68-79,240,25,67,.373,22,57,.386,3,10,.300,15,18,.833,68
24021,2009-11-02,LAC,,MIN,W 93-90,240,32,75,.427,28,57,.491,4,18,.222,25,32,.781,93
24022,2009-11-02,MIN,@,LAC,L 90-93,240,37,88,.420,35,82,.427,2,6,.333,14,16,.875,90
24023,2009-11-02,NOP,@,NYK,L 111-117,240,42,86,.488,32,60,.533,10,26,.385,17,19,.895,111
24024,2009-11-02,NYK,,NOH,W 117-111,240,43,93,.462,36,70,.514,7,23,.304,24,28,.857,117
24025,2009-11-02,MEM,@,SAC,L 116-127 (OT),265,45,99,.455,40,90,.444,5,9,.556,21,27,.778,116
24026,2009-11-02,SAC,,MEM,W 127-116 (OT),265,45,93,.484,31,68,.456,14,25,.560,23,36,.639,127
24027,2009-11-02,HOU,@,UTA,W 113-96,240,42,84,.500,32,65,.492,10,19,.526,19,26,.731,113
24028,2009-11-02,UTA,,HOU,L 96-113,240,32,71,.451,29,60,.483,3,11,.273,29,34,.853,96
24029,2009-11-01,BOS,,NOH,W 97-87,240,41,76,.539,35,61,.574,6,15,.400,9,14,.643,97
24030,2009-11-01,NOP,@,BOS,L 87-97,240,34,81,.420,21,53,.396,13,28,.464,6,8,.750,87
24031,2009-11-01,DEN,,MEM,W 133-123,240,47,85,.553,38,68,.559,9,17,.529,30,37,.811,133
24032,2009-11-01,MEM,@,DEN,L 123-133,240,48,83,.578,40,65,.615,8,18,.444,19,29,.655,123
24033,2009-11-01,ATL,@,LAL,L 110-118,240,40,89,.449,33,66,.500,7,23,.304,23,26,.885,110
24034,2009-11-01,LAL,,ATL,W 118-110,240,46,87,.529,41,72,.569,5,15,.333,21,25,.840,118
24035,2009-11-01,CHI,@,MIA,L 87-95,240,36,88,.409,34,76,.447,2,12,.167,13,17,.765,87
24036,2009-11-01,MIA,,CHI,W 95-87,240,35,72,.486,31,57,.544,4,15,.267,21,25,.840,95
24037,2009-11-01,OKC,,POR,L 74-83,240,24,70,.343,21,56,.375,3,14,.214,23,32,.719,74
24038,2009-11-01,POR,@,OKC,W 83-74,240,28,69,.406,20,48,.417,8,21,.381,19,25,.760,83
24039,2009-11-01,MIN,@,PHO,L 112-120,240,45,97,.464,40,86,.465,5,11,.455,17,23,.739,112
24040,2009-11-01,PHO,,MIN,W 120-112,240,41,82,.500,27,56,.482,14,26,.538,24,30,.800,120
24041,2009-11-01,ORL,@,TOR,W 125-116,240,36,82,.439,19,50,.380,17,32,.531,36,41,.878,125
24042,2009-11-01,TOR,,ORL,L 116-125,240,40,74,.541,30,57,.526,10,17,.588,26,35,.743,116
24043,2009-10-31,CHA,@,CLE,L 79-90,240,29,68,.426,23,55,.418,6,13,.462,15,20,.750,79
24044,2009-10-31,CLE,,CHA,W 90-79,240,36,62,.581,27,46,.587,9,16,.563,9,14,.643,90
24045,2009-10-31,HOU,,POR,W 111-107,240,40,79,.506,28,55,.509,12,24,.500,19,26,.731,111
24046,2009-10-31,POR,@,HOU,L 107-111,240,38,74,.514,32,56,.571,6,18,.333,25,31,.806,107
24047,2009-10-31,DAL,@,LAC,W 93-84,240,35,84,.417,32,70,.457,3,14,.214,20,23,.870,93
24048,2009-10-31,LAC,,DAL,L 84-93,240,32,75,.427,26,58,.448,6,17,.353,14,18,.778,84
24049,2009-10-31,DET,@,MIL,L 85-96,240,31,71,.437,27,55,.491,4,16,.250,19,25,.760,85
24050,2009-10-31,MIL,,DET,W 96-85,240,32,78,.410,24,59,.407,8,19,.421,24,33,.727,96
24051,2009-10-31,NYK,,PHI,L 127-141 (OT),265,47,100,.470,33,59,.559,14,41,.341,19,24,.792,127
24052,2009-10-31,PHI,@,NYK,W 141-127 (OT),265,51,84,.607,48,76,.632,3,8,.375,36,42,.857,141
24053,2009-10-31,SAC,@,SAS,L 94-113,240,33,74,.446,27,57,.474,6,17,.353,22,33,.667,94
24054,2009-10-31,SAS,,SAC,W 113-94,240,43,74,.581,35,58,.603,8,16,.500,19,24,.792,113
24055,2009-10-31,BRK,@,WAS,L 104-123,240,37,80,.463,32,71,.451,5,9,.556,25,32,.781,104
24056,2009-10-31,WAS,,NJN,W 123-104,240,48,78,.615,39,64,.609,9,14,.643,18,23,.783,123
24057,2009-10-30,ATL,,WAS,W 100-89,240,32,78,.410,27,58,.466,5,20,.250,31,34,.912,100
24058,2009-10-30,WAS,@,ATL,L 89-100,240,35,79,.443,30,66,.455,5,13,.385,14,22,.636,89
24059,2009-10-30,BOS,,CHI,W 118-90,240,43,74,.581,31,50,.620,12,24,.500,20,24,.833,118
24060,2009-10-30,CHI,@,BOS,L 90-118,240,34,82,.415,32,67,.478,2,15,.133,20,27,.741,90
24061,2009-10-30,CHA,,NYK,W 102-100 (2OT),290,35,92,.380,32,74,.432,3,18,.167,29,36,.806,102
24062,2009-10-30,NYK,@,CHA,L 100-102 (2OT),290,38,98,.388,29,62,.468,9,36,.250,15,18,.833,100
24063,2009-10-30,DET,,OKC,L 83-91,240,26,70,.371,21,53,.396,5,17,.294,26,34,.765,83
24064,2009-10-30,OKC,@,DET,W 91-83,240,33,76,.434,31,65,.477,2,11,.182,23,30,.767,91
24065,2009-10-30,IND,,MIA,L 83-96,240,29,79,.367,25,56,.446,4,23,.174,21,26,.808,83
24066,2009-10-30,MIA,@,IND,W 96-83,240,30,69,.435,29,62,.468,1,7,.143,35,46,.761,96
24067,2009-10-30,DAL,@,LAL,W 94-80,240,32,77,.416,27,62,.435,5,15,.333,25,32,.781,94
24068,2009-10-30,LAL,,DAL,L 80-94,240,32,81,.395,25,58,.431,7,23,.304,9,14,.643,80
24069,2009-10-30,MEM,,TOR,W 115-107,240,42,82,.512,39,73,.534,3,9,.333,28,35,.800,115
24070,2009-10-30,TOR,@,MEM,L 107-115,240,39,88,.443,32,66,.485,7,22,.318,22,28,.786,107
24071,2009-10-30,CLE,@,MIN,W 104-87,240,40,84,.476,30,66,.455,10,18,.556,14,20,.700,104
24072,2009-10-30,MIN,,CLE,L 87-104,240,36,86,.419,33,72,.458,3,14,.214,12,17,.706,87
24073,2009-10-30,BRK,,ORL,L 85-95,240,31,81,.383,26,66,.394,5,15,.333,18,25,.720,85
24074,2009-10-30,ORL,@,NJN,W 95-85,240,37,75,.493,31,54,.574,6,21,.286,15,25,.600,95
24075,2009-10-30,NOP,,SAC,W 97-92,240,33,73,.452,28,57,.491,5,16,.313,26,32,.813,97
24076,2009-10-30,SAC,@,NOH,L 92-97,240,36,96,.375,29,72,.403,7,24,.292,13,20,.650,92
24077,2009-10-30,MIL,@,PHI,L 86-99,240,34,85,.400,27,62,.435,7,23,.304,11,19,.579,86
24078,2009-10-30,PHI,,MIL,W 99-86,240,32,70,.457,26,52,.500,6,18,.333,29,34,.853,99
24079,2009-10-30,GSW,@,PHO,L 101-123,240,36,85,.424,30,72,.417,6,13,.462,23,28,.821,101
24080,2009-10-30,PHO,,GSW,W 123-101,240,45,84,.536,33,62,.532,12,22,.545,21,34,.618,123
24081,2009-10-30,LAC,@,UTA,L 98-111,240,34,74,.459,28,61,.459,6,13,.462,24,34,.706,98
24082,2009-10-30,UTA,,LAC,W 111-98,240,45,90,.500,43,81,.531,2,9,.222,19,25,.760,111
24083,2009-10-29,CHI,,SAS,W 92-85,240,35,84,.417,32,68,.471,3,16,.188,19,28,.679,92
24084,2009-10-29,SAS,@,CHI,L 85-92,240,33,78,.423,29,57,.509,4,21,.190,15,23,.652,85
24085,2009-10-29,DEN,@,POR,W 97-94,240,28,61,.459,25,50,.500,3,11,.273,38,49,.776,97
24086,2009-10-29,POR,,DEN,L 94-97,240,28,81,.346,23,62,.371,5,19,.263,33,41,.805,94
24087,2009-10-28,ATL,,IND,W 120-109,240,46,87,.529,39,75,.520,7,12,.583,21,29,.724,120
24088,2009-10-28,IND,@,ATL,L 109-120,240,39,73,.534,29,55,.527,10,18,.556,21,25,.840,109
24089,2009-10-28,BOS,,CHA,W 92-59,240,33,76,.434,22,47,.468,11,29,.379,15,19,.789,92
24090,2009-10-28,CHA,@,BOS,L 59-92,240,23,74,.311,23,64,.359,0,10,.000,13,25,.520,59
24091,2009-10-28,DEN,,UTA,W 114-105,240,43,89,.483,38,76,.500,5,13,.385,23,30,.767,114
24092,2009-10-28,UTA,@,DEN,L 105-114,240,37,81,.457,31,71,.437,6,10,.600,25,29,.862,105
24093,2009-10-28,GSW,,HOU,L 107-108,240,44,89,.494,40,78,.513,4,11,.364,15,23,.652,107
24094,2009-10-28,HOU,@,GSW,W 108-107,240,40,86,.465,28,60,.467,12,26,.462,16,20,.800,108
24095,2009-10-28,LAC,,PHO,L 107-109,240,43,77,.558,37,64,.578,6,13,.462,15,27,.556,107
24096,2009-10-28,PHO,@,LAC,W 109-107,240,41,80,.513,34,65,.523,7,15,.467,20,27,.741,109
24097,2009-10-28,DET,@,MEM,W 96-74,240,37,72,.514,31,56,.554,6,16,.375,16,29,.552,96
24098,2009-10-28,MEM,,DET,L 74-96,240,26,72,.361,24,60,.400,2,12,.167,20,31,.645,74
24099,2009-10-28,MIA,,NYK,W 115-93,240,47,83,.566,40,68,.588,7,15,.467,14,17,.824,115
24100,2009-10-28,NYK,@,MIA,L 93-115,240,33,87,.379,23,48,.479,10,39,.256,17,21,.810,93
24101,2009-10-28,MIN,,NJN,W 95-93,240,34,93,0.366,33,86,0.384,1,7,0.14300000000000002,26,35,0.743,95
24102,2009-10-28,BRK,@,MIN,L 93-95,240,34,81,0.42,34,73,0.466,0,8,0.0,25,29,0.862,93
24103,2009-10-28,OKC,,SAC,W 102-89,240,39,76,0.513,31,62,0.5,8,14,0.5710000000000001,16,20,0.8,102
24104,2009-10-28,SAC,@,OKC,L 89-102,240,32,79,0.405,29,63,0.46,3,16,0.188,22,28,0.7859999999999999,89
24105,2009-10-28,ORL,,PHI,W 120-106,240,45,81,0.556,29,52,0.5579999999999999,16,29,0.552,14,17,0.8240000000000001,120
24106,2009-10-28,PHI,@,ORL,L 106-120,240,39,78,0.5,32,60,0.5329999999999999,7,18,0.389,21,30,0.7,106
24107,2009-10-28,NOP,@,SAS,L 96-113,240,39,78,0.5,34,68,0.5,5,10,0.5,13,22,0.591,96
24108,2009-10-28,SAS,,NOH,W 113-96,240,45,86,0.523,36,62,0.581,9,24,0.375,14,20,0.7,113
24109,2009-10-28,CLE,@,TOR,L 91-101,240,29,83,0.349,20,61,0.32799999999999996,9,22,0.409,24,37,0.649,91
24110,2009-10-28,TOR,,CLE,W 101-91,240,34,75,0.45299999999999996,29,59,0.49200000000000005,5,16,0.313,28,37,0.757,101
24111,2009-10-27,BOS,@,CLE,W 95-89,240,32,72,0.444,23,53,0.434,9,19,0.474,22,26,0.846,95
24112,2009-10-27,CLE,,BOS,L 89-95,240,29,70,0.414,23,53,0.434,6,17,0.353,25,32,0.7809999999999999,89
24113,2009-10-27,DAL,,WAS,L 91-102,240,30,76,0.395,26,58,0.44799999999999995,4,18,0.222,27,34,0.794,91
24114,2009-10-27,WAS,@,DAL,W 102-91,240,39,84,0.46399999999999997,35,71,0.493,4,13,0.308,20,24,0.833,102
24115,2009-10-27,LAC,@,LAL,L 92-99,240,39,87,0.44799999999999995,36,72,0.5,3,15,0.2,11,16,0.688,92
24116,2009-10-27,LAL,,LAC,W 99-92,240,35,85,0.41200000000000003,31,68,0.456,4,17,0.235,25,37,0.6759999999999999,99
24117,2009-10-27,HOU,@,POR,L 87-96,240,30,81,0.37,25,63,0.397,5,18,0.278,22,29,0.759,87
24118,2009-10-27,POR,,HOU,W 96-87,240,33,77,0.429,23,56,0.41100000000000003,10,21,0.47600000000000003,20,22,0.909,96
